,fips,county,state,election,democrat,republican,other,total,democrat_percent,republican_percent,other_percent,democrat_diff,other_diff,republican_diff,total_diff,democrat_percent_diff,other_percent_diff,republican_percent_diff,democrat_margin,democrat_margin_diff,democrat_margin_percent,democrat_margin_percent_diff
0,2,Alaska,Alaska,2000,79004,167398,39158,285560,0.27666339823504693,0.5862095531587057,0.1371270486062474,0,0,0,0,0.0,0.0,0.0,-88394,0,-0.3095461549236588,0.0
1,2,Alaska,Alaska,2004,111025,190889,10684,312598,0.35516861912104364,0.6106532991253942,0.03417808175356208,32021,-28474,23491,27038,0.07850522088599671,-0.10294896685268531,0.024443745966688524,-79864,8530,-0.2554846800043506,0.05406147491930818
2,2,Alaska,Alaska,2008,123594,193841,8762,326197,0.37889373599389325,0.5942451953880631,0.026861068618043698,12569,-1922,2952,13599,0.023725116872849616,-0.007317013135518382,-0.016408103737331148,-70247,9617,-0.21535145939416983,0.040133220610180764
3,2,Alaska,Alaska,2012,122640,164676,13179,300495,0.40812659112464433,0.5480157739729447,0.04385763490241102,-954,4417,-29165,-25702,0.02923285513075108,0.016996566284367323,-0.04622942141511843,-42036,28211,-0.13988918284830032,0.07546227654586951
4,2,Alaska,Alaska,2016,116454,163387,38767,318608,0.36550871290111986,0.5128151207753728,0.12167616632350725,-6186,25588,-1289,18113,-0.042617878223524475,0.07781853142109624,-0.03520065319757182,-46933,-4897,-0.14730640787425298,-0.007417225025952656
5,1001,Autauga,Alabama,2000,4942,11993,273,17208,0.2871920037192004,0.6969432821943282,0.01586471408647141,0,0,0,0,0.0,0.0,0.0,-7051,0,-0.4097512784751278,0.0
6,1001,Autauga,Alabama,2004,4758,15196,127,20081,0.2369403914147702,0.7567352223494845,0.006324386235745232,-184,-146,3203,2873,-0.050251612304430204,-0.009540327850726176,0.05979194015515632,-10438,-3387,-0.5197948309347143,-0.11004355245958652
7,1001,Autauga,Alabama,2008,6093,17403,145,23641,0.25773021445793326,0.7361363732498625,0.006133412292204221,1335,18,2207,3560,0.02078982304316307,-0.0001909739435410106,-0.020598849099622063,-11310,-872,-0.4784061587919292,0.04138867214278513
8,1001,Autauga,Alabama,2012,6363,17379,231,23973,0.2654236015517457,0.7249405581278939,0.009635840320360406,270,86,-24,332,0.007693387093812454,0.003502428028156185,-0.011195815121968544,-11016,294,-0.4595169565761482,0.018889202215780998
9,1001,Autauga,Alabama,2016,5936,18172,865,24973,0.2376967124494454,0.7276658791494814,0.03463740840107316,-427,634,793,1000,-0.02772688910230031,0.025001568080712758,0.0027253210215875123,-12236,-1220,-0.48996916670003604,-0.030452210123887824
10,1003,Baldwin,Alabama,2000,13997,40872,1611,56480,0.24782223796033995,0.7236543909348442,0.028523371104815863,0,0,0,0,0.0,0.0,0.0,-26875,0,-0.4758321529745042,0.0
11,1003,Baldwin,Alabama,2004,15599,52971,750,69320,0.22502885170225043,0.7641517599538373,0.01081938834391229,1602,-861,12099,12840,-0.02279338625808952,-0.017703982760903573,0.040497369018993146,-37372,-10497,-0.5391229082515869,-0.06329075527708272
12,1003,Baldwin,Alabama,2008,19386,61271,756,81413,0.23811921928930269,0.7525947944431479,0.00928598626754941,3787,6,8300,12093,0.01309036758705226,-0.001533402076362881,-0.01155696551068941,-41885,-4513,-0.5144755751538452,0.024647333097741697
13,1003,Baldwin,Alabama,2012,18424,66016,1051,85491,0.21550806517645132,0.7721982430899159,0.01229369173363278,-962,295,4745,4078,-0.02261115411285136,0.003007705466083371,0.019603448646767996,-47592,-5707,-0.5566901779134645,-0.0422146027596193
14,1003,Baldwin,Alabama,2016,18458,72883,3874,95215,0.193856010082445,0.765457123352413,0.040686866565142046,34,2823,6867,9724,-0.021652055094006334,0.028393174831509264,-0.00674111973750291,-54425,-6833,-0.571601113269968,-0.014910935356503452
15,1005,Barbour,Alabama,2000,5188,5096,111,10395,0.4990860990860991,0.49023569023569025,0.010678210678210679,0,0,0,0,0.0,0.0,0.0,92,0,0.00885040885040883,0.0
16,1005,Barbour,Alabama,2004,4832,5899,46,10777,0.4483622529460889,0.5473693977915932,0.0042683492623178994,-356,-65,803,382,-0.05072384614001019,-0.00640986141589278,0.05713370755590297,-1067,-1159,-0.09900714484550432,-0.10785755369591316
17,1005,Barbour,Alabama,2008,5697,5866,67,11630,0.48985382631126395,0.5043852106620809,0.005760963026655202,865,21,-33,853,0.04149157336517506,0.001492613764337303,-0.04298418712951235,-169,898,-0.014531384350816912,0.08447576049468741
18,1005,Barbour,Alabama,2012,5912,5550,55,11517,0.5133281236433099,0.4818963271685335,0.004775549188156638,215,-12,-316,-113,0.02347429733204598,-0.000985413838498564,-0.022488883493547385,362,531,0.03143179647477645,0.045963180825593364
19,1005,Barbour,Alabama,2016,4871,5454,144,10469,0.46527844111185407,0.5209666634826631,0.013754895405482854,-1041,89,-96,-1048,-0.04804968253145586,0.008979346217326215,0.039070336314129595,-583,-945,-0.055688222370809004,-0.08712001884558546
20,1007,Bibb,Alabama,2000,2710,4273,118,7101,0.381636389240952,0.6017462329249401,0.016617377834107872,0,0,0,0,0.0,0.0,0.0,-1563,0,-0.22010984368398812,0.0
21,1007,Bibb,Alabama,2004,2089,5472,39,7600,0.2748684210526316,0.72,0.005131578947368421,-621,-79,1199,499,-0.1067679681883204,-0.011485798886739451,0.11825376707505986,-3383,-1820,-0.4451315789473684,-0.22502173526338026
22,1007,Bibb,Alabama,2008,2299,6262,83,8644,0.2659648310967145,0.7244331328088848,0.00960203609440074,210,44,790,1044,-0.008903589955917113,0.004470457147032319,0.004433132808884799,-3963,-580,-0.4584683017121703,-0.013336722764801912
23,1007,Bibb,Alabama,2012,2202,6132,86,8420,0.261520190023753,0.7282660332541567,0.010213776722090262,-97,3,-130,-224,-0.004444641072961497,0.0006117406276895214,0.0038329004452719584,-3930,33,-0.46674584323040375,-0.008277541518233456
24,1007,Bibb,Alabama,2016,1874,6738,207,8819,0.21249574781721284,0.7640322031976414,0.023472048985145707,-328,121,606,399,-0.04902444220654015,0.013258272263055445,0.035766169943484694,-4864,-934,-0.5515364553804286,-0.08479061215002487
25,1009,Blount,Alabama,2000,4977,12667,329,17973,0.2769153730595894,0.704779391309186,0.018305235631224614,0,0,0,0,0.0,0.0,0.0,-7690,0,-0.4278640182495966,0.0
26,1009,Blount,Alabama,2004,3938,17386,180,21504,0.18312872023809523,0.8085007440476191,0.008370535714285714,-1039,-149,4719,3531,-0.09378665282149418,-0.0099346999169389,0.10372135273843308,-13448,-5758,-0.6253720238095238,-0.19750800555992726
27,1009,Blount,Alabama,2008,3522,20389,356,24267,0.14513536901965632,0.8401945028227634,0.014670128157580254,-416,176,3003,2763,-0.037993351218438914,0.00629959244329454,0.031693758775144354,-16867,-3419,-0.6950591338031071,-0.0696871099935833
28,1009,Blount,Alabama,2012,2970,20757,333,24060,0.12344139650872818,0.862718204488778,0.013840399002493765,-552,-23,368,-207,-0.02169397251092814,-0.0008297291550864883,0.022523701666014584,-17787,-920,-0.7392768079800498,-0.04421767417694267
29,1009,Blount,Alabama,2016,2156,22859,573,25588,0.08425824605283727,0.8933484445833985,0.022393309363764265,-814,240,2102,1528,-0.03918315045589091,0.0085529103612705,0.030630240094620453,-20703,-2916,-0.8090901985305612,-0.06981339055051139
30,1011,Bullock,Alabama,2000,3395,1433,76,4904,0.6922920065252854,0.29221044045676997,0.015497553017944535,0,0,0,0,0.0,0.0,0.0,1962,0,0.40008156606851547,0.0
31,1011,Bullock,Alabama,2004,3210,1494,13,4717,0.6805172779308882,0.31672673309306765,0.002755988976044096,-185,-63,61,-187,-0.01177472859439721,-0.01274156404190044,0.024516292636297676,1716,-246,0.3637905448378206,-0.036291021230694887
32,1011,Bullock,Alabama,2008,4011,1391,13,5415,0.7407202216066482,0.25687903970452447,0.0024007386888273315,801,0,-103,698,0.06020294367575996,-0.00035525028721676436,-0.05984769338854318,2620,904,0.4838411819021237,0.12005063706430313
33,1011,Bullock,Alabama,2012,4061,1251,10,5322,0.7630590003757985,0.2350620067643743,0.0018789928598271326,50,-3,-140,-93,0.022338778769150358,-0.0005217458290001989,-0.021817032940150166,2810,190,0.5279969936114243,0.04415581170930055
34,1011,Bullock,Alabama,2016,3530,1140,40,4710,0.7494692144373672,0.24203821656050956,0.008492569002123142,-531,30,-111,-612,-0.013589785938431298,0.0066135761422960095,0.006976209796135252,2390,-420,0.5074309978768576,-0.020565995734566633
35,1013,Butler,Alabama,2000,3606,4127,70,7803,0.46212995001922336,0.5288991413558888,0.008970908624887863,0,0,0,0,0.0,0.0,0.0,-521,0,-0.06676919133666542,0.0
36,1013,Butler,Alabama,2004,3413,4979,24,8416,0.405537072243346,0.591611216730038,0.0028517110266159697,-193,-46,852,613,-0.05659287777587735,-0.006119197598271894,0.06271207537414925,-1566,-1045,-0.18607414448669202,-0.1193049531500266
37,1013,Butler,Alabama,2008,4188,5485,36,9709,0.43135235348645584,0.5649397466268411,0.003707899886703059,775,12,506,1293,0.025815281243109833,0.0008561888600870891,-0.026671470103196926,-1297,269,-0.13358739314038526,0.05248675134630676
38,1013,Butler,Alabama,2012,4374,5087,41,9502,0.46032414228583457,0.5353609766364976,0.00431488107766786,186,5,-398,-207,0.028971788799378728,0.0006069811909648008,-0.02957876999034348,-713,584,-0.07503683435066305,0.05855055878972221
39,1013,Butler,Alabama,2016,3726,4901,105,8732,0.4267063673843335,0.5612688960146587,0.012024736601007788,-648,64,-186,-770,-0.033617774901501085,0.0077098555233399285,0.02590791937816106,-1175,-462,-0.1345625286303252,-0.059525694279662145
40,1015,Calhoun,Alabama,2000,15781,22306,822,38909,0.40558739623223417,0.5732863861831453,0.021126217584620525,0,0,0,0,0.0,0.0,0.0,-6525,0,-0.16769898995091115,0.0
41,1015,Calhoun,Alabama,2004,15083,29814,352,45249,0.3333333333333333,0.6588874892262813,0.0077791774403854225,-698,-470,7508,6340,-0.07225406289890085,-0.013347040144235102,0.08560110304313595,-14731,-8206,-0.32555415589294795,-0.1578551659420368
42,1015,Calhoun,Alabama,2008,16334,32348,560,49242,0.331708703951911,0.6569188903781324,0.011372405669956542,1251,208,2534,3993,-0.0016246293814223267,0.0035932282295711195,-0.001968598848148817,-16014,-1283,-0.32521018642622146,0.0003439694667264903
43,1015,Calhoun,Alabama,2012,15511,30278,575,46364,0.3345483564834786,0.6530497800017254,0.012401863514795962,-823,15,-2070,-2878,0.0028396525315675936,0.00102945784483942,-0.0038691103764070256,-14767,1247,-0.31850142351824684,0.006708762907974619
44,1015,Calhoun,Alabama,2016,13242,32865,1757,47864,0.2766588667892362,0.6866329600534848,0.03670817315727896,-2269,1182,2587,1500,-0.0578894896942424,0.024306309642482996,0.03358318005175942,-19623,-4856,-0.40997409326424866,-0.09147266974600182
45,1017,Chambers,Alabama,2000,5616,6037,181,11834,0.47456481324995775,0.5101402737873922,0.015294912962649992,0,0,0,0,0.0,0.0,0.0,-421,0,-0.03557546053743449,0.0
46,1017,Chambers,Alabama,2004,5347,7622,63,13032,0.41029772866789443,0.5848680171884592,0.004834254143646409,-269,-118,1585,1198,-0.06426708458206332,-0.010460658819003583,0.07472774340106692,-2275,-1854,-0.17457028852056472,-0.13899482798313023
47,1017,Chambers,Alabama,2008,6799,8067,90,14956,0.4546001604707141,0.5393821877507355,0.006017651778550415,1452,27,445,1924,0.044302431802819675,0.0011833976349040062,-0.04548582943772361,-1268,1007,-0.08478202728002143,0.08978826124054329
48,1017,Chambers,Alabama,2012,6871,7626,132,14629,0.46968350536605374,0.5212933214847221,0.009023173149224144,72,42,-441,-327,0.015083344895339634,0.0030055213706737293,-0.01808886626601347,-755,513,-0.05160981611866833,0.033172211161353105
49,1017,Chambers,Alabama,2016,5784,7843,273,13900,0.41611510791366907,0.5642446043165468,0.019640287769784173,-1087,141,217,-729,-0.053568397452384675,0.010617114620560029,0.0429512828318247,-2059,-1304,-0.1481294964028777,-0.09651968028420937
50,1019,Cherokee,Alabama,2000,3497,4154,172,7823,0.4470152115556692,0.5309983382334142,0.02198645021091653,0,0,0,0,0.0,0.0,0.0,-657,0,-0.08398312667774505,0.0
51,1019,Cherokee,Alabama,2004,3040,5923,86,9049,0.33594872361586914,0.6545474638081556,0.009503812575975245,-457,-86,1769,1226,-0.11106648793980006,-0.012482637634941283,0.1235491255747414,-2883,-2226,-0.3185987401922865,-0.23461561351454147
52,1019,Cherokee,Alabama,2008,2306,7298,141,9745,0.2366341713699333,0.748896870189841,0.014468958440225757,-734,55,1375,696,-0.09931455224593583,0.004965145864250512,0.09434940638168532,-4992,-2109,-0.5122626988199077,-0.1936639586276212
53,1019,Cherokee,Alabama,2012,2132,7506,154,9792,0.21772875816993464,0.7665441176470589,0.015727124183006536,-174,13,208,47,-0.018905413199998666,0.0012581657427807782,0.017647247457217907,-5374,-382,-0.5488153594771242,-0.03655266065721652
54,1019,Cherokee,Alabama,2016,1547,8953,233,10733,0.14413491102208142,0.8341563402590143,0.021708748718904314,-585,79,1447,941,-0.07359384714785322,0.005981624535897779,0.06761222261195543,-7406,-2032,-0.6900214292369329,-0.14120606975980865
55,1021,Chilton,Alabama,2000,4806,10066,220,15092,0.3184468592631858,0.6669758812615956,0.014577259475218658,0,0,0,0,0.0,0.0,0.0,-5260,0,-0.3485290219984098,0.0
56,1021,Chilton,Alabama,2004,3778,12829,86,16693,0.2263224105912658,0.7685257293476307,0.005151860061103457,-1028,-134,2763,1601,-0.09212444867191999,-0.009425399414115201,0.10154984808603518,-9051,-3791,-0.542203318756365,-0.19367429675795517
57,1021,Chilton,Alabama,2008,3674,13960,151,17785,0.20657857745290975,0.7849311217317965,0.008490300815293787,-104,65,1131,1092,-0.019743833138356037,0.00333844075419033,0.016405392384165718,-10286,-1235,-0.5783525442788867,-0.036149225522521755
58,1021,Chilton,Alabama,2012,3397,13932,156,17485,0.1942808121246783,0.7967972547898199,0.008921933085501859,-277,5,-28,-300,-0.012297765328231458,0.00043163227020807243,0.01186613305802342,-10535,-249,-0.6025164426651416,-0.02416389838625488
59,1021,Chilton,Alabama,2016,2911,15081,377,18369,0.15847351516141325,0.8210027764167892,0.020523708421797595,-486,221,1149,884,-0.03580729696326504,0.011601775336295736,0.024205521626969317,-12170,-1635,-0.6625292612553759,-0.06001281859023433
60,1023,Choctaw,Alabama,2000,3707,3600,67,7374,0.5027122321670735,0.4882017900732303,0.00908597775969623,0,0,0,0,0.0,0.0,0.0,107,0,0.014510442093843223,0.0
61,1023,Choctaw,Alabama,2004,3303,3897,27,7227,0.45703611457036114,0.539227895392279,0.0037359900373599006,-404,-40,297,-147,-0.04567611759671236,-0.005349987722336329,0.05102610531904872,-594,-701,-0.08219178082191786,-0.09670222291576108
62,1023,Choctaw,Alabama,2008,3636,4223,35,7894,0.46060298961236384,0.5349632632379022,0.004433747149733975,333,8,326,667,0.003566875042002704,0.0006977571123740747,-0.0042646321543767796,-587,7,-0.07436027362553838,0.007831507196379484
63,1023,Choctaw,Alabama,2012,3786,4152,38,7976,0.4746740220661986,0.5205616850551655,0.004764292878635908,150,3,-71,82,0.014071032453834731,0.00033054572890193253,-0.014401578182736685,-366,221,-0.04588766298896696,0.028472610636571416
64,1023,Choctaw,Alabama,2016,3109,4106,77,7292,0.4263576522216127,0.5630828304991772,0.010559517279210093,-677,39,-46,-684,-0.04831636984458587,0.005795224400574186,0.04252114544401164,-997,-631,-0.13672517827756447,-0.09083751528859751
65,1025,Clarke,Alabama,2000,4679,5988,85,10752,0.43517485119047616,0.5569196428571429,0.007905505952380952,0,0,0,0,0.0,0.0,0.0,-1309,0,-0.12174479166666674,0.0
66,1025,Clarke,Alabama,2004,4627,6730,37,11394,0.40609092504827105,0.5906617517991926,0.0032473231525364226,-52,-48,742,642,-0.02908392614220512,-0.0046581827998445294,0.03374210894204965,-2103,-794,-0.1845708267509215,-0.06282603508425477
67,1025,Clarke,Alabama,2008,5914,7466,55,13435,0.44019352437662823,0.5557126907331597,0.004093784890212133,1287,18,736,2041,0.034102599328357186,0.0008464617376757102,-0.034949061066032905,-1552,551,-0.11551916635653142,0.06905166039439009
68,1025,Clarke,Alabama,2012,6334,7470,56,13860,0.456998556998557,0.538961038961039,0.00404040404040404,420,1,4,425,0.016805032621928784,-5.338084980809239e-05,-0.01675165177212068,-1136,416,-0.08196248196248196,0.03355668439404946
69,1025,Clarke,Alabama,2016,5749,7140,142,13031,0.4411787276494513,0.5479241807996317,0.010897091550917044,-585,86,-330,-829,-0.015819829349105696,0.006856687510513004,0.008963141838592703,-1391,-255,-0.10674545315018036,-0.0247829711876984
70,1027,Clay,Alabama,2000,2045,3719,119,5883,0.34761176270610233,0.6321604623491416,0.020227774944756076,0,0,0,0,0.0,0.0,0.0,-1674,0,-0.28454869964303925,0.0
71,1027,Clay,Alabama,2004,1893,4624,59,6576,0.28786496350364965,0.7031630170316302,0.008972019464720194,-152,-60,905,693,-0.05974679920245268,-0.011255755480035882,0.07100255468248862,-2731,-1057,-0.41529805352798055,-0.1307493538849413
72,1027,Clay,Alabama,2008,1760,4984,75,6819,0.25810236105000733,0.7308989587916117,0.010998680158380994,-133,16,360,243,-0.029762602453642317,0.0020266606936608002,0.02773594175998151,-3224,-493,-0.4727965977416044,-0.057498544213623826
73,1027,Clay,Alabama,2012,1777,4817,85,6679,0.2660577930827968,0.7212157508609073,0.012726456056295852,17,10,-167,-140,0.007955432032789478,0.0017277758979148579,-0.00968320793070443,-3040,184,-0.45515795777811047,0.017638639963493907
74,1027,Clay,Alabama,2016,1237,5245,142,6624,0.1867451690821256,0.7918176328502415,0.021437198067632852,-540,57,428,-55,-0.07931262400067121,0.008710742011337,0.07060188198933426,-4008,-968,-0.605072463768116,-0.1499145059900055
75,1029,Cleburne,Alabama,2000,1664,3333,95,5092,0.3267871170463472,0.6545561665357423,0.018656716417910446,0,0,0,0,0.0,0.0,0.0,-1669,0,-0.3277690494893951,0.0
76,1029,Cleburne,Alabama,2004,1391,4370,37,5798,0.2399103139013453,0.753708175232839,0.006381510865815798,-273,-58,1037,706,-0.08687680314500193,-0.012275205552094649,0.09915200869709662,-2979,-1310,-0.5137978613314936,-0.18602881184209852
77,1029,Cleburne,Alabama,2008,1168,5216,108,6492,0.17991373998767715,0.8034504004929144,0.0166358595194085,-223,71,846,694,-0.05999657391366814,0.010254348653592704,0.049742225260075434,-4048,-1069,-0.6235366605052373,-0.10973879917374363
78,1029,Cleburne,Alabama,2012,971,5272,76,6319,0.15366355435986706,0.8343092261433771,0.012027219496755816,-197,-32,56,-173,-0.02625018562781009,-0.004608640022652686,0.030858825650462718,-4301,-253,-0.6806456717835101,-0.057109011278272837
79,1029,Cleburne,Alabama,2016,684,5764,145,6593,0.1037463976945245,0.8742605794023964,0.021993022903079022,-287,69,492,274,-0.04991715666534256,0.009965803406323206,0.03995135325901933,-5080,-779,-0.7705141817078719,-0.0898685099243618
80,1031,Coffee,Alabama,2000,5220,9938,276,15434,0.3382143319942983,0.6439030711416354,0.017882596864066347,0,0,0,0,0.0,0.0,0.0,-4718,0,-0.3056887391473371,0.0
81,1031,Coffee,Alabama,2004,4480,13019,117,17616,0.254314259763851,0.739044050862852,0.006641689373297003,-740,-159,3081,2182,-0.08390007223044726,-0.011240907490769343,0.0951409797212166,-8539,-3821,-0.48472979109900094,-0.17904105195166387
82,1031,Coffee,Alabama,2008,5079,14919,130,20128,0.25233505564387915,0.7412062798092209,0.006458664546899841,599,13,1900,2512,-0.001979204119971878,-0.00018302482639716202,0.0021622289463689714,-9840,-1301,-0.4888712241653418,-0.004141433066340849
83,1031,Coffee,Alabama,2012,4925,14666,230,19821,0.24847384087583876,0.7399223046264063,0.011603854497754907,-154,100,-253,-307,-0.003861214768040383,0.005145189950855066,-0.001283975182814645,-9741,99,-0.4914484637505675,-0.00257723958522571
84,1031,Coffee,Alabama,2016,4221,15875,671,20767,0.20325516444358838,0.7644339577213849,0.03231087783502672,-704,441,1209,946,-0.04521867643225039,0.020707023337271816,0.024511653094978603,-11654,-1913,-0.5611787932777965,-0.06973032952722902
85,1033,Colbert,Alabama,2000,10543,10518,471,21532,0.4896433215678989,0.4884822589634033,0.021874419468697753,0,0,0,0,0.0,0.0,0.0,25,0,0.0011610626044956107,0.0
86,1033,Colbert,Alabama,2004,10598,13188,149,23935,0.44278253603509504,0.5509922707332359,0.0062251932316691036,55,-322,2670,2403,-0.04686078553280387,-0.01564922623702865,0.06251001176983256,-2590,-2615,-0.10820973469814082,-0.10937079730263644
87,1033,Colbert,Alabama,2008,9703,14739,401,24843,0.39057279716620374,0.5932858350440768,0.01614136778971944,-895,252,1551,908,-0.0522097388688913,0.009916174558050335,0.04229356431084097,-5036,-2446,-0.2027130378778731,-0.09450330317973227
88,1033,Colbert,Alabama,2012,9166,13936,342,23444,0.39097423647841667,0.5944378092475687,0.014587954274014674,-537,-59,-803,-1399,0.0004014393122129256,-0.0015534135157047654,0.00115197420349189,-4770,266,-0.20346357276915206,-0.0007505348912789644
89,1033,Colbert,Alabama,2016,7312,16746,857,24915,0.2934778246036524,0.6721252257676099,0.03439694962873771,-1854,515,2810,1471,-0.09749641187476427,0.01980899535472304,0.07768741652004119,-9434,-4664,-0.3786474011639575,-0.17518382839480545
90,1035,Conecuh,Alabama,2000,2783,2699,69,5551,0.5013511079084849,0.4862186993334534,0.012430192758061611,0,0,0,0,0.0,0.0,0.0,84,0,0.015132408575031508,0.0
91,1035,Conecuh,Alabama,2004,2719,3271,31,6021,0.4515861152632453,0.543265238332503,0.0051486464042517855,-64,-38,572,470,-0.04976499264523959,-0.007281546353809826,0.057046538999049545,-552,-636,-0.09167912306925763,-0.10681153164428914
92,1035,Conecuh,Alabama,2008,3429,3470,44,6943,0.49387872677516925,0.49978395506265305,0.006337318162177733,710,13,199,922,0.04229261151192393,0.0011886717579259473,-0.0434812832698499,-41,511,-0.005905228287483799,0.08577389478177383
93,1035,Conecuh,Alabama,2012,3555,3439,31,7025,0.5060498220640569,0.4895373665480427,0.004412811387900356,126,-13,-31,82,0.012171095288887657,-0.001924506774277377,-0.010246588514610355,116,157,0.016512455516014213,0.022417683803498012
94,1035,Conecuh,Alabama,2016,3080,3420,85,6585,0.4677296886864085,0.5193621867881549,0.012908124525436599,-475,54,-19,-440,-0.03832013337764839,0.008495313137536244,0.029824820240112238,-340,-456,-0.051632498101746416,-0.06814495361776063
95,1037,Coosa,Alabama,2000,2104,2382,81,4567,0.46069629954017954,0.5215677687760018,0.0177359316838187,0,0,0,0,0.0,0.0,0.0,-278,0,-0.060871469235822206,0.0
96,1037,Coosa,Alabama,2004,2055,2905,41,5001,0.41091781643671266,0.5808838232353529,0.008198360327934412,-49,-40,523,434,-0.049778483103466886,-0.009537571355884287,0.059316054459351175,-850,-572,-0.16996600679864027,-0.10909453756281806
97,1037,Coosa,Alabama,2008,2273,3248,42,5563,0.408592486068668,0.5838576307747618,0.007549883156570196,218,1,343,562,-0.0023253303680446646,-0.000648477171364216,0.0029738075394089014,-975,-125,-0.17526514470609383,-0.005299137907453566
98,1037,Coosa,Alabama,2012,2191,3049,42,5282,0.41480499810677773,0.5772434683831882,0.007951533510034078,-82,0,-199,-281,0.006212512038109741,0.00040165035346388135,-0.006614162391573641,-858,117,-0.16243847027641045,0.012826674429683382
99,1037,Coosa,Alabama,2016,1782,3381,89,5252,0.3392993145468393,0.6437547600913938,0.016945925361766947,-409,47,332,-30,-0.07550568355993842,0.00899439185173287,0.06651129170820558,-1599,-741,-0.30445544554455445,-0.142016975268144
100,1039,Covington,Alabama,2000,4440,8961,212,13613,0.3261588187761698,0.6582678322192023,0.015573349004627928,0,0,0,0,0.0,0.0,0.0,-4521,0,-0.33210901344303245,0.0
101,1039,Covington,Alabama,2004,3423,11119,85,14627,0.23401927941478087,0.7601695494633213,0.00581117112189786,-1017,-127,2158,1014,-0.09213953936138894,-0.009762177882730068,0.101901717244119,-7696,-3175,-0.5261502700485404,-0.19404125660550797
102,1039,Covington,Alabama,2008,3240,12444,103,15787,0.20523215303730918,0.7882434914803319,0.006524355482358903,-183,18,1325,1160,-0.02878712637747169,0.0007131843604610425,0.028073942017010634,-9204,-1508,-0.5830113384430227,-0.05686106839448224
103,1039,Covington,Alabama,2012,3158,12153,128,15439,0.20454692661441803,0.7871623809832243,0.008290692402357665,-82,25,-291,-348,-0.0006852264228911498,0.0017663369199987624,-0.0010811104971075736,-8995,209,-0.5826154543688062,0.0003958840742164238
104,1039,Covington,Alabama,2016,2387,13267,286,15940,0.14974905897114177,0.8323086574654956,0.01794228356336261,-771,158,1114,501,-0.054797867643276266,0.009651591161004945,0.04514627648227132,-10880,-1885,-0.6825595984943539,-0.09994414412554764
105,1041,Crenshaw,Alabama,2000,1934,2793,68,4795,0.4033368091762252,0.5824817518248175,0.014181438998957248,0,0,0,0,0.0,0.0,0.0,-859,0,-0.17914494264859232,0.0
106,1041,Crenshaw,Alabama,2004,1698,3777,25,5500,0.30872727272727274,0.6867272727272727,0.004545454545454545,-236,-43,984,705,-0.09460953644895248,-0.009635984453502703,0.1042455209024552,-2079,-1220,-0.378,-0.19885505735140768
107,1041,Crenshaw,Alabama,2008,1938,4319,34,6291,0.30805913209346686,0.6865363217294548,0.0054045461770783655,240,9,542,791,-0.0006681406338058804,0.0008590916316238203,-0.00019095099781796243,-2381,-302,-0.3784771896359879,-0.00047718963598791797
108,1041,Crenshaw,Alabama,2012,2050,4331,43,6424,0.31911581569115816,0.6741905354919053,0.006693648816936488,112,9,12,133,0.011056683597691297,0.0012891026398581225,-0.01234578623754945,-2281,100,-0.3550747198007472,0.023402469835240747
109,1041,Crenshaw,Alabama,2016,1664,4513,90,6267,0.2655177916068294,0.720121270145205,0.014360938247965534,-386,47,182,-157,-0.05359802408432873,0.007667289431029046,0.045930734653299665,-2849,-568,-0.45460347853837557,-0.0995287587376284
110,1043,Cullman,Alabama,2000,9758,19157,610,29525,0.3304995766299746,0.648839966130398,0.020660457239627436,0,0,0,0,0.0,0.0,0.0,-9399,0,-0.31834038950042337,0.0
111,1043,Cullman,Alabama,2004,8045,26818,328,35191,0.22860958767866785,0.7620698474041658,0.00932056491716632,-1713,-282,7661,5666,-0.10188998895130674,-0.011339892322461116,0.11322988127376787,-18773,-9374,-0.533460259725498,-0.21511987022507467
112,1043,Cullman,Alabama,2008,5864,28896,545,35305,0.16609545390171362,0.8184676391445971,0.015436906953689279,-2181,217,2078,114,-0.06251413377695422,0.006116342036522959,0.05639779174043125,-23032,-4259,-0.6523721852428834,-0.11891192551738539
113,1043,Cullman,Alabama,2012,5052,28999,504,34555,0.1462017074229489,0.8392128490811749,0.014585443495876139,-812,-41,103,-750,-0.019893746478764712,-0.00085146345781314,0.020745209936577802,-23947,-915,-0.693011141658226,-0.04063895641534254
114,1043,Cullman,Alabama,2016,3798,32989,1086,37873,0.10028252316954031,0.8710426953238455,0.028674781506614212,-1254,582,3990,3318,-0.0459191842534086,0.014089338010738073,0.0318298462426706,-29191,-5244,-0.7707601721543051,-0.07774903049607917
115,1045,Dale,Alabama,2000,4906,10593,307,15806,0.3103884600784512,0.6701885359989878,0.019423003922561053,0,0,0,0,0.0,0.0,0.0,-5687,0,-0.35980007592053653,0.0
116,1045,Dale,Alabama,2004,4484,13621,126,18231,0.2459546925566343,0.7471340025231749,0.006911304920190884,-422,-181,3028,2425,-0.06443376752181693,-0.01251169900237017,0.0769454665241871,-9137,-3450,-0.5011793099665406,-0.14137923404600405
117,1045,Dale,Alabama,2008,5270,13886,164,19320,0.2727743271221532,0.7187370600414079,0.008488612836438923,786,38,265,1089,0.02681963456551892,0.0015773079162480393,-0.02839694248176694,-8616,521,-0.4459627329192547,0.055216577047285886
118,1045,Dale,Alabama,2012,5286,13108,207,18601,0.2841782699854847,0.7046932960593516,0.011128433955163702,16,43,-778,-719,0.011403942863331462,0.002639821118724779,-0.014043763982056312,-7822,794,-0.4205150260738669,0.025447706845387774
119,1045,Dale,Alabama,2016,4413,13808,528,18749,0.23537255320283748,0.7364659448503921,0.028161501946770494,-873,321,700,148,-0.048805716782647196,0.017033067991606792,0.03177264879104047,-9395,-1573,-0.5010933916475546,-0.0805783655736877
120,1047,Dallas,Alabama,2000,10967,7360,137,18464,0.5939666377816292,0.3986135181975737,0.007419844020797227,0,0,0,0,0.0,0.0,0.0,3607,0,0.1953531195840555,0.0
121,1047,Dallas,Alabama,2004,11175,7335,63,18573,0.6016798578581812,0.39492812146664513,0.003392020675173639,208,-74,-25,109,0.007713220076552063,-0.004027823345623588,-0.0036853967309285474,3840,233,0.2067517363915361,0.01139861680748061
122,1047,Dallas,Alabama,2008,13986,6798,68,20852,0.6707270285823902,0.3260118933435642,0.003261078074045655,2811,5,-537,2279,0.06904717072420896,-0.00013094260112798397,-0.06891622812308096,7188,3348,0.344715135238826,0.13796339884728992
123,1047,Dallas,Alabama,2012,14612,6288,64,20964,0.6970043884754817,0.2999427590154551,0.0030528525090631558,626,-4,-510,112,0.026277359893091545,-0.0002082255649824994,-0.02606913432810909,8324,1136,0.39706162946002665,0.052346494221200635
124,1047,Dallas,Alabama,2016,12836,5789,167,18792,0.6830566198382291,0.308056619838229,0.008886760323541933,-1776,103,-499,-2172,-0.013947768637252667,0.005833907814478777,0.008113860822773933,7047,-1277,0.37500000000000006,-0.0220616294600266
125,1049,DeKalb,Alabama,2000,7056,12827,402,20285,0.3478432339166872,0.6323391668720729,0.019817599211239833,0,0,0,0,0.0,0.0,0.0,-5771,0,-0.2844959329553857,0.0
126,1049,DeKalb,Alabama,2004,7092,16904,173,24169,0.29343373743224793,0.699408332988539,0.007157929579213042,36,-229,4077,3884,-0.05440949648443927,-0.01265966963202679,0.06706916611646607,-9812,-4041,-0.40597459555629106,-0.12147866260090534
127,1049,DeKalb,Alabama,2008,5658,17957,400,24015,0.23560274828232355,0.7477409952113263,0.0166562565063502,-1434,227,1053,-154,-0.05783098914992438,0.009498326927137157,0.048332662222787315,-12299,-2487,-0.5121382469290028,-0.10616365137271172
128,1049,DeKalb,Alabama,2012,5239,18331,380,23950,0.21874739039665972,0.7653862212943633,0.015866388308977037,-419,-20,374,-65,-0.016855357885663835,-0.0007898681973731621,0.01764522608303698,-13092,-793,-0.5466388308977036,-0.034500583968700815
129,1049,DeKalb,Alabama,2016,3622,21405,799,25826,0.1402462634554325,0.8288159219391311,0.030937814605436383,-1617,419,3074,1876,-0.07850112694122721,0.015071426296459346,0.06342970064476783,-17783,-4691,-0.6885696584836987,-0.14193082758599507
130,1051,Elmore,Alabama,2000,6652,16777,375,23804,0.2794488321290539,0.7047975130230213,0.01575365484792472,0,0,0,0,0.0,0.0,0.0,-10125,0,-0.4253486808939674,0.0
131,1051,Elmore,Alabama,2004,6471,22056,153,28680,0.2256276150627615,0.7690376569037657,0.005334728033472803,-181,-222,5279,4876,-0.05382121706629242,-0.010418926814451916,0.0642401438807444,-15585,-5460,-0.5434100418410042,-0.11806136094703679
132,1051,Elmore,Alabama,2008,8301,25777,237,34315,0.2419058720676089,0.7511875273204138,0.00690660061197727,1830,84,3721,5635,0.01627825700484742,0.0015718725785044668,-0.01785012958335186,-17476,-1891,-0.5092816552528049,0.03412838658819928
133,1051,Elmore,Alabama,2012,8954,26253,339,35546,0.2518989478422326,0.7385641141056659,0.009536938052101502,653,102,476,1231,0.009993075774623689,0.002630337440124232,-0.012623413214747914,-17299,177,-0.4866651662634333,0.022616488989371575
134,1051,Elmore,Alabama,2016,8443,27634,1183,37260,0.22659688674181427,0.7416532474503489,0.03174986580783682,-511,844,1381,1714,-0.025302061100418327,0.02221292775573532,0.0030891333446829705,-19191,-1892,-0.5150563607085346,-0.028391194445101242
135,1053,Escambia,Alabama,2000,4523,6975,162,11660,0.3879073756432247,0.5981989708404802,0.013893653516295026,0,0,0,0,0.0,0.0,0.0,-2452,0,-0.21029159519725554,0.0
136,1053,Escambia,Alabama,2004,3814,8513,68,12395,0.30770471964501817,0.6868091972569584,0.005486083098023397,-709,-94,1538,735,-0.08020265599820653,-0.008407570418271629,0.0886102264164782,-4699,-2247,-0.37910447761194027,-0.16881288241468473
137,1053,Escambia,Alabama,2008,5188,9375,111,14674,0.35355049747853345,0.6388851029030939,0.007564399618372632,1374,43,862,2279,0.04584577783351529,0.0020783165203492352,-0.04792409435386458,-4187,512,-0.2853346054245604,0.09376987218737987
138,1053,Escambia,Alabama,2012,5489,9287,118,14894,0.3685376661742984,0.6235396804082181,0.007922653417483551,301,7,-88,220,0.01498716869576494,0.00035825379911091915,-0.015345422494875804,-3798,389,-0.25500201423391966,0.030332591190640745
139,1053,Escambia,Alabama,2016,4605,9935,305,14845,0.3102054563826204,0.6692489053553385,0.02054563826204109,-884,187,648,-49,-0.05833220979167797,0.01262298484455754,0.045709224947120486,-5330,-1532,-0.3590434489727181,-0.10404143473879846
140,1055,Etowah,Alabama,2000,17433,21087,828,39348,0.4430466605672461,0.5359103385178408,0.021043000914913082,0,0,0,0,0.0,0.0,0.0,-3654,0,-0.09286367795059464,0.0
141,1055,Etowah,Alabama,2004,15328,26999,353,42680,0.3591377694470478,0.6325913776944705,0.008270852858481724,-2105,-475,5912,3332,-0.08390889112019834,-0.012772148056431358,0.09668103917662974,-11671,-8017,-0.2734536082474227,-0.18058993029682807
142,1055,Etowah,Alabama,2008,13497,30595,645,44737,0.3016965822473568,0.6838858215794532,0.014417596173189978,-1831,292,3596,2057,-0.05744118719969099,0.006146743314708254,0.05129444388498272,-17098,-5427,-0.3821892393320964,-0.10873563108467371
143,1055,Etowah,Alabama,2012,12803,29130,691,42624,0.30037068318318316,0.6834177927927928,0.016211524024024024,-694,46,-1465,-2113,-0.0013258990641736301,0.0017939278508340463,-0.0004680287866604127,-16327,771,-0.38304710960960964,-0.0008578702775132174
144,1055,Etowah,Alabama,2016,10442,32353,1369,44164,0.2364369169459288,0.7325649850557014,0.030998097998369712,-2361,678,3223,1540,-0.06393376623725436,0.014786573974345688,0.049147192262908646,-21911,-5584,-0.4961280681097726,-0.11308095850016298
145,1057,Fayette,Alabama,2000,3064,4582,162,7808,0.39241803278688525,0.5868340163934426,0.02074795081967213,0,0,0,0,0.0,0.0,0.0,-1518,0,-0.19441598360655732,0.0
146,1057,Fayette,Alabama,2004,2408,5534,60,8002,0.30092476880779806,0.6915771057235691,0.007498125468632842,-656,-102,952,194,-0.09149326397908719,-0.013249825351039288,0.10474308933012655,-3126,-1608,-0.39065233691577106,-0.19623635330921374
147,1057,Fayette,Alabama,2008,1994,5883,80,7957,0.25059695865275855,0.7393490008797285,0.010054040467512881,-414,20,349,-45,-0.05032781015503951,0.002555914998880039,0.04777189515615943,-3889,-763,-0.48875204222697,-0.09809970531119894
148,1057,Fayette,Alabama,2012,1817,6054,87,7958,0.22832369942196531,0.7607439055038955,0.01093239507413923,-177,7,171,1,-0.022273259230793235,0.0008783546066263494,0.021394904624166933,-4237,-348,-0.5324202060819302,-0.043668163854960196
149,1057,Fayette,Alabama,2016,1362,6712,175,8249,0.165110922536065,0.813674384773912,0.021214692690023032,-455,88,658,291,-0.06321277688590032,0.010282297615883802,0.052930479270016484,-5350,-1113,-0.648563462237847,-0.11614325615591681
150,1059,Franklin,Alabama,2000,4793,6119,191,11103,0.43168513014500587,0.551112311987751,0.017202557867243087,0,0,0,0,0.0,0.0,0.0,-1326,0,-0.11942718184274514,0.0
151,1059,Franklin,Alabama,2004,4514,7690,65,12269,0.36791914581465485,0.6267829488955905,0.005297905289754666,-279,-126,1571,1166,-0.06376598433035102,-0.01190465257748842,0.07567063690783948,-3176,-1850,-0.25886380308093565,-0.1394366212381905
152,1059,Franklin,Alabama,2008,3469,8048,176,11693,0.29667322329598905,0.6882750363465321,0.015051740357478834,-1045,111,358,-576,-0.0712459225186658,0.009753835067724169,0.06149208745094159,-4579,-1403,-0.39160181305054304,-0.13273800996960738
153,1059,Franklin,Alabama,2012,3171,7567,143,10881,0.2914254204576785,0.6954324051098245,0.013142174432497013,-298,-33,-481,-812,-0.005247802838310556,-0.0019095659249818205,0.0071573687632924266,-4396,183,-0.404006984652146,-0.012405171601602982
154,1059,Franklin,Alabama,2016,2197,9466,377,12040,0.18247508305647842,0.7862126245847176,0.031312292358803985,-974,234,1899,1159,-0.10895033740120008,0.01817011792630697,0.09078021947489312,-7269,-2873,-0.6037375415282392,-0.1997305568760932
155,1061,Geneva,Alabama,2000,2769,6588,202,9559,0.28967465216026783,0.6891934302751334,0.02113191756459881,0,0,0,0,0.0,0.0,0.0,-3819,0,-0.3995187781148655,0.0
156,1061,Geneva,Alabama,2004,2113,8342,65,10520,0.2008555133079848,0.7929657794676807,0.006178707224334601,-656,-137,1754,961,-0.08881913885228304,-0.014953210340264207,0.1037723491925473,-6229,-2410,-0.5921102661596959,-0.19259148804483034
157,1061,Geneva,Alabama,2008,2134,9417,106,11657,0.18306596894569788,0.807840782362529,0.009093248691773184,21,41,1075,1137,-0.017789544362286913,0.002914541467438583,0.014875002894848333,-7283,-1054,-0.6247748134168312,-0.0326645472571353
158,1061,Geneva,Alabama,2012,2039,9175,117,11331,0.1799488129909099,0.8097255317271203,0.010325655281969817,-95,11,-242,-326,-0.0031171559547879812,0.001232406590196633,0.001884749364591265,-7136,147,-0.6297767187362103,-0.005001905319379163
159,1061,Geneva,Alabama,2016,1525,9994,239,11758,0.12969892838918184,0.8499744854567103,0.02032658615410784,-514,122,819,427,-0.05024988460172805,0.010000930872138025,0.04024895372959003,-8469,-1333,-0.7202755570675284,-0.09049883833131811
160,1063,Greene,Alabama,2000,3504,850,42,4396,0.7970882620564149,0.19335759781619655,0.009554140127388535,0,0,0,0,0.0,0.0,0.0,2654,0,0.6037306642402184,0.0
161,1063,Greene,Alabama,2004,3764,958,26,4748,0.7927548441449032,0.2017691659646167,0.005475989890480202,260,-16,108,352,-0.004333417911511761,-0.004078150236908332,0.008411568148420145,2806,152,0.5909856781802865,-0.012744986059931906
162,1063,Greene,Alabama,2008,4408,876,21,5305,0.830914231856739,0.1651272384542884,0.003958529688972668,644,-5,-82,557,0.0381593877118358,-0.0015174602015075346,-0.0366419275103283,3532,726,0.6657869934024505,0.07480131522216404
163,1063,Greene,Alabama,2012,4521,804,18,5343,0.8461538461538461,0.15047725996631106,0.003368893879842785,113,-3,-72,38,0.015239614297107185,-0.0005896358091298827,-0.014649978487977333,3717,185,0.6956765861875351,0.02988959278508463
164,1063,Greene,Alabama,2016,4013,838,29,4880,0.8223360655737705,0.17172131147540984,0.005942622950819672,-508,11,34,-463,-0.023817780580075665,0.002573729070976887,0.021244051509098777,3175,-542,0.6506147540983607,-0.04506183208917447
165,1065,Hale,Alabama,2000,4652,2984,95,7731,0.6017332815935843,0.3859785280041392,0.01228819040227655,0,0,0,0,0.0,0.0,0.0,1668,0,0.21575475358944513,0.0
166,1065,Hale,Alabama,2004,4631,3281,33,7945,0.5828823159219635,0.4129641283826306,0.004153555695405916,-21,-62,297,214,-0.018850965671620812,-0.008134634706870633,0.026985600378491403,1350,-318,0.1699181875393329,-0.045836566050112215
167,1065,Hale,Alabama,2008,4982,3200,32,8214,0.6065254443632822,0.38957876795714635,0.0038957876795714633,351,-1,-81,269,0.02364312844131866,-0.00025776801583445247,-0.023385360425484225,1782,432,0.2169466764061358,0.04702848886680289
168,1065,Hale,Alabama,2012,5411,3210,26,8647,0.6257661616745692,0.3712270151497629,0.003006823175667862,429,-6,10,433,0.01924071731128707,-0.0008889645039036015,-0.018351752807383437,2201,419,0.2545391465248063,0.03759247011867051
169,1065,Hale,Alabama,2016,4775,3173,92,8040,0.5939054726368159,0.39465174129353237,0.011442786069651741,-636,66,-37,-607,-0.0318606890377533,0.008435962893983878,0.023424726143769448,1602,-599,0.19925373134328356,-0.055285415181522746
170,1067,Henry,Alabama,2000,2782,4054,96,6932,0.4013271783035199,0.5848240046162724,0.013848817080207732,0,0,0,0,0.0,0.0,0.0,-1272,0,-0.1834968263127525,0.0
171,1067,Henry,Alabama,2004,2452,4881,28,7361,0.3331069148213558,0.6630892541774216,0.00380383100122266,-330,-68,827,429,-0.06822026348216409,-0.010044986078985072,0.07826524956114922,-2429,-1157,-0.3299823393560658,-0.1464855130433133
172,1067,Henry,Alabama,2008,3018,5585,45,8648,0.3489824236817761,0.6458140610545791,0.005203515263644773,566,17,704,1287,0.01587550886042033,0.0013996842624221131,-0.017275193122842536,-2567,-138,-0.29683163737280294,0.033150701983262865
173,1067,Henry,Alabama,2012,3083,5628,55,8766,0.3516997490303445,0.6420260095824778,0.006274241387177732,65,10,43,118,0.002717325348568389,0.0010707261235329592,-0.0037880514721012615,-2545,22,-0.2903262605521333,0.0065053768206696505
174,1067,Henry,Alabama,2016,2292,5632,148,8072,0.2839444995044599,0.6977205153617443,0.018334985133795837,-791,93,4,-694,-0.06775524952588463,0.012060743746618105,0.05569450577926649,-3340,-795,-0.4137760158572844,-0.12344975530515112
175,1069,Houston,Alabama,2000,9412,22150,495,32057,0.29360202139938235,0.6909567333187759,0.01544124528184172,0,0,0,0,0.0,0.0,0.0,-12738,0,-0.3973547119193936,0.0
176,1069,Houston,Alabama,2004,9144,26874,183,36201,0.25258970746664455,0.7423551835584652,0.005055108974890196,-268,-312,4724,4144,-0.0410123139327378,-0.010386136306951524,0.05139845023968925,-17730,-4992,-0.48976547609182064,-0.09241076417242705
177,1069,Houston,Alabama,2008,12225,29254,256,41735,0.292919611836588,0.700946447825566,0.006133940337845933,3081,73,2380,5534,0.04032990436994344,0.0010788313629557364,-0.04140873573289916,-17029,701,-0.40802683598897804,0.0817386401028426
178,1069,Houston,Alabama,2012,12367,29270,347,41984,0.29456459603658536,0.6971703506097561,0.008265053353658536,142,91,16,249,0.001644984199997368,0.0021311130158126034,-0.0037760972158099593,-16903,126,-0.4026057545731707,0.005421081415807327
179,1069,Houston,Alabama,2016,10664,30728,1247,42639,0.25009967400736416,0.7206547995966134,0.02924552639602242,-1703,900,1458,655,-0.0444649220292212,0.020980473042363883,0.02348444898685731,-20064,-3161,-0.4705551255892492,-0.06794937101607851
180,1071,Jackson,Alabama,2000,9066,8475,365,17906,0.506310733832235,0.47330503741762536,0.020384228750139618,0,0,0,0,0.0,0.0,0.0,591,0,0.03300569641460965,0.0
181,1071,Jackson,Alabama,2004,8635,11534,152,20321,0.42492987549825306,0.5675901776487378,0.007479946853009203,-431,-213,3059,2415,-0.08138085833398195,-0.012904281897130415,0.0942851402311124,-2899,-3490,-0.1426603021504847,-0.17566599856509435
182,1071,Jackson,Alabama,2008,6374,14083,417,20874,0.3053559451949794,0.674667049918559,0.019977004886461626,-2261,265,2549,553,-0.11957393030327368,0.012497058033452423,0.10707687226982121,-7709,-4810,-0.3693111047235796,-0.2266508025730949
183,1071,Jackson,Alabama,2012,5822,14439,371,20632,0.2821830166731291,0.699835207444746,0.017981775882124854,-552,-46,356,-242,-0.023172928521850267,-0.0019952290043367717,0.025168157526187063,-8617,-908,-0.4176521907716169,-0.04834108604803733
184,1071,Jackson,Alabama,2016,3673,16672,639,20984,0.17503812428516966,0.79451010293557,0.030451772779260387,-2149,268,2233,352,-0.10714489238795946,0.012469996897135533,0.09467489549082397,-12999,-4382,-0.6194719786504004,-0.20181978787878346
185,1073,Jefferson,Alabama,2000,129889,138491,5383,273763,0.4744578339658756,0.5058791728611974,0.019662993172926947,0,0,0,0,0.0,0.0,0.0,-8602,0,-0.03142133889532184,0.0
186,1073,Jefferson,Alabama,2004,132286,158680,2001,292967,0.4515389105257589,0.5416309686756529,0.006830120798588237,2397,-3382,20189,19204,-0.0229189234401167,-0.012832872374338711,0.03575179581445542,-26394,-17792,-0.09009205814989396,-0.05867071925457212
187,1073,Jefferson,Alabama,2008,166121,149921,2482,318524,0.5215336991875024,0.47067410932928133,0.007792191483216335,33835,481,-8759,25557,0.06999478866174347,0.0009620706846280988,-0.07095685934637153,16200,42594,0.05085958985822103,0.140951648008115
188,1073,Jefferson,Alabama,2012,159876,141683,2964,304523,0.5250046794494997,0.4652620655911048,0.009733254959395513,-6245,482,-8238,-14001,0.003470980261997325,0.0019410634761791775,-0.005412043738176553,18193,1993,0.05974261385839491,0.008883024000173878
189,1073,Jefferson,Alabama,2016,156873,134768,12550,304191,0.5157055928676391,0.4430374337176314,0.04125697341472956,-3003,9586,-6915,-332,-0.009299086581860627,0.03152371845533405,-0.0222246318734734,22105,3912,0.07266815915000768,0.012925545291612772
190,1075,Lamar,Alabama,2000,2653,4470,126,7249,0.3659815146916816,0.6166367774865499,0.01738170782176852,0,0,0,0,0.0,0.0,0.0,-1817,0,-0.25065526279486827,0.0
191,1075,Lamar,Alabama,2004,1956,4894,35,6885,0.2840958605664488,0.7108206245461147,0.005083514887436456,-697,-91,424,-364,-0.0818856541252328,-0.012298192934332066,0.09418384705956484,-2938,-1121,-0.4267247639796659,-0.17606950118479764
192,1075,Lamar,Alabama,2008,1614,5419,42,7075,0.22812720848056536,0.7659363957597173,0.005936395759717315,-342,7,525,190,-0.05596865208588345,0.000852880872280859,0.05511577121360256,-3805,-867,-0.537809187279152,-0.11108442329948603
193,1075,Lamar,Alabama,2012,1646,5457,73,7176,0.22937569676700112,0.7604515050167224,0.010172798216276478,32,31,38,101,0.001248488286435756,0.004236402456559163,-0.005484890742994852,-3811,-6,-0.5310758082497213,0.006733379029430608
194,1075,Lamar,Alabama,2016,1036,5823,107,6966,0.14872236577662934,0.8359173126614987,0.01536032156187195,-610,34,366,-210,-0.08065333099037178,0.005187523345595472,0.07546580764477628,-4787,-976,-0.6871949468848694,-0.15611913863514804
195,1077,Lauderdale,Alabama,2000,13875,17478,784,32137,0.4317453402620033,0.5438591032143635,0.024395556523633195,0,0,0,0,0.0,0.0,0.0,-3603,0,-0.1121137629523602,0.0
196,1077,Lauderdale,Alabama,2004,14628,22161,318,37107,0.3942113347885844,0.5972188535855768,0.00856981162583879,753,-466,4683,4970,-0.0375340054734189,-0.015825744897794404,0.05335975037121332,-7533,-3930,-0.20300751879699241,-0.09089375584463222
197,1077,Lauderdale,Alabama,2008,13329,24068,707,38104,0.34980579466722656,0.6316397228637414,0.018554482469032123,-1299,389,1907,997,-0.044405540121357834,0.009984670843193332,0.03442086927816457,-10739,-3206,-0.2818339281965148,-0.0788264093995224
198,1077,Lauderdale,Alabama,2012,12511,23911,610,37032,0.33784294664074316,0.6456848131345863,0.016472240224670556,-818,-97,-157,-1072,-0.011962848026483397,-0.002082242244361567,0.014045090270844884,-11400,-661,-0.3078418664938431,-0.02600793829732828
199,1077,Lauderdale,Alabama,2016,9952,27899,1674,39525,0.25179000632511067,0.7058570524984187,0.042352941176470586,-2559,1064,3988,2493,-0.08605294031563249,0.02588070095180003,0.060172239363832425,-17947,-6547,-0.454067046173308,-0.1462251796794649
200,1079,Lawrence,Alabama,2000,6296,5671,218,12185,0.5167008617152237,0.4654082888797702,0.017890849405006154,0,0,0,0,0.0,0.0,0.0,625,0,0.051292572835453465,0.0
201,1079,Lawrence,Alabama,2004,6155,7730,116,14001,0.43961145632454823,0.5521034211842011,0.008285122491250624,-141,-102,2059,1816,-0.07708940539067544,-0.00960572691375553,0.08669513230443088,-1575,-2200,-0.11249196485965285,-0.1637845376951063
202,1079,Lawrence,Alabama,2008,5164,9277,239,14680,0.3517711171662125,0.6319482288828338,0.01628065395095368,-991,123,1547,679,-0.08784033915833572,0.007995531459703055,0.07984480769863267,-4113,-2538,-0.28017711171662124,-0.1676851468569684
203,1079,Lawrence,Alabama,2012,5069,8874,205,14148,0.35828385637545945,0.6272264631043257,0.01448968052021487,-95,-34,-403,-532,0.006512739209246943,-0.0017909734307388087,-0.004721765778508025,-3805,308,-0.2689426067288663,0.011234504987754967
204,1079,Lawrence,Alabama,2016,3627,10833,369,14829,0.24458830669633824,0.730528019421404,0.024883673882257738,-1442,164,1959,681,-0.11369554967912121,0.010393993362042867,0.10330155631707827,-7206,-3401,-0.48593971272506575,-0.21699710599619948
205,1081,Lee,Alabama,2000,14574,22433,1257,38264,0.38088020071085094,0.5862690779845285,0.03285072130462053,0,0,0,0,0.0,0.0,0.0,-7859,0,-0.2053888772736776,0.0
206,1081,Lee,Alabama,2004,16227,27972,411,44610,0.3637525218560861,0.6270342972427707,0.009213180901143241,1653,-846,5539,6346,-0.01712767885476485,-0.02363754040347729,0.04076521925824217,-11745,-3886,-0.2632817753866846,-0.05789289811300702
207,1081,Lee,Alabama,2008,21498,32230,597,54325,0.3957294063506673,0.5932811780947999,0.010989415554532905,5271,186,4258,9715,0.03197688449458119,0.0017762346533896634,-0.033753119147970856,-10732,1013,-0.19755177174413258,0.06573000364255205
208,1081,Lee,Alabama,2012,21381,32194,921,54496,0.3923407222548444,0.5907589547856723,0.016900322959483266,-117,324,-36,171,-0.0033886840958228803,0.005910907404950361,-0.002522223309127547,-10813,-81,-0.1984182325308279,-0.0008664607866953333
209,1081,Lee,Alabama,2016,21230,34617,3344,59191,0.35866939230626277,0.5848355324289165,0.056495075264820664,-151,2423,2423,4695,-0.03367132994858163,0.0395947523053374,-0.005923422356755803,-13387,-2574,-0.22616614012265374,-0.027747907591825827
210,1083,Limestone,Alabama,2000,8992,14204,438,23634,0.3804688161123805,0.600998561394601,0.018532622493018534,0,0,0,0,0.0,0.0,0.0,-5212,0,-0.22052974528222047,0.0
211,1083,Limestone,Alabama,2004,9126,19702,245,29073,0.3138994943762254,0.6776734427131703,0.008427062910604341,134,-193,5498,5439,-0.0665693217361551,-0.010105559582414193,0.07667488131856937,-10576,-5364,-0.36377394833694493,-0.14324420305472446
212,1083,Limestone,Alabama,2008,9536,23598,417,33551,0.28422401716789364,0.7033471431551965,0.012428839676909779,410,172,3896,4478,-0.029675477208331746,0.004001776766305438,0.025673700442026215,-14062,-3486,-0.4191231259873029,-0.05534917765035796
213,1083,Limestone,Alabama,2012,9829,25295,416,35540,0.2765616207090602,0.7117332583005065,0.011705120990433315,293,-1,1697,1989,-0.0076623964588334315,-0.0007237186864764641,0.008386115145309958,-15466,-1404,-0.4351716375914463,-0.01604851160414339
214,1083,Limestone,Alabama,2016,9468,29067,1759,40294,0.23497294882612796,0.7213729091179828,0.04365414205588922,-361,1343,3772,4754,-0.04158867188293225,0.0319490210654559,0.009639650817476308,-19599,-4133,-0.48639996029185484,-0.05122832270040856
215,1085,Lowndes,Alabama,2000,4557,1638,48,6243,0.7299375300336377,0.2623738587217684,0.0076886112445939455,0,0,0,0,0.0,0.0,0.0,2919,0,0.4675636713118693,0.0
216,1085,Lowndes,Alabama,2004,4233,1786,2,6021,0.7030393622321873,0.2966284670320545,0.0003321707357581797,-324,-46,148,-222,-0.02689816780145038,-0.007356440508835766,0.034254608310286094,2447,-472,0.40641089520013285,-0.06115277611173647
217,1085,Lowndes,Alabama,2008,5449,1809,20,7278,0.7486946963451497,0.2485572959604287,0.0027480076944215444,1216,18,23,1257,0.04565533411296241,0.0024158369586633646,-0.048071171071625785,3640,1193,0.500137400384721,0.09372650518458814
218,1085,Lowndes,Alabama,2012,5747,1756,20,7523,0.763923966502725,0.23341751960653995,0.002658513890735079,298,0,-53,245,0.015229270157575248,-8.949380368646542e-05,-0.015139776353888745,3991,351,0.5305064468961851,0.030369046511464104
219,1085,Lowndes,Alabama,2016,4883,1751,50,6684,0.7305505685218432,0.26196888090963494,0.007480550568521843,-864,30,-5,-839,-0.03337339798088179,0.004822036677786764,0.02855136130309499,3132,-859,0.46858168761220825,-0.06192475928397684
220,1087,Macon,Alabama,2000,7665,1091,75,8831,0.8679651228626429,0.12354206771600046,0.008492809421356586,0,0,0,0,0.0,0.0,0.0,6574,0,0.7444230551466424,0.0
221,1087,Macon,Alabama,2004,7800,1570,37,9407,0.8291697671946423,0.1668969916019985,0.003933241203359201,135,-38,479,576,-0.03879535566800063,-0.004559568217997385,0.04335492388599804,6230,-344,0.6622727755926439,-0.08215027955399856
222,1087,Macon,Alabama,2008,9450,1396,31,10877,0.8688057368759768,0.12834421255860992,0.0028500505654132573,1650,-6,-174,1470,0.03963596968133454,-0.0010831906379459434,-0.03855277904338858,8054,1824,0.7404615243173669,0.07818874872472303
223,1087,Macon,Alabama,2012,9045,1331,20,10396,0.8700461716044633,0.1280300115429011,0.001923816852635629,-405,-11,-65,-481,0.0012404347284864503,-0.0009262337127776282,-0.0003142010157088093,7714,-340,0.7420161600615622,0.001554635744195343
224,1087,Macon,Alabama,2016,7566,1431,143,9140,0.8277899343544858,0.15656455142231948,0.015645514223194747,-1479,123,100,-1256,-0.04225623724997751,0.013721697370559118,0.02853453987941837,6135,-1579,0.6712253829321663,-0.07079077712939597
225,1089,Madison,Alabama,2000,48199,62151,2968,113318,0.42534284050195026,0.5484653806103179,0.02619177888773187,0,0,0,0,0.0,0.0,0.0,-13952,0,-0.12312254010836765,0.0
226,1089,Madison,Alabama,2004,52644,77173,1245,131062,0.4016724908821779,0.5888281881857441,0.009499320932077948,4445,-1723,15022,17744,-0.02367034961977238,-0.01669245795565392,0.04036280757542621,-24529,-10577,-0.18715569730356624,-0.06403315719519859
227,1089,Madison,Alabama,2008,64117,86965,1817,152899,0.41934218013198254,0.5687741581043696,0.011883661763647899,11473,572,9792,21837,0.017669689249804665,0.0023843408315699505,-0.02005403008137452,-22848,1681,-0.14943197797238705,0.037723719331179184
228,1089,Madison,Alabama,2012,62015,90884,2529,155428,0.3989950330699745,0.5847337674035566,0.016271199526468848,-2102,712,3919,2529,-0.02034714706200802,0.004387537762820949,0.01595960929918705,-28869,-6021,-0.18573873433358212,-0.03630675636119507
229,1089,Madison,Alabama,2016,62822,89520,11047,163389,0.38449344815134434,0.5478949011255347,0.06761165072312089,807,8518,-1364,7961,-0.014501584918630184,0.051340451196652044,-0.03683886627802191,-26698,2171,-0.1634014529741904,0.022337281359391725
230,1091,Marengo,Alabama,2000,4841,4690,77,9608,0.5038509575353872,0.48813488759367196,0.008014154870940883,0,0,0,0,0.0,0.0,0.0,151,0,0.01571606994171526,0.0
231,1091,Marengo,Alabama,2004,5037,5255,30,10322,0.4879868242588646,0.5091067622553769,0.002906413485758574,196,-47,565,714,-0.01586413327652264,-0.005107741385182309,0.020971874661704915,-218,-369,-0.021119937996512295,-0.036836007938227555
232,1091,Marengo,Alabama,2008,5926,5516,29,11471,0.5166070961555226,0.480864789469096,0.0025281143753813967,889,-1,261,1149,0.028620271896658,-0.00037829911037717736,-0.028241972786280878,410,628,0.035742306686426584,0.05686224468293888
233,1091,Marengo,Alabama,2012,6167,5336,40,11543,0.5342631898120073,0.46227150654076066,0.0034653036472320885,241,11,-180,72,0.017656093656484684,0.0009371892718506919,-0.018593282928335342,831,421,0.07199168327124661,0.036249376584820026
234,1091,Marengo,Alabama,2016,5615,5233,146,10994,0.5107331271602692,0.47598690194651627,0.01327997089321448,-552,106,-103,-549,-0.02353006265173807,0.009814667245982392,0.013715395405755615,382,-449,0.034746225213752924,-0.037245458057493686
235,1093,Marion,Alabama,2000,4600,6910,246,11756,0.39128955427015993,0.5877849608710446,0.020925484858795508,0,0,0,0,0.0,0.0,0.0,-2310,0,-0.19649540660088466,0.0
236,1093,Marion,Alabama,2004,3808,8983,84,12875,0.29576699029126213,0.6977087378640777,0.006524271844660194,-792,-162,2073,1119,-0.0955225639788978,-0.014401213014135314,0.10992377699303313,-5175,-2865,-0.4019417475728156,-0.20544634097193093
237,1093,Marion,Alabama,2008,2600,9536,219,12355,0.2104411169566977,0.7718332658842574,0.017725617159044922,-1208,135,553,-520,-0.08532587333456443,0.011201345314384728,0.07412452802017966,-6936,-1761,-0.5613921489275597,-0.15945040135474414
238,1093,Marion,Alabama,2012,2249,9697,183,12129,0.18542336548767416,0.7994888284277352,0.015087806084590651,-351,-36,161,-226,-0.025017751469023547,-0.002637811074454271,0.027655562543477785,-7448,-512,-0.614065462940061,-0.052673314012501304
239,1093,Marion,Alabama,2016,1432,11274,278,12984,0.11028958718422674,0.8682994454713494,0.021410967344423906,-817,95,1577,855,-0.07513377830344742,0.006323161259833255,0.06881061704361424,-9842,-2394,-0.7580098582871226,-0.1439443953470616
240,1095,Marshall,Alabama,2000,10381,17084,524,27989,0.3708957090285469,0.6103826503269142,0.018721640644538927,0,0,0,0,0.0,0.0,0.0,-6703,0,-0.23948694129836728,0.0
241,1095,Marshall,Alabama,2004,8452,22783,256,31491,0.2683941443587057,0.7234765488552285,0.00812930678606586,-1929,-268,5699,3502,-0.10250156466984123,-0.010592333858473068,0.11309389852831431,-14331,-7628,-0.4550824044965228,-0.21559546319815553
242,1095,Marshall,Alabama,2008,7038,25727,401,33166,0.21220527045769763,0.7757040342519448,0.012090695290357596,-1414,145,2944,1675,-0.056188873901008046,0.0039613885042917366,0.05222748539671629,-18689,-4358,-0.5634987637942471,-0.10841635929772431
243,1095,Marshall,Alabama,2012,6299,25867,478,32644,0.19296042151697096,0.7923967651023159,0.014642813380713148,-739,77,140,-522,-0.019244848940726672,0.002552118090355552,0.01669273085037115,-19568,-879,-0.5994363435853449,-0.035937579791097796
244,1095,Marshall,Alabama,2016,4917,29233,1166,35316,0.1392286782195039,0.8277551251557368,0.03301619662475932,-1382,688,3366,2672,-0.05373174329746705,0.018373383244046172,0.035358360053420856,-24316,-4748,-0.6885264469362329,-0.08909010335088796
245,1097,Mobile,Alabama,2000,58640,78162,2943,139745,0.4196214533614798,0.5593187591684855,0.021059787470034706,0,0,0,0,0.0,0.0,0.0,-19522,0,-0.13969730580700568,0.0
246,1097,Mobile,Alabama,2004,63732,92014,1025,156771,0.40652926880609297,0.5869325321647498,0.006538199029157178,5092,-1918,13852,17026,-0.013092184555386854,-0.014521588440877527,0.02761377299626433,-28282,-8760,-0.18040326335865686,-0.040705957551651184
247,1097,Mobile,Alabama,2008,82181,98049,1194,181424,0.4529775553399771,0.5404411764705882,0.006581268189434694,18449,169,6035,24653,0.04644828653388411,4.306916027751583e-05,-0.04649135569416163,-15868,12414,-0.08746362113061112,0.09293964222804574
248,1097,Mobile,Alabama,2012,78760,94893,1487,175140,0.4496973849491835,0.541812264474135,0.008490350576681512,-3421,293,-3156,-6284,-0.003280170390793591,0.0019090823872468183,0.0013710880035467943,-16133,-265,-0.09211487952495151,-0.004651258394340385
249,1097,Mobile,Alabama,2016,72186,95116,5435,172737,0.417895413258306,0.5506405691889983,0.03146401755269572,-6574,3948,223,-2403,-0.031801971690877506,0.022973666976014207,0.008828304714863289,-22930,-6797,-0.1327451559306923,-0.040630276405740795
250,1099,Monroe,Alabama,2000,3741,5153,57,8951,0.41794212937102,0.5756898670539604,0.006368003575019551,0,0,0,0,0.0,0.0,0.0,-1412,0,-0.15774773768294043,0.0
251,1099,Monroe,Alabama,2004,3666,5831,37,9534,0.38451856513530525,0.6116005873715125,0.003880847493182295,-75,-20,678,583,-0.03342356423571474,-0.0024871560818372556,0.03591072031755205,-2165,-753,-0.22708202223620721,-0.06933428455326679
252,1099,Monroe,Alabama,2008,5025,6175,52,11252,0.4465872733736225,0.5487913259864913,0.004621400639886242,1359,15,344,1718,0.06206870823831723,0.0007405531467039473,-0.06280926138502119,-1150,1015,-0.1022040526128688,0.12487796962333841
253,1099,Monroe,Alabama,2012,4914,5741,62,10717,0.45852384062704116,0.5356909582905663,0.00578520108239246,-111,10,-434,-535,0.011936567253418684,0.0011638004425062179,-0.01310036769592493,-827,323,-0.07716711766352519,0.025036934949343614
254,1099,Monroe,Alabama,2016,4332,5795,144,10271,0.4217700321292961,0.564209911401032,0.014020056469671891,-582,82,54,-446,-0.036753808497745066,0.00823485538727943,0.028518953110465706,-1463,-636,-0.14243987927173596,-0.06527276160821077
255,1101,Montgomery,Alabama,2000,40371,38827,1130,80328,0.5025769345682701,0.4833557414600139,0.014067323971715964,0,0,0,0,0.0,0.0,0.0,1544,0,0.019221193108256207,0.0
256,1101,Montgomery,Alabama,2004,45160,44097,393,89650,0.5037367540435025,0.4918795315114334,0.004383714445064139,4789,-737,5270,9322,0.0011598194752323598,-0.009683609526651826,0.008523790051419455,1063,-481,0.011857222532069112,-0.0073639705761870955
257,1101,Montgomery,Alabama,2008,62166,42031,546,104743,0.5935098288191096,0.40127741233304376,0.0052127588478466345,17006,153,-2066,15093,0.08977307477560714,0.0008290444027824959,-0.09060211917838962,20135,19072,0.19223241648606587,0.18037519395399676
258,1101,Montgomery,Alabama,2012,63085,38332,650,102067,0.618074402108419,0.37555723201426516,0.0063683658773158805,919,104,-3699,-2676,0.024564573289309388,0.001155607029469246,-0.025720180318778596,24753,4618,0.24251717009415386,0.050284753608087984
259,1101,Montgomery,Alabama,2016,58916,34003,2959,95878,0.6144892467510795,0.35464861594943575,0.03086213729948476,-4169,2309,-4329,-6189,-0.003585155357339498,0.02449377142216888,-0.02090861606482941,24913,160,0.25984063080164377,0.017323460707489913
260,1103,Morgan,Alabama,2000,16060,25774,847,42681,0.37627984349007754,0.6038752606546238,0.01984489585529861,0,0,0,0,0.0,0.0,0.0,-9714,0,-0.2275954171645463,0.0
261,1103,Morgan,Alabama,2004,14131,32477,399,47007,0.3006148020507584,0.6908971004318506,0.008488097517391028,-1929,-448,6703,4326,-0.07566504143931913,-0.011356798337907583,0.08702183977722677,-18346,-8632,-0.3902822983810922,-0.1626868812165459
262,1103,Morgan,Alabama,2008,13895,36014,633,50542,0.2749198686241146,0.7125558941078707,0.01252423726801472,-236,234,3537,3535,-0.025694933426643807,0.004036139750623693,0.021658793676020083,-22119,-3773,-0.4376360254837561,-0.04735372710266389
263,1103,Morgan,Alabama,2012,13439,35391,629,49459,0.2717200105137589,0.7155623850057623,0.01271760448047878,-456,-4,-623,-1083,-0.0031998581103557244,0.00019336721246406008,0.0030064908978916227,-21952,167,-0.4438423744920034,-0.006206349008247347
264,1103,Morgan,Alabama,2016,11254,37486,1904,50644,0.22221783429428954,0.7401863991785799,0.03759576652713056,-2185,1275,2095,1185,-0.04950217621946934,0.024878162046651775,0.024624014172817565,-26232,-4280,-0.5179685648842903,-0.0741261903922869
265,1105,Perry,Alabama,2000,4020,1732,35,5787,0.6946604458268533,0.299291515465699,0.0060480387074477275,0,0,0,0,0.0,0.0,0.0,2288,0,0.3953689303611543,0.0
266,1105,Perry,Alabama,2004,3767,1738,18,5523,0.6820568531595148,0.3146840485243527,0.0032590983161325366,-253,-17,6,-264,-0.012603592667338459,-0.002788940391315191,0.015392533058653735,2029,-259,0.3673728046351621,-0.027996125725992194
267,1105,Perry,Alabama,2008,4457,1679,23,6159,0.7236564377333983,0.27260918980353954,0.0037343724630621855,690,5,-59,636,0.041599584573883464,0.0004752741469296489,-0.04207485872081318,2778,749,0.45104724792985873,0.08367444329469664
268,1105,Perry,Alabama,2012,4568,1506,27,6101,0.7487297164399279,0.246844779544337,0.004425504015735125,111,4,-173,-58,0.025073278706529645,0.0006911315526729397,-0.025764410259202536,3062,284,0.5018849368955909,0.05083768896573215
269,1105,Perry,Alabama,2016,3824,1407,47,5278,0.7245168624478969,0.26657824933687,0.008904888215233043,-744,20,-99,-823,-0.02421285399203099,0.004479384199497918,0.019733469792533015,2417,-645,0.4579386131110269,-0.04394632378456398
270,1107,Pickens,Alabama,2000,4143,4306,91,8540,0.4851288056206089,0.5042154566744731,0.010655737704918032,0,0,0,0,0.0,0.0,0.0,-163,0,-0.0190866510538642,0.0
271,1107,Pickens,Alabama,2004,3915,5170,47,9132,0.42871222076215504,0.5661410424879545,0.005146736749890495,-228,-44,864,592,-0.056416584858453855,-0.005509000955027537,0.0619255858134814,-1255,-1092,-0.13742882172579945,-0.11834217067193525
272,1107,Pickens,Alabama,2008,4594,5434,39,10067,0.4563425052150591,0.53978345087911,0.0038740439058309326,679,-8,264,935,0.027630284452904053,-0.0012726928440595624,-0.026357591608844544,-840,415,-0.08344094566405086,0.053987876061748596
273,1107,Pickens,Alabama,2012,4455,5124,42,9621,0.4630495790458372,0.5325849703772997,0.004365450576863112,-139,3,-310,-446,0.006707073830778121,0.0004914066710321793,-0.007198480501810267,-669,171,-0.06953539133146247,0.013905554332588388
274,1107,Pickens,Alabama,2016,3972,5456,114,9542,0.41626493397610564,0.5717878851393837,0.011947180884510585,-483,72,332,-79,-0.04678464506973157,0.007581730307647473,0.03920291476208404,-1484,-815,-0.15552295116327808,-0.08598755983181561
275,1109,Pike,Alabama,2000,4357,6058,129,10544,0.4132207890743551,0.5745447647951442,0.012234446130500759,0,0,0,0,0.0,0.0,0.0,-1701,0,-0.16132397572078905,0.0
276,1109,Pike,Alabama,2004,4334,7483,66,11883,0.3647227131195826,0.6297231338887487,0.00555415299166877,-23,-63,1425,1339,-0.04849807595477251,-0.006680293138831989,0.05517836909360452,-3149,-1448,-0.2650004207691661,-0.10367644504837703
277,1109,Pike,Alabama,2008,5879,8004,72,13955,0.42128269437477606,0.5735578645646722,0.0051594410605517735,1545,6,521,2072,0.05655998125519346,-0.0003947119311169967,-0.056165269324076506,-2125,1024,-0.15227517018989611,0.11272525057926996
278,1109,Pike,Alabama,2012,6035,7963,125,14123,0.4273171422502301,0.5638320470155066,0.008850810734263258,156,53,-41,168,0.006034447875454041,0.003691369673711485,-0.009725817549165572,-1928,197,-0.1365149047652765,0.015760265424619613
279,1109,Pike,Alabama,2016,5056,7693,419,13168,0.3839611178614824,0.5842193195625759,0.03181956257594168,-979,294,-270,-955,-0.043356024388747694,0.02296875184167842,0.02038727254706929,-2637,-709,-0.20025820170109349,-0.06374329693581698
280,1111,Randolph,Alabama,2000,3094,4666,159,7919,0.3907058972092436,0.5892158100770299,0.020078292713726482,0,0,0,0,0.0,0.0,0.0,-1572,0,-0.19850991286778635,0.0
281,1111,Randolph,Alabama,2004,2817,6127,57,9001,0.3129652260859904,0.6807021442061993,0.006332629707810243,-277,-102,1461,1082,-0.07774067112325317,-0.013745663005916238,0.0914863341291694,-3310,-1738,-0.3677369181202089,-0.16922700525242257
282,1111,Randolph,Alabama,2008,3064,7175,145,10384,0.2950693374422188,0.6909668721109399,0.013963790446841295,247,88,1048,1383,-0.017895888643771618,0.007631160739031052,0.010264727904740534,-4111,-801,-0.3958975346687211,-0.028160616548512152
283,1111,Randolph,Alabama,2012,3078,7224,119,10421,0.2953651281067076,0.6932156223011228,0.011419249592169658,14,-26,49,37,0.0002957906644888153,-0.002544540854671637,0.002248750190182891,-4146,-35,-0.39785049419441515,-0.0019529595256940757
284,1111,Randolph,Alabama,2016,2291,7705,191,10187,0.2248944733483852,0.756356140178659,0.018749386472955726,-787,72,481,-234,-0.07047065475832243,0.007330136880786068,0.06314051787753627,-5414,-1268,-0.5314616668302738,-0.1336111726358587
285,1113,Russell,Alabama,2000,8396,6198,181,14775,0.5682571912013537,0.41949238578680204,0.012250423011844331,0,0,0,0,0.0,0.0,0.0,2198,0,0.14876480541455162,0.0
286,1113,Russell,Alabama,2004,8375,8337,97,16809,0.49824498780415255,0.49598429412814565,0.005770718067701826,-21,-84,2139,2034,-0.0700122033972011,-0.006479704944142505,0.07649190834134362,38,-2160,0.0022606936760068974,-0.14650411173854472
287,1113,Russell,Alabama,2008,10085,8705,125,18915,0.5331747290510177,0.4602167591858313,0.006608511763150938,1710,28,368,2106,0.034929741246865154,0.0008377936954491122,-0.03576753494231433,1380,1342,0.07295796986518638,0.07069727618917948
288,1113,Russell,Alabama,2012,10500,8278,132,18910,0.5552617662612375,0.43775780010576415,0.0069804336329984135,415,7,-427,-5,0.022087037210219762,0.0003719218698474752,-0.022458959080067176,2222,842,0.11750396615547332,0.04454599629028694
289,1113,Russell,Alabama,2016,9579,9210,467,19256,0.49745533859576235,0.47829248026589116,0.024252181138346488,-921,335,932,346,-0.05780642766547511,0.017271747505348073,0.04053468016012701,369,-1853,0.01916285832987119,-0.09834110782560213
290,1115,St. Clair,Alabama,2000,6485,17117,488,24090,0.2691988376919884,0.7105437941054379,0.02025736820257368,0,0,0,0,0.0,0.0,0.0,-10632,0,-0.4413449564134495,0.0
291,1115,St. Clair,Alabama,2004,5456,23500,205,29161,0.18709920784609582,0.8058708549089537,0.007029937244950448,-1029,-283,6383,5071,-0.08209962984589256,-0.013227430957623233,0.09532706080351583,-18044,-7412,-0.6187716470628579,-0.17742669064940841
292,1115,St. Clair,Alabama,2008,6091,27649,348,34088,0.17868458108425253,0.811106547758742,0.010208871157005398,635,143,4149,4927,-0.008414626761843291,0.00317893391205495,0.005235692849788309,-21558,-3514,-0.6324219666744895,-0.013650319611631545
293,1115,St. Clair,Alabama,2012,5801,29031,403,35235,0.16463743436923514,0.8239250744997871,0.011437491130977721,-290,55,1382,1147,-0.014047146715017389,0.0012286199739723232,0.012818526741045111,-23230,-1672,-0.659287640130552,-0.0268656734560625
294,1115,St. Clair,Alabama,2016,5589,31651,1160,38400,0.145546875,0.8242447916666666,0.030208333333333334,-212,757,2620,3165,-0.01909055936923515,0.018770842202355614,0.00031971716687950735,-26062,-2832,-0.6786979166666667,-0.019410276536114712
295,1117,Shelby,Alabama,2000,13183,47651,1294,62128,0.2121909605974762,0.7669810713365954,0.020827968065928407,0,0,0,0,0.0,0.0,0.0,-34468,0,-0.5547901107391192,0.0
296,1117,Shelby,Alabama,2004,14850,63435,621,78906,0.18819861607482322,0.8039312599802296,0.007870123944947151,1667,-673,15784,16778,-0.023992344522652975,-0.012957844120981256,0.036950188643634196,-48585,-14117,-0.6157326439054064,-0.06094253316628717
297,1117,Shelby,Alabama,2008,20625,69060,958,90643,0.22754101254371545,0.7618900521827389,0.010568935273545669,5775,337,5625,11737,0.03934239646889223,0.002698811328598517,-0.042041207797490765,-48435,150,-0.5343490396390234,0.08138360426638303
298,1117,Shelby,Alabama,2012,20051,71436,1255,92742,0.21620193655517456,0.7702658989454616,0.013532164499363827,-574,297,2376,2099,-0.011339075988540892,0.002963229225818159,0.008375846762722738,-51385,-2950,-0.554063962390287,-0.01971492275126363
299,1117,Shelby,Alabama,2016,22977,73020,5257,101254,0.22692436842001304,0.7211566950441464,0.05191893653584056,2926,4002,1584,8512,0.010722431864838483,0.03838677203647673,-0.049109203901315235,-50043,1342,-0.4942323266241333,0.05983163576615369
300,1119,Sumter,Alabama,2000,4415,1629,44,6088,0.7251971090670171,0.26757555847568987,0.007227332457293035,0,0,0,0,0.0,0.0,0.0,2786,0,0.4576215505913272,0.0
301,1119,Sumter,Alabama,2004,4527,1880,26,6433,0.7037152184050988,0.29224312140525416,0.004041660189647132,112,-18,251,345,-0.0214818906619183,-0.0031856722676459033,0.02466756292956429,2647,-139,0.4114720969998446,-0.04614945359148259
302,1119,Sumter,Alabama,2008,5264,1731,25,7020,0.7498575498575498,0.2465811965811966,0.0035612535612535613,737,-1,-149,587,0.04614233145245106,-0.00048040662839357075,-0.045661924824057565,3533,886,0.5032763532763532,0.09180425627650862
303,1119,Sumter,Alabama,2012,5421,1586,23,7030,0.7711237553342817,0.2256045519203414,0.003271692745376956,157,-2,-145,10,0.02126620547673186,-0.00028956081587660533,-0.020976644660855193,3835,302,0.5455192034139402,0.042242850137586996
304,1119,Sumter,Alabama,2016,4746,1581,84,6411,0.740290126345344,0.2466073935423491,0.013102480112306972,-675,61,-5,-619,-0.03083362898893771,0.009830787366930016,0.02100284162200769,3165,-670,0.4936827328029949,-0.05183647061094532
305,1121,Talladega,Alabama,2000,11264,13807,380,25451,0.4425759302188519,0.5424934187261797,0.01493065105496837,0,0,0,0,0.0,0.0,0.0,-2543,0,-0.09991748850732785,0.0
306,1121,Talladega,Alabama,2004,11374,18331,193,29898,0.3804267844002943,0.6131179343099873,0.006455281289718376,110,-187,4524,4447,-0.06214914581855757,-0.008475369765249994,0.07062451558380756,-6957,-4414,-0.23269114990969297,-0.13277366140236513
307,1121,Talladega,Alabama,2008,13779,20112,313,34204,0.40284762016138465,0.588001403344638,0.009150976493977312,2405,120,1781,4306,0.02242083576109033,0.002695695204258936,-0.02511653096534927,-6333,624,-0.18515378318325337,0.0475373667264396
308,1121,Talladega,Alabama,2012,13905,19246,265,33416,0.41611802729231506,0.5759516399329663,0.007930332774718697,126,-48,-866,-788,0.013270407130930417,-0.001220643719258615,-0.012049763411671743,-5341,992,-0.1598336126406512,0.02532017054260216
309,1121,Talladega,Alabama,2016,12121,20614,672,33407,0.3628281497889664,0.617056305564702,0.02011554464633161,-1784,407,1368,-9,-0.05328987750334868,0.012185211871612912,0.04110466563173576,-8493,-3152,-0.25422815577573565,-0.09439454313508444
310,1123,Tallapoosa,Alabama,2000,6183,9805,265,16253,0.3804220759244447,0.6032732418630407,0.01630468221251461,0,0,0,0,0.0,0.0,0.0,-3622,0,-0.22285116593859594,0.0
311,1123,Tallapoosa,Alabama,2004,5451,12392,109,17952,0.30364304812834225,0.6902852049910874,0.00607174688057041,-732,-156,2587,1699,-0.07677902779610246,-0.0102329353319442,0.08701196312804671,-6941,-3319,-0.3866421568627451,-0.16379099092414917
312,1123,Tallapoosa,Alabama,2008,6063,13116,132,19311,0.31396613329190615,0.6791983843405313,0.006835482367562529,612,23,724,1359,0.010323085163563894,0.0007637354869921191,-0.011086820650556106,-7053,-112,-0.3652322510486251,0.02140990581412
313,1123,Tallapoosa,Alabama,2012,6319,12396,136,18851,0.33520768129011724,0.6575778473290541,0.007214471380828603,256,4,-720,-460,0.021241547998211097,0.0003789890132660737,-0.021620537011477148,-6077,976,-0.32237016603893687,0.042862085009688244
314,1123,Tallapoosa,Alabama,2016,5519,13594,373,19486,0.2832289849122447,0.6976290670224776,0.019141948065277636,-800,237,1198,635,-0.05197869637787256,0.011927476684449033,0.04005121969342351,-8075,-1998,-0.41440008211023294,-0.09202991607129607
315,1125,Tuscaloosa,Alabama,2000,24614,34003,1497,60114,0.40945536813387895,0.5656419469674285,0.024902684898692483,0,0,0,0,0.0,0.0,0.0,-9389,0,-0.15618657883354958,0.0
316,1125,Tuscaloosa,Alabama,2004,26447,42877,506,69830,0.37873406845195473,0.6140197622798225,0.007246169268222827,1833,-991,8874,9716,-0.03072129968192422,-0.017656515630469657,0.048377815312393935,-16430,-7041,-0.23528569382786774,-0.07909911499431815
317,1125,Tuscaloosa,Alabama,2008,32796,45405,711,78912,0.4156021897810219,0.5753877737226277,0.009010036496350364,6349,205,2528,9082,0.036868121329067194,0.0017638672281275374,-0.03863198855719474,-12609,3821,-0.1597855839416058,0.07550010988626193
318,1125,Tuscaloosa,Alabama,2012,32048,45748,976,78772,0.40684507185294266,0.5807647387396537,0.012390189407403647,-748,265,343,-140,-0.008757117928079261,0.0033801529110532823,0.005376965017026003,-13700,-1091,-0.17391966688671107,-0.014134082945105264
319,1125,Tuscaloosa,Alabama,2016,31762,47723,3215,82700,0.38406287787182586,0.577061668681983,0.038875453446191054,-286,2239,1975,3928,-0.022782193981116805,0.026485264038787405,-0.0037030700576706765,-15961,-2261,-0.1929987908101572,-0.01907912392344613
320,1127,Walker,Alabama,2000,11621,13486,534,25641,0.4532194532194532,0.525954525954526,0.020826020826020825,0,0,0,0,0.0,0.0,0.0,-1865,0,-0.07273507273507274,0.0
321,1127,Walker,Alabama,2004,9016,19167,184,28367,0.3178341030070152,0.6756794867275355,0.00648641026544929,-2605,-350,5681,2726,-0.13538535021243803,-0.014339610560571536,0.14972496077300956,-10151,-8286,-0.3578453837205203,-0.2851103109854476
322,1127,Walker,Alabama,2008,7420,20722,510,28652,0.2589697054306855,0.7232304900181489,0.017799804551165713,-1596,326,1555,285,-0.05886439757632972,0.011313394285716424,0.04755100329061335,-13302,-3151,-0.4642607845874634,-0.10641540086694307
323,1127,Walker,Alabama,2012,6557,21651,377,28585,0.22938604163022563,0.7574252230190659,0.013188735350708414,-863,-133,929,-67,-0.029583663800459847,-0.004611069200457299,0.03419473300091702,-15094,-1792,-0.5280391813888403,-0.06377839680137692
324,1127,Walker,Alabama,2016,4497,24266,709,29472,0.15258550488599348,0.82335776330076,0.02405673181324647,-2060,332,2615,887,-0.07680053674423215,0.010867996462538058,0.06593254028169415,-19769,-4675,-0.6707722584147666,-0.1427330770259263
325,1129,Washington,Alabama,2000,3386,4117,93,7596,0.4457609268035808,0.5419957872564508,0.012243285939968405,0,0,0,0,0.0,0.0,0.0,-731,0,-0.09623486045287,0.0
326,1129,Washington,Alabama,2004,3145,5060,42,8247,0.38135079422820417,0.6135564447677944,0.005092761004001455,-241,-51,943,651,-0.06441013257537664,-0.00715052493596695,0.07156065751134355,-1915,-1184,-0.2322056505395902,-0.1359707900867202
327,1129,Washington,Alabama,2008,3067,5654,54,8775,0.34951566951566954,0.6443304843304843,0.006153846153846154,-78,12,594,528,-0.031835124712534635,0.001061085149844699,0.03077403956268998,-2587,-672,-0.2948148148148148,-0.06260916427522462
328,1129,Washington,Alabama,2012,2976,5761,50,8787,0.3386821440764766,0.6556276317286901,0.005690224194833276,-91,-4,107,12,-0.010833525439192915,-0.0004636219590128778,0.011297147398205754,-2785,-198,-0.3169454876522135,-0.02213067283739867
329,1129,Washington,Alabama,2016,2374,6042,117,8533,0.2782139927340912,0.7080745341614907,0.01371147310441814,-602,67,281,-254,-0.06046815134238542,0.008021248909584864,0.05244690243280059,-3668,-883,-0.4298605414273995,-0.11291505377518601
330,1131,Wilcox,Alabama,2000,3444,1661,21,5126,0.6718689036285603,0.3240343347639485,0.004096761607491221,0,0,0,0,0.0,0.0,0.0,1783,0,0.34783456886461184,0.0
331,1131,Wilcox,Alabama,2004,3838,1834,10,5682,0.6754663850756776,0.32277367124252027,0.0017599436818021823,394,-11,173,556,0.0035974814471172456,-0.002336817925689039,-0.0012606635214282291,2004,221,0.3526927138331573,0.004858144968545475
332,1131,Wilcox,Alabama,2008,4612,1868,14,6494,0.7101940252540807,0.2876501385894672,0.0021558361564521095,774,4,34,812,0.03472764017840313,0.0003958924746499271,-0.03512353265305307,2744,740,0.4225438866646135,0.0698511728314562
333,1131,Wilcox,Alabama,2012,4868,1679,8,6555,0.7426392067124332,0.256140350877193,0.0012204424103737605,256,-6,-189,61,0.03244518145835251,-0.0009353937460783489,-0.031509787712274195,3189,445,0.4864988558352402,0.06395496917062671
334,1131,Wilcox,Alabama,2016,4339,1742,42,6123,0.7086395557733137,0.28450106157112526,0.006859382655560999,-529,34,63,-432,-0.0339996509391195,0.005638940245187239,0.028360710693932256,2597,-592,0.42413849420218847,-0.06236036163305175
335,1133,Winston,Alabama,2000,2692,6413,213,9318,0.28890319811118265,0.6882378192745224,0.022858982614294913,0,0,0,0,0.0,0.0,0.0,-3721,0,-0.3993346211633398,0.0
336,1133,Winston,Alabama,2004,2236,8130,57,10423,0.21452556845437973,0.780005756500048,0.005468675045572292,-456,-156,1717,1105,-0.07437762965680292,-0.017390307568722622,0.09176793722552556,-5894,-2173,-0.5654801880456682,-0.16614556688232845
337,1133,Winston,Alabama,2008,1757,8103,171,10031,0.17515701325889743,0.8077958329179543,0.01704715382314824,-479,114,-27,-392,-0.0393685551954823,0.011578478777575948,0.027790076417906318,-6346,-452,-0.6326388196590569,-0.06715863161338864
338,1133,Winston,Alabama,2012,1286,8312,130,9728,0.13219572368421054,0.8544407894736842,0.013363486842105263,-471,-41,209,-303,-0.042961289574686895,-0.0036836669810429764,0.046644956555729866,-7026,-680,-0.7222450657894737,-0.08960624613041679
339,1133,Winston,Alabama,2016,872,9228,213,10313,0.08455347619509357,0.8947929797343159,0.020653544070590515,-414,83,916,585,-0.04764224748911697,0.007290057228485252,0.04035219026063175,-8356,-1330,-0.8102395035392224,-0.08799443774974869
340,4001,Apache,Arizona,2000,13025,5947,484,19456,0.6694592927631579,0.3056640625,0.024876644736842105,0,0,0,0,0.0,0.0,0.0,7078,0,0.36379523026315785,0.0
341,4001,Apache,Arizona,2004,15658,8384,156,24198,0.647078270931482,0.3464749152822547,0.006446813786263328,2633,-328,2437,4742,-0.022381021831675896,-0.018429830950578777,0.040810852782254714,7274,196,0.30060335564922724,-0.06319187461393061
342,4001,Apache,Arizona,2008,15390,8551,414,24355,0.6319030999794704,0.3510983370971053,0.01699856292342435,-268,258,167,157,-0.015175170952011596,0.010551749137161021,0.004623421814850592,6839,-435,0.28080476288236506,-0.01979859276686219
343,4001,Apache,Arizona,2012,17147,8250,520,25917,0.6616120692981441,0.3183238800787128,0.02006405062314311,1757,106,-301,1562,0.029708969318673728,0.003065487699718761,-0.03277445701839249,8897,2058,0.3432881892194313,0.06248342633706622
344,4001,Apache,Arizona,2016,17083,8240,2338,27661,0.6175843245001988,0.2978923393948158,0.08452333610498536,-64,1818,-10,1744,-0.044027744797945245,0.06445928548184225,-0.02043154068389702,8843,-54,0.31969198510538305,-0.023596204114048225
345,4003,Cochise,Arizona,2000,13360,18180,1701,33241,0.40191329984055835,0.5469149544237538,0.051171745735687856,0,0,0,0,0.0,0.0,0.0,-4820,0,-0.14500165458319547,0.0
346,4003,Cochise,Arizona,2004,17514,26556,525,44595,0.3927346115035318,0.5954927682475614,0.011772620248906828,4154,-1176,8376,11354,-0.009178688337026564,-0.039399125486781025,0.04857781382380755,-9042,-4222,-0.20275815674402958,-0.05775650216083411
347,4003,Cochise,Arizona,2008,18943,29026,1112,49081,0.38595383142152767,0.5913897434852591,0.02265642509321326,1429,587,2470,4486,-0.006780780082004112,0.010883804844306432,-0.0041030247623022875,-10083,-1041,-0.2054359120637314,-0.0026777553197018245
348,4003,Cochise,Arizona,2012,18546,29497,1157,49200,0.3769512195121951,0.5995325203252032,0.023516260162601627,-397,45,471,119,-0.009002611909332547,0.0008598350693883663,0.008142776839944132,-10951,-868,-0.2225813008130081,-0.01714538874927668
349,4003,Cochise,Arizona,2016,17450,28092,4473,50015,0.3488953314005798,0.5616714985504349,0.08943317004898531,-1096,3316,-1405,815,-0.0280558881116153,0.06591690988638368,-0.037861021774768355,-10642,309,-0.21277616714985503,0.009805133663153054
350,4005,Coconino,Arizona,2000,20280,17562,3041,40883,0.4960497028104591,0.4295673018124893,0.07438299537705159,0,0,0,0,0.0,0.0,0.0,2718,0,0.06648240099796981,0.0
351,4005,Coconino,Arizona,2004,29243,22526,622,52391,0.5581683877001775,0.42995934416216525,0.011872268137657231,8963,-2419,4964,11508,0.06211868488971839,-0.06251072723939435,0.0003920423496759362,6717,3999,0.12820904353801227,0.06172664254004245
352,4005,Coconino,Arizona,2008,31433,22186,964,54583,0.5758752725207482,0.4064635509224484,0.0176611765568034,2190,342,-340,2192,0.0177068848205707,0.005788908419146168,-0.023495793239716845,9247,2530,0.1694117215982998,0.041202678060287545
353,4005,Coconino,Arizona,2012,29257,21220,1485,51962,0.5630460721296332,0.4083753512181979,0.028578576652168893,-2176,521,-966,-2621,-0.012829200391115014,0.010917400095365494,0.0019118002957494995,8037,-1210,0.1546707209114353,-0.014741000686864514
354,4005,Coconino,Arizona,2016,32404,21108,6272,59784,0.5420179312190553,0.35307105580088316,0.10491101298006156,3147,4787,-112,7822,-0.02102814091057792,0.07633243632789266,-0.05530429541731474,11296,3259,0.18894687541817212,0.03427615450673682
355,4007,Gila,Arizona,2000,7700,9158,878,17736,0.4341452413170952,0.5163509246729815,0.04950383400992332,0,0,0,0,0.0,0.0,0.0,-1458,0,-0.0822056833558863,0.0
356,4007,Gila,Arizona,2004,8314,12343,220,20877,0.39823729463045454,0.5912247928342195,0.010537912535325957,614,-658,3185,3141,-0.03590794668664066,-0.03896592147459736,0.07487386816123798,-4029,-2571,-0.19298749820376493,-0.11078181484787863
357,4007,Gila,Arizona,2008,7884,14095,438,22417,0.3516973725297765,0.6287638845519026,0.019538742918320917,-430,218,1752,1540,-0.04653992210067803,0.00900083038299496,0.037539091717683104,-6211,-2182,-0.27706651202212607,-0.08407901381836114
358,4007,Gila,Arizona,2012,7697,13455,443,21595,0.356425098402408,0.6230608937253994,0.02051400787219264,-187,5,-640,-822,0.004727725872631483,0.0009752649538717212,-0.005702990826503163,-5758,453,-0.2666357953229914,0.010430716699134646
359,4007,Gila,Arizona,2016,7003,14182,1330,22515,0.31103708638685323,0.6298911836553409,0.05907172995780591,-694,887,727,920,-0.04538801201555476,0.03855772208561327,0.006830289929941502,-7179,-1421,-0.3188540972684877,-0.05221830194549626
360,4009,Graham,Arizona,2000,3355,6007,302,9664,0.34716473509933776,0.6215852649006622,0.03125,0,0,0,0,0.0,0.0,0.0,-2652,0,-0.2744205298013245,0.0
361,4009,Graham,Arizona,2004,3185,7467,68,10720,0.2971082089552239,0.6965485074626866,0.006343283582089552,-170,-234,1460,1056,-0.05005652614411388,-0.024906716417910448,0.07496324256202436,-4282,-1630,-0.3994402985074627,-0.12501976870613823
362,4009,Graham,Arizona,2008,3487,8376,206,12069,0.2889220316513381,0.694009445687298,0.017068522661363824,302,138,909,1349,-0.008186177303885767,0.010725239079274272,-0.0025390617753885403,-4889,-607,-0.40508741403595994,-0.005647115528497226
363,4009,Graham,Arizona,2012,3609,8076,220,11905,0.30314993700126,0.6783704325913482,0.018479630407391853,122,14,-300,-164,0.014227905349921854,0.0014111077460280293,-0.01563901309594984,-4467,422,-0.37522049559008824,0.029866918445871693
364,4009,Graham,Arizona,2016,3301,8025,955,12281,0.2687891865483267,0.6534484162527482,0.07776239719892516,-308,735,-51,376,-0.0343607504529333,0.05928276679153331,-0.024922016338600028,-4724,-257,-0.3846592297044215,-0.00943873411433327
365,4011,Greenlee,Arizona,2000,1216,1619,125,2960,0.41081081081081083,0.5469594594594595,0.04222972972972973,0,0,0,0,0.0,0.0,0.0,-403,0,-0.13614864864864862,0.0
366,4011,Greenlee,Arizona,2004,1146,1899,22,3067,0.3736550374959244,0.6191718291490056,0.007173133355070101,-70,-103,280,107,-0.03715577331488645,-0.035056596374659625,0.07221236968954614,-753,-350,-0.2455167916530812,-0.1093681430044326
367,4011,Greenlee,Arizona,2008,1165,1712,43,2920,0.398972602739726,0.5863013698630137,0.014726027397260274,19,21,-187,-147,0.025317565243801632,0.007552894042190173,-0.03287045928599186,-547,206,-0.18732876712328772,0.05818802452979349
368,4011,Greenlee,Arizona,2012,1310,1592,84,2986,0.43871399866041527,0.5331547220361688,0.02813127930341594,145,41,-120,66,0.03974139592068926,0.013405251906155666,-0.05314664782684497,-282,265,-0.09444072337575349,0.09288804374753423
369,4011,Greenlee,Arizona,2016,1092,1892,316,3300,0.33090909090909093,0.5733333333333334,0.09575757575757576,-218,232,300,314,-0.10780490775132434,0.06762629645415982,0.0401786112971646,-800,-518,-0.24242424242424243,-0.14798351904848894
370,4012,La Paz,Arizona,2000,1769,2543,171,4483,0.3946018291322775,0.567254070934642,0.03814409993308052,0,0,0,0,0.0,0.0,0.0,-774,0,-0.1726522418023645,0.0
371,4012,La Paz,Arizona,2004,1849,3158,52,5059,0.36548725044475194,0.6242340383474995,0.010278711207748568,80,-119,615,576,-0.02911457868752554,-0.027865388725331956,0.05697996741285749,-1309,-535,-0.2587467879027475,-0.08609454610038303
372,4012,La Paz,Arizona,2008,1929,3509,139,5577,0.3458848843464228,0.6291913214990138,0.024923794154563386,80,87,351,518,-0.01960236609832916,0.014645082946814818,0.004957283151514336,-1580,-271,-0.283306437152591,-0.024559649249843496
373,4012,La Paz,Arizona,2012,1880,3714,141,5735,0.32781168265039234,0.6476024411508282,0.024585876198779423,-49,2,205,158,-0.01807320169603044,-0.00033791795578396247,0.01841111965181441,-1834,-254,-0.31979075850043587,-0.03648432134784485
374,4012,La Paz,Arizona,2016,1575,4003,373,5951,0.2646614014451353,0.6726600571332549,0.0626785414216098,-305,232,289,216,-0.06315028120525706,0.038092665222830384,0.02505761598242673,-2428,-594,-0.40799865568811966,-0.08820789718768379
375,4013,Maricopa,Arizona,2000,386683,479967,35049,901699,0.42883822650352277,0.5322918180013508,0.038869955495126424,0,0,0,0,0.0,0.0,0.0,-93284,0,-0.10345359149782807,0.0
376,4013,Maricopa,Arizona,2004,504849,679455,10657,1194961,0.4224815705282432,0.5686001467830331,0.008918282688723732,118166,-24392,199488,293262,-0.006356655975279568,-0.029951672806402693,0.03630832878168222,-174606,-81322,-0.14611857625478986,-0.04266498475696179
377,4013,Maricopa,Arizona,2008,602166,746448,22756,1371370,0.43909812814922305,0.5443082464980276,0.01659362535274944,97317,12099,66993,176409,0.016616557620979855,0.007675342664025709,-0.024291900285005497,-144282,30324,-0.1052101183488045,0.04090845790598535
378,4013,Maricopa,Arizona,2012,602288,749885,28786,1380959,0.43613749575476174,0.5430175696744074,0.02084493457083085,122,6030,3437,9589,-0.0029606323944613155,0.004251309218081409,-0.0012906768236201627,-147597,-3315,-0.10688007391964566,-0.0016699555708411529
379,4013,Maricopa,Arizona,2016,702907,747361,117566,1567834,0.44832998901669435,0.4766837560609095,0.07498625492239612,100619,88780,-2524,186875,0.012192493261932613,0.05414132035156527,-0.06633381361349788,-44454,103143,-0.02835376704421516,0.0785263068754305
380,4015,Mohave,Arizona,2000,17470,24386,2285,44141,0.39577716861874446,0.5524568994812079,0.05176593190004757,0,0,0,0,0.0,0.0,0.0,-6916,0,-0.15667973086246345,0.0
381,4015,Mohave,Arizona,2004,20503,36794,618,57915,0.35401882068548735,0.6353103686437019,0.01067081067081067,3033,-1667,12408,13774,-0.04175834793325711,-0.041095121229236906,0.08285346916249403,-16291,-9375,-0.2812915479582146,-0.12461181709575114
382,4015,Mohave,Arizona,2008,22092,44333,1570,67995,0.32490624310611077,0.6520038238105743,0.02308993308331495,1589,952,7539,10080,-0.029112577579376575,0.012419122412504278,0.016693455166872373,-22241,-5950,-0.32709758070446354,-0.04580603274624895
383,4015,Mohave,Arizona,2012,19533,49168,1626,70327,0.2777453893952536,0.6991340452457804,0.023120565358965974,-2559,56,4835,2332,-0.047160853710857153,3.06322756510255e-05,0.047130221435206066,-29635,-7394,-0.42138865585052676,-0.09429107514606322
384,4015,Mohave,Arizona,2016,17455,58282,4206,79943,0.21834306943697385,0.7290444441664686,0.05261248639655755,-2078,2580,9114,9616,-0.05940231995827977,0.029491921037591576,0.029910398920688253,-40827,-11192,-0.5107013747294948,-0.08931271887896808
385,4017,Navajo,Arizona,2000,11794,12386,967,25147,0.4690022666719688,0.49254384220781805,0.03845389112021315,0,0,0,0,0.0,0.0,0.0,-592,0,-0.023541575535849235,0.0
386,4017,Navajo,Arizona,2004,14815,17277,312,32404,0.45719664238982843,0.5331749166769535,0.009628440933218121,3021,-655,4891,7257,-0.011805624282140381,-0.028825450186995026,0.04063107446913544,-2462,-1870,-0.07597827428712506,-0.05243669875127582
387,4017,Navajo,Arizona,2008,15579,19761,592,35932,0.43356896359790714,0.5499554714460648,0.016475564956028053,764,280,2484,3528,-0.02362767879192129,0.006847124022809932,0.016780554769111333,-4182,-1720,-0.11638650784815768,-0.040408233561032625
388,4017,Navajo,Arizona,2012,16945,19884,636,37465,0.4522888028826905,0.5307353529961297,0.016975844121179768,1366,44,123,1533,0.01871983928478338,0.0005002791651517145,-0.019220118449935097,-2939,1243,-0.0784465501134392,0.03793995773471848
389,4017,Navajo,Arizona,2016,16459,20577,3258,40294,0.4084727254678116,0.5106715640045665,0.08085571052762199,-486,2622,693,2829,-0.04381607741487892,0.06387986640644222,-0.020063788991563247,-4118,-1179,-0.10219883853675488,-0.02375228842331567
390,4019,Pima,Arizona,2000,147688,124579,15373,287640,0.5134473647615074,0.4331073564177444,0.053445278820748156,0,0,0,0,0.0,0.0,0.0,23109,0,0.08034000834376304,0.0
391,4019,Pima,Arizona,2004,193128,171109,3255,367492,0.5255298074515908,0.46561285687851706,0.008857335669892134,45440,-12118,46530,79852,0.012082442690083406,-0.04458794315085602,0.03250550046077266,22019,-1090,0.05991695057307378,-0.020423057770689257
392,4019,Pima,Arizona,2008,206254,182406,6180,394840,0.5223736196940533,0.46197447067166447,0.01565190963428224,13126,2925,11297,27348,-0.003156187757537565,0.006794573964390106,-0.003638386206852584,23848,1829,0.0603991490223888,0.0004821984493150189
393,4019,Pima,Arizona,2012,201251,174779,7139,383169,0.5252277715577199,0.45614076295316164,0.018631465489118378,-5003,959,-7627,-11671,0.002854151863666665,0.0029795558548361377,-0.005833707718502834,26472,2624,0.0690870086045583,0.0086878595821695
394,4019,Pima,Arizona,2016,224661,167428,29551,421640,0.5328265819182241,0.3970875628498245,0.07008585523195143,23410,22412,-7351,38471,0.007598810360504138,0.051454389742833055,-0.059053200103337145,57233,30761,0.13573901906839958,0.06665201046384128
395,4021,Pinal,Arizona,2000,19650,20122,1518,41290,0.47590215548558973,0.4873334947929281,0.0367643497214822,0,0,0,0,0.0,0.0,0.0,-472,0,-0.011431339307338362,0.0
396,4021,Pinal,Arizona,2004,27252,37006,364,64622,0.4217139673795302,0.5726532759741264,0.00563275664634335,7602,-1154,16884,23332,-0.05418818810605952,-0.031131593075138853,0.08531978118119832,-9754,-9282,-0.1509393085945962,-0.13950796928725784
397,4021,Pinal,Arizona,2008,44254,59421,1723,105398,0.4198751399457295,0.563777301277064,0.016347558777206398,17002,1359,22415,40776,-0.001838827433800705,0.010714802130863049,-0.008875974697062361,-15167,-5413,-0.14390216133133454,0.007037147263261656
398,4021,Pinal,Arizona,2012,44306,62079,2297,108682,0.4076664029002043,0.5711985425369427,0.021135054562853094,52,574,2658,3284,-0.01220873704552522,0.004787495785646696,0.0074212412598786415,-17773,-2606,-0.1635321396367384,-0.01962997830540386
399,4021,Pinal,Arizona,2016,47892,72819,8835,129546,0.3696910749849474,0.5621092121717383,0.06819971284331434,3586,6538,10740,20864,-0.03797532791525687,0.04706465828046125,-0.009089330365204429,-24927,-7154,-0.19241813718679085,-0.028885997550052445
400,4023,Santa Cruz,Arizona,2000,5233,3344,316,8893,0.5884403463398178,0.3760260879343304,0.03553356572585179,0,0,0,0,0.0,0.0,0.0,1889,0,0.2124142584054874,0.0
401,4023,Santa Cruz,Arizona,2004,6909,4668,112,11689,0.591068525964582,0.3993498160663872,0.009581657969030712,1676,-204,1324,2796,0.0026281796247642486,-0.02595190775682108,0.023323728132056798,2241,352,0.19171870989819484,-0.02069554850729255
402,4023,Santa Cruz,Arizona,2008,8683,4518,143,13344,0.6507044364508393,0.3385791366906475,0.010716426858513189,1774,31,-150,1655,0.05963591048625727,0.0011347688894824768,-0.06077067937573971,4165,1924,0.3121252997601918,0.12040658986199698
403,4023,Santa Cruz,Arizona,2012,9486,4235,190,13911,0.6819064050032349,0.30443533894040686,0.013658256056358278,803,47,-283,567,0.031201968552395543,0.0029418291978450892,-0.03414379775024062,5251,1086,0.377471066062828,0.06534576630263617
404,4023,Santa Cruz,Arizona,2016,11690,3897,846,16433,0.7113734558510315,0.2371447696707844,0.05148177447818414,2204,656,-338,2522,0.02946705084779666,0.03782351842182586,-0.06729056926962246,7793,2542,0.4742286861802471,0.09675762011741912
405,4025,Yavapai,Arizona,2000,24063,40144,4021,68228,0.3526851146157003,0.5883801371870786,0.05893474819722108,0,0,0,0,0.0,0.0,0.0,-16081,0,-0.2356950225713783,0.0
406,4025,Yavapai,Arizona,2004,33127,53468,988,87583,0.3782355023235103,0.6104837696813309,0.011280727995158878,9064,-3033,13324,19355,0.025550387707809985,-0.047654020202062206,0.02210363249425229,-20341,-4260,-0.23224826735782061,0.003446755213557695
407,4025,Yavapai,Arizona,2008,36889,61192,2104,100185,0.36820881369466485,0.6107900384289066,0.021001147876428608,3762,1116,7724,12602,-0.010026688628845426,0.00972041988126973,0.00030626874757566647,-24303,-3962,-0.2425812247342417,-0.010332957376421092
408,4025,Yavapai,Arizona,2012,33918,64468,2281,100667,0.3369326591633803,0.6404084754686242,0.02265886536799547,-2971,177,3276,482,-0.03127615453128457,0.0016577174915668631,0.02961843703971767,-30550,-6247,-0.30347581630524395,-0.06089459157100224
409,4025,Yavapai,Arizona,2016,35590,71330,7530,114450,0.3109654871122761,0.6232415902140673,0.06579292267365662,1672,5249,6862,13783,-0.02596717205110416,0.04313405730566115,-0.017166885254556896,-35740,-5190,-0.3122761031017912,-0.008800286796547263
410,4027,Yuma,Arizona,2000,12055,15708,889,28652,0.4207385173809856,0.548233980175904,0.03102750244311043,0,0,0,0,0.0,0.0,0.0,-3653,0,-0.12749546279491836,0.0
411,4027,Yuma,Arizona,2004,16032,22184,313,38529,0.41610215681694307,0.5757740922422072,0.00812375094084975,3977,-576,6476,9877,-0.004636360564042541,-0.022903751502260677,0.027540112066303246,-6152,-2499,-0.15967193542526414,-0.03217647263034579
412,4027,Yuma,Arizona,2008,18559,24577,636,43772,0.4239925066252399,0.5614776569496481,0.014529836425111943,2527,323,2393,5243,0.007890349808296837,0.0064060854842621934,-0.014296435292559084,-6018,134,-0.13748515032440822,0.02218678510085592
413,4027,Yuma,Arizona,2012,18059,23352,662,42073,0.42923014760059897,0.5550352957954032,0.015734556603997814,-500,26,-1225,-1699,0.005237640975359059,0.0012047201788858708,-0.006442361154244902,-5293,725,-0.12580514819480426,0.011680002129603961
414,4027,Yuma,Arizona,2016,24605,25165,3240,53010,0.46415770609318996,0.47472175061309185,0.06112054329371817,6546,2578,1813,10937,0.03492755849259099,0.04538598668972035,-0.08031354518231137,-560,4733,-0.010564044519901894,0.11524110367490237
415,5001,Arkansas,Arkansas,2000,2877,3353,142,6372,0.4515065913370998,0.5262084118016321,0.022284996861268048,0,0,0,0,0.0,0.0,0.0,-476,0,-0.07470182046453233,0.0
416,5001,Arkansas,Arkansas,2004,3110,3789,47,6946,0.4477397063057875,0.5454938093866973,0.006766484307515116,233,-95,436,574,-0.0037668850313122837,-0.01551851255375293,0.0192853975850652,-679,-203,-0.09775410308090982,-0.023052282616377484
417,5001,Arkansas,Arkansas,2008,2619,4185,174,6978,0.3753224419604471,0.5997420464316423,0.024935511607910577,-491,127,396,32,-0.0724172643453404,0.01816902730039546,0.05424823704494497,-1566,-887,-0.2244196044711952,-0.12666550139028537
418,5001,Arkansas,Arkansas,2012,2455,3897,142,6494,0.37804126886356637,0.6000923929781337,0.02186633815829997,-164,-32,-288,-484,0.0027188269031192536,-0.003069173449610607,0.00035034654649135355,-1442,124,-0.2220511241145673,0.0023684803566279
419,5001,Arkansas,Arkansas,2016,1939,3826,447,6212,0.312137797810689,0.6159047005795235,0.0719575016097875,-516,305,-71,-282,-0.06590347105287736,0.050091163451487536,0.015812307601389852,-1887,-445,-0.3037669027688345,-0.08171577865426721
420,5003,Ashley,Arkansas,2000,4253,3876,142,8271,0.5142062628460887,0.4686253173739572,0.017168419779954057,0,0,0,0,0.0,0.0,0.0,377,0,0.04558094547213154,0.0
421,5003,Ashley,Arkansas,2004,3881,4567,64,8512,0.45594454887218044,0.5365366541353384,0.007518796992481203,-372,-78,691,241,-0.05826171397390828,-0.009649622787472854,0.06791133676138117,-686,-1063,-0.08059210526315791,-0.12617305073528945
422,5003,Ashley,Arkansas,2008,2976,5406,260,8642,0.34436473038648463,0.6255496412867392,0.03008562832677621,-905,196,839,130,-0.11157981848569581,0.022566831334295007,0.08901298715140082,-2430,-1744,-0.28118491090025455,-0.20059280563709664
423,5003,Ashley,Arkansas,2012,2859,4867,195,7921,0.3609392753440222,0.6144426208812018,0.024618103774775912,-117,-65,-539,-721,0.016574544957537574,-0.0054675245520002975,-0.011107020405537349,-2008,422,-0.2535033455371796,0.027681565363074923
424,5003,Ashley,Arkansas,2016,2408,5338,337,8083,0.2979091921316343,0.6603983669429667,0.041692440925398984,-451,142,471,162,-0.0630300832123879,0.01707433715062307,0.04595574606176489,-2930,-922,-0.3624891748113324,-0.10898582927415279
425,5005,Baxter,Arkansas,2000,6516,9538,654,16708,0.38999281781182665,0.570864256643524,0.03914292554464927,0,0,0,0,0.0,0.0,0.0,-3022,0,-0.18087143883169737,0.0
426,5005,Baxter,Arkansas,2004,7129,11128,273,18530,0.3847274689692391,0.6005396654074474,0.014732865623313546,613,-381,1590,1822,-0.005265348842587558,-0.024410059921335728,0.029675408763923383,-3999,-977,-0.21581219643820831,-0.03494075760651094
427,5005,Baxter,Arkansas,2008,6539,12852,590,19981,0.3272608978529603,0.6432110504979731,0.029528051649066613,-590,317,1724,1451,-0.057466571116278786,0.014795186025753066,0.042671385090525704,-6313,-2314,-0.3159501526450128,-0.10013795620680449
428,5005,Baxter,Arkansas,2012,5172,13688,479,19339,0.2674388541289622,0.7077925435648172,0.02476860230622059,-1367,-111,836,-642,-0.05982204372399813,-0.004759449342846021,0.06458149306684413,-8516,-2203,-0.44035368943585507,-0.12440353679084226
429,5005,Baxter,Arkansas,2016,4169,14682,915,19766,0.21091773752909035,0.7427906506121623,0.04629161185874734,-1003,436,994,427,-0.05652111659987183,0.02152300955252675,0.03499810704734507,-10513,-1997,-0.5318729130830719,-0.09151922364721687
430,5007,Benton,Arkansas,2000,17277,34838,1531,53646,0.3220556984677329,0.6494053610707229,0.028538940461544197,0,0,0,0,0.0,0.0,0.0,-17561,0,-0.32734966260299,0.0
431,5007,Benton,Arkansas,2004,20756,46571,794,68121,0.304693119596013,0.6836511501592754,0.011655730244711617,3479,-737,11733,14475,-0.017362578871719936,-0.016883210216832582,0.03424578908855247,-25815,-8254,-0.3789580305632624,-0.051608367960272405
432,5007,Benton,Arkansas,2008,23331,51124,1618,76073,0.30669225612240875,0.6720386996700538,0.0212690442075375,2575,824,4553,7952,0.0019991365263957728,0.009613313962825882,-0.011612450489221549,-27793,-1978,-0.36534644354764506,0.013611587015617321
433,5007,Benton,Arkansas,2012,22636,54646,1975,79257,0.28560253353016135,0.6894785318646933,0.02491893460514529,-695,357,3522,3184,-0.021089722592247395,0.00364989039760779,0.017439832194639515,-32010,-4217,-0.40387599833453197,-0.03852955478688691
434,5007,Benton,Arkansas,2016,28005,60871,7948,96824,0.2892361398000496,0.628676774353466,0.08208708584648435,5369,5973,6225,17567,0.0036336062698882343,0.05716815124133906,-0.060801757511227295,-32866,-856,-0.33944063455341644,0.06443536378111553
435,5009,Boone,Arkansas,2000,4493,8569,573,13635,0.3295196186285295,0.6284561789512284,0.042024202420242025,0,0,0,0,0.0,0.0,0.0,-4076,0,-0.2989365603226989,0.0
436,5009,Boone,Arkansas,2004,4640,9793,344,14777,0.31400148880016243,0.6627190904784462,0.02327942072139135,147,-229,1224,1142,-0.015518129828367089,-0.018744781698850674,0.03426291152721783,-5153,-1077,-0.3487176016782838,-0.04978104135558492
437,5009,Boone,Arkansas,2008,4435,10575,464,15474,0.28660979707897116,0.6834044203179527,0.029985782603076126,-205,120,782,697,-0.02739169172119127,0.006706361881684775,0.02068532983950644,-6140,-987,-0.3967946232389815,-0.04807702156069771
438,5009,Boone,Arkansas,2012,3772,11159,460,15391,0.24507829250860894,0.7250341108439997,0.029887596647391334,-663,-4,584,-83,-0.04153150457036223,-9.818595568479235e-05,0.041629690526047036,-7387,-1247,-0.4799558183353908,-0.08316119509640929
439,5009,Boone,Arkansas,2016,2926,12235,950,16111,0.18161504562100428,0.7594190304760723,0.05896592390292347,-846,490,1076,720,-0.06346324688760466,0.029078327255532135,0.034384919632072575,-9309,-1922,-0.577803984855068,-0.0978481665196772
440,5011,Bradley,Arkansas,2000,2122,1793,64,3979,0.5332998240764011,0.4506157325961297,0.016084443327469212,0,0,0,0,0.0,0.0,0.0,329,0,0.0826840914802714,0.0
441,5011,Bradley,Arkansas,2004,2206,2011,32,4249,0.519180983760885,0.4732878324311603,0.007531183807954813,84,-32,218,270,-0.014118840315516135,-0.008553259519514399,0.0226720998350306,195,-134,0.04589315132972466,-0.036790940150546736
442,5011,Bradley,Arkansas,2008,1680,2262,99,4041,0.41573867854491464,0.5597624350408315,0.024498886414253896,-526,67,251,-208,-0.10344230521597031,0.01696770260629908,0.08647460260967116,-582,-777,-0.1440237564959168,-0.18991690782564147
443,5011,Bradley,Arkansas,2012,1449,2134,69,3652,0.39676889375684554,0.5843373493975904,0.018893756845564075,-231,-30,-128,-389,-0.0189697847880691,-0.005605129568689821,0.02457491435675896,-685,-103,-0.18756845564074487,-0.04354469914482806
444,5011,Bradley,Arkansas,2016,1317,2164,172,3653,0.36052559540104023,0.5923898165891048,0.04708458800985491,-132,103,30,1,-0.03624329835580531,0.028190831164290837,0.008052467191514423,-847,-162,-0.2318642211880646,-0.04429576554731973
445,5013,Calhoun,Arkansas,2000,1017,1128,40,2185,0.4654462242562929,0.5162471395881006,0.018306636155606407,0,0,0,0,0.0,0.0,0.0,-111,0,-0.05080091533180775,0.0
446,5013,Calhoun,Arkansas,2004,939,1340,20,2299,0.40843845150065244,0.5828621139625925,0.008699434536755112,-78,-20,212,114,-0.05700777275564045,-0.009607201618851296,0.06661497437449182,-401,-290,-0.17442366246194002,-0.12362274713013227
447,5013,Calhoun,Arkansas,2008,691,1462,64,2217,0.3116824537663509,0.6594497068110059,0.02886783942264321,-248,44,122,-82,-0.09675599773430155,0.0201684048858881,0.07658759284841343,-771,-370,-0.347767253044655,-0.17334359058271498
448,5013,Calhoun,Arkansas,2012,660,1458,56,2174,0.30358785648574055,0.6706531738730451,0.025758969641214352,-31,-8,-4,-43,-0.00809459728061035,-0.0031088697814288593,0.01120346706203923,-798,-27,-0.3670653173873046,-0.01929806434264958
449,5013,Calhoun,Arkansas,2016,639,1556,74,2269,0.28162185985015425,0.6857646540326134,0.03261348611723226,-21,18,98,95,-0.021965996635586293,0.006854516476017911,0.015111480159568313,-917,-119,-0.4041427941824592,-0.03707747679515461
450,5015,Carroll,Arkansas,2000,3595,5556,439,9590,0.3748696558915537,0.5793534932221064,0.04577685088633994,0,0,0,0,0.0,0.0,0.0,-1961,0,-0.2044838373305527,0.0
451,5015,Carroll,Arkansas,2004,4161,6184,136,10481,0.39700410266195973,0.5900200362560825,0.012975861081957828,566,-303,628,891,0.022134446770406047,-0.03280098980438211,0.010666543033976073,-2023,-62,-0.19301593359412272,0.011467903736429974
452,5015,Carroll,Arkansas,2008,4172,6083,324,10579,0.39436619718309857,0.5750070895169676,0.03062671329993383,11,188,-101,98,-0.002637905478861169,0.017650852217976003,-0.015012946739114907,-1911,112,-0.18064089233386899,0.012375041260253739
453,5015,Carroll,Arkansas,2012,3696,6125,362,10183,0.36295787096140625,0.6014926838849062,0.03554944515368752,-476,38,42,-396,-0.03140832622169232,0.004922731853753689,0.026485594367938625,-2429,-518,-0.23853481292349993,-0.05789392058963094
454,5015,Carroll,Arkansas,2016,3342,6786,630,10758,0.31065253764640266,0.6307863915225879,0.05856107083100948,-354,268,661,575,-0.05230533331500359,0.023011625677321963,0.029293707637681687,-3444,-1015,-0.3201338538761852,-0.08159904095268528
455,5017,Chicot,Arkansas,2000,2820,1564,68,4452,0.633423180592992,0.35130278526504943,0.015274034141958671,0,0,0,0,0.0,0.0,0.0,1256,0,0.28212039532794253,0.0
456,5017,Chicot,Arkansas,2004,2993,1725,39,4757,0.6291780533949969,0.3626235022072735,0.008198444397729661,173,-29,161,305,-0.00424512719799508,-0.00707558974422901,0.011320716942224085,1268,12,0.26655455118772337,-0.015565844140219165
457,5017,Chicot,Arkansas,2008,3043,2119,46,5208,0.5842933947772657,0.4068740399385561,0.008832565284178187,50,7,394,451,-0.044884658617731166,0.0006341208864485259,0.04425053773128257,924,-344,0.17741935483870963,-0.08913519634901373
458,5017,Chicot,Arkansas,2012,2649,1670,42,4361,0.6074294886493924,0.382939692731025,0.009630818619582664,-394,-4,-449,-847,0.023136093872126673,0.0007982533354044773,-0.02393434720753107,979,55,0.22448979591836737,0.04707044107965774
459,5017,Chicot,Arkansas,2016,2350,1716,110,4176,0.5627394636015326,0.4109195402298851,0.026340996168582376,-299,68,46,-185,-0.044690025047859794,0.016710177548999713,0.027979847498860067,634,-345,0.1518199233716475,-0.07266987254671986
460,5019,Clark,Arkansas,2000,4661,3776,189,8626,0.5403431486204499,0.43774634824947833,0.021910503130071875,0,0,0,0,0.0,0.0,0.0,885,0,0.10259680037097152,0.0
461,5019,Clark,Arkansas,2004,4990,4144,77,9211,0.5417435674736728,0.44989686244707416,0.008359570079253068,329,-112,368,585,0.0014004188532229511,-0.013550933050818807,0.01215051419759583,846,-39,0.09184670502659864,-0.010750095344372879
462,5019,Clark,Arkansas,2008,4267,4608,219,9094,0.46921046844073017,0.5067077193754124,0.02408181218385749,-723,142,464,-117,-0.07253309903294264,0.01572224210460442,0.056810856928338205,-341,-1187,-0.0374972509346822,-0.12934395596128084
463,5019,Clark,Arkansas,2012,3811,4343,255,8409,0.45320489951242715,0.5164704483291711,0.030324652158401712,-456,36,-265,-685,-0.016005568928303016,0.006242839974544223,0.009762728953758737,-532,-191,-0.06326554881674396,-0.025768297882061753
464,5019,Clark,Arkansas,2016,3620,4404,502,8526,0.4245836265540699,0.5165376495425756,0.05887872390335445,-191,247,61,117,-0.028621272958357258,0.028554071744952735,6.7201213404533e-05,-784,-252,-0.09195402298850575,-0.02868847417176179
465,5021,Clay,Arkansas,2000,3527,2254,119,5900,0.5977966101694915,0.3820338983050847,0.02016949152542373,0,0,0,0,0.0,0.0,0.0,1273,0,0.21576271186440676,0.0
466,5021,Clay,Arkansas,2004,3264,2759,73,6096,0.5354330708661418,0.4525918635170604,0.011975065616797901,-263,-46,505,196,-0.0623635393033497,-0.008194425908625829,0.07055796521197566,505,-768,0.0828412073490814,-0.13292150451532536
467,5021,Clay,Arkansas,2008,2244,3032,235,5511,0.40718562874251496,0.5501723825077118,0.04264198874977318,-1020,162,273,-585,-0.12824744212362682,0.03066692313297528,0.09758051899065145,-788,-1293,-0.14298675376519687,-0.22582796111427828
468,5021,Clay,Arkansas,2012,1738,3225,147,5110,0.3401174168297456,0.6311154598825832,0.028767123287671233,-506,-88,193,-401,-0.06706821191276935,-0.013874865462101947,0.08094307737487139,-1487,-699,-0.2909980430528376,-0.14801128928764073
469,5021,Clay,Arkansas,2016,1199,3781,220,5200,0.23057692307692307,0.7271153846153846,0.04230769230769231,-539,73,556,90,-0.10954049375282254,0.013540569020021077,0.09599992473280139,-2582,-1095,-0.49653846153846154,-0.20554041848562393
470,5023,Cleburne,Arkansas,2000,4120,5730,357,10207,0.40364455765651025,0.5613794454785931,0.03497599686489664,0,0,0,0,0.0,0.0,0.0,-1610,0,-0.15773488782208284,0.0
471,5023,Cleburne,Arkansas,2004,4517,7107,137,11761,0.38406598078394694,0.6042853498852139,0.011648669330839214,397,-220,1377,1554,-0.019578576872563314,-0.02332732753405743,0.04290590440662079,-2590,-980,-0.22021936910126694,-0.0624844812791841
472,5023,Cleburne,Arkansas,2008,2951,7962,425,11338,0.26027518080790263,0.7022402540130535,0.03748456517904392,-1566,288,855,-423,-0.12379079997604431,0.02583589584820471,0.09795490412783958,-5011,-2421,-0.4419650732051508,-0.2217457041038839
473,5023,Cleburne,Arkansas,2012,2620,8693,334,11647,0.22495063106379326,0.7463724564265476,0.02867691250965914,-331,-91,731,309,-0.03532454974410937,-0.008807652669384783,0.04413220241349414,-6073,-1062,-0.5214218253627543,-0.07945675215760345
474,5023,Cleburne,Arkansas,2016,2101,9458,526,12085,0.17385188249896566,0.7826230864708316,0.04352503103020273,-519,192,765,438,-0.0510987485648276,0.014848118520543588,0.03625063004428397,-7357,-1284,-0.6087712039718659,-0.08734937860911163
475,5025,Cleveland,Arkansas,2000,1414,1678,89,3181,0.44451430367808864,0.5275070732474064,0.027978623074504872,0,0,0,0,0.0,0.0,0.0,-264,0,-0.08299276956931778,0.0
476,5025,Cleveland,Arkansas,2004,1450,2009,37,3496,0.4147597254004577,0.5746567505720824,0.010583524027459955,36,-52,331,315,-0.02975457827763095,-0.017395099047044917,0.04714967732467601,-559,-295,-0.15989702517162474,-0.07690425560230696
477,5025,Cleveland,Arkansas,2008,911,2451,143,3505,0.2599144079885877,0.6992867332382311,0.04079885877318117,-539,106,442,9,-0.15484531741186996,0.030215334745721217,0.12462998266614866,-1540,-981,-0.43937232524964337,-0.27947530007801863
478,5025,Cleveland,Arkansas,2012,845,2313,108,3266,0.25872627066748316,0.7082057562767912,0.03306797305572566,-66,-35,-138,-239,-0.0011881373211045654,-0.0077308857174555115,0.00891902303856007,-1468,72,-0.449479485609308,-0.010107160359664635
479,5025,Cleveland,Arkansas,2016,723,2462,169,3354,0.21556350626118068,0.7340488968395945,0.050387596899224806,-122,61,149,88,-0.043162764406302484,0.017319623843499145,0.025843140562803346,-1739,-271,-0.5184853905784138,-0.0690059049691058
480,5027,Columbia,Arkansas,2000,4003,5018,286,9307,0.430106371548297,0.5391640700547975,0.030729558396905554,0,0,0,0,0.0,0.0,0.0,-1015,0,-0.10905769850650049,0.0
481,5027,Columbia,Arkansas,2004,4108,5729,72,9909,0.41457261075789686,0.5781612675345645,0.007266121707538601,105,-214,711,602,-0.015533760790400142,-0.023463436689366953,0.03899719747976704,-1621,-606,-0.16358865677666767,-0.054530958270167185
482,5027,Columbia,Arkansas,2008,3554,5861,143,9558,0.3718351119481063,0.6132035990793053,0.014961288972588407,-554,71,132,-351,-0.04273749880979055,0.007695167265049806,0.03504233154474079,-2307,-686,-0.24136848713119902,-0.07777983035453134
483,5027,Columbia,Arkansas,2012,3557,5790,108,9455,0.37620306716023266,0.612374405076679,0.011422527763088313,3,-35,-71,-103,0.004367955212126351,-0.003538761209500094,-0.0008291940026263767,-2233,74,-0.2361713379164463,0.005197149214752728
484,5027,Columbia,Arkansas,2016,3140,5456,291,8887,0.3533250815798357,0.6139304602227973,0.03274445819736694,-417,183,-334,-568,-0.022877985580396942,0.021321930434278626,0.0015560551461183403,-2316,-83,-0.26060537864296157,-0.024434040726515283
485,5029,Conway,Arkansas,2000,3496,3545,193,7234,0.4832734310201825,0.4900470002764722,0.026679568703345313,0,0,0,0,0.0,0.0,0.0,-49,0,-0.006773569256289691,0.0
486,5029,Conway,Arkansas,2004,3982,4009,93,8084,0.4925779317169718,0.4959178624443345,0.011504205838693715,486,-100,464,850,0.009304500696789286,-0.015175362864651598,0.005870862167862312,-27,22,-0.0033399307273627166,0.0034336385289269744
487,5029,Conway,Arkansas,2008,3149,4691,298,8138,0.3869501105922831,0.5764315556647825,0.036618333742934384,-833,205,682,54,-0.10562782112468866,0.02511412790424067,0.08051369322044805,-1542,-1515,-0.18948144507249942,-0.1861415143451367
488,5029,Conway,Arkansas,2012,3005,4514,211,7730,0.388745148771022,0.5839586028460544,0.027296248382923674,-144,-87,-177,-408,0.0017950381787388836,-0.00932208536001071,0.00752704718127184,-1509,33,-0.19521345407503238,-0.005732009002532956
489,5029,Conway,Arkansas,2016,2656,4849,422,7927,0.3350573987637189,0.6117068247760817,0.05323577646019932,-349,211,335,197,-0.05368775000730308,0.025939528077275648,0.02774822193002735,-2193,-684,-0.2766494260123628,-0.08143597193733043
490,5031,Craighead,Arkansas,2000,12376,12158,623,25157,0.4919505505425925,0.48328497038597606,0.024764479071431412,0,0,0,0,0.0,0.0,0.0,218,0,0.008665580156616448,0.0
491,5031,Craighead,Arkansas,2004,13665,15818,318,29801,0.4585416596758498,0.5307875574645146,0.010670782859635583,1289,-305,3660,4644,-0.0334088908667427,-0.014093696211795828,0.047502587078538494,-2153,-2371,-0.07224589778866475,-0.0809114779452812
492,5031,Craighead,Arkansas,2008,11294,18881,793,30968,0.3646990441746319,0.6096938775510204,0.025607078274347713,-2371,475,3063,1167,-0.09384261550121792,0.01493629541471213,0.07890632008650589,-7587,-5434,-0.24499483337638855,-0.1727489355877238
493,5031,Craighead,Arkansas,2012,10527,20350,823,31700,0.3320820189274448,0.6419558359621451,0.025962145110410093,-767,30,1469,732,-0.03261702524718707,0.00035506683606238015,0.03226195841112467,-9823,-2236,-0.3098738170347003,-0.06487898365831174
494,5031,Craighead,Arkansas,2016,10538,22892,2143,35573,0.29623590925702076,0.6435217721305484,0.060242318612430776,11,1320,2542,3873,-0.035846109670424064,0.034280173502020686,0.0015659361684032813,-12354,-2531,-0.34728586287352764,-0.037412045838827346
495,5033,Crawford,Arkansas,2000,6288,10804,533,17625,0.3567659574468085,0.6129929078014185,0.03024113475177305,0,0,0,0,0.0,0.0,0.0,-4516,0,-0.25622695035460996,0.0
496,5033,Crawford,Arkansas,2004,6764,13391,246,20401,0.33155237488358413,0.6563893926768296,0.012058232439586295,476,-287,2587,2776,-0.025213582563224368,-0.018182902312186756,0.043396484875411145,-6627,-2111,-0.3248370177932455,-0.06861006743863551
497,5033,Crawford,Arkansas,2008,5238,14688,606,20532,0.25511396843950906,0.7153711279953243,0.02951490356516657,-1526,360,1297,131,-0.07643840644407507,0.017456671125580275,0.05898173531849471,-9450,-2823,-0.46025715955581525,-0.13542014176256978
498,5033,Crawford,Arkansas,2012,4881,15145,565,20591,0.23704531105822932,0.7355155164877859,0.02743917245398475,-357,-41,457,59,-0.018068657381279746,-0.002075731111181818,0.020144388492461585,-10264,-814,-0.49847020542955656,-0.0382130458737413
499,5033,Crawford,Arkansas,2016,4488,16686,1276,22450,0.1999109131403118,0.7432516703786192,0.05683741648106904,-393,711,1541,1859,-0.037134397917917505,0.02939824402708429,0.007736153890833264,-12198,-1934,-0.5433407572383073,-0.04487055180875077
500,5035,Crittenden,Arkansas,2000,7224,5857,153,13234,0.5458667069669034,0.4425721626114553,0.011561130421641226,0,0,0,0,0.0,0.0,0.0,1367,0,0.1032945443554481,0.0
501,5035,Crittenden,Arkansas,2004,8277,6930,93,15300,0.5409803921568628,0.45294117647058824,0.00607843137254902,1053,-60,1073,2066,-0.004886314810040648,-0.005482699049092207,0.010369013859132914,1347,-20,0.08803921568627454,-0.015255328669173562
502,5035,Crittenden,Arkansas,2008,10330,7650,275,18255,0.5658723637359627,0.419063270336894,0.015064365927143249,2053,182,720,2955,0.024891971579099947,0.00898593455459423,-0.033877906133694236,2680,1333,0.14680909339906872,0.05876987771279418
503,5035,Crittenden,Arkansas,2012,9487,6998,231,16716,0.5675400813591769,0.4186408231634362,0.013819095477386936,-843,-44,-652,-1539,0.00166771762321416,-0.0012452704497563135,-0.00042244717345779614,2489,-191,0.14889925819574068,0.002090164796671956
504,5035,Crittenden,Arkansas,2016,8410,6964,578,15952,0.5272066198595787,0.43655967903711135,0.03623370110330993,-1077,347,-34,-764,-0.040333461499598156,0.022414605625922995,0.017918855873675144,1446,-1043,0.09064694082246738,-0.0582523173732733
505,5037,Cross,Arkansas,2000,3096,3033,86,6215,0.49814963797264683,0.48801287208366856,0.013837489943684634,0,0,0,0,0.0,0.0,0.0,63,0,0.010136765888978272,0.0
506,5037,Cross,Arkansas,2004,3135,3864,75,7074,0.4431721798134012,0.546225614927905,0.010602205258693808,39,-11,831,859,-0.05497745815924565,-0.003235284684990826,0.05821274284423644,-729,-792,-0.10305343511450382,-0.1131902010034821
507,5037,Cross,Arkansas,2008,2580,4393,157,7130,0.36185133239831696,0.6161290322580645,0.022019635343618515,-555,82,529,56,-0.08132084741508422,0.011417430084924707,0.06990341733015948,-1813,-1084,-0.2542776998597475,-0.1512242647452437
508,5037,Cross,Arkansas,2012,2279,4269,133,6681,0.3411165993114803,0.6389762011674899,0.019907199521029786,-301,-24,-124,-449,-0.020734733086836654,-0.002112435822588729,0.022847168909425397,-1990,-177,-0.29785960185600957,-0.04358190199626205
509,5037,Cross,Arkansas,2016,1999,4584,291,6874,0.29080593540878674,0.6668606342740763,0.04233343031713704,-280,158,315,193,-0.050310663902693564,0.02242623079610725,0.027884433106586393,-2585,-595,-0.3760546988652895,-0.07819509700927996
510,5039,Dallas,Arkansas,2000,1710,1571,44,3325,0.5142857142857142,0.4724812030075188,0.013233082706766918,0,0,0,0,0.0,0.0,0.0,139,0,0.041804511278195455,0.0
511,5039,Dallas,Arkansas,2004,1671,1700,17,3388,0.493211334120425,0.5017709563164109,0.005017709563164109,-39,-27,129,63,-0.02107438016528923,-0.008215373143602808,0.029289753308892108,-29,-168,-0.008559622195985883,-0.05036413347418134
512,5039,Dallas,Arkansas,2008,1471,1757,90,3318,0.44333936106088007,0.5295358649789029,0.027124773960216998,-200,73,57,-70,-0.04987197305954494,0.02210706439705289,0.027764908662492038,-286,-257,-0.08619650391802286,-0.07763688172203698
513,5039,Dallas,Arkansas,2012,1337,1665,82,3084,0.4335278858625162,0.5398832684824902,0.026588845654993514,-134,-8,-92,-234,-0.00981147519836384,-0.0005359283052234834,0.010347403503587316,-328,-42,-0.10635538261997401,-0.020158878701951155
514,5039,Dallas,Arkansas,2016,1165,1509,97,2771,0.4204258390472754,0.5445687477444966,0.03500541320822808,-172,15,-156,-313,-0.013102046815240853,0.008416567553234566,0.0046854792620063535,-344,-16,-0.12414290869722122,-0.017787526077247207
515,5041,Desha,Arkansas,2000,2776,1603,116,4495,0.617575083426029,0.35661846496106786,0.025806451612903226,0,0,0,0,0.0,0.0,0.0,1173,0,0.2609566184649611,0.0
516,5041,Desha,Arkansas,2004,2851,1729,67,4647,0.613514095115128,0.3720680008607704,0.01441790402410157,75,-49,126,152,-0.004060988310900959,-0.011388547588801656,0.015449535899702549,1122,-51,0.2414460942543576,-0.019510524210603508
517,5041,Desha,Arkansas,2008,2569,1999,110,4678,0.5491663103890552,0.4273193672509619,0.0235143223599829,-282,43,270,31,-0.06434778472607283,0.009096418335881328,0.055251366390191514,570,-552,0.12184694313809324,-0.11959915111626435
518,5041,Desha,Arkansas,2012,2443,1896,81,4420,0.5527149321266969,0.4289592760180995,0.01832579185520362,-126,-29,-103,-258,0.0035486217376416995,-0.005188530504779278,0.001639908767137599,547,-23,0.12375565610859734,0.0019087129705041006
519,5041,Desha,Arkansas,2016,2228,1919,110,4257,0.5233732675593141,0.4507869391590322,0.025839793281653745,-215,29,23,-163,-0.02934166456738274,0.0075140014264501245,0.02182766314093265,309,-238,0.07258632840028195,-0.05116932770831539
520,5043,Drew,Arkansas,2000,3060,2756,106,5922,0.5167173252279635,0.46538331644714626,0.01789935832489024,0,0,0,0,0.0,0.0,0.0,304,0,0.051334008780817286,0.0
521,5043,Drew,Arkansas,2004,2952,3262,35,6249,0.4723955832933269,0.5220035205632901,0.005600896143382941,-108,-71,506,327,-0.044321741934636616,-0.012298462181507298,0.05662020411614388,-310,-614,-0.04960793726996321,-0.1009419460507805
522,5043,Drew,Arkansas,2008,2598,3860,152,6610,0.3930408472012103,0.583963691376702,0.022995461422087745,-354,117,598,361,-0.07935473609211663,0.017394565278704803,0.061960170813411874,-1262,-952,-0.1909228441754917,-0.1413149069055285
523,5043,Drew,Arkansas,2012,2630,3887,116,6633,0.3965023368008443,0.586009347203377,0.017488315995778683,32,-36,27,23,0.0034614895996339934,-0.0055071454263090625,0.0020456558266750413,-1257,5,-0.18950701040253276,0.001415833772958952
524,5043,Drew,Arkansas,2016,2365,3968,262,6595,0.35860500379075055,0.6016679302501895,0.03972706595905989,-265,146,81,-38,-0.03789733301009374,0.02223874996328121,0.015658583046812447,-1603,-346,-0.24306292645943894,-0.05355591605690618
525,5045,Faulkner,Arkansas,2000,11950,16055,1211,29216,0.4090224534501643,0.5495276560788609,0.04144989047097481,0,0,0,0,0.0,0.0,0.0,-4105,0,-0.1405052026286966,0.0
526,5045,Faulkner,Arkansas,2004,14538,21514,634,36686,0.396281960420869,0.5864362427083901,0.01728179687074088,2588,-577,5459,7470,-0.012740493029295308,-0.02416809360023393,0.03690858662952923,-6976,-2871,-0.19015428228752113,-0.049649079658824535
527,5045,Faulkner,Arkansas,2008,14955,25362,862,41179,0.36317054809490273,0.6158964520750868,0.020932999830010443,417,228,3848,4493,-0.03311141232596626,0.0036512029592695623,0.029460209366696688,-10407,-3431,-0.2527259039801841,-0.06257162169266295
528,5045,Faulkner,Arkansas,2012,13621,26722,1117,41460,0.3285335262904004,0.644524843222383,0.026941630487216595,-1334,255,1360,281,-0.034637021804502344,0.0060086306572061515,0.028628391147296206,-13101,-2694,-0.3159913169319826,-0.06326541295179855
529,5045,Faulkner,Arkansas,2016,14629,29346,3552,47527,0.3078039851032045,0.617459549308814,0.07473646558798157,1008,2435,2624,6067,-0.020729541187195888,0.047794835100764974,-0.027065293913569044,-14717,-1616,-0.30965556420560947,0.006335752726373156
530,5047,Franklin,Arkansas,2000,2674,3277,189,6140,0.43550488599348536,0.53371335504886,0.030781758957654722,0,0,0,0,0.0,0.0,0.0,-603,0,-0.09820846905537461,0.0
531,5047,Franklin,Arkansas,2004,3008,4181,100,7289,0.4126766360268898,0.5736040609137056,0.013719303059404582,334,-89,904,1149,-0.02282824996659555,-0.017062455898250138,0.039890705864845666,-1173,-570,-0.16092742488681583,-0.06271895583144121
532,5047,Franklin,Arkansas,2008,1869,4411,195,6475,0.28864864864864864,0.6812355212355212,0.030115830115830116,-1139,95,230,-814,-0.12402798737824117,0.016396527056425532,0.10763146032181559,-2542,-1369,-0.3925868725868726,-0.23165944770005675
533,5047,Franklin,Arkansas,2012,1726,4631,183,6540,0.26391437308868504,0.7081039755351682,0.02798165137614679,-143,-12,220,65,-0.024734275559963603,-0.0021341787396833255,0.026868454299647015,-2905,-363,-0.4441896024464832,-0.05160272985961062
534,5047,Franklin,Arkansas,2016,1376,5039,355,6770,0.20324963072378138,0.7443131462333825,0.05243722304283604,-350,172,408,230,-0.06066474236490366,0.024455571666689248,0.03620917069821428,-3663,-758,-0.5410635155096011,-0.09687391306311788
535,5049,Fulton,Arkansas,2000,1976,2036,96,4108,0.4810126582278481,0.495618305744888,0.023369036027263874,0,0,0,0,0.0,0.0,0.0,-60,0,-0.01460564751703991,0.0
536,5049,Fulton,Arkansas,2004,2370,2522,63,4955,0.4783047426841574,0.5089808274470232,0.012714429868819375,394,-33,486,847,-0.0027079155436907087,-0.0106546061584445,0.0133625217021352,-152,-92,-0.03067608476286582,-0.016070437245825908
537,5049,Fulton,Arkansas,2008,1819,2702,155,4676,0.3890076988879384,0.5778443113772455,0.03314798973481608,-551,92,180,-279,-0.089297043796219,0.020433559865996702,0.06886348393022224,-883,-731,-0.18883661248930705,-0.15816052772644124
538,5049,Fulton,Arkansas,2012,1452,2949,121,4522,0.32109685979655017,0.6521450685537373,0.026758071649712518,-367,-34,247,-154,-0.06791083909138823,-0.006389918085103561,0.07430075717649187,-1497,-614,-0.33104820875718716,-0.1422115962678801
539,5049,Fulton,Arkansas,2016,1067,3471,234,4772,0.2235959765297569,0.7273679798826488,0.0490360435875943,-385,113,522,250,-0.09750088326679326,0.022277971937881783,0.07522291132891146,-2404,-907,-0.5037720033528919,-0.1727237945957047
540,5051,Garland,Arkansas,2000,15840,19098,997,35935,0.4407958814526228,0.5314595797968554,0.027744538750521776,0,0,0,0,0.0,0.0,0.0,-3258,0,-0.09066369834423266,0.0
541,5051,Garland,Arkansas,2004,18040,21734,380,40154,0.44927030930915973,0.541266125417144,0.009463565273696269,2200,-617,2636,4219,0.008474427856536959,-0.01828097347682551,0.009806545620288598,-3694,-436,-0.0919958161079843,-0.001332117763751639
542,5051,Garland,Arkansas,2008,15899,26825,995,43719,0.36366339577757956,0.613577620714106,0.022758983508314463,-2141,615,5091,3565,-0.08560691353158018,0.013295418234618194,0.07231149529696201,-10926,-7232,-0.24991422493652649,-0.1579184088285422
543,5051,Garland,Arkansas,2012,13804,26014,910,40728,0.3389314476527205,0.6387252013356904,0.022343351011589078,-2095,-85,-811,-2991,-0.02473194812485907,-0.00041563249672538563,0.025147580621584398,-12210,-1284,-0.29979375368296995,-0.04987952874644347
544,5051,Garland,Arkansas,2016,12311,26087,2407,40805,0.3017032226442838,0.6393089082220316,0.058987869133684596,-1493,1497,73,77,-0.0372282250084367,0.036644518122095515,0.0005837068863411288,-13776,-1566,-0.3376056855777478,-0.03781193189477783
545,5053,Grant,Arkansas,2000,2535,3285,193,6013,0.4215865624480293,0.5463163146515883,0.0320971229003825,0,0,0,0,0.0,0.0,0.0,-750,0,-0.12472975220355897,0.0
546,5053,Grant,Arkansas,2004,2524,4205,41,6770,0.372821270310192,0.6211225997045791,0.006056129985228951,-11,-152,920,757,-0.04876529213783726,-0.026040992915153553,0.0748062850529908,-1681,-931,-0.24830132939438704,-0.12357157719082806
547,5053,Grant,Arkansas,2008,1562,5023,208,6793,0.22994258795819225,0.7394376564110113,0.030619755630796407,-962,167,818,23,-0.14287868235199977,0.024563625645567456,0.11831505670643228,-3461,-1780,-0.5094950684528191,-0.2611937390584321
548,5053,Grant,Arkansas,2012,1468,4829,182,6479,0.22657817564438956,0.7453310696095077,0.028090754746102793,-94,-26,-194,-314,-0.0033644123138026893,-0.0025290008846936135,0.0058934131984963445,-3361,100,-0.5187528939651181,-0.009257825512299034
549,5053,Grant,Arkansas,2016,1373,5725,347,7445,0.18441907320349227,0.7689724647414372,0.046608462055070514,-95,165,896,966,-0.042159102440897295,0.01851770730896772,0.023641395131929532,-4352,-991,-0.5845533915379449,-0.0658004975728268
550,5055,Greene,Arkansas,2000,6319,5831,334,12484,0.506167894905479,0.46707785966036525,0.026754245434155718,0,0,0,0,0.0,0.0,0.0,488,0,0.03909003524511373,0.0
551,5055,Greene,Arkansas,2004,6564,7237,154,13955,0.47036904335363666,0.518595485489072,0.011035471157291293,245,-180,1406,1471,-0.035798851551842314,-0.015718774276864425,0.051517625828706726,-673,-1161,-0.04822644213543531,-0.08731647738054904
552,5055,Greene,Arkansas,2008,4541,8578,493,13612,0.3336027034969145,0.6301792535997649,0.0362180429033206,-2023,339,1341,-343,-0.13676633985672215,0.025182571746029305,0.11158376811069293,-4037,-3364,-0.2965765501028504,-0.24835010796741508
553,5055,Greene,Arkansas,2012,4000,9071,690,13761,0.2906765496693554,0.6591817455126807,0.05014170481796381,-541,197,493,149,-0.0429261538275591,0.013923661914643212,0.029002491912915818,-5071,-1034,-0.3685051958433253,-0.07192864574047492
554,5055,Greene,Arkansas,2016,3071,10720,809,14600,0.21034246575342466,0.7342465753424657,0.05541095890410959,-929,119,1649,839,-0.08033408391593075,0.005269254086145779,0.07506482982978502,-7649,-2578,-0.5239041095890411,-0.1553989137457158
555,5057,Hempstead,Arkansas,2000,3937,3257,95,7289,0.5401289614487584,0.44683770064480727,0.013033337906434354,0,0,0,0,0.0,0.0,0.0,680,0,0.09329126080395117,0.0
556,5057,Hempstead,Arkansas,2004,3817,3580,55,7452,0.5122114868491681,0.48040794417606014,0.007380568974771873,-120,-40,323,163,-0.027917474599590375,-0.0056527689316624805,0.033570243531252875,237,-443,0.03180354267310792,-0.06148771813084325
557,5057,Hempstead,Arkansas,2008,2869,4273,207,7349,0.3903932507824194,0.5814396516532861,0.02816709756429446,-948,152,693,-103,-0.12181823606674869,0.02078652858952259,0.10103170747722601,-1404,-1641,-0.19104640087086677,-0.2228499435439747
558,5057,Hempstead,Arkansas,2012,2468,4284,169,6921,0.35659586764918366,0.6189856957087126,0.024418436642103743,-401,-38,11,-428,-0.033797383133235714,-0.003748660922190717,0.0375460440554265,-1816,-412,-0.262389828059529,-0.07134342718866221
559,5057,Hempstead,Arkansas,2016,2377,4401,271,7049,0.33721095190807204,0.6243438785643354,0.03844516952759257,-91,102,117,128,-0.01938491574111162,0.014026732885488825,0.0053581828556227284,-2024,-208,-0.28713292665626333,-0.024743098596734348
560,5059,Hot Spring,Arkansas,2000,5527,5042,412,10981,0.503323923139969,0.45915672525270923,0.03751935160732174,0,0,0,0,0.0,0.0,0.0,485,0,0.04416719788725976,0.0
561,5059,Hot Spring,Arkansas,2004,5901,5960,204,12065,0.4891007045171985,0.4939908827186075,0.01690841276419395,374,-208,918,1084,-0.014223218622770484,-0.020610938843127792,0.0348341574658983,-59,-544,-0.004890178201409023,-0.04905737608866878
562,5059,Hot Spring,Arkansas,2008,4288,7209,458,11955,0.3586783772480134,0.6030112923462986,0.038310330405687994,-1613,254,1249,-110,-0.13042232726918512,0.021401917641494045,0.10902040962769105,-2921,-2862,-0.2443329150982852,-0.23944273689687617
563,5059,Hot Spring,Arkansas,2012,3830,7097,333,11260,0.3401420959147424,0.6302841918294849,0.029573712255772648,-458,-125,-112,-695,-0.018536281333270954,-0.008736618149915346,0.02727289948318634,-3267,-346,-0.2901420959147425,-0.045809180816457296
564,5059,Hot Spring,Arkansas,2016,3149,8172,623,11944,0.26364701942397856,0.6841929002009377,0.052160080375083726,-681,290,1075,684,-0.07649507649076387,0.022586368119311077,0.053908708371452785,-5023,-1756,-0.42054588077695915,-0.13040378486221665
565,5061,Howard,Arkansas,2000,2063,2326,70,4459,0.46265978919040146,0.52164162368244,0.015698587127158554,0,0,0,0,0.0,0.0,0.0,-263,0,-0.05898183449203859,0.0
566,5061,Howard,Arkansas,2004,2166,2736,41,4943,0.438195427877807,0.5535100141614404,0.00829455796075258,103,-29,410,484,-0.02446436131259444,-0.007404029166405975,0.031868390479000364,-570,-307,-0.11531458628363339,-0.056332751791594804
567,5061,Howard,Arkansas,2008,1746,2957,143,4846,0.3602971522905489,0.610193974411886,0.029508873297565002,-420,102,221,-97,-0.07789827558725809,0.021214315336812423,0.05668396025044564,-1211,-641,-0.24989682212133713,-0.13458223583770373
568,5061,Howard,Arkansas,2012,1471,2892,99,4462,0.3296727924697445,0.6481398476019722,0.02218735992828328,-275,-44,-65,-384,-0.030624359820804414,-0.0073215133692817215,0.03794587319008613,-1421,-210,-0.31846705513222767,-0.06857023301089055
569,5061,Howard,Arkansas,2016,1351,3157,166,4674,0.28904578519469404,0.6754385964912281,0.03551561831407788,-120,67,265,212,-0.040627007275050475,0.0133282583857946,0.027298748889255875,-1806,-385,-0.386392811296534,-0.06792575616430635
570,5063,Independence,Arkansas,2000,5146,6145,303,11594,0.44385026737967914,0.5300155252716923,0.0261342073486286,0,0,0,0,0.0,0.0,0.0,-999,0,-0.08616525789201313,0.0
571,5063,Independence,Arkansas,2004,5443,7430,138,13011,0.41833832910614094,0.5710552609330567,0.010606409960802398,297,-165,1285,1417,-0.025511938273538204,-0.015527797387826203,0.04103973566136443,-1987,-988,-0.15271693182691576,-0.06655167393490263
572,5063,Independence,Arkansas,2008,3688,8255,356,12299,0.2998617773802748,0.671192779900805,0.028945442718920238,-1755,218,825,-712,-0.11847655172586613,0.018339032758117838,0.10013751896774825,-4567,-2580,-0.37133100252053014,-0.21861407069361438
573,5063,Independence,Arkansas,2012,3281,8728,388,12397,0.26466080503347583,0.7040413003145922,0.03129789465193192,-407,32,473,98,-0.035200972346798975,0.0023524519330116803,0.032848520413787274,-5447,-880,-0.4393804952811164,-0.06804949276058625
574,5063,Independence,Arkansas,2016,2881,9936,797,13614,0.21162039077420303,0.7298369325694138,0.05854267665638314,-400,409,1208,1217,-0.053040414259272806,0.02724478200445122,0.02579563225482162,-7055,-1608,-0.5182165417952108,-0.07883604651409443
575,5065,Izard,Arkansas,2000,2587,2301,144,5032,0.5141096979332274,0.4572734499205087,0.028616852146263912,0,0,0,0,0.0,0.0,0.0,286,0,0.05683624801271864,0.0
576,5065,Izard,Arkansas,2004,2586,2833,74,5493,0.4707809939923539,0.5157473147642454,0.013471691243400691,-1,-70,532,461,-0.04332870394087346,-0.015145160902863221,0.05847386484373668,-247,-533,-0.0449663207718915,-0.10180256878461014
577,5065,Izard,Arkansas,2008,1792,3193,233,5218,0.3434266002299732,0.6119202759678037,0.044653123802223076,-794,159,360,-275,-0.12735439376238072,0.031181432558822386,0.09617296120355834,-1401,-1154,-0.26849367573783056,-0.22352735496593906
578,5065,Izard,Arkansas,2012,1524,3575,179,5278,0.2887457370215991,0.6773399014778325,0.033914361500568396,-268,-54,382,60,-0.054680863208374064,-0.01073876230165468,0.06541962551002878,-2051,-650,-0.3885941644562334,-0.12010048871840284
579,5065,Izard,Arkansas,2016,1113,4042,293,5448,0.20429515418502203,0.7419236417033774,0.05378120411160059,-411,114,467,170,-0.08445058283657708,0.019866842611032193,0.06458374022554492,-2929,-878,-0.5376284875183555,-0.14903432306212205
580,5067,Jackson,Arkansas,2000,3651,2280,141,6072,0.6012845849802372,0.37549407114624506,0.023221343873517788,0,0,0,0,0.0,0.0,0.0,1371,0,0.22579051383399212,0.0
581,5067,Jackson,Arkansas,2004,3515,2624,80,6219,0.5652034089081845,0.42193278662164335,0.012863804470172054,-136,-61,344,147,-0.036081176072052634,-0.010357539403345734,0.046438715475398296,891,-480,0.1432706222865412,-0.08251989154745093
582,5067,Jackson,Arkansas,2008,2207,3118,257,5582,0.395378000716589,0.5585811537083483,0.0460408455750627,-1308,177,494,-637,-0.16982540819159553,0.03317704110489065,0.1366483670867049,-911,-1802,-0.16320315299175925,-0.30647377527830044
583,5067,Jackson,Arkansas,2012,2095,3072,180,5347,0.3918084907424724,0.5745277725827567,0.0336637366747709,-112,-77,-46,-235,-0.0035695099741165914,-0.012377108900291804,0.015946618874408403,-977,-66,-0.18271928184028424,-0.019516128848524994
584,5067,Jackson,Arkansas,2016,1583,3267,306,5156,0.3070209464701319,0.6336307214895268,0.05934833204034135,-512,126,195,-191,-0.08478754427234053,0.025684595365570453,0.05910294890677015,-1684,-707,-0.3266097750193949,-0.14389049317911068
585,5069,Jefferson,Arkansas,2000,17716,8765,720,27201,0.6512995845740965,0.3222308003382229,0.0264696150876806,0,0,0,0,0.0,0.0,0.0,8951,0,0.32906878423587366,0.0
586,5069,Jefferson,Arkansas,2004,19675,10218,600,30493,0.645230052799003,0.33509330010166266,0.019676647099334272,1959,-120,1453,3292,-0.006069531775093506,-0.006792967988346329,0.012862499763439783,9457,506,0.31013675269734037,-0.01893203153853329
587,5069,Jefferson,Arkansas,2008,18465,10655,569,29689,0.6219475226514871,0.35888712991343596,0.019165347435076963,-1210,-31,437,-804,-0.023282530147515912,-0.0005112996642573087,0.023793829811773304,7810,-1647,0.26306039273805115,-0.047076359959289216
588,5069,Jefferson,Arkansas,2012,17470,9520,393,27383,0.6379870722711171,0.34766095752839354,0.014351970200489355,-995,-176,-1135,-2306,0.016039549619629945,-0.004813377234587609,-0.011226172385042421,7950,140,0.2903261147427235,0.027265722004672366
589,5069,Jefferson,Arkansas,2016,15772,9250,872,25894,0.6090986328879278,0.35722561211091375,0.03367575500115857,-1698,479,-270,-1489,-0.0288884393831893,0.019323784800669215,0.009564654582520205,6522,-1428,0.251873020777014,-0.038453093965709506
590,5071,Johnson,Arkansas,2000,3270,3657,234,7161,0.4566401340594889,0.5106828655215752,0.032677000418935905,0,0,0,0,0.0,0.0,0.0,-387,0,-0.05404273146208627,0.0
591,5071,Johnson,Arkansas,2004,3622,4311,111,8044,0.45027349577324716,0.5359273993038289,0.013799104922923919,352,-123,654,883,-0.0063666382862417326,-0.018877895496011987,0.025244533782253775,-689,-302,-0.08565390353058178,-0.03161117206849551
592,5071,Johnson,Arkansas,2008,3034,4922,224,8180,0.3709046454767726,0.6017114914425428,0.027383863080684596,-588,113,611,136,-0.07936885029647456,0.013584758157760677,0.06578409213871383,-1888,-1199,-0.23080684596577017,-0.1451529424351884
593,5071,Johnson,Arkansas,2012,2799,5064,235,8098,0.3456408989874043,0.6253395900222277,0.02901951099036799,-235,11,142,-82,-0.0252637464893683,0.001635647909683395,0.023628098579684953,-2265,-377,-0.2796986910348234,-0.04889184506905325
594,5071,Johnson,Arkansas,2016,2427,6091,594,9112,0.26635206321334504,0.668459174714662,0.06518876207199298,-372,359,1027,1014,-0.07928883577405926,0.036169251081624984,0.043119584692434265,-3664,-1399,-0.40210711150131695,-0.12240842046649353
595,5073,Lafayette,Arkansas,2000,1806,1538,39,3383,0.5338456990836535,0.4546260715341413,0.011528229382205143,0,0,0,0,0.0,0.0,0.0,268,0,0.07921962754951223,0.0
596,5073,Lafayette,Arkansas,2004,1567,1604,20,3191,0.4910686305233469,0.5026637417737386,0.006267627702914447,-239,-19,66,-192,-0.04277706856030661,-0.005260601679290697,0.04803767023959732,-37,-305,-0.011595111250391699,-0.09081473879990393
597,5073,Lafayette,Arkansas,2008,1133,1685,84,2902,0.39042039972432807,0.5806340454858718,0.028945554789800137,-434,64,81,-289,-0.10064823079901886,0.02267792708688569,0.0779703037121332,-552,-515,-0.19021364576154376,-0.17861853451115206
598,5073,Lafayette,Arkansas,2012,1173,1713,43,2929,0.400477978832366,0.5848412427449642,0.014680778422669852,40,-41,28,27,0.01005757910803795,-0.014264776367130284,0.0042071972590923545,-540,12,-0.18436326391259816,0.005850381848945596
599,5073,Lafayette,Arkansas,2016,1032,1758,70,2860,0.36083916083916084,0.6146853146853147,0.024475524475524476,-141,27,45,-69,-0.03963881799320518,0.009794746052854623,0.029844071940350547,-726,-186,-0.2538461538461539,-0.06948288993355572
600,5075,Lawrence,Arkansas,2000,3255,2626,159,6040,0.5389072847682119,0.4347682119205298,0.02632450331125828,0,0,0,0,0.0,0.0,0.0,629,0,0.10413907284768215,0.0
601,5075,Lawrence,Arkansas,2004,3544,2951,120,6615,0.5357520786092215,0.44610733182161755,0.018140589569160998,289,-39,325,575,-0.0031552061589904534,-0.00818391374209728,0.011339119901087769,593,-36,0.08964474678760392,-0.014494326060078222
602,5075,Lawrence,Arkansas,2008,2138,3357,335,5830,0.36672384219554033,0.5758147512864494,0.057461406518010294,-1406,215,406,-785,-0.16902823641368114,0.0393208169488493,0.12970741946483189,-1219,-1812,-0.2090909090909091,-0.29873565587851303
603,5075,Lawrence,Arkansas,2012,1788,3536,216,5540,0.3227436823104693,0.6382671480144404,0.03898916967509025,-350,-119,179,-290,-0.043980159885071035,-0.018472236842920042,0.062452396727990966,-1748,-529,-0.3155234657039711,-0.106432556613062
604,5075,Lawrence,Arkansas,2016,1263,4064,358,5685,0.22216358839050132,0.7148636763412489,0.06297273526824979,-525,142,528,145,-0.10058009391996797,0.023983565593159534,0.07659652832680852,-2801,-1053,-0.4927000879507476,-0.1771766222467765
605,5077,Lee,Arkansas,2000,2727,1351,43,4121,0.6617325891773841,0.32783305023052656,0.010434360592089298,0,0,0,0,0.0,0.0,0.0,1376,0,0.33389953894685753,0.0
606,5077,Lee,Arkansas,2004,2548,1492,40,4080,0.6245098039215686,0.3656862745098039,0.00980392156862745,-179,-3,141,-41,-0.03722278525581546,-0.000630439023461847,0.03785322427927734,1056,-320,0.25882352941176473,-0.0750760095350928
607,5077,Lee,Arkansas,2008,2263,1454,46,3763,0.6013818761626362,0.3863938347063513,0.01222428913101249,-285,6,-38,-317,-0.023127927758932465,0.0024203675623850392,0.020707560196547403,809,-247,0.21498804145628486,-0.04383548795547987
608,5077,Lee,Arkansas,2012,2107,1280,37,3424,0.6153621495327103,0.37383177570093457,0.01080607476635514,-156,-9,-174,-339,0.013980273370074126,-0.0014182143646573504,-0.012562059005416737,827,18,0.24153037383177572,0.026542332375490862
609,5077,Lee,Arkansas,2016,1735,1229,62,3026,0.5733641771315268,0.4061467283542631,0.020489094514210177,-372,25,-51,-398,-0.041997972401183525,0.009683019747855038,0.03231495265332851,506,-321,0.1672174487772637,-0.07431292505451204
610,5079,Lincoln,Arkansas,2000,1957,1526,63,3546,0.5518894529046813,0.43034404963338974,0.017766497461928935,0,0,0,0,0.0,0.0,0.0,431,0,0.12154540327129154,0.0
611,5079,Lincoln,Arkansas,2004,2149,1921,39,4109,0.5229982964224872,0.4675103431491847,0.00949136042832806,192,-24,395,563,-0.02889115648219409,-0.008275137033600876,0.03716629351579498,228,-203,0.05548795327330247,-0.06605744999798907
612,5079,Lincoln,Arkansas,2008,1710,2513,183,4406,0.3881071266454834,0.5703586019064911,0.04153427144802542,-439,144,592,297,-0.13489116977700377,0.03204291101969736,0.10284825875730641,-803,-1031,-0.1822514752610077,-0.23773942853431018
613,5079,Lincoln,Arkansas,2012,1425,2199,102,3726,0.3824476650563607,0.5901771336553945,0.027375201288244767,-285,-81,-314,-680,-0.005659461589122727,-0.014159070159780653,0.019818531748903356,-774,29,-0.2077294685990338,-0.025477993338026084
614,5079,Lincoln,Arkansas,2016,1252,2455,119,3826,0.32723470987977,0.641662310507057,0.031102979613173026,-173,17,256,100,-0.055212955176590695,0.003727778324928259,0.05148517685166254,-1203,-429,-0.31442760062728703,-0.10669813202825323
615,5081,Little River,Arkansas,2000,2883,2283,97,5263,0.5477864335930078,0.4337830134904047,0.018430552916587496,0,0,0,0,0.0,0.0,0.0,600,0,0.11400342010260311,0.0
616,5081,Little River,Arkansas,2004,2677,2575,42,5294,0.505666792595391,0.48639969777106157,0.007933509633547412,-206,-55,292,31,-0.04211964099761678,-0.010497043283040084,0.052616684280656856,102,-498,0.019267094824329478,-0.09473632527827364
617,5081,Little River,Arkansas,2008,1753,3247,152,5152,0.3402562111801242,0.6302406832298136,0.029503105590062112,-924,110,672,-142,-0.16541058141526682,0.021569595956514698,0.14384098545875207,-1494,-1596,-0.2899844720496894,-0.3092515668740189
618,5081,Little River,Arkansas,2012,1552,3385,114,5051,0.3072658879429816,0.6701643238962581,0.022569788160760246,-201,-38,138,-101,-0.03299032323714263,-0.006933317429301866,0.03992364066644449,-1833,-339,-0.36289843595327653,-0.07291396390358712
619,5081,Little River,Arkansas,2016,1397,3605,225,5227,0.2672661182322556,0.6896881576430075,0.043045724124736943,-155,111,220,176,-0.039999769710725996,0.020475935963976698,0.019523833746749375,-2208,-375,-0.4224220394107519,-0.05952360345747537
620,5083,Logan,Arkansas,2000,3283,4487,326,8096,0.4055088932806324,0.5542243083003953,0.040266798418972335,0,0,0,0,0.0,0.0,0.0,-1204,0,-0.14871541501976288,0.0
621,5083,Logan,Arkansas,2004,3361,5076,114,8551,0.39305344404163256,0.5936147818968541,0.013331774061513273,78,-212,589,455,-0.012455449238999827,-0.026935024357459064,0.039390473596458864,-1715,-511,-0.20056133785522157,-0.05184592283545869
622,5083,Logan,Arkansas,2008,2286,5350,271,7907,0.2891109143796636,0.6766156570127735,0.03427342860756292,-1075,157,274,-644,-0.10394252966196899,0.020941654546049647,0.08300087511591936,-3064,-1349,-0.3875047426331099,-0.18694340477788834
623,5083,Logan,Arkansas,2012,2009,5079,243,7331,0.2740417405538126,0.6928113490656118,0.033146910380575635,-277,-28,-271,-576,-0.01506917382585099,-0.001126518226987283,0.01619569205283833,-3070,-6,-0.41876960851179923,-0.03126486587868932
624,5083,Logan,Arkansas,2016,1715,5746,460,7921,0.21651306653200353,0.7254134578967302,0.058073475571266256,-294,217,667,590,-0.057528674021809056,0.02492656519069062,0.03260210883111836,-4031,-961,-0.5089003913647266,-0.09013078285292742
625,5085,Lonoke,Arkansas,2000,6851,10606,486,17943,0.38182020843783093,0.5910940199520704,0.027085771610098647,0,0,0,0,0.0,0.0,0.0,-3755,0,-0.20927381151423952,0.0
626,5085,Lonoke,Arkansas,2004,7454,14398,178,22030,0.3383567862006355,0.6535633227417158,0.00807989105764866,603,-308,3792,4087,-0.04346342223719546,-0.019005880552449984,0.06246930278964535,-6944,-3189,-0.31520653654108033,-0.10593272502684081
627,5085,Lonoke,Arkansas,2008,5968,17242,531,23741,0.25137947011499095,0.7262541594709574,0.02236637041405164,-1486,353,2844,1711,-0.08697731608564452,0.01428647935640298,0.07269083672924159,-11274,-4330,-0.47487468935596644,-0.1596681528148861
628,5085,Lonoke,Arkansas,2012,5625,17880,609,24114,0.23326698183627767,0.7414779795969146,0.025255038566807664,-343,78,638,373,-0.018112488278713285,0.0028886681527560236,0.015223820125957244,-12255,-981,-0.5082109977606369,-0.0333363084046705
629,5085,Lonoke,Arkansas,2016,5664,19958,1478,27100,0.20900369003690036,0.7364575645756457,0.054538745387453874,39,869,2078,2986,-0.024263291799377307,0.02928370682064621,-0.005020415021268931,-14294,-2039,-0.5274538745387454,-0.01924287677810843
630,5087,Madison,Arkansas,2000,2055,3387,186,5628,0.36513859275053306,0.6018123667377399,0.03304904051172708,0,0,0,0,0.0,0.0,0.0,-1332,0,-0.2366737739872068,0.0
631,5087,Madison,Arkansas,2004,2421,3873,90,6384,0.3792293233082707,0.6066729323308271,0.014097744360902255,366,-96,486,756,0.01409073055773763,-0.018951296150824824,0.004860565593087229,-1452,-120,-0.2274436090225564,0.0092301649646504
632,5087,Madison,Arkansas,2008,2144,3972,212,6328,0.3388116308470291,0.6276864728192162,0.03350189633375474,-277,122,99,-56,-0.040417692461241606,0.019404151972852487,0.021013540488389104,-1828,-376,-0.2888748419721871,-0.06143123294963071
633,5087,Madison,Arkansas,2012,2099,4263,206,6568,0.3195797807551766,0.6490560292326432,0.03136419001218027,-45,-6,291,240,-0.019231850091852465,-0.0021377063215744715,0.02136955641342697,-2164,-336,-0.32947624847746654,-0.040601406505279436
634,5087,Madison,Arkansas,2016,1588,4928,325,6841,0.23212980558397894,0.7203625200994007,0.047507674316620375,-511,119,665,273,-0.08744997517119768,0.016143484304440105,0.07130649086675755,-3340,-1176,-0.4882327145154218,-0.15875646603795524
635,5089,Marion,Arkansas,2000,2233,3402,380,6015,0.371238570241064,0.5655860349127182,0.06317539484621779,0,0,0,0,0.0,0.0,0.0,-1169,0,-0.1943474646716542,0.0
636,5089,Marion,Arkansas,2004,2602,4127,138,6867,0.37891364496869084,0.600990243192078,0.020096111839231105,369,-242,725,852,0.007675074727626852,-0.043079283006986685,0.03540420827935986,-1525,-356,-0.2220765982233872,-0.02772913355173301
637,5089,Marion,Arkansas,2008,2384,4524,254,7162,0.33286791399050547,0.6316671320860094,0.03546495392348506,-218,116,397,295,-0.04604573097818537,0.015368842084253955,0.030676888893931387,-2140,-615,-0.29879921809550397,-0.07672261987211676
638,5089,Marion,Arkansas,2012,2037,4774,240,7051,0.2888951921713232,0.6770670826833073,0.03403772514536945,-347,-14,250,-111,-0.04397272181918227,-0.0014272287781156093,0.045399950597297845,-2737,-597,-0.3881718905119841,-0.08937267241648011
639,5089,Marion,Arkansas,2016,1434,5336,337,7107,0.2017728999577881,0.7508090614886731,0.047418038553538766,-603,97,562,56,-0.0871222922135351,0.013380313408169316,0.07374197880536582,-3902,-1165,-0.549036161530885,-0.16086427101890088
640,5091,Miller,Arkansas,2000,6278,7276,191,13745,0.45674790833030193,0.5293561295016369,0.013895962168061113,0,0,0,0,0.0,0.0,0.0,-998,0,-0.07260822117133497,0.0
641,5091,Miller,Arkansas,2004,6139,8448,91,14678,0.418244992505791,0.5755552527592315,0.006199754734977517,-139,-100,1172,933,-0.03850291582451093,-0.007696207433083596,0.046199123257594565,-2309,-1311,-0.15731026025344047,-0.0847020390821055
642,5091,Miller,Arkansas,2008,4869,9913,281,15063,0.3232423819956184,0.6581026355971586,0.018654982407222995,-1270,190,1465,385,-0.09500261051017261,0.012455227672245477,0.08254738283792717,-5044,-2735,-0.33486025360154026,-0.1775499933480998
643,5091,Miller,Arkansas,2012,4518,10622,189,15329,0.2947354687194207,0.6929349598799661,0.012329571400613217,-351,-92,709,266,-0.0285069132761977,-0.006325411006609778,0.03483232428280747,-6104,-1060,-0.3981994911605454,-0.06333923755900517
644,5091,Miller,Arkansas,2016,4273,11294,524,16091,0.265552172021627,0.7018830402088124,0.03256478776956062,-245,335,672,762,-0.02918329669779368,0.020235216368947404,0.008948080328846308,-7021,-917,-0.4363308681871854,-0.03813137702663999
645,5093,Mississippi,Arkansas,2000,7107,5199,280,12586,0.5646750357540123,0.4130780232003814,0.02224694104560623,0,0,0,0,0.0,0.0,0.0,1908,0,0.15159701255363095,0.0
646,5093,Mississippi,Arkansas,2004,7593,6121,439,14153,0.5364940295343743,0.4324878117713559,0.031018158694269767,486,159,922,1567,-0.02818100621963804,0.008771217648663537,0.01940978857097453,1472,-436,0.10400621776301838,-0.04759079479061257
647,5093,Mississippi,Arkansas,2008,6667,6976,367,14010,0.47587437544610994,0.4979300499643112,0.02619557458957887,-926,-72,855,-143,-0.06061965408826436,-0.004822584104690896,0.0654422381929553,-309,-1781,-0.022055674518201285,-0.12606189228121967
648,5093,Mississippi,Arkansas,2012,6467,6603,305,13375,0.4835140186915888,0.4936822429906542,0.02280373831775701,-200,-62,-373,-635,0.007639643245478833,-0.0033918362718218624,-0.004247806973657009,-136,173,-0.010168224299065443,0.011887450219135842
649,5093,Mississippi,Arkansas,2016,5670,7061,473,13204,0.42941532868827625,0.5347621932747653,0.0358224780369585,-797,168,458,-171,-0.05409869000331252,0.013018739719201488,0.041079950284111044,-1391,-1255,-0.10534686458648901,-0.09517864028742357
650,5095,Monroe,Arkansas,2000,1910,1329,54,3293,0.5800182204676587,0.4035833586395384,0.016398420892802915,0,0,0,0,0.0,0.0,0.0,581,0,0.1764348618281203,0.0
651,5095,Monroe,Arkansas,2004,2049,1586,32,3667,0.5587673847832015,0.43250613580583586,0.00872647941096264,139,-22,257,374,-0.02125083568445718,-0.007671941481840276,0.02892277716629743,463,-118,0.12626124897736568,-0.05017361285075461
652,5095,Monroe,Arkansas,2008,1615,1754,80,3449,0.4682516671498985,0.5085532038271963,0.02319512902290519,-434,48,168,-218,-0.09051571763330302,0.01446864961194255,0.07604706802136041,-139,-602,-0.040301536677297745,-0.16656278565466343
653,5095,Monroe,Arkansas,2012,1583,1585,62,3230,0.49009287925696593,0.4907120743034056,0.019195046439628483,-32,-18,-169,-219,0.02184121210706741,-0.004000082583276707,-0.01784112952379069,-2,137,-0.0006191950464396467,0.0396823416308581
654,5095,Monroe,Arkansas,2016,1312,1489,83,2884,0.4549237170596394,0.5162968099861304,0.028779472954230237,-271,21,-96,-346,-0.03516916219732652,0.009584426514601754,0.02558473568272479,-177,-175,-0.06137309292649096,-0.06075389788005131
655,5097,Montgomery,Arkansas,2000,1438,2128,173,3739,0.38459481144691093,0.5691361326557903,0.046269055897298746,0,0,0,0,0.0,0.0,0.0,-690,0,-0.1845413212088794,0.0
656,5097,Montgomery,Arkansas,2004,1524,2367,67,3958,0.38504295098534613,0.5980293077311774,0.016927741283476502,86,-106,239,219,0.0004481395384351994,-0.029341314613822243,0.028893175075387023,-843,-153,-0.21298635674583122,-0.028445035536951824
657,5097,Montgomery,Arkansas,2008,1092,2365,165,3622,0.3014908890115958,0.6529541689674213,0.04555494202098288,-432,98,-2,-336,-0.08355206197375031,0.02862720073750638,0.05492486123624396,-1273,-430,-0.3514632799558255,-0.13847692320999427
658,5097,Montgomery,Arkansas,2012,920,2369,115,3404,0.2702702702702703,0.6959459459459459,0.033783783783783786,-172,-50,4,-218,-0.031220618741325534,-0.011771158237199097,0.04299177697852463,-1449,-176,-0.42567567567567566,-0.07421239571985017
659,5097,Montgomery,Arkansas,2016,748,2643,168,3559,0.2101713964596797,0.7426243326777184,0.04720427086260186,-172,53,274,155,-0.06009887381059059,0.013420487078818072,0.04667838673177249,-1895,-446,-0.5324529362180388,-0.10677726054236314
660,5099,Nevada,Arkansas,2000,1867,1796,75,3738,0.4994649545211343,0.48047084002140183,0.020064205457463884,0,0,0,0,0.0,0.0,0.0,71,0,0.018994114499732484,0.0
661,5099,Nevada,Arkansas,2004,1694,1752,31,3477,0.48720161058383665,0.5038826574633305,0.008915731952832903,-173,-44,-44,-261,-0.012263343937297666,-0.011148473504630982,0.023411817441928662,-58,-129,-0.016681046879493844,-0.03567516137922633
662,5099,Nevada,Arkansas,2008,1474,2062,99,3635,0.4055020632737277,0.5672627235213205,0.027235213204951855,-220,68,310,158,-0.08169954731010898,0.018319481252118953,0.06338006605798996,-588,-530,-0.16176066024759278,-0.14507961336809894
663,5099,Nevada,Arkansas,2012,1314,1996,74,3384,0.3882978723404255,0.5898345153664303,0.02186761229314421,-160,-25,-66,-251,-0.017204190933302166,-0.005367600911807647,0.022571791845109823,-682,-94,-0.20153664302600477,-0.03977598277841199
664,5099,Nevada,Arkansas,2016,1157,2000,89,3246,0.35643869377695625,0.6161429451632778,0.027418361059765865,-157,15,4,-138,-0.03185917856346926,0.005550748766621656,0.026308429796847554,-843,-161,-0.2597042513863216,-0.058167608360316814
665,5101,Newton,Arkansas,2000,1205,2529,193,3927,0.3068500127323657,0.6440030557677616,0.049146931499872676,0,0,0,0,0.0,0.0,0.0,-1324,0,-0.33715304303539595,0.0
666,5101,Newton,Arkansas,2004,1506,2779,93,4378,0.3439926907263591,0.6347647327546825,0.021242576518958427,301,-100,250,451,0.0371426779939934,-0.02790435498091425,-0.009238323013079142,-1273,51,-0.2907720420283234,0.04638100100707254
667,5101,Newton,Arkansas,2008,1182,2588,190,3960,0.29848484848484846,0.6535353535353535,0.047979797979797977,-324,97,-191,-418,-0.04550784224151061,0.02673722146083955,0.018770620780671043,-1406,-133,-0.35505050505050506,-0.06427846302218165
668,5101,Newton,Arkansas,2012,993,2508,160,3661,0.2712373668396613,0.6850587271237367,0.04370390603660202,-189,-30,-80,-299,-0.027247481645187144,-0.004275891943195956,0.0315233735883832,-1515,-109,-0.4138213602840754,-0.05877085523357034
669,5101,Newton,Arkansas,2016,699,2875,179,3753,0.18625099920063948,0.7660538236077804,0.04769517719158007,-294,19,367,92,-0.08498636763902184,0.003991271154978049,0.08099509648404368,-2176,-661,-0.5798028244071409,-0.16598146412306553
670,5103,Ouachita,Arkansas,2000,5464,4739,192,10395,0.5256373256373257,0.4558922558922559,0.01847041847041847,0,0,0,0,0.0,0.0,0.0,725,0,0.06974506974506978,0.0
671,5103,Ouachita,Arkansas,2004,5188,5345,117,10650,0.48713615023474177,0.5018779342723004,0.010985915492957746,-276,-75,606,255,-0.03850117540258391,-0.007484502977460724,0.045985678380044526,-157,-882,-0.014741784037558658,-0.08448685378262843
672,5103,Ouachita,Arkansas,2008,4346,5427,187,9960,0.4363453815261044,0.5448795180722892,0.018775100401606425,-842,70,82,-690,-0.05079076870863736,0.007789184908648678,0.04300158379998875,-1081,-924,-0.10853413654618477,-0.09379235250862611
673,5103,Ouachita,Arkansas,2012,4633,5521,161,10315,0.4491517207949588,0.5352399418322831,0.01560833737275812,287,-26,94,355,0.012806339268854383,-0.003166763028848305,-0.009639576240006109,-888,193,-0.08608822103732428,0.022445915508860492
674,5103,Ouachita,Arkansas,2016,4321,5351,263,9935,0.43492702566683444,0.5386009058882738,0.0264720684448918,-312,102,-170,-380,-0.014224695128124354,0.010863731072133679,0.003360964055990734,-1030,-142,-0.10367388022143936,-0.017585659184115088
675,5105,Perry,Arkansas,2000,1648,2114,245,4007,0.41128025954579484,0.5275767407037684,0.06114299975043674,0,0,0,0,0.0,0.0,0.0,-466,0,-0.11629648115797353,0.0
676,5105,Perry,Arkansas,2004,1921,2435,75,4431,0.4335364477544572,0.5495373504852178,0.016926201760324982,273,-170,321,424,0.022256188208662375,-0.04421679799011176,0.021960609781449425,-514,-48,-0.11600090273076058,0.00029557842721295025
677,5105,Perry,Arkansas,2008,1352,2743,184,4279,0.31596167328815145,0.6410376256134611,0.043000701098387474,-569,109,308,-152,-0.11757477446630576,0.026074499338062492,0.09150027512824332,-1391,-877,-0.32507595232530967,-0.2090750495945491
678,5105,Perry,Arkansas,2012,1187,2581,170,3938,0.30142204164550535,0.6554088369730828,0.043169121381411886,-165,-14,-162,-341,-0.0145396316426461,0.00016842028302441192,0.014371211359621716,-1394,-3,-0.3539867953275775,-0.028910843002267816
679,5105,Perry,Arkansas,2016,1049,3008,249,4306,0.24361356247097074,0.6985601486298189,0.057826288899210404,-138,79,427,368,-0.057808479174534605,0.014657167517798518,0.043151311656736024,-1959,-565,-0.4549465861588481,-0.1009597908312706
680,5107,Phillips,Arkansas,2000,6018,3154,141,9313,0.6461934929668206,0.33866638032857294,0.015140126704606464,0,0,0,0,0.0,0.0,0.0,2864,0,0.30752711263824767,0.0
681,5107,Phillips,Arkansas,2004,5642,3161,65,8868,0.6362201172755977,0.3564501578709968,0.007329724853405503,-376,-76,7,-445,-0.009973375691222919,-0.007810401851200961,0.017783777542423884,2481,-383,0.27976995940460087,-0.027757153233646803
682,5107,Phillips,Arkansas,2008,5695,3097,177,8969,0.6349648790277623,0.3453004794291448,0.019734641543092877,53,112,-64,101,-0.0012552382478353552,0.012404916689687375,-0.011149678441851996,2598,117,0.2896643995986175,0.00989444019401664
683,5107,Phillips,Arkansas,2012,5202,2598,130,7930,0.6559899117276167,0.32761664564943255,0.01639344262295082,-493,-47,-499,-1039,0.02102503269985434,-0.0033411989201420564,-0.017683833779712277,2604,6,0.3283732660781841,0.03870886647956662
684,5107,Phillips,Arkansas,2016,4310,2446,197,6953,0.619876312383144,0.35179059398820656,0.028333093628649504,-892,67,-152,-977,-0.03611359934447267,0.011939651005698684,0.02417394833877401,1864,-740,0.26808571839493744,-0.06028754768324668
685,5109,Pike,Arkansas,2000,1604,2275,92,3971,0.40392848149080834,0.5729035507428859,0.023167967766305718,0,0,0,0,0.0,0.0,0.0,-671,0,-0.16897506925207756,0.0
686,5109,Pike,Arkansas,2004,1310,2013,44,3367,0.38907038907038904,0.5978615978615979,0.013068013068013067,-294,-48,-262,-604,-0.0148580924204193,-0.01009995469829265,0.024958047118711968,-703,-32,-0.20879120879120883,-0.03981613953913127
687,5109,Pike,Arkansas,2008,1089,2727,150,3966,0.2745839636913767,0.6875945537065052,0.037821482602118005,-221,106,714,599,-0.11448642537901232,0.024753469534104938,0.08973295584490737,-1638,-935,-0.4130105900151285,-0.2042193812239197
688,5109,Pike,Arkansas,2012,851,2847,90,3788,0.22465681098204857,0.7515839493136219,0.02375923970432946,-238,-60,120,-178,-0.049927152709328154,-0.014062242897788544,0.0639893956071167,-1996,-358,-0.5269271383315733,-0.11391654831644482
689,5109,Pike,Arkansas,2016,685,3150,146,3981,0.1720673197689023,0.7912584777694047,0.03667420246169304,-166,56,303,193,-0.05258949121314627,0.01291496275736358,0.03967452845578279,-2465,-469,-0.6191911580005024,-0.09226401966892905
690,5111,Poinsett,Arkansas,2000,4102,2988,145,7235,0.5669661368348307,0.41299239806496196,0.020041465100207326,0,0,0,0,0.0,0.0,0.0,1114,0,0.1539737387698687,0.0
691,5111,Poinsett,Arkansas,2004,4069,3555,99,7723,0.5268677974880228,0.4603133497345591,0.012818852777418102,-33,-46,567,488,-0.04009833934680784,-0.007222612322789224,0.047320951669597155,514,-600,0.0665544477534637,-0.087419291016405
692,5111,Poinsett,Arkansas,2008,2742,4903,283,7928,0.3458627648839556,0.6184409687184662,0.035696266397578204,-1327,184,1348,205,-0.1810050326040672,0.022877413620160103,0.1581276189839071,-2161,-2675,-0.2725782038345106,-0.3391326515879743
693,5111,Poinsett,Arkansas,2012,2390,4974,196,7560,0.31613756613756616,0.6579365079365079,0.025925925925925925,-352,-87,71,-368,-0.02972519874638946,-0.009770340471652279,0.03949553921804172,-2584,-423,-0.34179894179894177,-0.06922073796443118
694,5111,Poinsett,Arkansas,2016,1880,5502,340,7722,0.24346024346024345,0.7125097125097125,0.04403004403004403,-510,144,528,162,-0.07267732267732271,0.018104118104118102,0.05457320457320458,-3622,-1038,-0.4690494690494691,-0.12725052725052732
695,5113,Polk,Arkansas,2000,2315,4600,278,7193,0.3218406784373697,0.6395106353399138,0.03864868622271653,0,0,0,0,0.0,0.0,0.0,-2285,0,-0.3176699569025441,0.0
696,5113,Polk,Arkansas,2004,2473,5192,134,7799,0.31709193486344406,0.6657263751763046,0.017181689960251316,158,-144,592,606,-0.004748743573925629,-0.02146699626246521,0.026215739836390806,-2719,-434,-0.34863444031286056,-0.030964483410316435
697,5113,Polk,Arkansas,2008,1957,5473,251,7681,0.25478453326389794,0.7125374300221325,0.03267803671396954,-516,117,281,-118,-0.06230740159954612,0.015496346753718221,0.046811054845827926,-3516,-797,-0.4577528967582346,-0.10911845644537405
698,5113,Polk,Arkansas,2012,1556,5955,215,7726,0.20139787729743722,0.7707740098369144,0.02782811286564846,-401,-36,482,45,-0.05338665596646072,-0.004849923848321076,0.05823657981478181,-4399,-883,-0.5693761325394772,-0.11162323578124256
699,5113,Polk,Arkansas,2016,1212,6618,401,8231,0.14724820799416838,0.8040335317701373,0.048718260235694325,-344,186,663,505,-0.05414966930326884,0.020890147370045863,0.0332595219332229,-5406,-1007,-0.6567853237759689,-0.08740919123649171
700,5115,Pope,Arkansas,2000,6669,11244,509,18422,0.36201281076973185,0.610357181630659,0.027630007599609162,0,0,0,0,0.0,0.0,0.0,-4575,0,-0.24834437086092714,0.0
701,5115,Pope,Arkansas,2004,7100,13614,188,20902,0.33968041335757343,0.651325232035212,0.00899435460721462,431,-321,2370,2480,-0.022332397412158422,-0.018635652992394544,0.04096805040455298,-6514,-1939,-0.31164481867763855,-0.0633004478167114
702,5115,Pope,Arkansas,2008,6002,15568,509,22079,0.27184202183069883,0.7051043978441053,0.023053580325195888,-1098,321,1954,1177,-0.0678383915268746,0.014059225717981268,0.0537791658088933,-9566,-3052,-0.43326237601340645,-0.1216175573357679
703,5115,Pope,Arkansas,2012,5126,14763,550,20439,0.25079504868144237,0.7222956113312784,0.02690933998727922,-876,41,-805,-1640,-0.021046973149256465,0.003855759662083333,0.017191213487173118,-9637,-71,-0.47150056264983603,-0.03823818663642958
704,5115,Pope,Arkansas,2016,5000,16256,1313,22569,0.22154282422792326,0.7202800301298241,0.058177145642252646,-126,763,1493,2130,-0.029252224453519104,0.031267805654973425,-0.002015581201454286,-11256,-1619,-0.49873720590190085,-0.02723664325206482
705,5117,Prairie,Arkansas,2000,1563,1862,82,3507,0.44568006843455943,0.530938123752495,0.023381807812945538,0,0,0,0,0.0,0.0,0.0,-299,0,-0.08525805531793562,0.0
706,5117,Prairie,Arkansas,2004,1562,2030,32,3624,0.4310154525386313,0.5601545253863135,0.008830022075055188,-1,-50,168,117,-0.014664615895928101,-0.01455178573789035,0.029216401633818445,-468,-169,-0.12913907284768217,-0.04388101752974655
707,5117,Prairie,Arkansas,2008,1048,2223,110,3381,0.30996746524696833,0.6574977817213842,0.03253475303164744,-514,78,193,-243,-0.121047987291663,0.023704730956592254,0.09734325633507068,-1175,-707,-0.34753031647441585,-0.21839124362673368
708,5117,Prairie,Arkansas,2012,880,2153,108,3141,0.2801655523718561,0.6854504934734161,0.034383954154727794,-168,-2,-70,-240,-0.029801912875112246,0.0018492011230803532,0.027952711752031956,-1273,-98,-0.40528494110156005,-0.0577546246271442
709,5117,Prairie,Arkansas,2016,814,2505,125,3444,0.23635307781649245,0.7273519163763066,0.03629500580720093,-66,17,352,303,-0.043812474555363634,0.001911051652473135,0.04190142290289045,-1691,-418,-0.49099883855981413,-0.08571389745825408
710,5119,Pulaski,Arkansas,2000,68320,55866,2965,127151,0.5373139023680505,0.4393673663596826,0.023318731272266833,0,0,0,0,0.0,0.0,0.0,12454,0,0.09794653600836795,0.0
711,5119,Pulaski,Arkansas,2004,84532,67903,1185,153620,0.5502668923317277,0.44201926832443694,0.007713839343835438,16212,-1780,12037,26469,0.012952989963677108,-0.015604891928431395,0.002651901964754344,16629,4175,0.10824762400729071,0.010301087998922764
712,5119,Pulaski,Arkansas,2008,88854,70212,2277,161343,0.5507149365017385,0.4351722727357245,0.014112790762536956,4322,1092,2309,7723,0.00044804417001087504,0.006398951418701518,-0.0068469955887124345,18642,2013,0.11554266376601402,0.0072950397587233096
713,5119,Pulaski,Arkansas,2012,87248,68984,3149,159381,0.5474178227015767,0.4328244897446998,0.01975768755372347,-1606,872,-1228,-1962,-0.003297113800161844,0.005644896791186514,-0.002347782991024727,18264,-378,0.1145933329568769,-0.0009493308091371166
714,5119,Pulaski,Arkansas,2016,89574,61257,8945,159776,0.5606223713198478,0.3833930002002804,0.05598462847987182,2326,5796,-7727,395,0.013204548618271139,0.03622694092614835,-0.049431489544419394,28317,10053,0.17722937111956744,0.06263603816269053
715,5121,Randolph,Arkansas,2000,3019,2673,185,5877,0.5136974646928705,0.4548238897396631,0.03147864556746639,0,0,0,0,0.0,0.0,0.0,346,0,0.058873574953207386,0.0
716,5121,Randolph,Arkansas,2004,3412,3158,97,6667,0.511774411279436,0.4736763161841908,0.01454927253637318,393,-88,485,790,-0.0019230534134344612,-0.016929373031093212,0.018852426444527726,254,-92,0.0380980950952452,-0.020775479857962187
717,5121,Randolph,Arkansas,2008,2469,3615,235,6319,0.39072638075644883,0.5720841905364773,0.0371894287070739,-943,138,457,-348,-0.12104803052298718,0.022640156170700722,0.09840787435228648,-1146,-1400,-0.18135780978002847,-0.21945590487527367
718,5121,Randolph,Arkansas,2012,2046,3701,209,5956,0.3435191403626595,0.621390194761585,0.03509066487575554,-423,-26,86,-363,-0.04720724039378932,-0.002098763831318365,0.04930600422510767,-1655,-509,-0.27787105439892545,-0.09651324461889699
719,5121,Randolph,Arkansas,2016,1425,4509,445,6379,0.22338924596331713,0.7068506035428751,0.06976015049380781,-621,236,808,423,-0.12012989439934238,0.03466948561805227,0.08546040878129013,-3084,-1429,-0.483461357579558,-0.20559030318063254
720,5123,St. Francis,Arkansas,2000,4986,3414,96,8496,0.586864406779661,0.4018361581920904,0.011299435028248588,0,0,0,0,0.0,0.0,0.0,1572,0,0.1850282485875706,0.0
721,5123,St. Francis,Arkansas,2004,5684,3815,89,9588,0.5928243637880685,0.39789319983312477,0.009282436378806842,698,-7,401,1092,0.005959957008407457,-0.002016998649441746,-0.003942958358965631,1869,297,0.1949311639549437,0.009902915367373089
722,5123,St. Francis,Arkansas,2008,5486,3917,102,9505,0.5771699105733824,0.41209889531825356,0.010731194108364019,-198,13,102,-83,-0.01565445321468606,0.001448757729557177,0.014205695485128789,1569,-300,0.16507101525512885,-0.029860148699814848
723,5123,St. Francis,Arkansas,2012,4910,3368,84,8362,0.5871801004544367,0.402774455871801,0.010045443673762257,-576,-18,-549,-1143,0.010010189881054288,-0.0006857504346017614,-0.00932443944645256,1542,-27,0.1844056445826357,0.019334629327506847
724,5123,St. Francis,Arkansas,2016,4031,3195,204,7430,0.5425302826379542,0.4300134589502019,0.027456258411843876,-879,120,-173,-932,-0.04464981781648247,0.01741081473808162,0.02723900307840088,836,-706,0.11251682368775234,-0.07188882089488335
725,5125,Saline,Arkansas,2000,12700,18617,1074,32391,0.3920842209255657,0.5747584205489179,0.03315735852551635,0,0,0,0,0.0,0.0,0.0,-5917,0,-0.18267419962335218,0.0
726,5125,Saline,Arkansas,2004,14153,24864,359,39376,0.35943214140593255,0.6314506298252742,0.009117228768793173,1453,-715,6247,6985,-0.03265207951963317,-0.024040129756723178,0.05669220927635632,-10711,-4794,-0.2720184884193417,-0.08934428879598949
727,5125,Saline,Arkansas,2008,12695,30981,977,44653,0.28430340626609635,0.6938167648310304,0.021879828902873266,-1458,618,6117,5277,-0.0751287351398362,0.012762600134080093,0.06236613500575616,-18286,-7575,-0.40951335856493404,-0.13749487014559236
728,5125,Saline,Arkansas,2012,12869,32963,1230,47062,0.2734477922740215,0.7004164718881476,0.026135735837830947,174,253,1982,2409,-0.010855613992074853,0.004255906934957681,0.00659970705711721,-20094,-1808,-0.4269686796141261,-0.017455321049192063
729,5125,Saline,Arkansas,2016,13256,35863,2981,52100,0.2544337811900192,0.6883493282149712,0.0572168905950096,387,1751,2900,5038,-0.019014011084002302,0.03108115475717865,-0.012067143673176406,-22607,-2513,-0.433915547024952,-0.0069468674108258965
730,5127,Scott,Arkansas,2000,1444,2399,138,3981,0.3627229339361969,0.6026124089424768,0.0346646571213263,0,0,0,0,0.0,0.0,0.0,-955,0,-0.23988947500627988,0.0
731,5127,Scott,Arkansas,2004,1473,2514,51,4038,0.36478454680534916,0.6225854383358098,0.01263001485884101,29,-87,115,57,0.0020616128691522406,-0.022034642262485287,0.01997302939333301,-1041,-86,-0.25780089153046065,-0.017911416524180768
732,5127,Scott,Arkansas,2008,1053,2791,151,3995,0.26357947434292867,0.6986232790988736,0.037797246558197745,-420,100,277,-43,-0.1012050724624205,0.025167231699356734,0.07603784076306375,-1738,-697,-0.4350438047559449,-0.17724291322548424
733,5127,Scott,Arkansas,2012,897,2631,112,3640,0.24642857142857144,0.7228021978021978,0.03076923076923077,-156,-39,-160,-355,-0.017150902914357224,-0.007028015788966974,0.024178918703324226,-1734,4,-0.47637362637362635,-0.04132982161768145
734,5127,Scott,Arkansas,2016,602,2731,177,3510,0.17150997150997152,0.778062678062678,0.05042735042735043,-295,65,100,-130,-0.07491859991859992,0.019658119658119658,0.05526048026048025,-2129,-395,-0.6065527065527065,-0.1301790801790802
735,5129,Searcy,Arkansas,2000,1229,2610,219,4058,0.3028585510103499,0.6431739773287334,0.053967471660916706,0,0,0,0,0.0,0.0,0.0,-1381,0,-0.34031542631838346,0.0
736,5129,Searcy,Arkansas,2004,1370,2565,57,3992,0.34318637274549096,0.6425350701402806,0.014278557114228457,141,-162,-45,-66,0.040327821735141045,-0.03968891454668825,-0.0006389071884528308,-1195,186,-0.2993486973947896,0.040966728923593876
737,5129,Searcy,Arkansas,2008,961,2726,160,3847,0.24980504289056407,0.7086041070964387,0.041590850012997144,-409,103,161,-145,-0.09338132985492689,0.027312292898768686,0.06606903695615818,-1765,-570,-0.4587990642058747,-0.1594503668110851
738,5129,Searcy,Arkansas,2012,814,2699,181,3694,0.22035733622089876,0.7306442880346508,0.04899837574445046,-147,21,-27,-153,-0.029447706669665313,0.00740752573145332,0.02204018093821203,-1885,-120,-0.510286951813752,-0.05148788760787737
739,5129,Searcy,Arkansas,2016,601,2955,172,3728,0.16121244635193133,0.7926502145922747,0.046137339055793994,-213,-9,256,34,-0.05914488986896743,-0.0028610366886564695,0.062005926557623936,-2354,-469,-0.6314377682403434,-0.12115081642659131
740,5131,Sebastian,Arkansas,2000,15555,23483,1121,40159,0.3873353420154884,0.5847506163002066,0.027914041684304888,0,0,0,0,0.0,0.0,0.0,-7928,0,-0.19741527428471822,0.0
741,5131,Sebastian,Arkansas,2004,16479,27303,429,44211,0.3727352921218701,0.6175612404152813,0.009703467462848612,924,-692,3820,4052,-0.014600049893618294,-0.018210574221456277,0.03281062411507463,-10824,-2896,-0.24482594829341114,-0.04741067400869292
742,5131,Sebastian,Arkansas,2008,13673,28637,902,43212,0.31641673609182636,0.6627094325650282,0.020873831343145424,-2806,473,1334,-999,-0.056318556030043765,0.011170363880296812,0.04514819214974697,-14964,-4140,-0.3462926964732019,-0.10146674817979073
743,5131,Sebastian,Arkansas,2012,13092,29169,1101,43362,0.3019233430192334,0.6726857617268576,0.025390895253908953,-581,199,532,150,-0.014493393072592953,0.004517063910763529,0.009976329161829334,-16077,-1113,-0.37076241870762416,-0.024469722234422286
744,5131,Sebastian,Arkansas,2016,12300,29127,3210,44637,0.2755561529672693,0.6525304119900531,0.0719134350426776,-792,2109,-42,1275,-0.026367190051964084,0.04652253978876864,-0.02015534973680444,-16827,-750,-0.3769742590227838,-0.006211840315159645
745,5133,Sevier,Arkansas,2000,2095,2111,87,4293,0.4880037269974377,0.49173072443512694,0.02026554856743536,0,0,0,0,0.0,0.0,0.0,-16,0,-0.003726997437689228,0.0
746,5133,Sevier,Arkansas,2004,2035,2516,50,4601,0.44229515322755925,0.5468376439904369,0.010867202782003912,-60,-37,405,308,-0.04570857376987847,-0.009398345785431448,0.05510691955530994,-481,-465,-0.10454249076287764,-0.10081549332518841
747,5133,Sevier,Arkansas,2008,1291,3125,164,4580,0.28187772925764193,0.6823144104803494,0.03580786026200873,-744,114,609,-21,-0.16041742396991732,0.02494065748000482,0.13547676648991247,-1834,-1353,-0.4004366812227074,-0.2958941904598298
748,5133,Sevier,Arkansas,2012,1042,3136,152,4330,0.24064665127020785,0.7242494226327945,0.03510392609699769,-249,-12,11,-250,-0.041231077987434084,-0.0007039341650110428,0.041935012152445106,-2094,-260,-0.4836027713625866,-0.08316609013987919
749,5133,Sevier,Arkansas,2016,1075,3282,205,4562,0.2356422621657168,0.7194213064445418,0.04493643138974134,33,53,146,232,-0.005004389104491053,0.009832505292743654,-0.004828116188252629,-2207,-113,-0.483779044278825,-0.0001762729162383958
750,5135,Sharp,Arkansas,2000,3236,3698,192,7126,0.4541117036205445,0.5189447095144541,0.026943586865001402,0,0,0,0,0.0,0.0,0.0,-462,0,-0.06483300589390967,0.0
751,5135,Sharp,Arkansas,2004,3265,4097,108,7470,0.43708165997322623,0.5484605087014726,0.014457831325301205,29,-84,399,344,-0.01703004364731825,-0.012485755539700197,0.02951579918701841,-832,-370,-0.11137884872824633,-0.04654584283433666
752,5135,Sharp,Arkansas,2008,2436,4535,281,7252,0.3359073359073359,0.6253447324875896,0.03874793160507446,-829,173,438,-218,-0.10117432406589033,0.024290100279773255,0.07688422378611703,-2099,-1267,-0.2894373965802537,-0.17805854785200737
753,5135,Sharp,Arkansas,2012,2092,4921,270,7283,0.2872442674721955,0.6756830976246052,0.03707263490319923,-344,-11,386,31,-0.0486630684351404,-0.0016752967018752313,0.05033836513701562,-2829,-730,-0.3884388301524097,-0.09900143357215602
754,5135,Sharp,Arkansas,2016,1472,5407,370,7249,0.20306249137812113,0.7458959856531936,0.05104152296868534,-620,100,486,-34,-0.08418177609407437,0.013968888065486108,0.07021288802858838,-3935,-1106,-0.5428334942750724,-0.15439466412266273
755,5137,Stone,Arkansas,2000,2043,2623,194,4860,0.4203703703703704,0.5397119341563786,0.03991769547325103,0,0,0,0,0.0,0.0,0.0,-580,0,-0.11934156378600824,0.0
756,5137,Stone,Arkansas,2004,2255,3188,106,5549,0.4063795278428546,0.5745179311587674,0.019102540998378086,212,-88,565,689,-0.013990842527515812,-0.020815154474872945,0.03480599700238873,-933,-353,-0.1681384033159128,-0.048796839529904545
757,5137,Stone,Arkansas,2008,1598,3534,192,5324,0.3001502629601803,0.663786626596544,0.03606311044327573,-657,86,346,-225,-0.10622926488267426,0.016960569444897645,0.0892686954377766,-1936,-1003,-0.36363636363636365,-0.19549796032045086
758,5137,Stone,Arkansas,2012,1356,3776,222,5354,0.25326858423608517,0.7052670900261486,0.04146432573776616,-242,30,242,30,-0.046881678724095155,0.005401215294490426,0.04148046342960465,-2420,-484,-0.45199850579006345,-0.08836214215369981
759,5137,Stone,Arkansas,2016,1203,4113,261,5577,0.2157073695535234,0.7374932759548144,0.046799354491662185,-153,39,337,223,-0.03756121468256177,0.0053350287538960275,0.032226185928665774,-2910,-490,-0.521785906401291,-0.06978740061122751
760,5139,Union,Arkansas,2000,6261,8647,701,15609,0.4011147414952912,0.5539752706771734,0.04490998782753539,0,0,0,0,0.0,0.0,0.0,-2386,0,-0.15286052918188225,0.0
761,5139,Union,Arkansas,2004,7071,10502,259,17832,0.3965343203230148,0.5889412292507851,0.01452445042620009,810,-442,1855,2223,-0.0045804211722764165,-0.030385537401335302,0.03496595857361162,-3431,-1045,-0.1924069089277703,-0.03954637974588804
762,5139,Union,Arkansas,2008,6190,10677,312,17179,0.3603236509692066,0.6215146399674021,0.01816170906339135,-881,53,175,-653,-0.03621066935380818,0.003637258637191259,0.03257341071661701,-4487,-1056,-0.2611909889981955,-0.06878408007042519
763,5139,Union,Arkansas,2012,6196,10699,282,17177,0.3607149094719683,0.6228677883215928,0.016417302206438843,6,-30,22,-2,0.0003912585027617266,-0.001744406856952506,0.0013531483541907585,-4503,-16,-0.2621528788496245,-0.0009618898514290319
764,5139,Union,Arkansas,2016,5855,10456,583,16894,0.34657274772108443,0.6189179590387119,0.034509293240203624,-341,301,-243,-283,-0.014142161750883897,0.01809199103376478,-0.003949829282880901,-4601,-98,-0.2723452113176275,-0.010192332468002996
765,5141,Van Buren,Arkansas,2000,3202,3485,297,6984,0.45847651775486825,0.49899770904925544,0.04252577319587629,0,0,0,0,0.0,0.0,0.0,-283,0,-0.04052119129438719,0.0
766,5141,Van Buren,Arkansas,2004,3310,3988,76,7374,0.4488744236506645,0.5408190941144562,0.010306482234879306,108,-221,503,390,-0.009602094104203762,-0.03221929096099699,0.04182138506520072,-678,-395,-0.09194467046379168,-0.051423479169404485
767,5141,Van Buren,Arkansas,2008,2151,4276,276,6703,0.32090108906459797,0.6379233179173505,0.04117559301805162,-1159,200,288,-671,-0.12797333458606652,0.030869110783172313,0.0971042238028943,-2125,-1447,-0.3170222288527525,-0.22507755838896082
768,5141,Van Buren,Arkansas,2012,1832,4365,233,6430,0.2849144634525661,0.6788491446345256,0.03623639191290824,-319,-43,89,-273,-0.035986625612031864,-0.004939201105143377,0.04092582671717515,-2533,-408,-0.3939346811819595,-0.07691245232920702
769,5141,Van Buren,Arkansas,2016,1549,5382,408,7339,0.21106417768088295,0.7333424172230549,0.055593405096062136,-283,175,1017,909,-0.07385028577168315,0.019357013183153894,0.05449327258852932,-3833,-1300,-0.522278239542172,-0.1283435583602125
770,5143,Washington,Arkansas,2000,21425,28231,1803,51459,0.4163508812841291,0.5486115159641657,0.03503760275170524,0,0,0,0,0.0,0.0,0.0,-6806,0,-0.13226063468003657,0.0
771,5143,Washington,Arkansas,2004,27597,35726,780,64103,0.4305102725301468,0.5573218102116906,0.012167917258162644,6172,-1023,7495,12644,0.014159391246017672,-0.022869685493542596,0.008710294247524897,-8129,-1323,-0.1268115376815438,0.005449096998492775
772,5143,Washington,Arkansas,2008,29021,37963,1396,68380,0.42440772155601053,0.5551769523252413,0.020415326118748172,1424,616,2237,4277,-0.006102550974136256,0.008247408860585528,-0.0021448578864492474,-8942,-813,-0.1307692307692308,-0.003957693087687009
773,5143,Washington,Arkansas,2012,28236,39688,2536,70460,0.4007380073800738,0.5632699403917116,0.03599205222821459,-785,1140,1725,2080,-0.023669714175936718,0.015576726109466418,0.008092988066470297,-11452,-2510,-0.16253193301163782,-0.031762702242407015
774,5143,Washington,Arkansas,2016,33366,41476,7019,81861,0.407593359475208,0.5066637348676415,0.08574290565715054,5130,4483,1788,11401,0.0068553520951341596,0.04975085342893595,-0.05660620552407014,-8110,3342,-0.09907037539243352,0.0634615576192043
775,5145,White,Arkansas,2000,8342,13170,638,22150,0.3766139954853273,0.5945823927765237,0.028803611738148983,0,0,0,0,0.0,0.0,0.0,-4828,0,-0.21796839729119638,0.0
776,5145,White,Arkansas,2004,9129,17001,295,26425,0.34546830652790916,0.6433680227057711,0.011163670766319774,787,-343,3831,4275,-0.03114568895741815,-0.017639940971829207,0.0487856299292474,-7872,-3044,-0.29789971617786193,-0.07993131888666555
777,5145,White,Arkansas,2008,6732,19467,756,26955,0.24974958263772956,0.7222036727879799,0.028046744574290485,-2397,461,2466,530,-0.0957187238901796,0.01688307380797071,0.07883565008220883,-12735,-4863,-0.47245409015025036,-0.17455437397238843
778,5145,White,Arkansas,2012,5765,20011,738,26514,0.21743229991702498,0.7547333484197027,0.027834351663272233,-967,-18,544,-441,-0.03231728272070458,-0.00021239291101825264,0.03252967563172282,-14246,-1511,-0.5373010485026778,-0.06484695835242743
779,5145,White,Arkansas,2016,5170,21077,1752,27999,0.1846494517661345,0.7527768848887461,0.06257366334511946,-595,1014,1066,1485,-0.03278284815089047,0.034739311681847226,-0.001956463530956687,-15907,-1661,-0.5681274331226116,-0.03082638461993381
780,5147,Woodruff,Arkansas,2000,1699,898,54,2651,0.6408902301018483,0.33874009807619765,0.02036967182195398,0,0,0,0,0.0,0.0,0.0,801,0,0.30215013202565066,0.0
781,5147,Woodruff,Arkansas,2004,1972,1021,33,3026,0.651685393258427,0.33740912095175146,0.010905485789821546,273,-21,123,375,0.010795163156578691,-0.009464186032132433,-0.0013309771244461865,951,150,0.31427627230667554,0.012126140281024878
782,5147,Woodruff,Arkansas,2008,1412,1206,143,2761,0.5114089098152843,0.4367982614994567,0.05179282868525897,-560,110,185,-265,-0.1402764834431427,0.04088734289543742,0.09938914054770526,206,-745,0.07461064831582759,-0.23966562399084795
783,5147,Woodruff,Arkansas,2012,1340,1227,118,2685,0.49906890130353815,0.4569832402234637,0.04394785847299814,-72,-25,21,-76,-0.012340008511746159,-0.007844970212260827,0.020184978724006986,113,-93,0.042085661080074444,-0.032524987235753144
784,5147,Woodruff,Arkansas,2016,1118,1347,106,2571,0.4348502528199144,0.5239206534422404,0.041229093737845196,-222,-12,120,-114,-0.06421864848362374,-0.002718764735152944,0.06693741321877666,-229,-342,-0.08907040062232596,-0.1311560617024004
785,5149,Yell,Arkansas,2000,3062,3223,194,6479,0.4726037968822349,0.49745331069609505,0.02994289242167001,0,0,0,0,0.0,0.0,0.0,-161,0,-0.024849513813860136,0.0
786,5149,Yell,Arkansas,2004,2913,3678,68,6659,0.43745307103168646,0.5523351854632828,0.010211743505030785,-149,-126,455,180,-0.03515072585054846,-0.019731148916639227,0.0548818747671877,-765,-604,-0.1148821144315963,-0.09003260061773616
787,5149,Yell,Arkansas,2008,2003,3808,225,6036,0.3318422796554009,0.6308813783962889,0.037276341948310136,-910,157,130,-623,-0.10561079137628554,0.027064598443279353,0.07854619293300613,-1805,-1040,-0.29903909874088797,-0.18415698430929167
788,5149,Yell,Arkansas,2012,1722,4042,210,5974,0.2882490793438232,0.67659859390693,0.03515232674924674,-281,-15,234,-62,-0.04359320031157771,-0.0021240151990633976,0.04571721551064112,-2320,-515,-0.3883495145631068,-0.08931041582221882
789,5149,Yell,Arkansas,2016,1480,4608,351,6439,0.22984935548998292,0.7156390743904333,0.05451157011958379,-242,141,566,465,-0.05839972385384029,0.01935924337033705,0.03904048048350328,-3128,-808,-0.48578971890045036,-0.09744020433734357
790,6001,Alameda,California,2000,342889,119279,32168,494336,0.6936355029777318,0.2412913483946142,0.06507314862765406,0,0,0,0,0.0,0.0,0.0,223610,0,0.4523441545831176,0.0
791,6001,Alameda,California,2004,422585,130911,8594,562090,0.751810208329627,0.23290042519881157,0.015289366471561493,79696,-23574,11632,67754,0.05817470535189517,-0.04978378215609257,-0.008390923195802619,291674,68064,0.5189097831308154,0.06656562854769776
792,6001,Alameda,California,2008,489106,119555,14252,622913,0.7851915114951847,0.19192888894596838,0.022879599558846903,66521,5658,-11356,60823,0.03338130316555776,0.00759023308728541,-0.040971536252843194,369551,77877,0.5932626225492164,0.07435283941840098
793,6001,Alameda,California,2012,469684,108182,19027,596893,0.7868814008540894,0.18124186411969984,0.03187673502621073,-19422,4775,-11373,-26020,0.0016898893589046837,0.008997135467363828,-0.010687024826268543,361502,-8049,0.6056395367343896,0.012376914185173282
794,6001,Alameda,California,2016,514842,95922,48779,659543,0.7806041455977851,0.14543706778784704,0.07395878661436783,45158,29752,-12260,62650,-0.006277255256304293,0.0420820515881571,-0.035804796331852795,418920,57418,0.6351670778099381,0.029527541075548447
795,6003,Alpine,California,2000,265,281,40,586,0.4522184300341297,0.47952218430034127,0.06825938566552901,0,0,0,0,0.0,0.0,0.0,-16,0,-0.027303754266211566,0.0
796,6003,Alpine,California,2004,373,311,17,701,0.5320970042796006,0.44365192582025675,0.024251069900142655,108,-23,30,115,0.0798785742454709,-0.04400831576538636,-0.035870258480084516,62,78,0.08844507845934385,0.11574883272555542
797,6003,Alpine,California,2008,422,252,20,694,0.6080691642651297,0.3631123919308357,0.02881844380403458,49,3,-59,-7,0.07597215998552909,0.004567373903891926,-0.08053953388942103,170,108,0.24495677233429397,0.15651169387495012
798,6003,Alpine,California,2012,389,236,29,654,0.5948012232415902,0.36085626911314983,0.04434250764525994,-33,9,-16,-40,-0.013267941023539453,0.015524063841225358,-0.0022561228176858905,153,-17,0.2339449541284404,-0.011011818205853563
799,6003,Alpine,California,2016,334,217,51,602,0.5548172757475083,0.36046511627906974,0.08471760797342193,-55,22,-19,-52,-0.03998394749408196,0.04037510032816199,-0.0003911528340800885,117,-36,0.19435215946843853,-0.03959279466000187
800,6005,Amador,California,2000,5906,8766,792,15464,0.38191929643041905,0.5668649767201241,0.0512157268494568,0,0,0,0,0.0,0.0,0.0,-2860,0,-0.1849456802897051,0.0
801,6005,Amador,California,2004,6541,11107,243,17891,0.3656028170588564,0.620814934883461,0.013582248057682633,635,-549,2341,2427,-0.016316479371562664,-0.037633478791774165,0.05394995816333681,-4566,-1706,-0.25521211782460457,-0.07026643753489947
802,6005,Amador,California,2008,7813,10561,505,18879,0.4138460723555273,0.5594046294824938,0.026749298161978918,1272,262,-546,988,0.048243255296670895,0.013167050104296285,-0.06141030540096715,-2748,1818,-0.14555855712696653,0.10965356069763804
803,6005,Amador,California,2012,6830,10281,582,17693,0.3860283728028034,0.5810772621940881,0.03289436500310857,-983,77,-280,-1186,-0.027817699552723896,0.006145066841129653,0.021672632711594253,-3451,-703,-0.19504888939128467,-0.04949033226431815
804,6005,Amador,California,2016,6004,10485,1474,17963,0.33424260980905196,0.5836998274230363,0.08205756276791182,-826,892,204,270,-0.05178576299375143,0.04916319776480325,0.002622565228948215,-4481,-1030,-0.24945721761398432,-0.05440832822269964
805,6007,Butte,California,2000,31338,45584,6799,83721,0.37431468807109325,0.544475101826304,0.0812102101026027,0,0,0,0,0.0,0.0,0.0,-14246,0,-0.17016041375521074,0.0
806,6007,Butte,California,2004,42448,51662,2047,96157,0.44144472061316387,0.5372671776365735,0.021288101750262592,11110,-4752,6078,12436,0.06713003254207062,-0.0599221083523401,-0.007207924189730486,-9214,5032,-0.09582245702340964,0.0743379567318011
807,6007,Butte,California,2008,49013,46706,2988,98707,0.4965503966284053,0.47317819404905426,0.03027140932254045,6565,941,-4956,2550,0.05510567601524141,0.008983307572277856,-0.06408898358751924,2307,11521,0.02337220257935102,0.11919465960276066
808,6007,Butte,California,2012,42669,44479,3873,91021,0.46878192944485336,0.48866745036859627,0.042550620186550356,-6344,885,-2227,-7686,-0.027768467183551915,0.012279210864009907,0.01548925631954201,-1810,-4117,-0.019885520923742905,-0.043257723503093926
809,6007,Butte,California,2016,41567,45144,10291,97002,0.42851693779509703,0.46539246613471885,0.10609059607018412,-1102,6418,665,5981,-0.04026499164975633,0.06353997588363376,-0.023274984233877416,-3577,-1767,-0.03687552833962182,-0.016990007415878916
810,6009,Calaveras,California,2000,7093,10599,1184,18876,0.37576817122271666,0.5615066751430388,0.06272515363424454,0,0,0,0,0.0,0.0,0.0,-3506,0,-0.1857385039203221,0.0
811,6009,Calaveras,California,2004,8286,13601,456,22343,0.37085440630175,0.6087365170299422,0.020409076668307748,1193,-728,3002,3467,-0.004913764920966679,-0.04231607696593679,0.04722984188690349,-5315,-1809,-0.23788211072819226,-0.05214360680787017
812,6009,Calaveras,California,2008,9813,12835,773,23421,0.4189829640066607,0.5480124674437471,0.033004568549592245,1527,317,-766,1078,0.0481285577049107,0.012595491881284497,-0.06072404958619515,-3022,2293,-0.1290295034370864,0.10885260729110585
813,6009,Calaveras,California,2012,8670,12365,827,21862,0.3965785381026439,0.5655932668557314,0.03782819504162474,-1143,54,-470,-1559,-0.02240442590401681,0.004823626492032496,0.017580799411984316,-3695,-673,-0.16901472875308754,-0.03998522531600113
814,6009,Calaveras,California,2016,7944,13511,2076,23531,0.3375972121881773,0.5741787429348519,0.0882240448769708,-726,1249,1146,1669,-0.05898132591446659,0.05039584983534606,0.008585476079120524,-5567,-1872,-0.23658153074667465,-0.06756680199358711
815,6011,Colusa,California,2000,1745,3629,216,5590,0.31216457960644006,0.6491949910554562,0.03864042933810376,0,0,0,0,0.0,0.0,0.0,-1884,0,-0.33703041144901613,0.0
816,6011,Colusa,California,2004,1947,4142,77,6166,0.3157638663639312,0.6717482971132014,0.012487836522867337,202,-139,513,576,0.0035992867574911602,-0.026152592815236422,0.022553306057745193,-2195,-311,-0.35598443074927016,-0.018954019300254032
817,6011,Colusa,California,2008,2569,3733,146,6448,0.3984181141439206,0.578939205955335,0.022642679900744415,622,69,-409,282,0.08265424777998936,0.010154843377877079,-0.0928090911578664,-1164,1031,-0.1805210918114144,0.17546333893785576
818,6011,Colusa,California,2012,2314,3601,130,6045,0.3827956989247312,0.5956989247311828,0.021505376344086023,-255,-16,-132,-403,-0.01562241521918939,-0.0011373035566583922,0.01675971877584781,-1287,-123,-0.2129032258064516,-0.0323821339950372
819,6011,Colusa,California,2016,2661,3551,485,6697,0.3973420934746902,0.5302374197401821,0.07242048678512766,347,355,-50,652,0.014546394549958985,0.05091511044104164,-0.06546150499100067,-890,397,-0.13289532626549194,0.08000789954095966
820,6013,Contra Costa,California,2000,224338,141373,15767,381478,0.5880758523427301,0.3705927995847729,0.04133134807249697,0,0,0,0,0.0,0.0,0.0,82965,0,0.21748305275795715,0.0
821,6013,Contra Costa,California,2004,257254,150608,5166,413028,0.622848814123982,0.36464355927443176,0.012507626601586334,32916,-10601,9235,31550,0.03477296178125189,-0.028823721470910637,-0.005949240310341164,106646,23681,0.2582052548495502,0.04072220209159305
822,6013,Contra Costa,California,2008,306983,136436,9825,453244,0.6773018506588063,0.3010210835664675,0.021677065774726195,49729,4659,-14172,40216,0.05445303653482436,0.009169439173139862,-0.06362247570796425,170547,63901,0.3762807670923388,0.11807551224278862
823,6013,Contra Costa,California,2012,290824,136517,11804,439145,0.6622505095128033,0.310869985995514,0.0268795044916827,-16159,1979,81,-14099,-0.015051341146003039,0.005202438716956505,0.009848902429046513,154307,-16240,0.35138052351728927,-0.024900243575049552
824,6013,Contra Costa,California,2016,319287,115956,37771,473014,0.675005390960944,0.2451428498945063,0.07985175914454963,28463,25967,-20561,33869,0.012754881448140742,0.05297225465286693,-0.06572713610100772,203331,49024,0.42986254106643773,0.07848201754914846
825,6015,Del Norte,California,2000,3117,4526,651,8294,0.3758138413310827,0.5456956836267182,0.07849047504219918,0,0,0,0,0.0,0.0,0.0,-1409,0,-0.16988184229563547,0.0
826,6015,Del Norte,California,2004,3892,5356,173,9421,0.41311962636662775,0.568517142553869,0.018363231079503238,775,-478,830,1127,0.03730578503554505,-0.06012724396269594,0.022821458927150817,-1464,-55,-0.15539751618724124,0.01448432610839423
827,6015,Del Norte,California,2008,4323,4967,241,9531,0.45357255272269437,0.5211415381387052,0.025285909138600356,431,68,-389,110,0.04045292635606662,0.006922678059097118,-0.04737560441516375,-644,820,-0.06756898541601086,0.08782853077123037
828,6015,Del Norte,California,2012,3791,4614,365,8770,0.4322690992018244,0.5261117445838084,0.04161915621436716,-532,124,-353,-761,-0.021303453520869986,0.016333247075766805,0.004970206445103154,-823,-179,-0.093842645381984,-0.02627365996597314
829,6015,Del Norte,California,2016,3485,5134,939,9558,0.36461602845783636,0.5371416614354467,0.09824231010671688,-306,574,520,788,-0.06765307074398802,0.056623153892349724,0.011029916851638344,-1649,-826,-0.17252563297761037,-0.07868298759562636
830,6017,El Dorado,California,2000,26220,42045,3871,72136,0.3634800931573694,0.5828573805034934,0.053662526339137186,0,0,0,0,0.0,0.0,0.0,-15825,0,-0.21937728734612405,0.0
831,6017,El Dorado,California,2004,32242,52878,1244,86364,0.37332684915010883,0.6122690009726275,0.014404149877263675,6022,-2627,10833,14228,0.009846755992739431,-0.03925837646187351,0.029411620469134037,-20636,-4811,-0.23894215182251866,-0.019564864476394606
832,6017,El Dorado,California,2008,40529,50314,2466,93309,0.4343525276232732,0.5392191535650366,0.02642831881169019,8287,1222,-2564,6945,0.06102567847316437,0.012024168934426515,-0.0730498474075909,-9785,10851,-0.10486662594176338,0.13407552588075528
833,6017,El Dorado,California,2012,35166,50973,2859,88998,0.3951324748870761,0.5727432077125328,0.03212431740039102,-5363,393,659,-4311,-0.03922005273619711,0.005695998588700828,0.03352405414749626,-15807,-6022,-0.17761073282545675,-0.07274410688369337
834,6017,El Dorado,California,2016,36404,49247,9498,95149,0.3825999222272436,0.517577693932674,0.0998223838400824,1238,6639,-1726,6151,-0.012532552659832497,0.06769806643969137,-0.05516551377985879,-12843,2964,-0.13497777170543046,0.04263296112002629
835,6019,Fresno,California,2000,95059,117342,8434,220835,0.43045260035773314,0.531355989766115,0.038191409876151876,0,0,0,0,0.0,0.0,0.0,-22283,0,-0.10090338940838184,0.0
836,6019,Fresno,California,2004,103154,141988,2321,247463,0.4168461547786942,0.5737746653035,0.009379179917805893,8095,-6113,24646,26628,-0.01360644557903895,-0.02881222995834598,0.04241867553738499,-38834,-16551,-0.15692851052480578,-0.05602512111642394
837,6019,Fresno,California,2008,136706,131015,5731,273452,0.4999268610213127,0.47911516463584103,0.020957974342846276,33552,3410,-10973,25989,0.08308070624261849,0.011578794425040383,-0.09465950066765894,5691,44525,0.020811696385471645,0.17774020691027742
838,6019,Fresno,California,2012,129129,124490,6078,259697,0.49722946356715714,0.4793663384636711,0.023404197969171765,-7577,347,-6525,-13755,-0.0026973974541555368,0.002446223626325489,0.0002511738278300757,4639,-1052,0.017863125103486033,-0.0029485712819856125
839,6019,Fresno,California,2016,141341,124049,21672,287062,0.49237098605876084,0.43213312803505866,0.07549588590618055,12212,15594,-441,27365,-0.004858477508396297,0.05209168793700878,-0.04723321042861245,17292,12653,0.060237858023702184,0.04237473292021615
840,6021,Glenn,California,2000,2498,5795,418,8711,0.2867638617839513,0.665250832281024,0.04798530593502468,0,0,0,0,0.0,0.0,0.0,-3297,0,-0.3784869704970727,0.0
841,6021,Glenn,California,2004,2995,6308,151,9454,0.31679712291093715,0.6672308017770257,0.01597207531203723,497,-267,513,743,0.030033261126985844,-0.03201323062298745,0.0019799694960016545,-3313,-16,-0.3504336788660885,0.02805329163098419
842,6021,Glenn,California,2008,3734,5910,235,9879,0.3779734790970746,0.5982386881263285,0.02378783277659682,739,84,-398,425,0.06117635618613748,0.007815757464559588,-0.06899211365069713,-2176,1137,-0.2202652090292539,0.1301684698368346
843,6021,Glenn,California,2012,3301,5632,305,9238,0.3573284260662481,0.6096557696471098,0.03301580428664213,-433,70,-278,-641,-0.020645053030826532,0.00922797151004531,0.011417081520781247,-2331,-155,-0.2523273435808617,-0.03206213455160778
844,6021,Glenn,California,2016,3065,5788,617,9470,0.3236536430834213,0.6111932418162619,0.0651531151003168,-236,312,156,232,-0.03367478298282678,0.032137310813674665,0.001537472169152121,-2723,-392,-0.2875395987328406,-0.0352122551519789
845,6023,Humboldt,California,2000,24851,23219,7902,55972,0.4439898520688916,0.41483241620810407,0.14117773172300435,0,0,0,0,0.0,0.0,0.0,1632,0,0.029157435860787506,0.0
846,6023,Humboldt,California,2004,37988,25714,2184,65886,0.5765716540691498,0.3902801809185563,0.033148165012293965,13137,-5718,2495,9914,0.1325818020002582,-0.10802956671071039,-0.024552235289547752,12274,10642,0.18629147315059347,0.15713403728980596
847,6023,Humboldt,California,2008,39692,21713,2563,63968,0.6204977488744372,0.3394353426713357,0.04006690845422711,1704,379,-4001,-1918,0.04392609480528742,0.006918743441933148,-0.050844838247220636,17979,5705,0.2810624062031015,0.09477093305250806
848,6023,Humboldt,California,2012,34457,18825,4404,57686,0.5973199736504524,0.3263356793676109,0.07634434698193669,-5235,1841,-2888,-6282,-0.023177775223984787,0.03627743852770958,-0.013099663303724807,15632,-2347,0.27098429428284154,-0.01007811192025998
849,6023,Humboldt,California,2016,33200,18373,8441,60014,0.5532042523411204,0.30614523277901823,0.14065051487986135,-1257,4037,-452,2328,-0.04411572130933206,0.06430616789792466,-0.020190446588592648,14827,-805,0.24705901956210213,-0.02392527472073941
850,6025,Imperial,California,2000,15489,12524,924,28937,0.5352662680996648,0.4328022946400802,0.03193143726025504,0,0,0,0,0.0,0.0,0.0,2965,0,0.10246397345958463,0.0
851,6025,Imperial,California,2004,17964,15890,420,34274,0.5241290774347902,0.463616735718037,0.012254186847172784,2475,-504,3366,5337,-0.011137190664874619,-0.019677250413082256,0.030814441077956833,2074,-891,0.06051234171675318,-0.04195163174283145
852,6025,Imperial,California,2008,24162,14008,650,38820,0.6224111282843895,0.36084492529623907,0.016743946419371457,6198,230,-1882,4546,0.09828205084959929,0.004489759572198673,-0.10277181042179795,10154,8080,0.2615662029881504,0.20105386127139724
853,6025,Imperial,California,2012,25136,12777,652,38565,0.6517827045248282,0.3313107740178919,0.016906521457279916,974,2,-1231,-255,0.029371576240438735,0.00016257503790845923,-0.029534151278347187,12359,2205,0.32047193050693634,0.05890572751878592
854,6025,Imperial,California,2016,32667,12704,2720,48091,0.6792747083653906,0.26416585223846456,0.05655943939614481,7531,2068,-73,9526,0.027492003840562385,0.03965291793886489,-0.06714492177942732,19963,7604,0.41510885612692605,0.09463692561998971
855,6027,Inyo,California,2000,2652,4713,450,7815,0.3393474088291747,0.6030710172744722,0.05758157389635317,0,0,0,0,0.0,0.0,0.0,-2061,0,-0.2637236084452975,0.0
856,6027,Inyo,California,2004,3350,5091,175,8616,0.38881151346332404,0.5908774373259053,0.02031104921077066,698,-275,378,801,0.04946410463414935,-0.03727052468558251,-0.012193579948566957,-1741,320,-0.2020659238625812,0.06165768458271631
857,6027,Inyo,California,2008,3743,4523,288,8554,0.4375730652326397,0.5287584755669862,0.0336684592003741,393,113,-568,-62,0.04876155176931568,0.013357409989603438,-0.06211896175891907,-780,961,-0.09118541033434646,0.11088051352823475
858,6027,Inyo,California,2012,3422,4340,274,8036,0.4258337481333997,0.5400696864111498,0.03409656545545047,-321,-14,-183,-518,-0.011739317099240032,0.00042810625507637423,0.011311210844163644,-918,-138,-0.11423593827775014,-0.023050527943403676
859,6027,Inyo,California,2016,3155,4248,776,8179,0.38574397848147696,0.5193788971756939,0.0948771243428292,-267,502,-92,143,-0.040089769651922735,0.06078055888737873,-0.020690789235455975,-1093,-175,-0.1336349186942169,-0.01939898041646676
860,6029,Kern,California,2000,66003,110663,5642,182308,0.3620411611119644,0.6070112117954232,0.030947627092612503,0,0,0,0,0.0,0.0,0.0,-44660,0,-0.24497005068345878,0.0
861,6029,Kern,California,2004,68603,140417,2154,211174,0.3248648034322407,0.6649350772348869,0.010200119332872418,2600,-3488,29754,28866,-0.03717635767972366,-0.020747507759740085,0.057923865439463706,-71814,-27154,-0.34007027380264615,-0.09510022311918737
862,6029,Kern,California,2008,93457,134793,5558,233808,0.39971686169848764,0.5765114966126053,0.023771641688907136,24854,3404,-5624,22634,0.07485205826624691,0.013571522356034718,-0.08842358062228162,-41336,30478,-0.17679463491411762,0.16327563888852853
863,6029,Kern,California,2012,89495,126618,6076,222189,0.40278771676365616,0.5698661949961519,0.02734608824019191,-3962,518,-8175,-11619,0.0030708550651685207,0.0035744465512847733,-0.006645301616453381,-37123,4213,-0.16707847823249572,0.009716156681621901
864,6029,Kern,California,2016,98689,129584,15890,244163,0.4041931005107244,0.530727423893055,0.06507947559622056,9194,9814,2966,21974,0.0014053837470682229,0.037733387356028644,-0.039138771103096825,-30895,6228,-0.12653432338233067,0.04054415485016505
865,6031,Kings,California,2000,11041,16377,917,28335,0.3896594317981295,0.5779777660137639,0.03236280218810658,0,0,0,0,0.0,0.0,0.0,-5336,0,-0.18831833421563443,0.0
866,6031,Kings,California,2004,10833,21003,274,32110,0.33737153534724384,0.6540952974151355,0.00853316723762068,-208,-643,4626,3775,-0.05228789645088566,-0.0238296349504859,0.07611753140137156,-10170,-4834,-0.31672376206789166,-0.12840542785225723
867,6031,Kings,California,2008,14747,19710,651,35108,0.42004671299988605,0.561410504728267,0.018542782271846872,3914,377,-1293,2998,0.0826751776526422,0.010009615034226193,-0.09268479268686847,-4963,5207,-0.14136379172838098,0.17535997033951067
868,6031,Kings,California,2012,12979,17671,768,31418,0.4131071360366669,0.5624482780571647,0.02444458590616844,-1768,117,-2039,-3690,-0.006939576963219174,0.005901803634321568,0.001037773328897651,-4692,271,-0.1493411420204978,-0.007977350292116825
869,6031,Kings,California,2016,13617,18093,2600,34310,0.396881375692218,0.5273389682308365,0.07577965607694549,638,1832,422,2892,-0.016225760344448892,0.051335070170777056,-0.035109309826328206,-4476,216,-0.1304575925386185,0.018883549481879314
870,6033,Lake,California,2000,10717,8699,1503,20919,0.5123093838137578,0.41584205745972563,0.07184855872651656,0,0,0,0,0.0,0.0,0.0,2018,0,0.09646732635403216,0.0
871,6033,Lake,California,2004,13141,11093,485,24719,0.5316153566082771,0.4487641085804442,0.019620534811278772,2424,-1018,2394,3800,0.01930597279451929,-0.05222802391523779,0.032922051120718554,2048,30,0.08285124802783289,-0.013616078326199266
872,6033,Lake,California,2008,14854,9935,840,25629,0.5795778219985173,0.3876468063521792,0.032775371649303525,1713,355,-1158,910,0.04796246539024018,0.013154836838024753,-0.061117302228265,4919,2871,0.19193101564633808,0.10907976761850519
873,6033,Lake,California,2012,13163,9200,1028,23391,0.5627378051387286,0.39331366764995085,0.043948527211320594,-1691,188,-735,-2238,-0.016840016859788642,0.011173155562017069,0.005666861297771664,3963,-956,0.16942413748877777,-0.022506878157560306
874,6033,Lake,California,2016,11496,10599,2580,24675,0.46589665653495443,0.42954407294832825,0.10455927051671733,-1667,1552,1399,1284,-0.09684114860377419,0.06061074330539674,0.0362304052983774,897,-3066,0.036352583586626186,-0.13307155390215158
875,6035,Lassen,California,2000,2982,7080,524,10586,0.28169280181371625,0.6688078594369923,0.049499338749291515,0,0,0,0,0.0,0.0,0.0,-4098,0,-0.387115057623276,0.0
876,6035,Lassen,California,2004,3158,8126,166,11450,0.2758078602620087,0.7096943231441049,0.014497816593886463,176,-358,1046,864,-0.005884941551707545,-0.03500152215540505,0.040886463707112575,-4968,-870,-0.43388646288209615,-0.04677140525882012
877,6035,Lassen,California,2008,3586,7483,364,11433,0.31365345928452726,0.6545088778098487,0.03183766290562407,428,198,-643,-17,0.03784559902251855,0.017339846311737607,-0.05518544533425618,-3897,1071,-0.3408554185253214,0.09303104435677473
878,6035,Lassen,California,2012,3053,7296,376,10725,0.28466200466200464,0.6802797202797203,0.03505827505827506,-533,12,-187,-708,-0.028991454622522617,0.0032206121526509868,0.025770842469871602,-4243,-346,-0.39561771561771564,-0.05476229709239422
879,6035,Lassen,California,2016,2224,7574,901,10699,0.20786989438265258,0.7079166277222171,0.08421347789513038,-829,525,278,-26,-0.07679211027935207,0.04915520283685532,0.027636907442496805,-5350,-1107,-0.5000467333395645,-0.10442901772184887
880,6037,Los Angeles,California,2000,1710505,871930,112719,2695154,0.6346594665833567,0.32351769138238484,0.041822842034258526,0,0,0,0,0.0,0.0,0.0,838575,0,0.31114177520097186,0.0
881,6037,Los Angeles,California,2004,1907736,1076225,39319,3023280,0.6310153211082004,0.355979267550475,0.013005411341324654,197231,-73400,204295,328126,-0.0036441454751563462,-0.02881743069293387,0.032461576168090145,831511,-7064,0.27503605355772537,-0.03610572164324649
882,6037,Los Angeles,California,2008,2295853,956425,65970,3318248,0.6918871042791256,0.28823192238795897,0.01988097333291544,388117,26651,-119800,294968,0.06087178317092523,0.006875561991590787,-0.06774734516251602,1339428,507917,0.4036551818911666,0.12861912833344125
883,6037,Los Angeles,California,2012,2216903,885333,78831,3181067,0.6969054722833565,0.27831322006106757,0.024781307655575943,-78950,12861,-71092,-137181,0.005018368004230944,0.004900334322660502,-0.009918702326891404,1331570,-7858,0.41859225222228896,0.014937070331122348
884,6037,Los Angeles,California,2016,2464364,769743,200201,3434308,0.7175722154215638,0.22413336252892868,0.0582944220495075,247461,121370,-115590,253241,0.020666743138207266,0.03351311439393156,-0.054179857532138886,1694621,363051,0.4934388528926351,0.07484660067034615
885,6039,Madera,California,2000,11650,20283,1462,33395,0.34885461895493336,0.6073663722114089,0.043779008833657734,0,0,0,0,0.0,0.0,0.0,-8633,0,-0.2585117532564755,0.0
886,6039,Madera,California,2004,13481,24871,498,38850,0.347001287001287,0.6401801801801802,0.012818532818532818,1831,-964,4588,5455,-0.0018533319536463422,-0.030960476015124916,0.032813807968771314,-11390,-2757,-0.2931788931788932,-0.034667139922417656
887,6039,Madera,California,2008,17952,23583,939,42474,0.422658567594293,0.5552337900833451,0.022107642322361915,4471,441,-1288,3624,0.07565728059300597,0.009289109503829097,-0.08494639009683513,-5631,5759,-0.13257522248905207,0.1606036706898411
888,6039,Madera,California,2012,16018,22852,1063,39933,0.4011218791475722,0.5722585330428468,0.026619587809581048,-1934,124,-731,-2541,-0.021536688446720798,0.004511945487219133,0.017024742959501737,-6834,-1203,-0.1711366538952746,-0.038561431406222535
889,6039,Madera,California,2016,17029,23357,3121,43507,0.3914082791274967,0.5368561380927207,0.07173558277978256,1011,2058,505,3574,-0.009713600020075486,0.045115994970201516,-0.03540239495012609,-6328,506,-0.145447858965224,0.025688794930050607
890,6041,Marin,California,2000,79135,34872,9148,123155,0.6425642483049815,0.2831553733100564,0.07428037838496204,0,0,0,0,0.0,0.0,0.0,44263,0,0.3594088749949251,0.0
891,6041,Marin,California,2004,99070,34378,1877,135325,0.7320894143728062,0.2540402734158507,0.013870312211343064,19935,-7271,-494,12170,0.08952516606782468,-0.06041006617361898,-0.029115099894205687,64692,20429,0.47804914095695544,0.11864026596203037
892,6041,Marin,California,2008,109320,28384,2866,140570,0.7776908301913638,0.20192075122714662,0.02038841858148965,10250,989,-5994,5245,0.04560141581855759,0.006518106370146586,-0.05211952218870411,80936,16244,0.5757700789642172,0.09772093800726173
893,6041,Marin,California,2012,99896,30880,3955,134731,0.7414477737120633,0.22919743785765712,0.029354788430279593,-9424,1089,2496,-5839,-0.036243056479300484,0.008966369848789943,0.0272766866305105,69016,-11920,0.5122503358544062,-0.06351974310981101
894,6041,Marin,California,2016,108707,21771,10205,140683,0.7727088560806921,0.15475217332584604,0.0725389705934619,8811,6250,-9109,5952,0.03126108236862879,0.0431841821631823,-0.07444526453181108,86936,17920,0.617956682754846,0.1057063469004399
895,6043,Mariposa,California,2000,2816,4727,531,8074,0.34877384196185285,0.5854594996284369,0.06576665840971017,0,0,0,0,0.0,0.0,0.0,-1911,0,-0.23668565766658406,0.0
896,6043,Mariposa,California,2004,3251,5215,192,8658,0.3754908754908755,0.6023331023331023,0.022176022176022176,435,-339,488,584,0.02671703352902266,-0.043590636233688,0.016873602704665425,-1964,-53,-0.22684222684222682,0.009843430824357235
897,6043,Mariposa,California,2008,4100,5298,279,9677,0.42368502635114186,0.5474837242947195,0.02883124935413868,849,87,83,1019,0.04819415086026635,0.006655227178116504,-0.05484937803838286,-1198,766,-0.12379869794357762,0.1030435288986492
898,6043,Mariposa,California,2012,3498,5140,400,9038,0.38703252932064613,0.5687098915689311,0.04425757911042266,-602,121,-158,-639,-0.03665249703049572,0.015426329756283982,0.02122616727421167,-1642,-444,-0.181677362248285,-0.057878664304707395
899,6043,Mariposa,California,2016,3122,5185,570,8877,0.3516953925875859,0.5840937253576659,0.06421088205474823,-376,170,45,-161,-0.035337136733060215,0.01995330294432557,0.015383833788734758,-2063,-421,-0.23239833277007999,-0.05072097052179497
900,6045,Mendocino,California,2000,16634,12272,5504,34410,0.48340598663179307,0.35664051147922116,0.15995350188898577,0,0,0,0,0.0,0.0,0.0,4362,0,0.12676547515257192,0.0
901,6045,Mendocino,California,2004,24385,12955,1089,38429,0.6345468266153166,0.3371151994587421,0.028337973925941347,7751,-4415,683,4019,0.1511408399835235,-0.13161552796304443,-0.01952531202047908,11430,7068,0.2974316271565745,0.1706661520040026
902,6045,Mendocino,California,2008,27843,10721,1620,40184,0.6928877165040812,0.2667977304399761,0.04031455305594266,3458,531,-2234,1755,0.058340889888764624,0.011976579130001316,-0.07031746901876595,17122,5692,0.4260899860641051,0.12865835890753058
903,6045,Mendocino,California,2012,23193,9658,2286,35137,0.6600734268719584,0.27486694936961037,0.06505962375843129,-4650,666,-1063,-5047,-0.03281428963212285,0.024745070702488624,0.008069218929634248,13535,-3587,0.385206477502348,-0.0408835085617571
904,6045,Mendocino,California,2016,22079,10888,4948,37915,0.5823288935777396,0.28716866675458264,0.1305024396676777,-1114,2662,1230,2778,-0.07774453329421871,0.0654428159092464,0.012301717384972266,11191,-2344,0.295160226823157,-0.09004625067919098
905,6047,Merced,California,2000,22726,26102,1590,50418,0.4507517156571066,0.5177119282795827,0.03153635606331072,0,0,0,0,0.0,0.0,0.0,-3376,0,-0.06696021262247609,0.0
906,6047,Merced,California,2004,24491,32773,696,57960,0.42255003450655626,0.5654416839199448,0.012008281573498964,1765,-894,6671,7542,-0.02820168115055033,-0.019528074489811753,0.04772975564036208,-8282,-4906,-0.1428916494133885,-0.07593143679091241
907,6047,Merced,California,2008,34031,28704,1316,64051,0.5313109865575869,0.4481428861376091,0.020546127304803985,9540,620,-4069,6091,0.10876095205103065,0.00853784573130502,-0.11729879778233565,5327,13609,0.0831681004199778,0.2260597498333663
908,6047,Merced,California,2012,33005,27581,1636,62222,0.5304393944264086,0.4432676545273376,0.026292951046253735,-1026,320,-1123,-1829,-0.0008715921311782671,0.00574682374144975,-0.004875231610271535,5424,97,0.08717173989907107,0.004003639479093268
909,6047,Merced,California,2016,37317,28725,4747,70789,0.5271581742926161,0.4057833844241337,0.06705844128325023,4312,3111,1144,8567,-0.003281220133792506,0.04076549023699649,-0.037484270103203876,8592,3168,0.12137478986848244,0.03420304996941137
910,6049,Modoc,California,2000,945,2969,193,4107,0.23009495982468955,0.7229121012904797,0.046992938884830776,0,0,0,0,0.0,0.0,0.0,-2024,0,-0.49281714146579014,0.0
911,6049,Modoc,California,2004,1149,3235,83,4467,0.25721961047683006,0.7241996865905529,0.018580702932616967,204,-110,266,360,0.02712465065214051,-0.02841223595221381,0.001287585300073224,-2086,-62,-0.46698007611372283,0.025837065352067312
912,6049,Modoc,California,2008,1313,2981,126,4420,0.29705882352941176,0.6744343891402715,0.02850678733031674,164,43,-254,-47,0.0398392130525817,0.009926084397699774,-0.049765297450281354,-1668,418,-0.3773755656108598,0.08960451050286306
913,6049,Modoc,California,2012,1111,2777,131,4019,0.2764369246081115,0.6909679024632993,0.032595172928589204,-202,5,-204,-401,-0.020621898921300286,0.004088385598272463,0.01653351332302777,-1666,2,-0.41453097785518783,-0.03715541224432806
914,6049,Modoc,California,2016,877,2696,270,3843,0.22820712984647412,0.7015352589123081,0.0702576112412178,-234,139,-81,-176,-0.04822979476163736,0.03766243831262859,0.010567356449008747,-1819,-153,-0.47332812906583394,-0.058797151210646104
915,6051,Mono,California,2000,1788,2296,287,4371,0.40905971173644473,0.5252802562342713,0.06566003202928392,0,0,0,0,0.0,0.0,0.0,-508,0,-0.1162205444978266,0.0
916,6051,Mono,California,2004,2628,2621,89,5338,0.4923192206819033,0.49100786811539904,0.01667291120269764,840,-198,325,967,0.08325950894545858,-0.04898712082658628,-0.03427238811887229,7,515,0.0013113525665042758,0.11753189706433087
917,6051,Mono,California,2008,3093,2354,124,5571,0.5551965535810447,0.422545323999282,0.022258122419673308,465,35,-267,233,0.06287733289914138,0.00558521121697567,-0.06846254411611702,739,732,0.13265122958176268,0.1313398770152584
918,6051,Mono,California,2012,2733,2285,163,5181,0.527504342790967,0.44103454931480407,0.031461107894228915,-360,39,-69,-390,-0.027692210790077665,0.009202985474555607,0.01848922531552205,448,-291,0.08646979347616296,-0.046181436105599716
919,6051,Mono,California,2016,2773,2111,397,5281,0.5250899450861579,0.39973489869342926,0.0751751562204128,40,234,-174,100,-0.0024143977048091125,0.04371404832618389,-0.041299650621374806,662,214,0.12535504639272865,0.038885252916565693
920,6053,Monterey,California,2000,67618,43761,6155,117534,0.5753058689400514,0.37232630557966206,0.05236782548028655,0,0,0,0,0.0,0.0,0.0,23857,0,0.20297956336038936,0.0
921,6053,Monterey,California,2004,75241,47838,1574,124653,0.6036036036036037,0.38376934369810595,0.012627052698290455,7623,-4581,4077,7119,0.028297734663552232,-0.0397407727819961,0.011443038118443882,27403,3546,0.2198342599054977,0.01685469654510835
922,6053,Monterey,California,2008,88453,38797,2533,129783,0.6815453487744928,0.2989374571399952,0.01951719408551197,13212,959,-9041,5130,0.07794174517088914,0.006890141387221516,-0.08483188655811075,49656,22253,0.3826078916344976,0.1627736317289999
923,6053,Monterey,California,2012,82920,37390,3208,123518,0.6713191599604916,0.30270891691899154,0.025971923120516847,-5533,675,-1407,-6265,-0.01022618881400117,0.006454729035004877,0.0037714597789963444,45530,-4126,0.3686102430415001,-0.013997648592997514
924,6053,Monterey,California,2016,89088,34895,9425,133408,0.6677860398177021,0.2615660230271048,0.07064793715519309,6168,6217,-2495,9890,-0.003533120142789503,0.04467601403467624,-0.041142893891886745,54193,8663,0.4062200167905973,0.03760977374909724
925,6055,Napa,California,2000,28097,20633,2994,51724,0.5432101152269739,0.3989057304152811,0.05788415435774495,0,0,0,0,0.0,0.0,0.0,7464,0,0.14430438481169283,0.0
926,6055,Napa,California,2004,33666,22059,874,56599,0.5948161628297319,0.38974186823088747,0.015441968939380555,5569,-2120,1426,4875,0.051606047602758,-0.0424421854183644,-0.009163862184393634,11607,4143,0.20507429459884446,0.06076990978715163
927,6055,Napa,California,2008,38849,19484,1309,59642,0.6513698400456055,0.32668253915026324,0.021947620804131318,5183,435,-2575,3043,0.056553677215873566,0.0065056518647507635,-0.06305932908062423,19365,7758,0.32468730089534226,0.11961300629649779
928,6055,Napa,California,2012,35870,19526,1572,56968,0.6296517343069794,0.34275382670973176,0.027594438983288862,-2979,263,42,-2674,-0.021718105738626092,0.005646818179157544,0.016071287559468517,16344,-3021,0.28689790759724765,-0.03778939329809461
929,6055,Napa,California,2016,39199,17411,4762,61372,0.6387114645115036,0.28369614808055793,0.07759238740793847,3329,3190,-2115,4404,0.009059730204524219,0.04999794842464961,-0.059057678629173826,21788,5444,0.3550153164309457,0.06811740883369805
930,6057,Nevada,California,2000,17670,25998,3811,47479,0.37216453590008214,0.5475683986604604,0.08026706543945744,0,0,0,0,0.0,0.0,0.0,-8328,0,-0.17540386276037823,0.0
931,6057,Nevada,California,2004,24220,28790,910,53920,0.4491839762611276,0.5339391691394659,0.016876854599406528,6550,-2901,2792,6441,0.07701944036104547,-0.06339021084005092,-0.013629229520994435,-4570,3758,-0.08475519287833833,0.0906486698820399
932,6057,Nevada,California,2008,28617,25663,1367,55647,0.5142595288155696,0.4611749061045519,0.02456556507987852,4397,457,-3127,1727,0.06507555255444197,0.007688710480471993,-0.07276426303491401,2954,7524,0.05308462271101766,0.13783981558935599
933,6057,Nevada,California,2012,24663,24986,2027,51676,0.4772621719947364,0.48351265577831104,0.03922517222695255,-3954,660,-677,-3971,-0.03699735682083316,0.014659607147074028,0.022337749673759122,-323,-3277,-0.006250483783574623,-0.05933510649459228
934,6057,Nevada,California,2016,26053,23365,5517,54935,0.47425138800400474,0.4253208337125694,0.10042777828342586,1390,3490,-1621,3259,-0.0030107839907316802,0.06120260605647331,-0.05819182206574164,2688,3011,0.048930554291435335,0.05518103807500996
935,6059,Orange,California,2000,391819,541299,37787,970905,0.4035605955268538,0.5575200457305297,0.03891935874261643,0,0,0,0,0.0,0.0,0.0,-149480,0,-0.1539594502036759,0.0
936,6059,Orange,California,2004,419239,641832,14328,1075399,0.38984507145719866,0.5968315016101,0.013323426932701258,27420,-23459,100533,104494,-0.01371552406965515,-0.025595931809915172,0.0393114558795703,-222593,-73113,-0.20698643015290136,-0.05302697994922545
937,6059,Orange,California,2008,549558,579064,25065,1153687,0.47634930444739343,0.5019246988134564,0.02172599673915022,130319,10737,-62768,78288,0.08650423299019477,0.008402569806448964,-0.09490680279664365,-29506,193087,-0.02557539436606293,0.18141103578683843
938,6059,Orange,California,2012,512440,582332,27892,1122664,0.45645001532070145,0.5187055076140323,0.02484447706526619,-37118,2827,3268,-31023,-0.019899289126691977,0.0031184803261159674,0.016780808800575975,-69892,-40386,-0.06225549229333088,-0.03668009792726795
939,6059,Orange,California,2016,609961,507148,80412,1197521,0.5093530718876746,0.4234982100522663,0.06714871806005908,97521,52520,-75184,74857,0.052903056566973194,0.042304240994792894,-0.09520729756176605,102813,172705,0.08585486183540836,0.14811035412873924
940,6061,Placer,California,2000,42449,69835,5515,117799,0.36035110654589597,0.5928318576558375,0.046817035798266536,0,0,0,0,0.0,0.0,0.0,-27386,0,-0.23248075110994149,0.0
941,6061,Placer,California,2004,55573,95969,1736,153278,0.3625634468090659,0.6261107269144952,0.011325826276438888,13124,-3779,26134,35479,0.0022123402631699096,-0.035491209521827646,0.03327886925865775,-40396,-13010,-0.2635472801054293,-0.03106652899548784
942,6061,Placer,California,2008,75112,94647,4053,173812,0.4321450762893241,0.544536625779578,0.023318297931097968,19539,2317,-1322,20534,0.0695816294802582,0.01199247165465908,-0.08157410113491725,-19535,20861,-0.11239154949025387,0.15115573061517545
943,6061,Placer,California,2012,66818,99921,4972,171711,0.389130574045926,0.5819137970194105,0.028955628934663476,-8294,919,5274,-2101,-0.04301450224339809,0.005637331003565508,0.03737717123983253,-33103,-13568,-0.1927832229734845,-0.08039167348323062
944,6061,Placer,California,2016,73509,95138,17377,186024,0.39515868920139335,0.5114286328645766,0.09341267793403002,6691,12405,-4783,14313,0.006028115155467362,0.06445704899936655,-0.07048516415483386,-21629,11474,-0.11626994366318327,0.07651327931030122
945,6063,Plumas,California,2000,3458,6343,600,10401,0.3324680319200077,0.6098452071916162,0.05768676088837612,0,0,0,0,0.0,0.0,0.0,-2885,0,-0.2773771752716085,0.0
946,6063,Plumas,California,2004,4129,6905,156,11190,0.36899016979445937,0.6170688114387847,0.013941018766756031,671,-444,562,789,0.03652213787445169,-0.043745742121620086,0.0072236042471685025,-2776,109,-0.2480786416443253,0.029298533627283185
947,6063,Plumas,California,2008,4715,6035,278,11028,0.4275480594849474,0.5472433804860355,0.025208560029017047,586,122,-870,-162,0.05855788969048803,0.011267541262261016,-0.06982543095274918,-1320,1456,-0.1196953210010881,0.1283833206432372
948,6063,Plumas,California,2012,4026,5721,333,10080,0.39940476190476193,0.5675595238095238,0.033035714285714286,-689,55,-314,-948,-0.028143297580185467,0.00782715425669724,0.0203161433234883,-1695,-375,-0.16815476190476186,-0.04845944090367377
949,6063,Plumas,California,2016,3459,5420,971,9850,0.35116751269035534,0.550253807106599,0.09857868020304568,-567,638,-301,-230,-0.048237249214406586,0.06554296591733139,-0.0173057167029248,-1961,-266,-0.19908629441624365,-0.030931532511481785
950,6065,Riverside,California,2000,202576,231955,16596,451127,0.4490442824304464,0.5141678507382622,0.03678786683129141,0,0,0,0,0.0,0.0,0.0,-29379,0,-0.0651235683078158,0.0
951,6065,Riverside,California,2004,228806,322473,6300,557579,0.4103562006460071,0.5783449520157682,0.011298847338224718,26230,-10296,90518,106452,-0.03868808178443933,-0.025489019493066693,0.06417710127750598,-93667,-64288,-0.1679887513697611,-0.10286518306194531
952,6065,Riverside,California,2008,325017,310041,12241,647299,0.5021126249229491,0.47897648536456877,0.018910889712482178,96211,5941,-12432,89720,0.09175642427694197,0.0076120423742574595,-0.09936846665119942,14976,108643,0.023136139558380286,0.1911248909281414
953,6065,Riverside,California,2012,329063,318127,15926,663116,0.4962374607157722,0.47974562519981423,0.024016914084413588,4046,3685,8086,15817,-0.005875164207176875,0.00510602437193141,0.0007691398352454581,10936,-4040,0.016491835515957953,-0.006644304042422333
954,6065,Riverside,California,2016,373695,333243,44453,751391,0.49733760452281167,0.4435014526391719,0.05916094283801643,44632,28527,15116,88275,0.0011001438070394887,0.03514402875360284,-0.03624417256064233,40452,29516,0.05383615188363977,0.03734431636768182
955,6067,Sacramento,California,2000,212792,195619,23139,431550,0.49308770710230565,0.4532939404472251,0.05361835245046924,0,0,0,0,0.0,0.0,0.0,17173,0,0.039793766655080554,0.0
956,6067,Sacramento,California,2004,236657,235539,5670,477866,0.4952371585339823,0.49289759053793325,0.011865250928084442,23865,-17469,39920,46316,0.0021494514316766633,-0.041753101522384796,0.03960365009070815,1118,-16055,0.0023395679960490634,-0.03745419865903149
957,6067,Sacramento,California,2008,316506,213583,12770,542859,0.5830353738263527,0.39344102243860746,0.023523603735039852,79849,7100,-21956,64993,0.08779821529237042,0.01165835280695541,-0.09945656809932579,102923,101805,0.18959435138774527,0.1872547833916962
958,6067,Sacramento,California,2012,300503,202514,14565,517582,0.5805901287139043,0.39126940272266036,0.02814046856343536,-16003,1795,-11069,-25277,-0.0024452451124484798,0.004616864828395507,-0.002171619715947093,97989,-4934,0.1893207259912439,-0.00027362539650138684
959,6067,Sacramento,California,2016,326023,189789,46473,562285,0.579818063793272,0.33753167877499846,0.08265025743172946,25520,31908,-12725,44703,-0.0007720649206321983,0.05450978886829411,-0.05373772394766191,136234,38245,0.2422863850182736,0.05296565902702971
960,6069,San Benito,California,2000,9131,7015,685,16831,0.5425108430871606,0.4167904462004634,0.04069871071237597,0,0,0,0,0.0,0.0,0.0,2116,0,0.12572039688669717,0.0
961,6069,San Benito,California,2004,9851,8698,176,18725,0.5260881174899866,0.46451268357810416,0.009399198931909212,720,-509,1683,1894,-0.01642272559717395,-0.031299511780466756,0.04772223737764075,1153,-963,0.06157543391188247,-0.0641449629748147
962,6069,San Benito,California,2008,11917,7425,446,19788,0.602233676975945,0.3752274105518496,0.022538912472205377,2066,270,-1273,1063,0.07614555948595836,0.013139713540296164,-0.08928527302625455,4492,3339,0.22700626642409538,0.1654308325122129
963,6069,San Benito,California,2012,11276,7343,462,19081,0.5909543524972486,0.38483308002725225,0.024212567475499186,-641,16,-82,-707,-0.011279324478696395,0.0016736550032938093,0.009605669475402645,3933,-559,0.20612127246999634,-0.02088499395409904
964,6069,San Benito,California,2016,12521,7841,1760,22122,0.5659976493987885,0.35444354036705544,0.07955881023415605,1245,1298,498,3041,-0.024956703098460098,0.05534624275865686,-0.030389539660196807,4680,747,0.21155410903173305,0.005432836561736709
965,6071,San Bernardino,California,2000,214749,221757,18387,454893,0.47208684240030074,0.4874926631097863,0.040420494489913014,0,0,0,0,0.0,0.0,0.0,-7008,0,-0.01540582070948554,0.0
966,6071,San Bernardino,California,2004,227789,289306,6181,523276,0.4353132954693126,0.5528745824383309,0.011812122092356615,13040,-12206,67549,68383,-0.036773546930988166,-0.028608372397556397,0.06538191932854459,-61517,-54509,-0.1175612869690183,-0.10215546625953276
967,6071,San Bernardino,California,2008,315720,277408,13206,606334,0.5207031108267061,0.4575168141651301,0.021780075008163816,87931,7025,-11898,83058,0.08538981535739348,0.009967952915807201,-0.09535776827320075,38312,99829,0.06318629666157594,0.18074758363059423
968,6071,San Bernardino,California,2012,305109,262358,15463,582930,0.5234058977921877,0.4500677611377009,0.026526341070111335,-10611,2257,-15050,-23404,0.0027027869654816516,0.004746266061947519,-0.007449053027429209,42751,4439,0.0733381366544868,0.01015183999291086
969,6071,San Bernardino,California,2016,340833,271240,41910,653983,0.5211649232472404,0.4147508421472729,0.06408423460548669,35724,26447,8882,71053,-0.002240974544947316,0.03755789353537536,-0.03531691899042799,69593,26842,0.10641408109996747,0.033075944445480676
970,6073,San Diego,California,2000,437666,475736,45232,958634,0.45655171838261527,0.4962644763277747,0.047183805289610005,0,0,0,0,0.0,0.0,0.0,-38070,0,-0.03971275794515944,0.0
971,6073,San Diego,California,2004,526437,596033,13881,1136351,0.46326971155919255,0.5245148726053833,0.01221541583542409,88771,-31351,120297,177717,0.006717993176577286,-0.034968389454185914,0.028250396277608614,-69596,-31526,-0.061245161046190766,-0.021532403101031328
972,6073,San Diego,California,2008,666581,541032,27890,1235503,0.5395219598819266,0.43790423819286556,0.02257380192520779,140144,14009,-55001,99152,0.07625224832273408,0.0103583860897837,-0.08661063441251776,125549,195145,0.10161772168906108,0.16286288273525185
973,6073,San Diego,California,2012,626957,536726,30266,1193949,0.5251120441492895,0.4495384643732689,0.025349491477441668,-39624,2376,-4306,-41554,-0.014409915732637169,0.002775689552233878,0.011634226180403329,90231,-35318,0.07557357977602058,-0.026044141913040497
974,6073,San Diego,California,2016,735476,477766,93158,1306400,0.5629791794243724,0.3657118799755052,0.07130894060012248,108519,62892,-58960,112451,0.0378671352750829,0.04595944912268081,-0.08382658439776369,257710,167479,0.19726729944886717,0.12169371967284659
975,6075,San Francisco,California,2000,241578,51496,26712,319786,0.7554364481246834,0.16103269061184666,0.08353086126346995,0,0,0,0,0.0,0.0,0.0,190082,0,0.5944037575128367,0.0
976,6075,San Francisco,California,2004,296772,54355,6338,357465,0.8302127481012127,0.1520568447260571,0.0177304071727302,55194,-20374,2859,37679,0.07477629997652935,-0.06580045409073976,-0.008975845885789563,242417,52335,0.6781559033751556,0.08375214586231894
977,6075,San Francisco,California,2008,322220,52292,9284,383796,0.8395605999020312,0.13624946586207257,0.024189934235896153,25448,2946,-2063,26331,0.00934785180081854,0.006459527063165955,-0.015807378863984534,269928,27511,0.7033111340399587,0.025155230664803074
978,6075,San Francisco,California,2012,301723,47076,12996,361795,0.8339612211335148,0.13011788443731948,0.03592089442916569,-20497,3712,-5216,-22001,-0.005599378768516461,0.011730960193269538,-0.006131581424753091,254647,-15281,0.7038433366961954,0.0005322026562366577
979,6075,San Francisco,California,2016,345084,37688,25769,408541,0.8446740963575259,0.09225022702739749,0.06307567661507658,43361,12773,-9388,46746,0.010712875224011098,0.027154782185910893,-0.037867657409921984,307396,52749,0.7524238693301284,0.04858053263393303
980,6077,San Joaquin,California,2000,79776,81773,5690,167239,0.47701792046113645,0.4889589150855961,0.03402316445326748,0,0,0,0,0.0,0.0,0.0,-1997,0,-0.011940994624459633,0.0
981,6077,San Joaquin,California,2004,87012,100978,1874,189864,0.45828593098217674,0.5318438461214343,0.009870222896388994,7236,-3816,19205,22625,-0.01873198947895971,-0.024152941556878485,0.042884931035838236,-13966,-11969,-0.07355791513925758,-0.061616920514797946
982,6077,San Joaquin,California,2008,113974,91607,4727,210308,0.5419384902143523,0.4355849515948038,0.022476558190843904,26962,2853,-9371,20444,0.08365255923217552,0.01260633529445491,-0.0962588945266305,22367,36333,0.10635353861954844,0.17991145375880602
983,6077,San Joaquin,California,2012,114121,86071,5172,205364,0.5557010965894704,0.4191143530511677,0.025184550359361912,147,445,-5536,-4944,0.01376260637511817,0.002707992168518008,-0.01647059854363614,28050,5683,0.13658674353830275,0.03023320491875431
984,6077,San Joaquin,California,2016,121124,88936,16942,227002,0.5335812019277363,0.3917850944044546,0.0746337036678091,7003,11770,2865,21638,-0.02211989466173414,0.04944915330844718,-0.027329258646713095,32188,4138,0.1417961075232817,0.005209363984978954
985,6079,San Luis Obispo,California,2000,44526,56859,7501,108886,0.40892309387800085,0.5221883437723858,0.06888856234961335,0,0,0,0,0.0,0.0,0.0,-12333,0,-0.11326524989438491,0.0
986,6079,San Luis Obispo,California,2004,58742,67995,2313,129050,0.45518791166214645,0.5268888027896165,0.017923285548237116,14216,-5188,11136,20164,0.046264817784145595,-0.05096527680137623,0.004700459017230707,-9253,3080,-0.07170089112747002,0.04156435876691489
987,6079,San Luis Obispo,California,2008,68176,61055,3924,133155,0.5120048064285982,0.4585257782283805,0.02946941534302129,9434,1611,-6940,4105,0.0568168947664518,0.011546129794784175,-0.068363024561236,7121,16374,0.05347902820021777,0.1251799193276878
988,6079,San Luis Obispo,California,2012,61258,59967,4741,125966,0.4863058285569122,0.4760570312624041,0.037637140180683676,-6918,817,-1088,-7189,-0.02569897787168607,0.008167724837662385,0.01753125303402364,1291,-5830,0.01024879729450806,-0.04323023090570971
989,6079,San Luis Obispo,California,2016,67107,56164,13931,137202,0.48911094590457865,0.4093526333435373,0.10153642075188409,5849,9190,-3803,11236,0.002805117347666475,0.06389928057120041,-0.06670439791886684,10943,9652,0.07975831256104138,0.06950951526653332
990,6081,San Mateo,California,2000,166757,80296,12346,259399,0.6428590703896314,0.30954629740284273,0.047594632207525855,0,0,0,0,0.0,0.0,0.0,86461,0,0.3333127729867887,0.0
991,6081,San Mateo,California,2004,197922,83315,3620,284857,0.6948117827541538,0.2924800864995419,0.012708130746304286,31165,-8726,3019,25458,0.05195271236452237,-0.03488650146122157,-0.01706621090330085,114607,28146,0.4023316962546119,0.06901892326782322
992,6081,San Mateo,California,2008,222826,75057,5409,303292,0.734691320575551,0.2474743811244609,0.01783429829998813,24904,1789,-8258,18435,0.03987953782139719,0.0051261675536838445,-0.04500570537508097,147769,33162,0.48721693945109007,0.08488524319647817
993,6081,San Mateo,California,2012,206085,72756,6879,285720,0.7212830743385132,0.25464090718185634,0.024076018479630406,-16741,1470,-2301,-17572,-0.013408246237037735,0.006241720179642276,0.007166526057395428,133329,-14440,0.4666421671566569,-0.020574772294433163
994,6081,San Mateo,California,2016,237882,57929,18573,314384,0.7566606443075984,0.1842619217262965,0.059077433966105146,31797,11694,-14827,28664,0.03537756996908514,0.03500141548647474,-0.07037898545555984,179953,46624,0.5723987225813019,0.10575655542464496
995,6083,Santa Barbara,California,2000,73411,71493,10070,154974,0.47369881399460556,0.4613225444268071,0.06497864157858738,0,0,0,0,0.0,0.0,0.0,1918,0,0.01237626956779847,0.0
996,6083,Santa Barbara,California,2004,90314,76806,2741,169861,0.5316935612059271,0.45216971523775323,0.01613672355631958,16903,-7329,5313,14887,0.057994747211321585,-0.0488419180222678,-0.009152829189053857,13508,11590,0.07952384596817391,0.06714757640037544
997,6083,Santa Barbara,California,2008,105614,65585,4208,175407,0.6021082396939689,0.37390183972133384,0.023989920584697302,15300,1467,-11221,5546,0.07041467848804173,0.007853197028377723,-0.0782678755164194,40029,26521,0.22820639997263503,0.14868255400446112
998,6083,Santa Barbara,California,2012,94129,64606,5150,163885,0.5743600695609726,0.3942154559599719,0.031424474479055435,-11485,942,-979,-11522,-0.02774817013299624,0.007434553894358133,0.020313616238638088,29523,-10506,0.1801446136010007,-0.04806178637163433
999,6083,Santa Barbara,California,2016,107142,56365,15371,178878,0.598966893637004,0.31510303111617977,0.08593007524681627,13013,10221,-8241,14993,0.02460682407603132,0.054505600767760835,-0.07911242484379216,50777,21254,0.2838638625208242,0.10371924891982348
1000,6085,Santa Clara,California,2000,332490,188750,26889,548129,0.6065907842861809,0.344353245312691,0.049055970401128204,0,0,0,0,0.0,0.0,0.0,143740,0,0.26223753897348984,0.0
1001,6085,Santa Clara,California,2004,386100,209094,8622,603816,0.6394332048173615,0.34628761079534165,0.014279184387296792,53610,-18267,20344,55687,0.032842420531180694,-0.03477678601383141,0.0019343654826506351,177006,33266,0.2931455940220199,0.03090805504853006
1002,6085,Santa Clara,California,2008,462241,190039,13309,665589,0.6944841336019676,0.2855200431497516,0.019995823248280847,76141,4687,-19055,61773,0.055050928784606046,0.0057166388609840545,-0.06076756764559005,272202,95196,0.408964090452216,0.1158184964301961
1003,6085,Santa Clara,California,2012,450818,174843,18616,644277,0.6997269807862146,0.27137861509878514,0.028894404115000227,-11423,5307,-15196,-21312,0.005242847184247057,0.00889858086671938,-0.014141428050966465,275975,3773,0.4283483656874295,0.01938427523521352
1004,6085,Santa Clara,California,2016,511684,144826,47199,703709,0.7271244221688227,0.20580381947651658,0.06707175835466081,60866,28583,-30017,59432,0.027397441382608023,0.03817735423966058,-0.06557479562226856,366858,90883,0.5213206026923061,0.09297223700487656
1005,6087,Santa Cruz,California,2000,66618,29627,12105,108350,0.6148407937240424,0.2734379326257499,0.11172127365020766,0,0,0,0,0.0,0.0,0.0,36991,0,0.34140286109829254,0.0
1006,6087,Santa Cruz,California,2004,89102,30354,2628,122084,0.7298417483044461,0.2486320893810819,0.021526162314472002,22484,-9477,727,13734,0.11500095458040371,-0.09019511133573566,-0.024805843244668002,58748,21757,0.48120965892336426,0.13980679782507172
1007,6087,Santa Cruz,California,2008,98745,25244,3747,127736,0.7730397068954719,0.19762635435585896,0.02933393874866913,9643,1119,-5110,5652,0.04319795859102571,0.0078077764341971286,-0.05100573502522293,73501,14753,0.5754133525396129,0.09420369361624864
1008,6087,Santa Cruz,California,2012,90805,24047,5533,120385,0.7542883249574283,0.1997507995182124,0.045960875524359346,-7940,1786,-1197,-7351,-0.0187513819380436,0.016626936775690215,0.002124445162353439,66758,-6743,0.5545375254392159,-0.020875827100397037
1009,6087,Santa Cruz,California,2016,95249,22438,12325,130012,0.7326169892009968,0.1725840691628465,0.09479894163615667,4444,6792,-1609,9627,-0.02167133575643143,0.04883806611179732,-0.027166730355365903,72811,6053,0.5600329200381503,0.005495394598934444
1010,6089,Shasta,California,2000,20127,43278,3139,66544,0.3024615292137533,0.6503666746814138,0.047171796104832894,0,0,0,0,0.0,0.0,0.0,-23151,0,-0.34790514546766055,0.0
1011,6089,Shasta,California,2004,24339,52249,1143,77731,0.313118318302865,0.672177123670093,0.014704558027041978,4212,-1996,8971,11187,0.010656789089111718,-0.032467238077790915,0.02181044898867912,-27910,-4759,-0.35905880536722795,-0.011153659899567403
1012,6089,Shasta,California,2008,28867,49588,1935,80390,0.35908695111332256,0.6168428909068292,0.02407015797984824,4528,792,-2661,2659,0.045968632810457544,0.009365599952806261,-0.05533423276326377,-20721,7189,-0.25775593979350664,0.10130286557372131
1013,6089,Shasta,California,2012,25819,48067,2615,76501,0.33749885622410164,0.6283185840707964,0.034182559705101895,-3048,680,-1521,-3889,-0.02158809488922092,0.010112401725253656,0.011475693163967238,-22248,-1527,-0.2908197278466948,-0.03306378805318816
1014,6089,Shasta,California,2016,22301,51778,6945,81024,0.2752394352290679,0.6390452211690363,0.08571534360189574,-3518,4330,3711,4523,-0.06225942099503373,0.051532783896793846,0.010726637098239844,-29477,-7229,-0.3638057859399684,-0.07298605809327358
1015,6091,Sierra,California,2000,540,1172,135,1847,0.292365998917163,0.6345425013535463,0.07309149972929074,0,0,0,0,0.0,0.0,0.0,-632,0,-0.3421765024363833,0.0
1016,6091,Sierra,California,2004,646,1249,53,1948,0.3316221765913758,0.641170431211499,0.027207392197125257,106,-82,77,101,0.0392561776742128,-0.045884107532165486,0.006627929857952686,-603,29,-0.3095482546201232,0.032628247816260114
1017,6091,Sierra,California,2008,743,1158,90,1991,0.37317930688096435,0.5816172777498745,0.045203415369161226,97,37,-91,43,0.04155713028958857,0.01799602317203597,-0.059553153461624486,-415,188,-0.20843797086891014,0.10111028375121306
1018,6091,Sierra,California,2012,653,1056,90,1799,0.3629794330183435,0.5869927737632018,0.0500277932184547,-90,0,-102,-192,-0.010199873862620834,0.004824377849293474,0.005375496013327319,-403,12,-0.2240133407448583,-0.015575369875948153
1019,6091,Sierra,California,2016,601,1048,209,1858,0.3234660925726588,0.5640473627556513,0.11248654467168999,-52,119,-8,59,-0.03951334044568472,0.06245875145323529,-0.022945411007550542,-447,-44,-0.24058127018299247,-0.016567929438134177
1020,6093,Siskiyou,California,2000,6323,12198,1298,19819,0.3190372874514355,0.6154700035319642,0.06549270901660023,0,0,0,0,0.0,0.0,0.0,-5875,0,-0.29643271608052874,0.0
1021,6093,Siskiyou,California,2004,7880,12673,346,20899,0.37705153356619936,0.6063926503660462,0.01655581606775444,1557,-952,475,1080,0.05801424611476386,-0.04893689294884579,-0.009077353165918067,-4793,1082,-0.2293411167998468,0.06709159928068192
1022,6093,Siskiyou,California,2008,9292,11520,752,21564,0.43090335744759783,0.5342237061769616,0.03487293637544055,1412,406,-1153,665,0.053851823881398475,0.01831712030768611,-0.0721689441890846,-2228,2565,-0.10332034872936374,0.12602076807048307
1023,6093,Siskiyou,California,2012,8046,11077,870,19993,0.40244085429900467,0.5540439153703797,0.04351523033061572,-1246,118,-443,-1571,-0.028462503148593166,0.00864229395517517,0.019820209193418092,-3031,-803,-0.151603061071375,-0.04828271234201126
1024,6093,Siskiyou,California,2016,7234,11341,1918,20493,0.35299858488264285,0.5534084809447128,0.09359293417264432,-812,1048,264,500,-0.04944226941636182,0.0500777038420286,-0.0006354344256668254,-4107,-1076,-0.20040989606207,-0.04880683499069499
1025,6095,Solano,California,2000,75116,51604,5015,131735,0.5702053364709455,0.39172581318556193,0.03806885034349262,0,0,0,0,0.0,0.0,0.0,23512,0,0.17847952328538358,0.0
1026,6095,Solano,California,2004,85096,62301,1440,148837,0.5717395540087479,0.4185854323857643,0.009675013605487883,9980,-3575,10697,17102,0.0015342175378023626,-0.028393836738004732,0.026859619200202356,22795,-717,0.15315412162298359,-0.025325401662399993
1027,6095,Solano,California,2008,102095,56035,3458,161588,0.6318229076416566,0.34677698839022697,0.021400103968116445,16999,2018,-6266,12751,0.06008335363290873,0.011725090362628561,-0.07180844399553732,46060,23265,0.28504591925142964,0.13189179762844605
1028,6095,Solano,California,2012,96783,52092,3965,152840,0.6332308296257524,0.3408270086364826,0.025942161737764983,-5312,507,-3943,-8748,0.0014079219840957835,0.004542057769648538,-0.005949979753744394,44691,-1369,0.2924038209892698,0.007357901737840178
1029,6095,Solano,California,2016,102360,51920,13870,168150,0.608742194469224,0.3087719298245614,0.08248587570621468,5577,9905,-172,15310,-0.024488635156528438,0.056543713968449705,-0.032055078811921156,50440,5749,0.29997026464466253,0.007566443655392718
1030,6097,Sonoma,California,2000,117295,63529,16182,197006,0.5953879577271758,0.3224724120077561,0.08213963026506807,0,0,0,0,0.0,0.0,0.0,53766,0,0.27291554571941967,0.0
1031,6097,Sonoma,California,2004,148261,68204,4225,220690,0.6718066065521773,0.3090488921111061,0.019144501336716663,30966,-11957,4675,23684,0.07641864882500149,-0.06299512892835141,-0.013423519896650027,80057,26291,0.3627577144410712,0.08984216872165152
1032,6097,Sonoma,California,2008,168888,55127,5336,229351,0.7363735061107212,0.24036084429542492,0.023265649593853962,20627,1111,-13077,8661,0.06456689955854389,0.004121148257137299,-0.06868804781568116,113761,33704,0.49601266181529624,0.13325494737422505
1033,6097,Sonoma,California,2012,153942,54784,8139,216865,0.7098517510893874,0.25261798814930947,0.037530260761303114,-14946,2803,-343,-12486,-0.026521755021333804,0.014264611167449152,0.012257143853884545,99158,-14603,0.4572337629400779,-0.03877889887521835
1034,6097,Sonoma,California,2016,160435,51408,21460,233303,0.6876679682644458,0.22034864532389212,0.0919833864116621,6493,13321,-3376,16438,-0.0221837828249416,0.05445312565035898,-0.03226934282541735,109027,9869,0.46731932294055367,0.01008556000047578
1035,6099,Stanislaus,California,2000,56448,67188,4631,128267,0.44008201641887623,0.5238136075529949,0.036104376028128826,0,0,0,0,0.0,0.0,0.0,-10740,0,-0.08373159113411865,0.0
1036,6099,Stanislaus,California,2004,58829,85407,1388,145624,0.40397873976817006,0.586489864308081,0.009531395923748832,2381,-3243,18219,17357,-0.03610327665070617,-0.026572980104379994,0.06267625675508615,-26578,-15838,-0.18251112453991097,-0.09877953340579232
1037,6099,Stanislaus,California,2008,80279,77497,3736,161512,0.49704665907177176,0.4798219327356481,0.023131408192580118,21450,2348,-7910,15888,0.0930679193036017,0.013600012268831285,-0.10666793157243293,2782,29360,0.017224726336123652,0.19973585087603463
1038,6099,Stanislaus,California,2012,77724,73459,4633,155816,0.49881911998767775,0.471447091441187,0.029733788571135185,-2555,897,-4038,-5696,0.0017724609159059934,0.006602380378555067,-0.008374841294461088,4265,1483,0.027372028546490734,0.010147302210367082
1039,6099,Stanislaus,California,2016,81647,78494,14265,174406,0.4681432978223226,0.45006479134892147,0.08179191082875589,3923,9632,5035,18590,-0.030675822165355138,0.05205812225762071,-0.02138230009226555,3153,-1112,0.018078506473401146,-0.009293522073089588
1040,6101,Sutter,California,2000,8416,17350,798,26564,0.31681975606083423,0.6531395874115344,0.030040656527631382,0,0,0,0,0.0,0.0,0.0,-8934,0,-0.3363198313507002,0.0
1041,6101,Sutter,California,2004,9602,20254,289,30145,0.3185271189251949,0.6718858848896998,0.009586996185105324,1186,-509,2904,3581,0.0017073628643606842,-0.020453660342526058,0.018746297478165364,-10652,-1718,-0.3533587659645049,-0.01703893461380468
1042,6101,Sutter,California,2008,13412,18911,698,33021,0.40616577329578146,0.5726961630477575,0.02113806365646104,3810,409,-1343,2876,0.08763865437058654,0.011551067471355717,-0.0991897218419423,-5499,5153,-0.16653038975197604,0.18682837621252885
1043,6101,Sutter,California,2012,12192,18122,769,31083,0.39224013126146123,0.5830196570472606,0.02474021169127819,-1220,71,-789,-1938,-0.01392564203432023,0.0036021480348171486,0.010323493999503053,-5930,-431,-0.19077952578579932,-0.024249136033823282
1044,6101,Sutter,California,2016,13076,18176,2572,33824,0.38658940397350994,0.5373699148533586,0.07604068117313151,884,1803,54,2741,-0.005650727287951296,0.05130046948185332,-0.04564974219390194,-5100,830,-0.15078051087984867,0.03999901490595065
1045,6103,Tehama,California,2000,6507,13270,1077,20854,0.3120264697420159,0.6363287618682267,0.05164476838975736,0,0,0,0,0.0,0.0,0.0,-6763,0,-0.3243022921262108,0.0
1046,6103,Tehama,California,2004,7504,15572,368,23444,0.32008189728715236,0.6642211226753114,0.015696980037536258,997,-709,2302,2590,0.00805542754513644,-0.0359477883522211,0.027892360807084682,-8068,-1305,-0.34413922538815905,-0.019836933261948242
1047,6103,Tehama,California,2008,8945,14843,772,24560,0.36421009771986973,0.60435667752443,0.031433224755700324,1441,404,-729,1116,0.04412820043271737,0.015736244718164066,-0.05986444515088141,-5898,2170,-0.24014657980456028,0.10399264558359878
1048,6103,Tehama,California,2012,7934,14235,808,22977,0.3453018235626931,0.6195325760543152,0.035165600382991685,-1011,36,-608,-1583,-0.018908274157176608,0.003732375627291361,0.015175898529885212,-6301,-403,-0.2742307524916221,-0.03408417268706182
1049,6103,Tehama,California,2016,6809,15494,1605,23908,0.28480006692320564,0.6480675924376778,0.06713234063911662,-1125,797,1259,931,-0.06050175663948748,0.031966740256124934,0.028535016383362533,-8685,-2384,-0.3632675255144721,-0.08903677302285001
1050,6105,Trinity,California,2000,1932,3340,525,5797,0.3332758323270657,0.576160082801449,0.09056408487148525,0,0,0,0,0.0,0.0,0.0,-1408,0,-0.24288425047438333,0.0
1051,6105,Trinity,California,2004,2782,3560,171,6513,0.42714570858283435,0.546599109473361,0.0262551819438047,850,-354,220,716,0.09386987625576865,-0.06430890292768054,-0.029560973328088047,-778,630,-0.11945340089052664,0.1234308495838567
1052,6105,Trinity,California,2008,3233,2940,257,6430,0.5027993779160187,0.4572317262830482,0.03996889580093312,451,86,-620,-83,0.07565366933318435,0.013713713857128423,-0.08936738319031279,293,1071,0.045567651632970496,0.16502105252349714
1053,6105,Trinity,California,2012,2674,2716,349,5739,0.46593483185223905,0.47325317999651506,0.06081198815124586,-559,92,-224,-691,-0.036864546063779646,0.020843092350312738,0.01602145371346686,-42,-335,-0.00731834814427601,-0.052885999777246506
1054,6105,Trinity,California,2016,2214,2812,758,5784,0.38278008298755184,0.48616874135546334,0.1310511756569848,-460,409,96,45,-0.08315474886468721,0.07023918750573893,0.01291556135894828,-598,-556,-0.1033886583679115,-0.09607031022363549
1055,6107,Tulare,California,2000,33006,54070,2742,89818,0.3674764523814826,0.6019951457391615,0.030528401879356033,0,0,0,0,0.0,0.0,0.0,-21064,0,-0.2345186933576789,0.0
1056,6107,Tulare,California,2004,32494,65399,967,98860,0.32868703216670037,0.6615314586283634,0.009781509204936274,-512,-1775,11329,9042,-0.03878942021478221,-0.02074689267441976,0.059536312889201914,-32905,-11841,-0.332844426461663,-0.09832573310398413
1057,6107,Tulare,California,2008,43634,59765,2126,105525,0.4134944325989102,0.5663586827765932,0.020146884624496566,11140,1159,-5634,6665,0.08480740043220986,0.010365375419560292,-0.0951727758517702,-16131,16774,-0.15286425017768296,0.17998017628398005
1058,6107,Tulare,California,2012,41752,56956,2571,101279,0.4122473563127598,0.5623673219522309,0.025385321735009233,-1882,445,-2809,-4246,-0.0012470762861503948,0.005238437110512667,-0.0039913608243622445,-15204,927,-0.1501199656394711,0.0027442845382118497
1059,6107,Tulare,California,2016,47585,58299,8218,114102,0.41703914041822226,0.5109375821633275,0.07202327741845016,5833,5647,1343,12823,0.004791784105462438,0.046637955683440924,-0.05142973978890342,-10714,4490,-0.09389844174510525,0.056221523894365855
1060,6109,Tuolumne,California,2000,9359,13172,1196,23727,0.3944451468790829,0.5551481434652505,0.05040670965566654,0,0,0,0,0.0,0.0,0.0,-3813,0,-0.16070299658616766,0.0
1061,6109,Tuolumne,California,2004,10104,15745,386,26235,0.38513436249285304,0.6001524680769964,0.014713169430150563,745,-810,2573,2508,-0.009310784386229842,-0.03569354022551598,0.04500432461174586,-5641,-1828,-0.21501810558414336,-0.0543151089979757
1062,6109,Tuolumne,California,2008,11532,14988,783,27303,0.4223711680035161,0.5489506647621141,0.02867816723436985,1428,397,-757,1068,0.03723680551066305,0.013964997804219288,-0.05120180331488233,-3456,2185,-0.12657949675859798,0.08843860882554538
1063,6109,Tuolumne,California,2012,9998,13880,880,24758,0.4038290653526133,0.5606268680830438,0.035544066564342836,-1534,97,-1108,-2545,-0.01854210265090278,0.006865899329972985,0.011676203320929779,-3882,-426,-0.15679780273043054,-0.03021830597183256
1064,6109,Tuolumne,California,2016,9123,14551,2219,25893,0.35233460780906034,0.5619665546672846,0.08569883752365504,-875,1339,671,1135,-0.051494457543552974,0.0501547709593122,0.0013396865842407735,-5428,-1546,-0.20963194685822428,-0.05283414412779375
1065,6111,Ventura,California,2000,133258,136173,13261,282692,0.4713893566142657,0.48170093246359996,0.046909710922134334,0,0,0,0,0.0,0.0,0.0,-2915,0,-0.010311575849334287,0.0
1066,6111,Ventura,California,2004,148859,160314,4020,313193,0.47529478628194116,0.5118696778025051,0.012835535915553668,15601,-9241,24141,30501,0.0039054296676754863,-0.034074175006580665,0.03016874533890518,-11455,-8540,-0.03657489152056398,-0.026263315671229692
1067,6111,Ventura,California,2008,187601,145853,7587,341041,0.5500834210549465,0.4276699868930715,0.02224659205198202,38742,3567,-14461,27848,0.07478863477300529,0.00941105613642835,-0.08419969090943363,41748,53203,0.12241343416187495,0.15898832568243892
1068,6111,Ventura,California,2012,170929,147958,8825,327712,0.5215829752953813,0.4514878918074407,0.02692913289717801,-16672,1238,2105,-13329,-0.02850044575956512,0.004682540845195992,0.023817904914369192,22971,-18777,0.07009508348794063,-0.05231835067393431
1069,6111,Ventura,California,2016,194402,132323,29382,356107,0.5459089543311421,0.37158213682966074,0.0825089088391972,23473,20557,-15635,28395,0.024325979035760725,0.0555797759420192,-0.07990575497777996,62079,39108,0.17432681750148132,0.10423173401354069
1070,6113,Yolo,California,2000,33747,23057,4632,61436,0.5493033400612019,0.3753011263754151,0.07539553356338304,0,0,0,0,0.0,0.0,0.0,10690,0,0.17400221368578678,0.0
1071,6113,Yolo,California,2004,42885,28005,1379,72269,0.5934079619200487,0.38751055085859776,0.019081487221353555,9138,-3253,4948,10833,0.04410462185884689,-0.05631404634202948,0.012209424483182685,14880,4190,0.20589741106145099,0.03189519737566421
1072,6113,Yolo,California,2008,53488,24592,1669,79749,0.6707043348505938,0.30836750304079047,0.020928162108615783,10603,290,-3413,7480,0.07729637293054503,0.0018466748872622285,-0.07914304781780729,28896,14016,0.3623368318098033,0.15643942074835232
1073,6113,Yolo,California,2012,48715,23368,2588,74671,0.6523951734943955,0.312946123662466,0.034658702843138565,-4773,919,-1224,-5078,-0.01830916135619831,0.013730540734522782,0.004578620621675522,25347,-3549,0.3394490498319295,-0.022887781977873833
1074,6113,Yolo,California,2016,54752,20739,6599,82090,0.6669752710439761,0.25263734925082226,0.08038737970520161,6037,4011,-2629,7419,0.014580097549580673,0.04572867686206305,-0.06030877441164373,34013,8666,0.4143379217931539,0.0748888719612244
1075,6115,Yuba,California,2000,5546,9838,743,16127,0.3438953308116823,0.6100328641408818,0.04607180504743598,0,0,0,0,0.0,0.0,0.0,-4292,0,-0.2661375333291995,0.0
1076,6115,Yuba,California,2004,5687,12076,261,18024,0.3155237461162894,0.6699955614735907,0.01448069241011984,141,-482,2238,1897,-0.02837158469539286,-0.031591112637316135,0.05996269733270898,-6389,-2097,-0.3544718153573013,-0.08833428202810184
1077,6115,Yuba,California,2008,8866,12007,528,21401,0.4142797065557684,0.5610485491332181,0.024671744311013506,3179,267,-69,3377,0.09875596043947898,0.010191051900893665,-0.10894701234037263,-3141,3248,-0.1467688425774497,0.2077029727798516
1078,6115,Yuba,California,2012,7711,11275,775,19761,0.39021304589848693,0.5705682910783867,0.03921866302312636,-1155,247,-732,-1640,-0.02406666065728147,0.014546918712112857,0.00951974194516858,-3564,-423,-0.18035524517989976,-0.03358640260245005
1079,6115,Yuba,California,2016,7910,13170,1918,22998,0.3439429515610053,0.5726584920427863,0.08339855639620837,199,1143,1895,3237,-0.04627009433748164,0.04417989337308201,0.0020902009643996022,-5260,-1696,-0.228715540481781,-0.04836029530188124
1080,8001,Adams,Colorado,2000,54132,47561,6159,107852,0.5019100248488669,0.4409839409561251,0.057106034195007975,0,0,0,0,0.0,0.0,0.0,6571,0,0.060926083892741845,0.0
1081,8001,Adams,Colorado,2004,69122,65912,1643,136677,0.5057324933968407,0.4822464642917243,0.01202104231143499,14990,-4516,18351,28825,0.0038224685479737452,-0.045084991883572983,0.04126252333559921,3210,-3361,0.02348602910511638,-0.037440054787625465
1082,8001,Adams,Colorado,2008,93445,63976,3080,160501,0.5822082105407443,0.3986018778699198,0.019189911589335893,24323,1437,-1936,23824,0.07647571714390367,0.007168869277900903,-0.0836445864218045,29469,26259,0.18360633267082455,0.16012030356570817
1083,8001,Adams,Colorado,2012,100649,70972,5272,176893,0.5689823791783734,0.4012142933863974,0.029803327435229208,7204,2192,6996,16392,-0.013225831362370988,0.010613415845893315,0.0026124155164776175,29677,208,0.16776808579197594,-0.015838246878848605
1084,8001,Adams,Colorado,2016,96558,80082,17037,193677,0.49855171238711876,0.4134822410508217,0.08796604656205952,-4091,11765,9110,16784,-0.07043066679125459,0.05816271912683031,0.012267947664424295,16476,-13201,0.08506947133629705,-0.08269861445567889
1085,8003,Alamosa,Colorado,2000,2455,2857,347,5659,0.43382223007598514,0.5048595158155151,0.06131825410849973,0,0,0,0,0.0,0.0,0.0,-402,0,-0.07103728573953,0.0
1086,8003,Alamosa,Colorado,2004,3017,3179,83,6279,0.48049052396878483,0.5062908106386367,0.013218665392578436,562,-264,322,620,0.046668293892799695,-0.04809958871592129,0.0014312948231215428,-162,240,-0.025800286669851846,0.04523699906967815
1087,8003,Alamosa,Colorado,2008,3521,2635,130,6286,0.5601336302895323,0.41918549156856505,0.020680878141902642,504,47,-544,7,0.0796431063207475,0.007462212749324206,-0.08710531907007163,886,1048,0.1409481387209673,0.16674842539081913
1088,8003,Alamosa,Colorado,2012,3811,2705,199,6715,0.5675353685778108,0.4028294862248697,0.029635145197319433,290,69,70,429,0.007401738288278503,0.008954267055416791,-0.016356005343695357,1106,220,0.16470588235294115,0.02375774363197386
1089,8003,Alamosa,Colorado,2016,3189,3046,704,6939,0.45957630782533504,0.4389681510304078,0.1014555411442571,-622,505,341,224,-0.1079590607524758,0.07182039594693768,0.03613866480553812,143,-963,0.020608156794927224,-0.14409772555801392
1090,8005,Arapahoe,Colorado,2000,82614,97768,9560,189942,0.4349432984805888,0.5147255477988018,0.05033115372060945,0,0,0,0,0.0,0.0,0.0,-15154,0,-0.07978224931821293,0.0
1091,8005,Arapahoe,Colorado,2004,110262,119475,2628,232365,0.47452068943257375,0.51416951778452,0.011309792782906204,27648,-6932,21707,42423,0.039577390951984925,-0.039021360937703246,-0.0005560300142817276,-9213,5941,-0.039648828351946275,0.04013342096626665
1092,8005,Arapahoe,Colorado,2008,148224,113868,4064,266156,0.5569064759013511,0.4278242835029081,0.015269240595740844,37962,1436,-5607,33791,0.08238578646877737,0.0039594478128346395,-0.08634523428161195,34356,43569,0.12908219239844304,0.16873102075038932
1093,8005,Arapahoe,Colorado,2012,153905,125588,6023,285516,0.5390415948668376,0.43986326510598356,0.02109514002717886,5681,1959,11720,19360,-0.017864881034513558,0.005825899431438018,0.012038981603075483,28317,-6039,0.099178329760854,-0.02990386263758904
1094,8005,Arapahoe,Colorado,2016,159885,117053,26110,303048,0.5275896887621763,0.3862523428631768,0.08615796837464693,5980,20087,-8535,17532,-0.011451906104661291,0.06506282834746807,-0.05361092224280678,42832,14515,0.1413373458989995,0.04215901613814549
1095,8007,Archuleta,Colorado,2000,1432,2988,338,4758,0.30096679277007143,0.6279949558638083,0.07103825136612021,0,0,0,0,0.0,0.0,0.0,-1556,0,-0.32702816309373683,0.0
1096,8007,Archuleta,Colorado,2004,2141,3601,97,5839,0.36667237540674774,0.6167151909573557,0.016612433635896557,709,-241,613,1081,0.06570558263667631,-0.05442581773022366,-0.01127976490645255,-1460,96,-0.250042815550608,0.07698534754312886
1097,8007,Archuleta,Colorado,2008,2836,3638,151,6625,0.4280754716981132,0.5491320754716981,0.02279245283018868,695,54,37,786,0.06140309629136548,0.0061800191942921225,-0.06758311548565765,-802,658,-0.12105660377358485,0.12898621177702313
1098,8007,Archuleta,Colorado,2012,2679,3872,183,6734,0.3978318978318978,0.574992574992575,0.027175527175527174,-157,32,234,109,-0.0302435738662154,0.004383074345338495,0.02586049952087688,-1193,-391,-0.17716067716067713,-0.05610407338709228
1099,8007,Archuleta,Colorado,2016,2500,4264,575,7339,0.34064586455920426,0.5810055865921788,0.07834854884861697,-179,392,392,605,-0.05718603327269356,0.0511730216730898,0.006013011599603879,-1764,-571,-0.24035972203297457,-0.06319904487229744
1100,8009,Baca,Colorado,2000,531,1663,84,2278,0.233099209833187,0.7300263388937664,0.03687445127304653,0,0,0,0,0.0,0.0,0.0,-1132,0,-0.49692712906057945,0.0
1101,8009,Baca,Colorado,2004,483,1680,23,2186,0.22095150960658738,0.7685269899359561,0.010521500457456541,-48,-61,17,-92,-0.012147700226599611,-0.02635295081558999,0.03850065104218969,-1197,-65,-0.5475754803293688,-0.050648351268789304
1102,8009,Baca,Colorado,2008,536,1572,67,2175,0.2464367816091954,0.7227586206896551,0.030804597701149426,53,44,-108,-11,0.025485272002608028,0.020283097243692885,-0.04576836924630101,-1036,161,-0.4763218390804597,0.07125364124890904
1103,8009,Baca,Colorado,2012,467,1559,80,2106,0.22174738841405509,0.7402659069325735,0.03798670465337132,-69,13,-13,-69,-0.024689393195140324,0.007182106952221892,0.01750728624291842,-1092,-56,-0.5185185185185185,-0.04219667943805877
1104,8009,Baca,Colorado,2016,283,1753,117,2153,0.13144449605202044,0.8142127264282397,0.0543427775197399,-184,37,194,47,-0.09030289236203465,0.01635607286636858,0.07394681949566617,-1470,-378,-0.6827682303762193,-0.16424971185770076
1105,8011,Bent,Colorado,2000,783,1096,84,1963,0.3988792664289353,0.5583290881304126,0.04279164544065207,0,0,0,0,0.0,0.0,0.0,-313,0,-0.1594498217014773,0.0
1106,8011,Bent,Colorado,2004,785,1338,32,2155,0.3642691415313225,0.6208816705336427,0.014849187935034803,2,-52,242,192,-0.03461012489761278,-0.027942457505617264,0.06255258240323014,-553,-240,-0.25661252900232023,-0.09716270730084292
1107,8011,Bent,Colorado,2008,799,1077,44,1920,0.4161458333333333,0.5609375,0.022916666666666665,14,12,-261,-235,0.05187669180201082,0.008067478731631862,-0.05994417053364276,-278,275,-0.14479166666666665,0.11182086233565358
1108,8011,Bent,Colorado,2012,815,1075,52,1942,0.4196704428424305,0.5535530381050463,0.026776519052523172,16,8,-2,22,0.003524609509097165,0.003859852385856507,-0.0073844618949536756,-260,18,-0.1338825952626158,0.01090907140405084
1109,8011,Bent,Colorado,2016,590,1188,149,1927,0.3061754021795537,0.6165023352361183,0.07732226258432798,-225,97,113,-15,-0.1134950406628768,0.050545743531804806,0.062949297131072,-598,-338,-0.3103269330565646,-0.1764443377939488
1110,8013,Boulder,Colorado,2000,69983,50873,18770,139626,0.5012175382808359,0.36435191153510094,0.13443055018406314,0,0,0,0,0.0,0.0,0.0,19110,0,0.136865626745735,0.0
1111,8013,Boulder,Colorado,2004,105564,51586,2109,159259,0.662844799979907,0.32391262032287027,0.013242579697222763,35581,-16661,713,19633,0.16162726169907105,-0.12118797048684038,-0.040439291212230666,53978,34868,0.3389321796570367,0.2020665529113017
1112,8013,Boulder,Colorado,2008,124159,44904,2700,171763,0.7228506721470864,0.26142999365404657,0.015719334198867042,18595,591,-6682,12504,0.06000587216717945,0.0024767545016442793,-0.062482626668823704,79255,25277,0.46142067849303986,0.12248849883600316
1113,8013,Boulder,Colorado,2012,125091,49981,4427,179499,0.6968896762656059,0.27844723368932417,0.024663090045069887,932,1727,5077,7736,-0.025960995881480486,0.008943755846202845,0.017017240035277603,75110,-4145,0.41844244257628177,-0.04297823591675809
1114,8013,Boulder,Colorado,2016,132334,41396,14415,188145,0.7033617688484946,0.22002179170320763,0.07661643944829785,7243,9988,-8585,8646,0.006472092582888611,0.05195334940322796,-0.058425441986116544,90938,15828,0.4833399771452869,0.06489753456900516
1115,8014,Broomfield,Colorado,2004,10935,12007,293,23235,0.47062621045836023,0.5167635033354853,0.012610286206154508,0,0,0,0,0.0,0.0,0.0,-1072,0,-0.046137292877125036,0.0
1116,8014,Broomfield,Colorado,2008,16168,12757,528,29453,0.5489423827793434,0.4331307506875361,0.017926866533120565,5233,235,750,6218,0.07831617232098315,0.005316580326966056,-0.08363275264794917,3411,4483,0.11581163209180728,0.16194892496893232
1117,8014,Broomfield,Colorado,2012,16966,15008,891,32865,0.5162330746995284,0.4566560170394036,0.027110908261068007,798,363,2251,3412,-0.03270930807981498,0.009184041727947442,0.023525266351867524,1958,-1453,0.05957705766012478,-0.056234574431682505
1118,8014,Broomfield,Colorado,2016,19731,14367,3592,37690,0.5235075616874503,0.38118864420270626,0.09530379410984346,2765,2701,-641,4825,0.00727448698792188,0.06819288584877546,-0.07546737283669736,5364,3406,0.142318917484744,0.08274185982461923
1119,8015,Chaffee,Colorado,2000,2768,4300,542,7610,0.36373193166885676,0.5650459921156373,0.07122207621550591,0,0,0,0,0.0,0.0,0.0,-1532,0,-0.20131406044678057,0.0
1120,8015,Chaffee,Colorado,2004,3766,4875,129,8770,0.42941847206385403,0.5558722919042189,0.014709236031927024,998,-413,575,1160,0.06568654039499727,-0.05651284018357889,-0.00917370021141839,-1109,423,-0.1264538198403649,0.07486024060641566
1121,8015,Chaffee,Colorado,2008,4862,4873,186,9921,0.4900715653663945,0.491180324564056,0.01874811006954944,1096,57,-2,1151,0.060653093302540484,0.004038874037622417,-0.06469196734016291,-11,1098,-0.001108759197661513,0.1253450606427034
1122,8015,Chaffee,Colorado,2012,5086,5070,306,10462,0.4861403173389409,0.4846109730453068,0.029248709615752246,224,120,197,541,-0.003931248027453593,0.010500599546202805,-0.006569351518749211,16,27,0.001529344293634105,0.002638103491295618
1123,8015,Chaffee,Colorado,2016,4888,5391,971,11250,0.43448888888888887,0.4792,0.08631111111111112,-198,665,321,788,-0.05165142845005205,0.05706240149535887,-0.0054109730453067995,-503,-519,-0.044711111111111146,-0.04624045540474525
1124,8017,Cheyenne,Colorado,2000,209,957,46,1212,0.17244224422442245,0.7896039603960396,0.037953795379537955,0,0,0,0,0.0,0.0,0.0,-748,0,-0.6171617161716172,0.0
1125,8017,Cheyenne,Colorado,2004,198,923,13,1134,0.1746031746031746,0.8139329805996472,0.01146384479717813,-11,-33,-34,-78,0.002160930378752146,-0.026489950582359825,0.02432902020360761,-725,23,-0.6393298059964727,-0.02216808982485552
1126,8017,Cheyenne,Colorado,2008,198,890,23,1111,0.1782178217821782,0.8010801080108011,0.020702070207020702,0,10,-33,-23,0.003614647179003616,0.009238225409842572,-0.012852872588846154,-692,33,-0.6228622862286228,0.01646751976784988
1127,8017,Cheyenne,Colorado,2012,172,889,32,1093,0.15736505032021958,0.8133577310155535,0.0292772186642269,-26,9,-1,-18,-0.02085277146195863,0.008575148457206198,0.012277623004752436,-717,-25,-0.655992680695334,-0.03313039446671118
1128,8017,Cheyenne,Colorado,2016,132,925,45,1102,0.11978221415607986,0.8393829401088929,0.04083484573502722,-40,13,36,9,-0.037582836164139724,0.011557627070800321,0.026025209093339385,-793,-76,-0.7196007259528131,-0.0636080452574791
1129,8019,Clear Creek,Colorado,2000,2188,2247,489,4924,0.44435418359057677,0.456336311941511,0.09930950446791227,0,0,0,0,0.0,0.0,0.0,-59,0,-0.011982128350934207,0.0
1130,8019,Clear Creek,Colorado,2004,2989,2522,102,5613,0.5325138072332086,0.4493140922857652,0.018172100481026188,801,-387,275,689,0.08815962364263186,-0.08113740398688608,-0.007022219655745787,467,526,0.08319971494744344,0.09518184329837764
1131,8019,Clear Creek,Colorado,2008,3332,2300,135,5767,0.5777700710941565,0.3988208774059303,0.0234090514999133,343,33,-222,154,0.04525626386094783,0.005236951018887111,-0.05049321487983488,1032,565,0.17894919368822615,0.09574947874078271
1132,8019,Clear Creek,Colorado,2012,3119,2430,194,5743,0.5430959428869928,0.42312380289047535,0.03378025422253178,-213,59,130,-24,-0.034674128207163646,0.010371202722618482,0.024302925484545046,689,-343,0.11997213999651746,-0.05897705369170869
1133,8019,Clear Creek,Colorado,2016,2729,2575,562,5866,0.4652233208319127,0.4389703375383566,0.09580634162973065,-390,368,145,123,-0.07787262205508011,0.062026087407198865,0.015846534647881272,154,-535,0.026252983293556076,-0.09371915670296138
1134,8021,Conejos,Colorado,2000,1749,1772,150,3671,0.476436938163988,0.4827022609643149,0.040860800871697085,0,0,0,0,0.0,0.0,0.0,-23,0,-0.006265322800326878,0.0
1135,8021,Conejos,Colorado,2004,1894,1864,45,3803,0.4980278727320536,0.4901393636602682,0.011832763607678149,145,-105,92,132,0.0215909345680656,-0.029028037264018938,0.007437102695953324,30,53,0.007888509071785399,0.014153831872112277
1136,8021,Conejos,Colorado,2008,2154,1653,67,3874,0.5560144553433144,0.426690758905524,0.01729478575116159,260,22,-211,71,0.05798658261126077,0.0054620221434834425,-0.06344860475474423,501,471,0.1293236964377904,0.121435187366005
1137,8021,Conejos,Colorado,2012,2213,1835,53,4101,0.539624481833699,0.44745184101438673,0.012923677151914167,59,-14,182,227,-0.016389973509615352,-0.0043711085992474245,0.02076108210886274,378,-123,0.09217264081931231,-0.03715105561847809
1138,8021,Conejos,Colorado,2016,1771,1914,337,4022,0.44032819492789654,0.47588264545002484,0.08378915962207857,-442,284,79,-79,-0.0992962869058025,0.0708654824701644,0.028430804435638113,-143,-521,-0.0355544505221283,-0.1277270913414406
1139,8023,Costilla,Colorado,2000,1054,504,90,1648,0.6395631067961165,0.3058252427184466,0.05461165048543689,0,0,0,0,0.0,0.0,0.0,550,0,0.3337378640776699,0.0
1140,8023,Costilla,Colorado,2004,1170,566,24,1760,0.6647727272727273,0.3215909090909091,0.013636363636363636,116,-66,62,112,0.025209620476610795,-0.040975286849073256,0.015765666372462517,604,54,0.3431818181818182,0.009443954104148278
1141,8023,Costilla,Colorado,2008,1245,415,37,1697,0.7336476134354744,0.24454920447849146,0.021803182086034177,75,13,-151,-63,0.06887488616274706,0.008166818449670541,-0.07704170461241763,830,226,0.48909840895698287,0.14591659077516467
1142,8023,Costilla,Colorado,2012,1340,446,51,1837,0.7294501905280348,0.24278715296679368,0.027762656505171474,95,14,31,140,-0.004197422907439519,0.005959474419137297,-0.001762051511697782,894,64,0.4866630375612412,-0.002435371395741681
1143,8023,Costilla,Colorado,2016,1125,588,135,1848,0.6087662337662337,0.3181818181818182,0.07305194805194805,-215,84,142,11,-0.1206839567618011,0.04528929154677658,0.0753946652150245,537,-357,0.29058441558441556,-0.19607862197682563
1144,8025,Crowley,Colorado,2000,511,855,79,1445,0.35363321799307956,0.5916955017301038,0.05467128027681661,0,0,0,0,0.0,0.0,0.0,-344,0,-0.2380622837370242,0.0
1145,8025,Crowley,Colorado,2004,478,1006,9,1493,0.3201607501674481,0.6738111185532485,0.006028131279303416,-33,-70,151,48,-0.03347246782563146,-0.048643148997513194,0.08211561682314472,-528,-184,-0.3536503683858004,-0.11558808464877618
1146,8025,Crowley,Colorado,2008,552,976,30,1558,0.35430038510911427,0.6264441591784339,0.019255455712451863,74,21,-30,65,0.034139634941666164,0.013227324433148446,-0.04736695937481461,-424,104,-0.2721437740693196,0.08150659431648077
1147,8025,Crowley,Colorado,2012,535,924,43,1502,0.3561917443408788,0.6151797603195739,0.02862849533954727,-17,13,-52,-56,0.0018913592317645334,0.009373039627095407,-0.011264398858859992,-389,35,-0.2589880159786951,0.013155758090624525
1148,8025,Crowley,Colorado,2016,339,1079,109,1527,0.2220039292730845,0.7066142763588736,0.07138179436804191,-196,66,155,25,-0.1341878150677943,0.042753299028494646,0.09143451603929975,-740,-351,-0.48461034708578915,-0.22562233110709407
1149,8027,Custer,Colorado,2000,507,1451,153,2111,0.24017053529133112,0.6873519658929418,0.07247749881572714,0,0,0,0,0.0,0.0,0.0,-944,0,-0.44718143060161064,0.0
1150,8027,Custer,Colorado,2004,739,1657,32,2428,0.3043657331136738,0.6824546952224053,0.013179571663920923,232,-121,206,317,0.0641951978223427,-0.05929792715180622,-0.004897270670536469,-918,26,-0.3780889621087315,0.06909246849287914
1151,8027,Custer,Colorado,2008,912,1672,45,2629,0.3468999619627235,0.6359832635983264,0.017116774438950173,173,13,15,201,0.04253422884904967,0.00393720277502925,-0.04647143162407896,-760,158,-0.28908330163560286,0.08900566047312863
1152,8027,Custer,Colorado,2012,868,1788,59,2715,0.3197053406998158,0.6585635359116022,0.021731123388581953,-44,14,116,86,-0.02719462126290767,0.00461434894963178,0.022580272313275862,-920,-160,-0.3388581952117864,-0.04977489357618353
1153,8027,Custer,Colorado,2016,797,2061,208,3066,0.2599478147423353,0.6722113502935421,0.06784083496412263,-71,149,273,351,-0.05975752595748052,0.04610971157554068,0.013647814381939849,-1264,-344,-0.41226353555120676,-0.07340534033942037
1154,8029,Delta,Colorado,2000,3264,8372,1050,12686,0.25729150244363863,0.659940091439382,0.08276840611697935,0,0,0,0,0.0,0.0,0.0,-5108,0,-0.4026485889957434,0.0
1155,8029,Delta,Colorado,2004,4224,9722,213,14159,0.2983261529769051,0.6866304117522424,0.015043435270852461,960,-837,1350,1473,0.04103465053326649,-0.06772497084612689,0.02669032031286034,-5498,-390,-0.38830425877533725,0.014344330220406154
1156,8029,Delta,Colorado,2008,5084,10067,283,15434,0.329402617597512,0.6522612414150577,0.01833614098743035,860,70,345,1275,0.03107646462060687,0.003292705716577889,-0.034369170337184674,-4983,515,-0.3228586238175457,0.06544563495779154
1157,8029,Delta,Colorado,2012,4622,10915,388,15925,0.29023547880690737,0.6854003139717425,0.02436420722135008,-462,105,848,491,-0.03916713879060463,0.006028066233919729,0.0331390725566848,-6293,-1310,-0.39516483516483514,-0.07230621134728943
1158,8029,Delta,Colorado,2016,4087,11655,1048,16790,0.24341870160810006,0.6941631923764146,0.062418106015485406,-535,660,740,865,-0.04681677719880731,0.03805389879413533,0.008762878404672048,-7568,-1275,-0.45074449076831447,-0.05557965560347933
1159,8031,Denver,Colorado,2000,122693,61224,14430,198347,0.6185775433961693,0.30867116719688226,0.07275128940694843,0,0,0,0,0.0,0.0,0.0,61469,0,0.30990637619928707,0.0
1160,8031,Denver,Colorado,2004,166135,69903,2788,238826,0.6956319663688209,0.2926942627687103,0.01167377086246891,43442,-11642,8679,40479,0.07705442297265153,-0.06107751854447952,-0.015976904428171956,96232,34763,0.40293770360011055,0.09303132740082348
1161,8031,Denver,Colorado,2008,204882,62567,4084,271533,0.7545381224381567,0.230421348418056,0.01504052914378731,38747,1296,-7336,32707,0.0589061560693358,0.0033667582813184,-0.062272914350654296,142315,46083,0.5241167740201007,0.12117907041999015
1162,8031,Denver,Colorado,2012,222018,73111,7289,302418,0.7341428089597841,0.24175478972812464,0.024102401312091213,17136,3205,10544,30885,-0.020395313478372534,0.009061872168303902,0.011333441310068637,148907,6592,0.4923880192316595,-0.03172875478844123
1163,8031,Denver,Colorado,2016,244551,62690,24611,331852,0.7369279076214698,0.1889095138796813,0.07416257849884889,22533,17322,-10421,29434,0.0027850986616856366,0.050060177186757676,-0.05284527584844334,181861,32954,0.5480183937417884,0.05563037451012892
1164,8033,Dolores,Colorado,2000,293,741,100,1134,0.2583774250440917,0.6534391534391535,0.08818342151675485,0,0,0,0,0.0,0.0,0.0,-448,0,-0.39506172839506176,0.0
1165,8033,Dolores,Colorado,2004,333,785,29,1147,0.2903225806451613,0.6843940714908456,0.025283347863993024,40,-71,44,13,0.031945155601069586,-0.06290007365276182,0.03095491805169215,-452,-4,-0.3940714908456843,0.0009902375493774374
1166,8033,Dolores,Colorado,2008,369,818,30,1217,0.3032046014790468,0.6721446179129006,0.024650780608052588,36,1,33,70,0.01288202083388551,-0.0006325672559404361,-0.012249453577945046,-449,3,-0.36894001643385377,0.025131474411830557
1167,8033,Dolores,Colorado,2012,334,859,52,1245,0.26827309236947794,0.6899598393574298,0.04176706827309237,-35,22,41,28,-0.03493150910956888,0.017116287665039785,0.017815221444529183,-525,-76,-0.42168674698795183,-0.052746730554098065
1168,8033,Dolores,Colorado,2016,242,944,69,1255,0.19282868525896416,0.7521912350597609,0.0549800796812749,-92,17,85,10,-0.07544440711051378,0.013213011408182526,0.06223139570233116,-702,-177,-0.5593625498007968,-0.13767580281284497
1169,8035,Douglas,Colorado,2000,27076,56007,3142,86225,0.3140156567120905,0.6495447955929254,0.03643954769498405,0,0,0,0,0.0,0.0,0.0,-28931,0,-0.33552913888083497,0.0
1170,8035,Douglas,Colorado,2004,39661,80651,889,121201,0.32723327365285765,0.665431803367959,0.00733492297918334,12585,-2253,24644,34976,0.013217616940767174,-0.029104624715800713,0.0158870077750336,-40990,-12059,-0.3381985297151014,-0.0026693908342664274
1171,8035,Douglas,Colorado,2008,61960,88108,1751,151819,0.4081175610430842,0.5803489681792134,0.011533470777702396,22299,862,7457,30618,0.08088428739022657,0.004198547798519056,-0.0850828351887456,-26148,14842,-0.17223140713612922,0.16596712257897217
1172,8035,Douglas,Colorado,2012,61094,104397,2593,168084,0.3634730253920659,0.6211001642036125,0.015426810404321648,-866,842,16289,16265,-0.044644535651018336,0.003893339626619252,0.04075119602439903,-43303,-17155,-0.2576271388115466,-0.08539573167541736
1173,8035,Douglas,Colorado,2016,68657,102573,16270,187500,0.36617066666666664,0.547056,0.08677333333333333,7563,13677,-1824,19416,0.0026976412746007594,0.07134652292901168,-0.07404416420361248,-33916,9387,-0.18088533333333334,0.07674180547821324
1174,8037,Eagle,Colorado,2000,6772,7165,1251,15188,0.44587832499341584,0.4717540163286805,0.0823676586779036,0,0,0,0,0.0,0.0,0.0,-393,0,-0.025875691335264683,0.0
1175,8037,Eagle,Colorado,2004,9744,8533,234,18511,0.526389714223975,0.4609691534763114,0.012641132299713684,2972,-1017,1368,3323,0.08051138923055912,-0.06972652637818992,-0.010784862852369126,1211,1604,0.06542056074766356,0.09129625208292824
1176,8037,Eagle,Colorado,2008,13191,8181,286,21658,0.6090590082186721,0.3777357096684828,0.013205282112845138,3447,52,-352,3147,0.08266929399469714,0.0005641498131314544,-0.0832334438078286,5010,3799,0.2313232985501893,0.16590273780252573
1177,8037,Eagle,Colorado,2012,12792,9411,465,22668,0.5643197458973002,0.4151667548967708,0.020513499205929063,-399,179,1230,1010,-0.04473926232137193,0.007308217093083925,0.037431045228287996,3381,-1629,0.14915299100052937,-0.08217030754965993
1178,8037,Eagle,Colorado,2016,14099,8990,2134,25223,0.5589739523450818,0.35642072711414186,0.08460532054077627,1307,1669,-421,2555,-0.005345793552218314,0.0640918213348472,-0.05874602778262894,5109,1728,0.20255322523094,0.053400234230410626
1179,8039,Elbert,Colorado,2000,2326,6151,488,8965,0.25945343000557725,0.6861126603457892,0.05443390964863357,0,0,0,0,0.0,0.0,0.0,-3825,0,-0.42665923034021197,0.0
1180,8039,Elbert,Colorado,2004,2834,8389,141,11364,0.24938401971136923,0.7382083773319253,0.012407602956705385,508,-347,2238,2399,-0.01006941029420802,-0.04202630669192819,0.05209571698613613,-5555,-1730,-0.4888243576205561,-0.062165127280344123
1181,8039,Elbert,Colorado,2008,3819,9108,279,13206,0.28918673330304406,0.6896865061335756,0.02112676056338028,985,138,719,1842,0.03980271359167484,0.008719157606674896,-0.04852187119834972,-5289,266,-0.40049977283053156,0.08832458479002453
1182,8039,Elbert,Colorado,2012,3603,10266,309,14178,0.25412611087600506,0.7240795598815065,0.021794329242488364,-216,30,1158,972,-0.035060622427039,0.0006675686791080826,0.03439305374793089,-6663,-1374,-0.46995344900550146,-0.06945367617496989
1183,8039,Elbert,Colorado,2016,3134,11705,1141,15980,0.19612015018773468,0.7324780976220275,0.0714017521902378,-469,832,1439,1802,-0.05800596068827038,0.04960742294774943,0.008398537740521017,-8571,-1908,-0.5363579474342929,-0.06640449842879143
1184,8041,El Paso,Colorado,2000,61799,128294,10664,200757,0.30782986396489287,0.6390511912411523,0.05311894479395488,0,0,0,0,0.0,0.0,0.0,-66495,0,-0.3312213272762594,0.0
1185,8041,El Paso,Colorado,2004,77648,161361,2779,241788,0.3211408341191457,0.6673656260856619,0.011493539795192482,15849,-7885,33067,41031,0.01331097015425281,-0.0416254049987624,0.028314434844509573,-83713,-17218,-0.3462247919665162,-0.015003464690256763
1186,8041,El Paso,Colorado,2008,108899,160318,3958,273175,0.39864189622037155,0.5868692230255331,0.01448888075409536,31251,1179,-1043,31387,0.07750106210122587,0.002995340958902878,-0.08049640306012873,-51419,32294,-0.18822732680516158,0.1579974651613546
1187,8041,El Paso,Colorado,2012,111819,170952,7404,290175,0.38535021969501165,0.5891341431894547,0.02551563711553373,2920,3446,10634,17000,-0.013291676525359897,0.01102675636143837,0.0022649201639215466,-59133,-7714,-0.20378392349444302,-0.015556596689281443
1188,8041,El Paso,Colorado,2016,108010,179228,31730,318968,0.3386233101753154,0.5618996262948007,0.09947706352988388,-3809,24326,8276,28793,-0.04672690951969627,0.07396142641435015,-0.02723451689465395,-71218,-12085,-0.22327631611948534,-0.01949239262504232
1189,8043,Fremont,Colorado,2000,5293,9914,849,16056,0.3296586945690085,0.6174638764324863,0.052877428998505234,0,0,0,0,0.0,0.0,0.0,-4621,0,-0.28780518186347787,0.0
1190,8043,Fremont,Colorado,2004,5933,12313,280,18526,0.32025261794235127,0.6646334880708193,0.015113893986829321,640,-569,2399,2470,-0.009406076626657212,-0.03776353501167591,0.047169611638333,-6380,-1759,-0.3443808701284681,-0.05657568826499021
1191,8043,Fremont,Colorado,2008,6844,12668,407,19919,0.34359154576032935,0.6359757015914453,0.020432752648225312,911,127,355,1393,0.023338927817978083,0.005318858661395991,-0.028657786479374003,-5824,556,-0.292384155831116,0.05199671429735209
1192,8043,Fremont,Colorado,2012,6704,13174,538,20416,0.3283699059561129,0.6452782131661442,0.026351880877742945,-140,131,506,497,-0.01522163980421648,0.005919128229517633,0.009302511574698857,-6470,-646,-0.3169083072100313,-0.024524151378915338
1193,8043,Fremont,Colorado,2016,5297,15122,1554,21973,0.2410685841714832,0.6882082555864015,0.07072316024211532,-1407,1016,1948,1557,-0.08730132178462968,0.04437127936437238,0.04293004242025733,-9825,-3355,-0.44713967141491834,-0.130231364204887
1194,8045,Garfield,Colorado,2000,6087,9103,1914,17104,0.3558816651075772,0.5322146866230122,0.11190364826941067,0,0,0,0,0.0,0.0,0.0,-3016,0,-0.176333021515435,0.0
1195,8045,Garfield,Colorado,2004,9228,11123,296,20647,0.446941444277619,0.538722332542258,0.014336223180123021,3141,-1618,2020,3543,0.09105977917004182,-0.09756742508928765,0.006507645919245797,-1895,1121,-0.09178088826463898,0.08455213325079602
1196,8045,Garfield,Colorado,2008,11357,11359,366,23082,0.49202842041417555,0.4921150680183693,0.01585651156745516,2129,70,236,2435,0.045086976136556545,0.0015202883873321384,-0.04660726452388869,-2,1893,-8.664760419374584e-05,0.09169424066044524
1197,8045,Garfield,Colorado,2012,11305,12535,568,24408,0.46316781383153066,0.5135611274991806,0.023271058669288757,-52,202,1176,1326,-0.028860606582644888,0.007414547101833598,0.021446059480811297,-1230,-1228,-0.05039331366764993,-0.050306666063456185
1198,8045,Garfield,Colorado,2016,11271,13132,2067,26470,0.4258027956176804,0.4961088024178315,0.0780884019644881,-34,1499,597,2062,-0.03736501821385024,0.05481734329519934,-0.017452325081349085,-1861,-631,-0.07030600680015109,-0.019912693132501158
1199,8047,Gilpin,Colorado,2000,1099,1006,360,2465,0.445841784989858,0.4081135902636917,0.1460446247464503,0,0,0,0,0.0,0.0,0.0,93,0,0.037728194726166286,0.0
1200,8047,Gilpin,Colorado,2004,1807,1329,60,3196,0.5653942428035044,0.4158322903629537,0.01877346683354193,708,-300,323,731,0.11955245781364637,-0.12727115791290838,0.00771870009926201,478,385,0.14956195244055065,0.11183375771438436
1201,8047,Gilpin,Colorado,2008,1990,1283,96,3369,0.5906797269219353,0.38082517067379046,0.028495102404274265,183,36,-46,173,0.0252854841184309,0.009721635570732336,-0.03500711968916326,707,229,0.2098545562481448,0.06029260380759416
1202,8047,Gilpin,Colorado,2012,1892,1346,100,3338,0.566806470940683,0.40323547034152185,0.029958058717795086,-98,4,63,-31,-0.023873255981252228,0.0014629563135208218,0.022410299667731393,546,-161,0.1635710005991612,-0.04628355564898362
1203,8047,Gilpin,Colorado,2016,1634,1566,376,3576,0.4569351230425056,0.43791946308724833,0.10514541387024609,-258,276,220,238,-0.10987134789817743,0.07518735515245101,0.03468399274572648,68,-478,0.01901565995525728,-0.1445553406439039
1204,8049,Grand,Colorado,2000,2308,3570,475,6353,0.3632929324728475,0.5619392413033213,0.07476782622383125,0,0,0,0,0.0,0.0,0.0,-1262,0,-0.1986463088304738,0.0
1205,8049,Grand,Colorado,2004,3243,4260,106,7609,0.42620580891050075,0.5598633197529241,0.013930871336575109,935,-369,690,1256,0.06291287643765325,-0.06083695488725614,-0.002075921550397153,-1017,245,-0.1336575108424234,0.0649887979880504
1206,8049,Grand,Colorado,2008,4037,4128,144,8309,0.485858707425683,0.4968106872066434,0.017330605367673606,794,38,-132,700,0.05965289851518224,0.003399734031098497,-0.06305263254628074,-91,926,-0.010951979780960408,0.12270553106146298
1207,8049,Grand,Colorado,2012,3684,4253,250,8187,0.44998167827042873,0.519482105777452,0.030536215952119212,-353,106,125,-122,-0.03587702915525426,0.013205610584445606,0.02267141857080862,-569,-478,-0.06950042750702329,-0.05854844772606288
1208,8049,Grand,Colorado,2016,3358,4494,736,8588,0.3910107126222636,0.5232883092687471,0.08570097810898929,-326,486,241,401,-0.05897096564816512,0.05516476215687008,0.0038062034912951237,-1136,-567,-0.13227759664648353,-0.06277716913946024
1209,8051,Gunnison,Colorado,2000,3059,3128,1049,7236,0.42274737423991154,0.43228302929795465,0.14496959646213378,0,0,0,0,0.0,0.0,0.0,-69,0,-0.009535655058043102,0.0
1210,8051,Gunnison,Colorado,2004,4782,3479,159,8420,0.5679334916864608,0.4131828978622328,0.018883610451306414,1723,-890,351,1184,0.14518611744654925,-0.12608598601082738,-0.019100131435721868,1303,1372,0.154750593824228,0.1642862488822711
1211,8051,Gunnison,Colorado,2008,5557,3131,183,8871,0.6264231766429941,0.3529478074625183,0.020629015894487658,775,24,-348,451,0.05848968495653328,0.0017454054431812437,-0.060235090399714475,2426,1123,0.27347536918047577,0.11872477535624776
1212,8051,Gunnison,Colorado,2012,5044,3341,282,8667,0.581977616245529,0.3854851736471674,0.032537210107303566,-513,99,210,-204,-0.044445560397465056,0.011908194212815908,0.032537366184649086,1703,-723,0.19649244259836163,-0.07698292658211414
1213,8051,Gunnison,Colorado,2016,5128,3289,995,9412,0.5448363790905227,0.3494475138121547,0.10571610709732257,84,713,-52,745,-0.03714123715500628,0.073178896990019,-0.03603765983501267,1839,136,0.19538886527836802,-0.0011035773199936094
1214,8053,Hinsdale,Colorado,2000,188,316,62,566,0.3321554770318021,0.558303886925795,0.10954063604240283,0,0,0,0,0.0,0.0,0.0,-128,0,-0.22614840989399293,0.0
1215,8053,Hinsdale,Colorado,2004,236,355,11,602,0.3920265780730897,0.5897009966777409,0.018272425249169437,48,-51,39,36,0.05987110104128762,-0.09126821079323338,0.03139710975194587,-119,9,-0.19767441860465118,0.02847399128934175
1216,8053,Hinsdale,Colorado,2008,240,344,15,599,0.4006677796327212,0.5742904841402338,0.025041736227045076,4,4,-11,-3,0.008641201559631495,0.006769310977875639,-0.015410512537507137,-104,15,-0.17362270450751255,0.024051714097138632
1217,8053,Hinsdale,Colorado,2012,229,353,18,600,0.38166666666666665,0.5883333333333334,0.03,-11,3,9,1,-0.019001112966054556,0.004958263772954923,0.014042849193099616,-124,-20,-0.20666666666666672,-0.03304396215915417
1218,8053,Hinsdale,Colorado,2016,197,339,53,589,0.33446519524617996,0.5755517826825127,0.0899830220713073,-32,35,-14,-11,-0.047201471420486696,0.059983022071307304,-0.01278155065082065,-142,-18,-0.24108658743633277,-0.034419920769666046
1219,8055,Huerfano,Colorado,2000,1495,1466,213,3174,0.47101449275362317,0.461877756773787,0.0671077504725898,0,0,0,0,0.0,0.0,0.0,29,0,0.009136735979836164,0.0
1220,8055,Huerfano,Colorado,2004,1656,1701,39,3396,0.4876325088339223,0.5008833922261484,0.011484098939929329,161,-174,235,222,0.016618016080299114,-0.05562365153266047,0.03900563545236141,-45,-74,-0.013250883392226132,-0.022387619372062295
1221,8055,Huerfano,Colorado,2008,1989,1580,74,3643,0.5459785890749382,0.4337084820203129,0.020312928904748832,333,35,-121,247,0.05834608024101595,0.008828829964819504,-0.06717491020583549,409,454,0.11227010705462531,0.12552099044685144
1222,8055,Huerfano,Colorado,2012,1953,1646,124,3723,0.5245769540692989,0.44211657265645987,0.0333064732742412,-36,50,66,80,-0.021401635005639297,0.01299354436949237,0.008408090636146948,307,-102,0.08246038141283907,-0.029809725641786244
1223,8055,Huerfano,Colorado,2016,1633,1883,267,3783,0.4316679883690193,0.4977531060005287,0.07057890563045202,-320,143,237,60,-0.09290896570027962,0.03727243235621082,0.05563653334406882,-250,-557,-0.06608511763150937,-0.14854549904434844
1224,8057,Jackson,Colorado,2000,173,682,70,925,0.18702702702702703,0.7372972972972973,0.07567567567567568,0,0,0,0,0.0,0.0,0.0,-509,0,-0.5502702702702703,0.0
1225,8057,Jackson,Colorado,2004,210,710,14,934,0.22483940042826553,0.7601713062098501,0.014989293361884369,37,-56,28,9,0.0378123734012385,-0.06068638231379131,0.022874008912552757,-500,9,-0.5353319057815845,0.014938364488685796
1226,8057,Jackson,Colorado,2008,277,624,13,914,0.30306345733041573,0.6827133479212254,0.014223194748358862,67,-1,-86,-20,0.0782240569021502,-0.0007660986135255062,-0.07745795828862467,-347,153,-0.37964989059080967,0.15568201519077485
1227,8057,Jackson,Colorado,2012,216,600,32,848,0.25471698113207547,0.7075471698113207,0.03773584905660377,-61,19,-24,-66,-0.04834647619834026,0.02351265430824491,0.02483382189009531,-384,-37,-0.45283018867924524,-0.07318029808843557
1228,8057,Jackson,Colorado,2016,171,629,61,861,0.1986062717770035,0.7305458768873403,0.07084785133565621,-45,29,29,13,-0.05611070935507198,0.03311200227905244,0.022998707076019587,-458,-74,-0.5319396051103368,-0.07910941643109154
1229,8059,Jefferson,Colorado,2000,100970,120138,14383,235491,0.4287637319472931,0.5101596239346726,0.061076644118034235,0,0,0,0,0.0,0.0,0.0,-19168,0,-0.08139589198737951,0.0
1230,8059,Jefferson,Colorado,2004,126558,140644,4366,271568,0.4660269251163613,0.5178960702291875,0.016077004654451187,25588,-10017,20506,36077,0.037263193169068176,-0.04499963946358305,0.007736446294514865,-14086,5082,-0.0518691451128262,0.02952674687455331
1231,8059,Jefferson,Colorado,2008,158158,131628,5282,295068,0.5360052598045196,0.4460937817723372,0.01790095842314314,31600,916,-9016,23500,0.06997833468815834,0.0018239537686919535,-0.07180228845685027,26530,40616,0.08991147803218241,0.1417806231450086
1232,8059,Jefferson,Colorado,2012,159296,144197,7559,311052,0.5121201599732521,0.46357843704589585,0.024301402980852076,1138,2277,12569,15984,-0.02388509983126752,0.006400444557708936,0.017484655273558636,15099,-11431,0.04854172292735626,-0.041369755104826156
1233,8059,Jefferson,Colorado,2016,160776,138177,29930,328883,0.48885469908751744,0.4201402930525445,0.09100500785993804,1480,22371,-6020,17831,-0.023265460885734668,0.06670360487908596,-0.04343814399335133,22599,7500,0.06871440603497292,0.020172683107616662
1234,8061,Kiowa,Colorado,2000,211,728,29,968,0.21797520661157024,0.7520661157024794,0.029958677685950414,0,0,0,0,0.0,0.0,0.0,-517,0,-0.5340909090909092,0.0
1235,8061,Kiowa,Colorado,2004,172,712,8,892,0.19282511210762332,0.7982062780269058,0.008968609865470852,-39,-21,-16,-76,-0.025150094503946924,-0.02099006782047956,0.046140162324426415,-540,-23,-0.6053811659192825,-0.07129025682837331
1236,8061,Kiowa,Colorado,2008,178,650,24,852,0.20892018779342722,0.7629107981220657,0.028169014084507043,6,16,-62,-40,0.0160950756858039,0.01920040421903619,-0.035295479904840055,-472,68,-0.5539906103286385,0.05139055559064398
1237,8061,Kiowa,Colorado,2012,118,677,26,821,0.14372716199756394,0.8246041412911084,0.031668696711327646,-60,2,27,-31,-0.06519302579586328,0.003499682626820603,0.061693343169042625,-559,-87,-0.6808769792935444,-0.1268863689649059
1238,8061,Kiowa,Colorado,2016,91,728,36,855,0.1064327485380117,0.8514619883040936,0.042105263157894736,-27,10,51,34,-0.03729441345955224,0.01043656644656709,0.026857847012985214,-637,-78,-0.7450292397660819,-0.06415226047253753
1239,8063,Kit Carson,Colorado,2000,809,2542,107,3458,0.23395026026604973,0.735106998264893,0.030942741469057258,0,0,0,0,0.0,0.0,0.0,-1733,0,-0.5011567379988433,0.0
1240,8063,Kit Carson,Colorado,2004,729,2721,52,3502,0.20816676185037122,0.7769845802398629,0.014848657909765849,-80,-55,179,44,-0.025783498415678507,-0.016094083559291407,0.041877581974969935,-1992,-259,-0.5688178183894917,-0.06766108039064844
1241,8063,Kit Carson,Colorado,2008,912,2455,75,3442,0.26496223126089485,0.7132481115630448,0.02178965717606043,183,23,-266,-60,0.05679546941052363,0.006940999266294582,-0.06373646867681815,-1543,449,-0.44828588030214994,0.1205319380873418
1242,8063,Kit Carson,Colorado,2012,838,2785,79,3702,0.22636412749864937,0.7522960561858455,0.021339816315505133,-74,4,330,260,-0.038598103762245484,-0.0004498408605552971,0.0390479446228007,-1947,-404,-0.5259319286871962,-0.07764604838504624
1243,8063,Kit Carson,Colorado,2016,536,2967,199,3702,0.14478660183684494,0.8014586709886548,0.05375472717450027,-302,120,182,0,-0.08157752566180443,0.03241491085899514,0.04916261480280926,-2431,-484,-0.6566720691518098,-0.13074014046461357
1244,8065,Lake,Colorado,2000,1296,1056,276,2628,0.4931506849315068,0.4018264840182648,0.1050228310502283,0,0,0,0,0.0,0.0,0.0,240,0,0.091324200913242,0.0
1245,8065,Lake,Colorado,2004,1623,1261,65,2949,0.5503560528992879,0.4276025771447948,0.02204136995591726,327,-211,205,321,0.057205367967781084,-0.08298146109431104,0.02577609312653001,362,122,0.12275347575449308,0.031429274841251076
1246,8065,Lake,Colorado,2008,1859,1078,65,3002,0.6192538307794804,0.35909393737508327,0.021652231845436375,236,0,-183,53,0.06889777788019247,-0.00038913811048088554,-0.06850863976971155,781,419,0.2601598934043971,0.13740641764990402
1247,8065,Lake,Colorado,2012,1839,1098,103,3040,0.6049342105263158,0.3611842105263158,0.03388157894736842,-20,38,20,38,-0.014319620253164578,0.012229347101932048,0.0020902731512325023,741,-40,0.24375000000000002,-0.01640989340439708
1248,8065,Lake,Colorado,2016,1616,1270,313,3199,0.5051578618318224,0.39699906220693965,0.09784307596123788,-223,210,172,159,-0.09977634869449337,0.06396149701386947,0.03581485168062387,346,-395,0.10815879962488278,-0.13559120037511724
1249,8067,La Plata,Colorado,2000,7864,9993,2633,20490,0.38379697413372377,0.487701317715959,0.12850170815031722,0,0,0,0,0.0,0.0,0.0,-2129,0,-0.10390434358223521,0.0
1250,8067,La Plata,Colorado,2004,13409,11704,400,25513,0.5255751969584134,0.4587465213812566,0.01567828166033003,5545,-2233,1711,5023,0.1417782228246896,-0.1128234264899872,-0.028954796334702382,1705,3834,0.06682867557715677,0.17073301915939199
1251,8067,La Plata,Colorado,2008,16057,11503,419,27979,0.573894706744344,0.4111297759033561,0.01497551735229994,2648,19,-201,2466,0.04831950978593058,-0.0007027643080300891,-0.04761674547790051,4554,2849,0.16276493084098786,0.0959362552638311
1252,8067,La Plata,Colorado,2012,15489,12794,1025,29308,0.5284905145352805,0.43653609935853693,0.03497338610618261,-568,606,1291,1329,-0.04540419220906344,0.019997868753882674,0.025406323455180846,2695,-1859,0.09195441517674358,-0.07081051566424429
1253,8067,La Plata,Colorado,2016,15525,12587,3038,31150,0.4983948635634029,0.40407704654895665,0.09752808988764045,36,2013,-207,1842,-0.030095650971877608,0.06255470378145783,-0.03245905280958028,2938,243,0.09431781701444625,0.002363401837702672
1254,8069,Larimer,Colorado,2000,46055,62429,10053,118537,0.38852847634072063,0.5266625610568851,0.08480896260239419,0,0,0,0,0.0,0.0,0.0,-16374,0,-0.1381340847161645,0.0
1255,8069,Larimer,Colorado,2004,68266,75884,2286,146436,0.4661831789996995,0.5182059056516157,0.015610915348684749,22211,-7767,13455,27899,0.07765470265897889,-0.06919804725370944,-0.008456655405269409,-7618,8756,-0.05202272665191621,0.0861113580642483
1256,8069,Larimer,Colorado,2008,89823,73642,2910,166375,0.5398827948910594,0.4426265965439519,0.01749060856498873,21557,624,-2242,19939,0.07369961589135987,0.0018796932163039817,-0.0755793091076638,16181,23799,0.09725619834710747,0.14927892499902368
1257,8069,Larimer,Colorado,2012,92747,82376,5057,180180,0.5147463647463647,0.45718725718725717,0.028066378066378066,2924,2147,8734,13805,-0.025136430144694688,0.010575769501389335,0.014560660643305245,10371,-5810,0.057559107559107536,-0.039697090787999934
1258,8069,Larimer,Colorado,2016,93113,83430,19438,195981,0.47511238334328326,0.4257045325822401,0.09918308407447661,366,14381,1054,15801,-0.03963398140308144,0.07111670600809855,-0.031482724605017054,9683,-688,0.04940785076104315,-0.008151256798064388
1259,8071,Las Animas,Colorado,2000,3243,2569,282,6094,0.5321627830653102,0.42156219232031505,0.04627502461437479,0,0,0,0,0.0,0.0,0.0,674,0,0.11060059074499512,0.0
1260,8071,Las Animas,Colorado,2004,3300,3196,96,6592,0.5006067961165048,0.4848300970873786,0.014563106796116505,57,-186,627,498,-0.03155598694880535,-0.03171191781825829,0.06326790476706357,104,-570,0.015776699029126207,-0.09482389171586891
1261,8071,Las Animas,Colorado,2008,3562,3086,113,6761,0.5268451412512942,0.45644135482916726,0.01671350391953853,262,17,-110,169,0.026238345134789398,0.0021503971234220244,-0.028388742258211364,476,372,0.07040378642212697,0.05462708739300076
1262,8071,Las Animas,Colorado,2012,3445,3263,154,6862,0.5020402215097639,0.475517341882833,0.02244243660740309,-117,41,177,101,-0.024804919741530318,0.0057289326878645595,0.019075987053665755,182,-294,0.026522879626930895,-0.04388090679519607
1263,8071,Las Animas,Colorado,2016,2650,3710,433,6793,0.390107463565435,0.546150448991609,0.06374208744295598,-795,279,447,-69,-0.11193275794432889,0.04129965083555289,0.07063310710877602,-1060,-1242,-0.156042985426174,-0.1825658650531049
1264,8073,Lincoln,Colorado,2000,510,1630,59,2199,0.23192360163710776,0.7412460209185994,0.026830377444292862,0,0,0,0,0.0,0.0,0.0,-1120,0,-0.5093224192814916,0.0
1265,8073,Lincoln,Colorado,2004,503,1819,15,2337,0.21523320496362858,0.7783483097988875,0.006418485237483954,-7,-44,189,138,-0.016690396673479185,-0.020411892206808908,0.0371022888802881,-1316,-196,-0.563115104835259,-0.05379268555376737
1266,8073,Lincoln,Colorado,2008,546,1717,41,2304,0.23697916666666666,0.7452256944444444,0.017795138888888888,43,26,-102,-33,0.02174596170303808,0.011376653651404934,-0.03312261535444305,-1171,145,-0.5082465277777778,0.05486857705748116
1267,8073,Lincoln,Colorado,2012,552,1687,48,2287,0.24136423261915171,0.7376475732400525,0.020988194140795804,6,7,-30,-17,0.004385065952485057,0.0031930552519069157,-0.007578121204391941,-1135,36,-0.49628334062090074,0.011963187156877053
1268,8073,Lincoln,Colorado,2016,409,1892,135,2436,0.16789819376026272,0.7766830870279147,0.05541871921182266,-143,87,205,149,-0.073466038858889,0.034430525071026855,0.039035513787862186,-1483,-348,-0.608784893267652,-0.11250155264675121
1269,8075,Logan,Colorado,2000,2296,5531,269,8096,0.283596837944664,0.6831768774703557,0.03322628458498024,0,0,0,0,0.0,0.0,0.0,-3235,0,-0.3995800395256917,0.0
1270,8075,Logan,Colorado,2004,2491,6168,107,8766,0.284166096281086,0.70362765229295,0.012206251425963951,195,-162,637,670,0.0005692583364220183,-0.021020033159016287,0.020450774822594275,-3677,-442,-0.41946155601186397,-0.019881516486172257
1271,8075,Logan,Colorado,2008,2846,6002,129,8977,0.3170324161746686,0.6685975270134789,0.014370056811852511,355,22,-166,211,0.032866319893582574,0.0021638053858885602,-0.035030125279471136,-3156,521,-0.35156511083881026,0.06789644517305371
1272,8075,Logan,Colorado,2012,2712,6179,233,9124,0.29723805348531346,0.677224901359053,0.025537045155633493,-134,104,177,147,-0.01979436268935514,0.011166988343780982,0.008627374345574146,-3467,-311,-0.37998684787373954,-0.028421737034929284
1273,8075,Logan,Colorado,2016,1851,7282,589,9722,0.19039292326681753,0.7490228348076527,0.060584241925529726,-861,356,1103,598,-0.10684513021849593,0.03504719676989623,0.07179793344859975,-5431,-1964,-0.5586299115408352,-0.17864306366709565
1274,8077,Mesa,Colorado,2000,15465,32396,3193,51054,0.3029145610530027,0.6345438163513143,0.06254162259568301,0,0,0,0,0.0,0.0,0.0,-16931,0,-0.3316292552983116,0.0
1275,8077,Mesa,Colorado,2004,19564,41539,782,61885,0.31613476609840835,0.6712288923002343,0.012636341601357357,4099,-2411,9143,10831,0.013220205045405664,-0.04990528099432565,0.03668507594892001,-21975,-5044,-0.35509412620182595,-0.023464870903514345
1276,8077,Mesa,Colorado,2008,24008,44578,1045,69631,0.3447889589407017,0.640203357699875,0.015007683359423245,4444,263,3039,7746,0.02865419284229337,0.0023713417580658886,-0.031025534600359284,-20570,1405,-0.2954143987591733,0.05967972744265265
1277,8077,Mesa,Colorado,2012,23846,47472,1629,72947,0.32689486887740415,0.6507738495071764,0.022331281615419415,-162,584,2894,3316,-0.017894090063297563,0.007323598255996169,0.010570491807301408,-23626,-3056,-0.3238789806297723,-0.02846458187059897
1278,8077,Mesa,Colorado,2016,21729,49779,6146,77654,0.27981816776985086,0.6410358770958354,0.07914595513431374,-2117,4517,2307,4707,-0.0470767011075533,0.056814673518894326,-0.009737972411341,-28050,-4424,-0.36121770932598457,-0.0373387286962123
1279,8079,Mineral,Colorado,2000,168,294,24,486,0.345679012345679,0.6049382716049383,0.04938271604938271,0,0,0,0,0.0,0.0,0.0,-126,0,-0.2592592592592593,0.0
1280,8079,Mineral,Colorado,2004,227,383,9,619,0.3667205169628433,0.6187399030694669,0.014539579967689823,59,-15,89,133,0.02104150461716431,-0.03484313608169289,0.013801631464528619,-156,-30,-0.2520193861066236,0.00723987315263569
1281,8079,Mineral,Colorado,2008,270,334,19,623,0.4333868378812199,0.536115569823435,0.030497592295345103,43,10,-49,4,0.0666663209183766,0.01595801232765528,-0.08262433324603191,-64,92,-0.1027287319422151,0.1492906541644085
1282,8079,Mineral,Colorado,2012,291,344,15,650,0.44769230769230767,0.5292307692307693,0.023076923076923078,21,-4,10,27,0.014305469811087768,-0.007420669218422025,-0.0068848005926657185,-53,11,-0.08153846153846162,0.021190270403753486
1283,8079,Mineral,Colorado,2016,237,344,71,652,0.36349693251533743,0.5276073619631901,0.10889570552147239,-54,56,0,2,-0.08419537517697023,0.08581878244454931,-0.0016234072675791467,-107,-54,-0.1641104294478527,-0.08257196790939109
1284,8081,Moffat,Colorado,2000,1223,3840,274,5337,0.22915495596777216,0.7195053400786959,0.05133970395353195,0,0,0,0,0.0,0.0,0.0,-2617,0,-0.4903503841109238,0.0
1285,8081,Moffat,Colorado,2004,1355,4247,123,5725,0.2366812227074236,0.7418340611353712,0.02148471615720524,132,-151,407,388,0.007526266739651427,-0.02985498779632671,0.02232872105667527,-2892,-275,-0.5051528384279476,-0.014802454317023761
1286,8081,Moffat,Colorado,2008,1582,4135,154,5871,0.2694600579117697,0.7043093169817748,0.02623062510645546,227,31,-112,146,0.0327788352043461,0.00474590894925022,-0.03752474415359641,-2553,339,-0.4348492590700051,0.07030357935794246
1287,8081,Moffat,Colorado,2012,1330,4695,143,6168,0.21562905317769132,0.7611867704280155,0.023184176394293127,-252,-11,560,297,-0.05383100473407837,-0.003046448712162333,0.05687745344624073,-3365,-812,-0.5455577172503242,-0.1107084581803191
1288,8081,Moffat,Colorado,2016,874,5305,346,6525,0.1339463601532567,0.8130268199233717,0.053026819923371646,-456,203,610,357,-0.08168269302443462,0.02984264352907852,0.051840049495356144,-4431,-1066,-0.679080459770115,-0.1335227425197908
1289,8083,Montezuma,Colorado,2000,2556,6158,670,9384,0.27237851662404094,0.6562233589087809,0.07139812446717818,0,0,0,0,0.0,0.0,0.0,-3602,0,-0.38384484228474,0.0
1290,8083,Montezuma,Colorado,2004,3867,6988,160,11015,0.3510667271901952,0.6344076259645938,0.014525646845211076,1311,-510,830,1631,0.07868821056615427,-0.0568724776219671,-0.02181573294418715,-3121,481,-0.28334089877439855,0.10050394351034142
1291,8083,Montezuma,Colorado,2008,4661,6961,203,11825,0.39416490486257927,0.5886680761099365,0.017167019027484142,794,43,-27,810,0.04309817767238405,0.002641372182273066,-0.045739549854657224,-2300,821,-0.19450317124735728,0.08883772752704128
1292,8083,Montezuma,Colorado,2012,4542,7401,375,12318,0.3687286897223575,0.600828056502679,0.03044325377496347,-119,172,440,493,-0.025436215140221763,0.013276234747479326,0.012159980392742464,-2859,-559,-0.2320993667803215,-0.03759619553296423
1293,8083,Montezuma,Colorado,2016,3973,7853,1032,12858,0.30899051174366154,0.610748172344066,0.08026131591227252,-569,657,452,540,-0.05973817797869596,0.04981806213730905,0.009920115841386967,-3880,-1021,-0.30175766060040443,-0.06965829382008293
1294,8085,Montrose,Colorado,2000,4041,9266,908,14215,0.28427717200140695,0.651846640872318,0.06387618712627506,0,0,0,0,0.0,0.0,0.0,-5225,0,-0.3675694688709111,0.0
1295,8085,Montrose,Colorado,2004,4776,11218,225,16219,0.2944694494111844,0.6916579320549973,0.01387261853381836,735,-683,1952,2004,0.010192277409777462,-0.0500035685924567,0.03981129118267923,-6442,-1217,-0.39718848264381285,-0.02961901377290177
1296,8085,Montrose,Colorado,2008,6495,12199,459,19153,0.3391113663655824,0.636923719521746,0.023964914112671643,1719,234,981,2934,0.04464191695439801,0.010092295578853282,-0.05473421253325128,-5704,738,-0.29781235315616356,0.09937612948764929
1297,8085,Montrose,Colorado,2012,6138,13552,440,20130,0.30491803278688523,0.673224043715847,0.02185792349726776,-357,-19,1353,977,-0.034193333578697194,-0.0021069906154038837,0.03630032419410101,-7414,-1710,-0.36830601092896176,-0.0704936577727982
1298,8085,Montrose,Colorado,2016,5466,14382,1338,21186,0.2580005664117814,0.6788445199660152,0.06315491362220334,-672,898,830,1056,-0.046917466375103856,0.04129699012493558,0.00562047625016826,-8916,-1502,-0.4208439535542339,-0.052537942625272116
1299,8087,Morgan,Colorado,2000,2885,5722,391,8998,0.3206268059568793,0.6359190931318071,0.043454100911313624,0,0,0,0,0.0,0.0,0.0,-2837,0,-0.31529228717492774,0.0
1300,8087,Morgan,Colorado,2004,3039,6787,110,9936,0.30585748792270534,0.6830716586151369,0.01107085346215781,154,-281,1065,938,-0.014769318034173973,-0.032383247449155814,0.0471525654833298,-3748,-911,-0.3772141706924315,-0.06192188351750377
1301,8087,Morgan,Colorado,2008,3813,6272,149,10234,0.37258159077584524,0.612859097127223,0.014559312096931796,774,39,-515,298,0.0667241028531399,0.003488458634773985,-0.07021256148791388,-2459,1289,-0.24027750635137773,0.13693666434105378
1302,8087,Morgan,Colorado,2012,3912,6602,263,10777,0.3629952676997309,0.6126009093439733,0.024403822956295815,99,114,330,543,-0.009586323076114345,0.00984451085936402,-0.00025818778324970815,-2690,-231,-0.24960564164424237,-0.009328135292864637
1303,8087,Morgan,Colorado,2016,3151,8145,664,11960,0.26346153846153847,0.6810200668896321,0.05551839464882943,-761,401,1543,1183,-0.09953372923819243,0.031114571692533618,0.06841915754565886,-4994,-2304,-0.41755852842809366,-0.16795288678385129
1304,8089,Otero,Colorado,2000,2963,4082,267,7312,0.40522428884026257,0.5582603938730853,0.036515317286652076,0,0,0,0,0.0,0.0,0.0,-1119,0,-0.15303610503282278,0.0
1305,8089,Otero,Colorado,2004,3164,4947,69,8180,0.3867970660146699,0.6047677261613692,0.00843520782396088,201,-198,865,868,-0.01842722282559267,-0.028080109462691197,0.046507332288283854,-1783,-664,-0.2179706601466993,-0.06493455511387652
1306,8089,Otero,Colorado,2008,3547,4393,125,8065,0.4398016119032858,0.5446993180409175,0.015499070055796652,383,56,-554,-115,0.05300454588861592,0.007063862231835772,-0.060068408120451666,-846,937,-0.10489770613763172,0.11307295400906758
1307,8089,Otero,Colorado,2012,3647,4382,163,8192,0.4451904296875,0.534912109375,0.0198974609375,100,38,-11,127,0.005388817784214184,0.004398390881703348,-0.009787208665917535,-735,111,-0.0897216796875,0.015176026450131719
1308,8089,Otero,Colorado,2016,2943,4928,581,8452,0.34820160908660674,0.5830572645527686,0.06874112636062471,-704,418,546,260,-0.09698882060089326,0.04884366542312471,0.04814515517776863,-1985,-1250,-0.23485565546616188,-0.14513397577866188
1309,8091,Ouray,Colorado,2000,705,1279,249,2233,0.31571876399462606,0.5727720555306762,0.11150918047469771,0,0,0,0,0.0,0.0,0.0,-574,0,-0.25705329153605017,0.0
1310,8091,Ouray,Colorado,2004,1278,1402,41,2721,0.4696802646085998,0.5152517456817347,0.015067989709665565,573,-208,123,488,0.15396150061397373,-0.09644119076503214,-0.05752030984894152,-124,450,-0.04557148107313491,0.21148181046291525
1311,8091,Ouray,Colorado,2008,1636,1367,57,3060,0.534640522875817,0.4467320261437909,0.018627450980392157,358,16,-35,339,0.06496025826721719,0.003559461270726592,-0.06851971953794384,269,393,0.08790849673202611,0.13347997780516102
1312,8091,Ouray,Colorado,2012,1646,1481,75,3202,0.514053716427233,0.4625234228607121,0.023422860712054967,10,18,114,142,-0.020586806448584016,0.004795409731662811,0.015791396716921202,165,-104,0.05153029356652089,-0.03637820316550522
1313,8091,Ouray,Colorado,2016,1697,1351,262,3310,0.5126888217522658,0.4081570996978852,0.07915407854984895,51,187,-130,108,-0.0013648946749671431,0.05573121783779398,-0.05436632316282686,346,181,0.1045317220543806,0.053001428487859714
1314,8093,Park,Colorado,2000,2393,3677,595,6665,0.359039759939985,0.5516879219804951,0.08927231807951988,0,0,0,0,0.0,0.0,0.0,-1284,0,-0.1926481620405101,0.0
1315,8093,Park,Colorado,2004,3445,4781,131,8357,0.41222926887639105,0.5720952494914443,0.015675481632164652,1052,-464,1104,1692,0.05318950893640606,-0.07359683644735524,0.020407327510949202,-1336,-52,-0.15986598061505325,0.03278218142545686
1316,8093,Park,Colorado,2008,4250,4896,237,9383,0.4529468187146968,0.5217947351593307,0.025258446125972504,805,106,115,1026,0.04071754983830572,0.009582964493807852,-0.05030051433211358,-646,690,-0.06884791644463395,0.0910180641704193
1317,8093,Park,Colorado,2012,3862,5236,268,9366,0.41234251548152895,0.5590433482810164,0.028614136237454624,-388,31,340,-17,-0.04060430323316783,0.00335569011148212,0.0372486131216857,-1374,-728,-0.14670083279948748,-0.07785291635485353
1318,8093,Park,Colorado,2016,3421,6135,861,10417,0.32840549102428723,0.5889411538830758,0.08265335509263703,-441,593,899,1051,-0.08393702445724172,0.05403921885518241,0.029897805602059346,-2714,-1340,-0.26053566285878854,-0.11383483005930106
1319,8095,Phillips,Colorado,2000,564,1573,83,2220,0.25405405405405407,0.7085585585585585,0.03738738738738739,0,0,0,0,0.0,0.0,0.0,-1009,0,-0.45450450450450447,0.0
1320,8095,Phillips,Colorado,2004,582,1717,26,2325,0.2503225806451613,0.738494623655914,0.011182795698924731,18,-57,144,105,-0.0037314734088927937,-0.026204591688462654,0.02993606509735547,-1135,-126,-0.48817204301075273,-0.03366753850624826
1321,8095,Phillips,Colorado,2008,622,1613,26,2261,0.2750995134896064,0.7134011499336577,0.011499336576735958,40,0,-104,-64,0.0247769328444451,0.00031654087781122706,-0.025093473722256343,-991,144,-0.4383016364440513,0.04987040656670144
1322,8095,Phillips,Colorado,2012,588,1637,40,2265,0.2596026490066225,0.7227373068432671,0.017660044150110375,-34,14,24,4,-0.015496864482983874,0.006160707573374417,0.009336156909609428,-1049,-58,-0.4631346578366446,-0.024833021392593302
1323,8095,Phillips,Colorado,2016,436,1791,105,2332,0.18696397941680962,0.7680102915951973,0.04502572898799314,-152,65,154,67,-0.07263866958981288,0.027365684837882764,0.0452729847519302,-1355,-306,-0.5810463121783876,-0.11791165434174306
1324,8097,Pitkin,Colorado,2000,4137,2565,1098,7800,0.5303846153846153,0.32884615384615384,0.14076923076923076,0,0,0,0,0.0,0.0,0.0,1572,0,0.2015384615384615,0.0
1325,8097,Pitkin,Colorado,2004,6335,2784,137,9256,0.6844209161624892,0.30077787381158166,0.014801210025929127,2198,-961,219,1456,0.1540363007778739,-0.12596802074330163,-0.02806828003457218,3551,1979,0.38364304235090757,0.18210458081244607
1326,8097,Pitkin,Colorado,2008,7349,2484,133,9966,0.737407184427052,0.24924744130042142,0.01334537427252659,1014,-4,-300,710,0.052986268264562764,-0.0014558357534025373,-0.05153043251116024,4865,1314,0.4881597431266306,0.104516700775723
1327,8097,Pitkin,Colorado,2012,6849,3024,202,10075,0.6798014888337469,0.3001488833746898,0.020049627791563277,-500,69,540,109,-0.057605695593305084,0.006704253519036687,0.05090144207426839,3825,-1040,0.3796526054590571,-0.10850713766757347
1328,8097,Pitkin,Colorado,2016,7333,2550,640,10523,0.6968545091703887,0.24232633279483037,0.060819158034780954,484,438,-474,448,0.0170530203366418,0.04076953024321768,-0.05782255057985944,4783,958,0.4545281763755583,0.07487557091650121
1329,8099,Prowers,Colorado,2000,1361,3026,137,4524,0.30083996463306806,0.6688770999115826,0.03028293545534925,0,0,0,0,0.0,0.0,0.0,-1665,0,-0.36803713527851456,0.0
1330,8099,Prowers,Colorado,2004,1308,3392,45,4745,0.2756585879873551,0.7148577449947313,0.009483667017913594,-53,-92,366,221,-0.02518137664571296,-0.020799268437435653,0.0459806450831487,-2084,-419,-0.4391991570073762,-0.07116202172886166
1331,8099,Prowers,Colorado,2008,1487,3043,85,4615,0.3222101841820152,0.6593716143011917,0.018418201516793065,179,40,-349,-130,0.046551596194660094,0.008934534498879472,-0.05548613069353958,-1556,528,-0.33716143011917654,0.10203772688819968
1332,8099,Prowers,Colorado,2012,1519,3230,114,4863,0.3123586263623278,0.6641990540818424,0.023442319555829736,32,29,187,248,-0.009851557819687384,0.005024118039036671,0.0048274397806507,-1711,-155,-0.3518404277195146,-0.014678997600338084
1333,8099,Prowers,Colorado,2016,1186,3531,299,5016,0.2364433811802233,0.7039473684210527,0.059609250398724084,-333,185,301,153,-0.07591524518210452,0.03616693084289435,0.03974831433921022,-2345,-634,-0.46750398724082937,-0.11566355952131474
1334,8101,Pueblo,Colorado,2000,28888,22827,2231,53946,0.5354984614243874,0.423145367589812,0.04135617098580061,0,0,0,0,0.0,0.0,0.0,6061,0,0.11235309383457537,0.0
1335,8101,Pueblo,Colorado,2004,35369,31117,701,67187,0.5264262431720422,0.46314019081072233,0.010433566017235477,6481,-1530,8290,13241,-0.009072218252345166,-0.030922604968565137,0.0399948232209103,4252,-1809,0.0632860523613199,-0.04906704147325547
1336,8101,Pueblo,Colorado,2008,41097,30257,1073,72427,0.5674265122122966,0.41775857069877254,0.014814917088930924,5728,372,-860,5240,0.041000269040254333,0.004381351071695447,-0.045381620111949794,10840,6588,0.14966794151352403,0.08638188915220413
1337,8101,Pueblo,Colorado,2012,42551,31894,1974,76419,0.556811787644434,0.4173569400280035,0.025831272327562518,1454,901,1637,3992,-0.01061472456786261,0.011016355238631594,-0.0004016306707690376,10657,-183,0.13945484761643046,-0.010213093897093573
1338,8101,Pueblo,Colorado,2016,35875,36265,6506,78646,0.45615797370495637,0.46111690359331686,0.08272512270172673,-6676,4532,4371,2227,-0.10065381393947759,0.05689385037416421,0.043759963565313365,-390,-11047,-0.004958929888360497,-0.14441377750479095
1339,8103,Rio Blanco,Colorado,2000,543,2185,127,2855,0.1901926444833625,0.7653239929947461,0.04448336252189142,0,0,0,0,0.0,0.0,0.0,-1642,0,-0.5751313485113836,0.0
1340,8103,Rio Blanco,Colorado,2004,566,2403,34,3003,0.18847818847818848,0.8001998001998002,0.011322011322011322,23,-93,218,148,-0.001714456005174031,-0.0331613511998801,0.03487580720505412,-1837,-195,-0.6117216117216118,-0.03659026321022818
1341,8103,Rio Blanco,Colorado,2008,655,2437,55,3147,0.20813473149030823,0.7743883063234827,0.01747696218620909,89,21,34,144,0.019656543012119748,0.0061549508641977665,-0.025811493876317537,-1782,55,-0.5662535748331744,0.04546803688843737
1342,8103,Rio Blanco,Colorado,2012,568,2724,77,3369,0.16859602255862274,0.8085485307212823,0.022855446720094985,-87,22,287,222,-0.039538708931685485,0.005378484533885897,0.03416022439779964,-2156,-374,-0.6399525081626596,-0.07369893332948518
1343,8103,Rio Blanco,Colorado,2016,436,2791,223,3450,0.1263768115942029,0.8089855072463769,0.06463768115942028,-132,146,67,81,-0.04221921096441986,0.0417822344393253,0.00043697652509455676,-2355,-199,-0.682608695652174,-0.042656187489514386
1344,8105,Rio Grande,Colorado,2000,1707,3111,257,5075,0.3363546798029557,0.6130049261083744,0.05064039408866995,0,0,0,0,0.0,0.0,0.0,-1404,0,-0.27665024630541873,0.0
1345,8105,Rio Grande,Colorado,2004,2006,3448,72,5526,0.3630112196887441,0.6239594643503439,0.013029315960912053,299,-185,337,451,0.02665653988578842,-0.0376110781277579,0.010954538241969458,-1442,-38,-0.26094824466159977,0.015702001643818964
1346,8105,Rio Grande,Colorado,2008,2448,2930,66,5444,0.449669360764144,0.5382072005878031,0.012123438648052902,442,-6,-518,-82,0.08665814107539987,-0.0009058773128591512,-0.08575226376254075,-482,960,-0.08853783982365915,0.17241040483794062
1347,8105,Rio Grande,Colorado,2012,2478,2918,137,5533,0.44785830471715166,0.5273811675402132,0.0247605277426351,30,71,-12,89,-0.001811056046992332,0.012637089094582199,-0.01082603304758989,-440,42,-0.07952286282306159,0.009014977000597557
1348,8105,Rio Grande,Colorado,2016,2001,3085,448,5534,0.3615829418142392,0.5574629562703288,0.08095410191543187,-477,311,167,1,-0.08627536290291243,0.05619357417279677,0.030081788730115577,-1084,-644,-0.1958800144560896,-0.11635715163302801
1349,8107,Routt,Colorado,2000,4208,4472,958,9638,0.4366051047935256,0.46399667980908904,0.09939821539738534,0,0,0,0,0.0,0.0,0.0,-264,0,-0.02739157501556344,0.0
1350,8107,Routt,Colorado,2004,6392,5199,171,11762,0.5434449923482401,0.4420166638326815,0.014538343819078389,2184,-787,727,2124,0.10683988755471446,-0.08485987157830696,-0.02198001597640753,1193,1457,0.10142832851555855,0.128819903531122
1351,8107,Routt,Colorado,2008,8270,4725,204,13199,0.6265626183801803,0.35798166527767256,0.015455716342147133,1878,33,-474,1437,0.08311762603194028,0.0009173725230687442,-0.08403499855500896,3545,2352,0.2685809531025078,0.16715262458694924
1352,8107,Routt,Colorado,2012,7547,5469,301,13317,0.5667192310580461,0.4106780806487948,0.02260268829315912,-723,97,744,118,-0.059843387322134234,0.007146971951011988,0.05269641537112224,2078,-1467,0.15604115040925132,-0.11253980269325647
1353,8107,Routt,Colorado,2016,7600,5230,1156,13986,0.5434005434005434,0.37394537394537397,0.08265408265408265,53,855,-239,669,-0.023318687657502668,0.060051394360923535,-0.036732706703420825,2370,292,0.16945516945516947,0.013414019045918157
1354,8109,Saguache,Colorado,2000,1145,1078,306,2529,0.4527481217872677,0.4262554369315935,0.12099644128113879,0,0,0,0,0.0,0.0,0.0,67,0,0.026492684855674187,0.0
1355,8109,Saguache,Colorado,2004,1594,1163,46,2803,0.5686764181234392,0.4149125936496611,0.01641098822689975,449,-260,85,274,0.11592829633617147,-0.10458545305423904,-0.011342843281932413,431,364,0.15376382447377807,0.12727113961810388
1356,8109,Saguache,Colorado,2008,1730,956,64,2750,0.6290909090909091,0.34763636363636363,0.02327272727272727,136,18,-207,-53,0.06041449096746998,0.006861739045827521,-0.06727623001329747,774,343,0.2814545454545455,0.12769072098076745
1357,8109,Saguache,Colorado,2012,1865,964,103,2932,0.6360845839017736,0.32878581173260574,0.03512960436562074,135,39,8,182,0.006993674810864436,0.011856877092893466,-0.018850551903757895,901,127,0.30729877216916784,0.02584422671462233
1358,8109,Saguache,Colorado,2016,1417,1147,271,2835,0.4998236331569665,0.40458553791887125,0.09559082892416226,-448,168,183,-97,-0.1362609507448071,0.060461224558541526,0.07579972618626551,270,-631,0.09523809523809523,-0.2120606769310726
1359,8111,San Juan,Colorado,2000,149,210,77,436,0.34174311926605505,0.481651376146789,0.17660550458715596,0,0,0,0,0.0,0.0,0.0,-61,0,-0.13990825688073394,0.0
1360,8111,San Juan,Colorado,2004,253,216,17,486,0.5205761316872428,0.4444444444444444,0.03497942386831276,104,-60,6,50,0.17883301242118776,-0.1416260807188432,-0.03720693170234457,37,98,0.0761316872427984,0.21603994412353233
1361,8111,San Juan,Colorado,2008,264,218,14,496,0.532258064516129,0.43951612903225806,0.028225806451612902,11,-3,2,10,0.011681932828886188,-0.006753617416699855,-0.004928315412186357,46,9,0.09274193548387094,0.016610248241072545
1362,8111,San Juan,Colorado,2012,266,212,28,506,0.525691699604743,0.4189723320158103,0.05533596837944664,2,14,-6,10,-0.006566364911385958,0.027110161927833738,-0.020543797016447762,54,8,0.10671936758893275,0.013977432105061804
1363,8111,San Juan,Colorado,2016,265,215,26,506,0.5237154150197628,0.424901185770751,0.05138339920948617,-1,-2,3,0,-0.0019762845849802257,-0.003952569169960472,0.005928853754940677,50,-4,0.09881422924901184,-0.007905138339920903
1364,8113,San Miguel,Colorado,2000,1598,1043,614,3255,0.490937019969278,0.3204301075268817,0.18863287250384025,0,0,0,0,0.0,0.0,0.0,555,0,0.1705069124423963,0.0
1365,8113,San Miguel,Colorado,2004,2876,1079,64,4019,0.7156008957452102,0.2684747449614332,0.015924359293356557,1278,-550,36,764,0.22466387577593222,-0.1727085132104837,-0.051955362565448526,1797,1242,0.44712615078377704,0.27661923834138075
1366,8113,San Miguel,Colorado,2008,3349,933,68,4350,0.7698850574712643,0.21448275862068966,0.015632183908045976,473,4,-146,331,0.0542841617260541,-0.00029217538531058074,-0.053991986340743536,2416,619,0.5554022988505747,0.10827614806679764
1367,8113,San Miguel,Colorado,2012,2992,1154,110,4256,0.7030075187969925,0.27114661654135336,0.025845864661654134,-357,42,221,-94,-0.06687753867427182,0.010213680753608158,0.056663857920663696,1838,-578,0.43186090225563917,-0.12354139659493552
1368,8113,San Miguel,Colorado,2016,2975,1033,321,4329,0.6872256872256872,0.23862323862323861,0.07415107415107415,-17,211,-121,73,-0.015781831571305305,0.04830520948942002,-0.03252337791811474,1942,104,0.4486024486024486,0.01674154634680941
1369,8115,Sedgwick,Colorado,2000,384,877,42,1303,0.29470452801227937,0.6730621642363775,0.03223330775134305,0,0,0,0,0.0,0.0,0.0,-493,0,-0.3783576362240982,0.0
1370,8115,Sedgwick,Colorado,2004,374,971,15,1360,0.275,0.7139705882352941,0.011029411764705883,-10,-27,94,57,-0.019704528012279343,-0.021203895986637168,0.04090842399891659,-597,-104,-0.4389705882352941,-0.06061295201119593
1371,8115,Sedgwick,Colorado,2008,468,857,26,1351,0.3464100666173205,0.6343449296817173,0.01924500370096225,94,11,-114,-9,0.07141006661732047,0.008215591936256367,-0.07962565855357684,-389,208,-0.2879348630643968,0.1510357251708973
1372,8115,Sedgwick,Colorado,2012,419,881,38,1338,0.3131539611360239,0.6584454409566517,0.028400597907324365,-49,12,24,-13,-0.033256105481296594,0.009155594206362114,0.0241005112749344,-462,-73,-0.3452914798206278,-0.057356616756230994
1373,8115,Sedgwick,Colorado,2016,267,1015,82,1364,0.19574780058651026,0.7441348973607038,0.060117302052785926,-152,44,134,26,-0.11740616054951364,0.03171670414546156,0.08568945640405212,-748,-286,-0.5483870967741935,-0.2030956169535657
1374,8117,Summit,Colorado,2000,5304,4497,1267,11068,0.4792193711601012,0.4063064691001084,0.11447415973979039,0,0,0,0,0.0,0.0,0.0,807,0,0.07291290205999279,0.0
1375,8117,Summit,Colorado,2004,8144,5370,221,13735,0.5929377502730251,0.3909719694211867,0.016090280305788133,2840,-1046,873,2667,0.11371837911292387,-0.09838387943400226,-0.015334499678921698,2774,1967,0.20196578085183836,0.12905287879184557
1376,8117,Summit,Colorado,2008,9802,4883,214,14899,0.6578965031210149,0.3277401167863615,0.014363380092623666,1658,-7,-487,1164,0.0649587528479898,-0.001726900213164467,-0.06323185263482523,4919,2145,0.3301563863346534,0.12819060548281502
1377,8117,Summit,Colorado,2012,9347,5571,394,15312,0.6104362591431557,0.3638322884012539,0.025731452455590387,-455,180,688,413,-0.047460243977859196,0.01136807236296672,0.03609217161489242,3776,-1143,0.24660397074190177,-0.08355241559275162
1378,8117,Summit,Colorado,2016,9557,5100,1517,16174,0.5908866081365154,0.31532088537158404,0.09379250649190059,210,1123,-471,862,-0.0195496510066403,0.0680610540363102,-0.048511403029669886,4457,681,0.27556572276493135,0.028961752023029586
1379,8119,Teller,Colorado,2000,2750,6477,620,9847,0.2792728749873058,0.6577637859246471,0.06296333908804712,0,0,0,0,0.0,0.0,0.0,-3727,0,-0.37849091093734133,0.0
1380,8119,Teller,Colorado,2004,3556,8094,192,11842,0.3002871136632326,0.6834994088836345,0.016213477453132917,806,-428,1617,1995,0.021014238675926777,-0.0467498616349142,0.025735622958987348,-4538,-811,-0.3832122952204019,-0.00472138428306057
1381,8119,Teller,Colorado,2008,4513,8146,247,12906,0.34968231830156515,0.631179296451263,0.019138385247171857,957,55,52,1064,0.04939520463833258,0.0029249077940389397,-0.052320112432371446,-3633,905,-0.2814969781496979,0.10171531707070403
1382,8119,Teller,Colorado,2012,4333,8702,438,13473,0.32160617531359015,0.6458843613152231,0.03250946337118682,-180,191,556,567,-0.028076142987975006,0.013371078124014963,0.01470506486396006,-4369,-736,-0.32427818600163294,-0.042781207851935066
1383,8119,Teller,Colorado,2016,3603,9745,1096,14444,0.24944613680420935,0.674674605372473,0.07587925782331764,-730,658,1043,971,-0.0721600385093808,0.04336979445213082,0.028790244057249947,-6142,-1773,-0.4252284685682637,-0.10095028256663074
1384,8121,Washington,Colorado,2000,477,1878,90,2445,0.1950920245398773,0.7680981595092025,0.03680981595092025,0,0,0,0,0.0,0.0,0.0,-1401,0,-0.5730061349693252,0.0
1385,8121,Washington,Colorado,2004,455,2050,25,2530,0.17984189723320157,0.8102766798418972,0.009881422924901186,-22,-65,172,85,-0.015250127306675743,-0.026928393026019064,0.04217852033269476,-1595,-194,-0.6304347826086957,-0.0574286476393705
1386,8121,Washington,Colorado,2008,529,1949,35,2513,0.21050537206526065,0.775567051333068,0.013927576601671309,74,10,-101,-17,0.030663474832059084,0.004046153676770123,-0.03470962850882919,-1420,175,-0.5650616792678074,0.0653731033408883
1387,8121,Washington,Colorado,2012,468,2076,47,2591,0.18062524121960633,0.8012350443844075,0.018139714395986106,-61,12,127,78,-0.02988013084565433,0.0042121377943147974,0.02566799305133949,-1608,-188,-0.6206098031648012,-0.05554812389699382
1388,8121,Washington,Colorado,2016,296,2299,138,2733,0.10830589096231248,0.8412001463593121,0.050493962678375415,-172,91,223,142,-0.07231935025729384,0.03235424828238931,0.03996510197490455,-2003,-395,-0.7328942553969996,-0.1122844522321984
1389,8123,Weld,Colorado,2000,23436,37409,3696,64541,0.36311801800405946,0.5796160580096373,0.05726592398630328,0,0,0,0,0.0,0.0,0.0,-13973,0,-0.21649804000557787,0.0
1390,8123,Weld,Colorado,2004,31868,55591,1194,88653,0.3594689407013863,0.6270628179531431,0.013468241345470542,8432,-2502,18182,24112,-0.003649077302673165,-0.04379768264083274,0.04744675994350578,-23723,-9750,-0.2675938772517568,-0.05109583724617894
1391,8123,Weld,Colorado,2008,47292,56526,2048,105866,0.4467156594185102,0.5339391305990592,0.019345209982430618,15424,854,935,17213,0.08724671871712392,0.0058769686369600765,-0.09312368735408394,-9234,14489,-0.08722347118054896,0.18037040607120786
1392,8123,Weld,Colorado,2012,49050,63775,3466,116291,0.42178672468204764,0.5484087332639671,0.02980454205398526,1758,1418,7249,10425,-0.02492893473646257,0.010459332071554642,0.014469602664907932,-14725,-5491,-0.12662200858191947,-0.039398537401370504
1393,8123,Weld,Colorado,2016,46519,76651,12260,135430,0.3434911024145315,0.5659824263457136,0.09052647123975485,-2531,8794,12876,19139,-0.07829562226751613,0.06072192918576959,0.0175736930817465,-30132,-15407,-0.2224913239311821,-0.09586931534926263
1394,8125,Yuma,Colorado,2000,1082,3156,120,4358,0.24827902707664065,0.7241854061496099,0.027535566773749427,0,0,0,0,0.0,0.0,0.0,-2074,0,-0.4759063790729693,0.0
1395,8125,Yuma,Colorado,2004,1064,3456,39,4559,0.23338451414783945,0.7580609782847115,0.008554507567449002,-18,-81,300,201,-0.014894512928801201,-0.018981059206300423,0.03387557213510162,-2392,-318,-0.5246764641368721,-0.04877008506390279
1396,8125,Yuma,Colorado,2008,1117,3286,80,4483,0.2491635065804149,0.7329913004684363,0.017845192951148784,53,41,-170,-76,0.01577899243257544,0.009290685383699782,-0.025069677816275227,-2169,223,-0.48382779388802144,0.04084867024885064
1397,8125,Yuma,Colorado,2012,987,3490,100,4577,0.21564343456412496,0.762508193139611,0.021848372296263928,-130,20,204,94,-0.033520072016289926,0.004003179345115144,0.029516892671174744,-2503,-334,-0.5468647585754861,-0.06303696468746467
1398,8125,Yuma,Colorado,2016,726,3850,215,4791,0.15153412648716344,0.8035900647046545,0.04487580880818201,-261,115,360,214,-0.06410930807696152,0.023027436511918083,0.041081871565043504,-3124,-621,-0.6520559382174911,-0.10519117964200497
1399,9001,Fairfield,Connecticut,2000,193769,159659,16861,370289,0.52329126709138,0.43117402893415685,0.045534703974463187,0,0,0,0,0.0,0.0,0.0,34110,0,0.09211723815722311,0.0
1400,9001,Fairfield,Connecticut,2004,205902,189605,5460,400967,0.5135135809181304,0.4728693383744797,0.013617080707389885,12133,-11401,29946,30678,-0.009777686173249589,-0.0319176232670733,0.04169530944032285,16297,-17813,0.04064424254365068,-0.051472995613572436
1401,9001,Fairfield,Connecticut,2008,242936,167736,3069,413741,0.587169267730295,0.40541304825966,0.007417684010044932,37034,-2391,-21869,12774,0.07365568681216461,-0.006199396697344953,-0.06745629011481968,75200,58903,0.18175621947063497,0.1411119769269843
1402,9001,Fairfield,Connecticut,2012,217294,175168,3668,396130,0.5485421452553455,0.44219826824527303,0.009259586499381516,-25642,599,7432,-17611,-0.03862712247494948,0.0018419024893365837,0.036785219985613016,42126,-33074,0.10634387701007247,-0.0754123424605625
1403,9001,Fairfield,Connecticut,2016,243852,160077,17280,421209,0.5789334985719679,0.38004173699992166,0.04102476442811051,26558,13612,-15091,25079,0.03039135331662235,0.031765177928728995,-0.062156531245351365,83775,41649,0.1988917615720462,0.09254788456197371
1404,9003,Hartford,Connecticut,2000,221167,127468,18921,367556,0.6017232748207076,0.3467988551404412,0.05147787003885122,0,0,0,0,0.0,0.0,0.0,93699,0,0.25492441968026647,0.0
1405,9003,Hartford,Connecticut,2004,229902,154919,6987,391808,0.5867720924534466,0.3953951935641947,0.017832713982358705,8735,-11934,27451,24252,-0.014951182367261007,-0.033645156056492515,0.04859633842375355,74983,-18716,0.1913768988892519,-0.06354752079101456
1406,9003,Hartford,Connecticut,2008,268721,138984,5023,412728,0.6510849760617162,0.3367447810664651,0.012170242871818728,38819,-1964,-15935,20920,0.06431288360826959,-0.005662471110539977,-0.05865041249772962,129737,54754,0.3143401949952511,0.12296329610599921
1407,9003,Hartford,Connecticut,2012,244639,143238,4363,392240,0.6236972261880481,0.36517948194982663,0.01112329186212523,-24082,-660,4254,-20488,-0.0273877498736681,-0.0010469510096934986,0.02843470088336153,101401,-28336,0.2585177442382215,-0.05582245075702963
1408,9003,Hartford,Connecticut,2016,240403,148173,18288,406864,0.5908682016595226,0.36418311770026346,0.04494868064021393,-4236,13925,4935,14624,-0.03282902452852554,0.0338253887780887,-0.0009963642495631753,92230,-9171,0.22668508395925913,-0.031832660278962366
1409,9005,Litchfield,Connecticut,2000,41806,39172,6360,87338,0.4786690787515171,0.44851038494126266,0.07282053630722023,0,0,0,0,0.0,0.0,0.0,2634,0,0.030158693810254433,0.0
1410,9005,Litchfield,Connecticut,2004,44647,50160,1861,96668,0.46185914677038936,0.5188893946290396,0.019251458600571026,2841,-4499,10988,9330,-0.016809931981127735,-0.053569077706649204,0.07037900968777694,-5513,-8147,-0.05703024785865024,-0.08718894166890467
1411,9005,Litchfield,Connecticut,2008,51041,46173,1752,98966,0.5157427803488066,0.4665541701190308,0.017703049532162562,6394,-109,-3987,2298,0.053883633578417245,-0.0015484090684084635,-0.052335224510008826,4868,10381,0.04918861022977583,0.10621885808842607
1412,9005,Litchfield,Connecticut,2012,43856,47201,1370,92427,0.47449338396788815,0.5106841074577775,0.01482250857433434,-7185,-382,1028,-6539,-0.04124939638091846,-0.002880540957828222,0.044129937338746705,-3345,-8213,-0.03619072348988933,-0.08537933371966516
1413,9005,Litchfield,Connecticut,2016,39775,53051,4616,97442,0.40819153958252086,0.5444366905441186,0.047371769873360565,-4081,3246,5850,5015,-0.06630184438536729,0.03254926129902622,0.033752583086341104,-13276,-9931,-0.13624515096159773,-0.1000544274717084
1414,9007,Middlesex,Connecticut,2000,43319,29295,4819,77433,0.5594384823008278,0.37832706985393827,0.062234447845233944,0,0,0,0,0.0,0.0,0.0,14024,0,0.18111141244688955,0.0
1415,9007,Middlesex,Connecticut,2004,47292,35252,1440,83984,0.5631072585254334,0.4197466184035054,0.017146123071061156,3973,-3379,5957,6551,0.0036687762246055966,-0.04508832477417279,0.04141954854956714,12040,-1984,0.143360640121928,-0.037750772324961546
1416,9007,Middlesex,Connecticut,2008,52984,32918,1351,87253,0.6072455961399608,0.3772706955634763,0.015483708296562869,5692,-89,-2334,3269,0.044138337614527345,-0.0016624147744982876,-0.0424759228400291,20066,8026,0.22997490057648445,0.08661426045455645
1417,9007,Middlesex,Connecticut,2012,47855,34591,1092,83538,0.5728530728530729,0.41407503172209054,0.013071895424836602,-5129,-259,1673,-3715,-0.03439252328688791,-0.002411812871726267,0.036804336158614226,13264,-6802,0.15877804113098232,-0.07119685944550214
1418,9007,Middlesex,Connecticut,2016,45357,38867,4400,88624,0.511791388337245,0.4385606607690919,0.04964795089366312,-2498,3308,4276,5086,-0.06106168451582783,0.036576055468826515,0.024485629047001356,6490,-6774,0.07323072756815313,-0.08554731356282919
1419,9009,New Haven,Connecticut,2000,197928,122919,20252,341099,0.5802655534023846,0.36036165453431407,0.05937279206330127,0,0,0,0,0.0,0.0,0.0,75009,0,0.21990389886807055,0.0
1420,9009,New Haven,Connecticut,2004,199060,160390,6942,366392,0.5432978886001878,0.43775519116137906,0.018946920238433154,1132,-13310,37471,25293,-0.03696766480219682,-0.04042587182486811,0.077393536627065,38670,-36339,0.10554269743880873,-0.11436120142926182
1421,9009,New Haven,Connecticut,2008,233589,144650,4647,382886,0.6100745391578695,0.3777886890614961,0.012136771780634445,34529,-2295,-15740,16494,0.06677665055768167,-0.006810148457798709,-0.05996650209988297,88939,50269,0.23228585009637337,0.12674315265756464
1422,9009,New Haven,Connecticut,2012,218998,138364,3697,361059,0.6065435288969393,0.38321714733603096,0.010239323767029766,-14591,-950,-6286,-21827,-0.0035310102609301675,-0.0018974480136046794,0.005428458274534864,80634,-8305,0.22332638156090834,-0.008959468535465032
1423,9009,New Haven,Connecticut,2016,205609,159048,14349,379006,0.5424953694664464,0.4196450715819802,0.03785955895157333,-13389,10652,20684,17947,-0.06404815943049291,0.02762023518454356,0.03642792424594926,46561,-34073,0.12285029788446616,-0.10047608367644217
1424,9011,New London,Connecticut,2000,60449,41168,7530,109147,0.55383107185722,0.37717940025836716,0.06898952788441276,0,0,0,0,0.0,0.0,0.0,19281,0,0.17665167159885287,0.0
1425,9011,New London,Connecticut,2004,66062,49931,2367,118360,0.5581446434606286,0.4218570462994255,0.019998310239945926,5613,-5163,8763,9213,0.004313571603408617,-0.04899121764446683,0.04467764604105834,16131,-3150,0.13628759716120314,-0.04036407443764972
1426,9011,New London,Connecticut,2008,74776,48491,1607,124874,0.5988116020949117,0.38831942598138924,0.01286897192369909,8714,-760,-1440,6514,0.040666958634283046,-0.007129338316246837,-0.033537620318036254,26285,10154,0.21049217611352244,0.0742045789523193
1427,9011,New London,Connecticut,2012,67144,46119,1839,115102,0.5833434692707338,0.4006793974040416,0.015977133325224584,-7632,232,-2372,-9772,-0.015468132824177916,0.003108161401525495,0.012359971422652383,21025,-5260,0.18266407186669215,-0.0278281042468303
1428,9011,New London,Connecticut,2016,62278,54058,7192,123528,0.5041609999352373,0.4376173822938929,0.05822161777086976,-4866,5353,7939,8426,-0.07918246933549644,0.04224448444564517,0.03693798488985128,8220,-12805,0.06654361764134442,-0.11612045422534772
1429,9013,Tolland,Connecticut,2000,33554,24705,4441,62700,0.5351515151515152,0.3940191387559809,0.07082934609250399,0,0,0,0,0.0,0.0,0.0,8849,0,0.14113237639553428,0.0
1430,9013,Tolland,Connecticut,2004,39146,31245,1338,71729,0.5457485814663525,0.43559787533633537,0.018653543197312106,5592,-3103,6540,9029,0.010597066314837367,-0.052175802895191886,0.04157873658035449,7901,-948,0.11015070613001715,-0.030981670265517125
1431,9013,Tolland,Connecticut,2008,45053,29266,1182,75501,0.5967205732374405,0.3876240049800665,0.015655421782492948,5907,-156,-1979,3772,0.05097199177108802,-0.0029981214148191576,-0.04797387035626888,15787,7886,0.20909656825737405,0.0989458621273569
1432,9013,Tolland,Connecticut,2012,39366,30450,1175,70991,0.554520995619163,0.4289276105421814,0.016551393838655604,-5687,-7,1184,-4510,-0.04219957761827753,0.0008959720561626562,0.04130360556211493,8916,-6871,0.1255933850769816,-0.08350318318039246
1433,9013,Tolland,Connecticut,2016,38506,34194,4724,77424,0.4973393263070882,0.4416460012399256,0.061014672452986154,-860,3549,3744,6433,-0.0571816693120748,0.044463278614330554,0.012718390697744164,4312,-4604,0.055693325067162625,-0.06990006000981897
1434,9015,Windham,Connecticut,2000,24023,16708,3232,43963,0.5464367763801379,0.38004685758478723,0.07351636603507494,0,0,0,0,0.0,0.0,0.0,7315,0,0.16638991879535064,0.0
1435,9015,Windham,Connecticut,2004,25477,22324,1060,48861,0.521417899756452,0.45688790651030475,0.021694193733243283,1454,-2172,5616,4898,-0.02501887662368585,-0.05182217230183166,0.07684104892551752,3153,-4162,0.06452999324614728,-0.10185992554920337
1436,9015,Windham,Connecticut,2008,28673,21210,961,50844,0.5639406812996617,0.4171583667689403,0.018900951931398003,3196,-99,-1114,1983,0.04252278154320965,-0.0027932418018452795,-0.03972953974136445,7463,4310,0.14678231453072138,0.0822523212845741
1437,9015,Windham,Connecticut,2012,25957,19768,863,46588,0.5571606422254658,0.4243152743195673,0.018524083454966943,-2716,-98,-1442,-4256,-0.006780039074195887,-0.0003768684764310602,0.007156907550626979,6189,-1274,0.13284536790589851,-0.013936946624822866
1438,9015,Windham,Connecticut,2016,21792,25747,3284,50823,0.4287822442594888,0.5066013419121264,0.06461641382838479,-4165,2421,5979,4235,-0.128378397965977,0.046092330373417846,0.08228606759255908,-3955,-10144,-0.07781909765263756,-0.21066446555853607
1439,10001,Kent,Delaware,2000,22790,24081,1383,48254,0.472292452439176,0.4990467111534795,0.02866083640734447,0,0,0,0,0.0,0.0,0.0,-1291,0,-0.02675425871430348,0.0
1440,10001,Kent,Delaware,2004,23875,31578,538,55991,0.4264078155417835,0.5639834973477881,0.009608687110428461,1085,-845,7497,7737,-0.04588463689739253,-0.01905214929691601,0.0649367861943086,-7703,-6412,-0.1375756818060046,-0.11082142309170112
1441,10001,Kent,Delaware,2008,36392,29827,706,66925,0.5437728800896526,0.4456779977586851,0.010549122151662309,12517,168,-1751,10934,0.11736506454786916,0.0009404350412338478,-0.11830549958910297,6565,14268,0.09809488233096753,0.23567056413697213
1442,10001,Kent,Delaware,2012,35527,32135,1018,68680,0.5172830518345952,0.46789458357600466,0.014822364589400117,-865,312,2308,1755,-0.026489828255057413,0.004273242437737808,0.022216585817319556,3392,-3173,0.04938846825859056,-0.04870641407237697
1443,10001,Kent,Delaware,2016,33351,36991,4387,74729,0.4462926039422446,0.4950019403444446,0.05870545571331076,-2176,3369,4856,6049,-0.0709904478923506,0.043883091123910645,0.02710735676843995,-3640,-7032,-0.04870933640219999,-0.09809780466079054
1444,10003,New Castle,Delaware,2000,127539,78587,6934,213060,0.5986060264714165,0.3688491504740449,0.03254482305453863,0,0,0,0,0.0,0.0,0.0,48952,0,0.2297568759973716,0.0
1445,10003,New Castle,Delaware,2004,146179,93079,2269,241527,0.6052284009655235,0.3853772042049129,0.00939439482956357,18640,-4665,14492,28467,0.006622374494107075,-0.02315042822497506,0.01652805373086802,53100,4148,0.21985119676061066,-0.009905679236760945
1446,10003,New Castle,Delaware,2008,178768,74608,3245,256621,0.696622645847378,0.2907322471660542,0.01264510698656774,32589,976,-18471,15094,0.09139424488185444,0.003250712157004171,-0.09464495703885867,104160,51060,0.40589039868132376,0.1860392019207131
1447,10003,New Castle,Delaware,2012,167082,81230,3700,252012,0.662992238464835,0.3223259209878895,0.014681840547275527,-11686,455,6622,-4609,-0.03363040738254297,0.0020367335607077864,0.031593673821835255,85852,-18308,0.34066631747694553,-0.06522408120437823
1448,10003,New Castle,Delaware,2016,162919,85525,14535,262979,0.6195133451720479,0.3252160818924705,0.05527057293548154,-4163,10835,4295,10967,-0.04347889329278709,0.04058873238820602,0.002890160904580996,77394,-8458,0.29429726327957745,-0.04636905419736809
1449,10005,Sussex,Delaware,2000,29739,34620,1928,66287,0.44864000482749256,0.5222743524371295,0.02908564273537798,0,0,0,0,0.0,0.0,0.0,-4881,0,-0.07363434760963694,0.0
1450,10005,Sussex,Delaware,2004,30098,47003,651,77752,0.3871025825702233,0.6045246424529273,0.00837277497684947,359,-1277,12383,11465,-0.06153742225726927,-0.020712867758528507,0.08225029001579776,-16905,-12024,-0.21742205988270397,-0.14378771227306703
1451,10005,Sussex,Delaware,2008,40299,47939,832,89070,0.4524418996295049,0.538217132592343,0.009340967778152015,10201,181,936,11318,0.06533931705928159,0.0009681928013025448,-0.0663075098605842,-7640,9265,-0.08577523296283818,0.1316468269198658
1452,10005,Sussex,Delaware,2012,39975,52119,1135,93229,0.4287828894442716,0.5590427871155971,0.01217432344013129,-324,303,4180,4159,-0.023659010185233253,0.0028333556619792744,0.020825654523254022,-12144,-4504,-0.13025989767132545,-0.044484664708487276
1453,10005,Sussex,Delaware,2016,39333,62611,4162,106106,0.3706953423934556,0.5900797315891656,0.03922492601737885,-642,3027,10492,12877,-0.058087547050816035,0.02705060257724756,0.03103694447356853,-23278,-11134,-0.21938438919571002,-0.08912449152438456
1454,11001,District of Columbia,District of Columbia,2000,171923,18073,11898,201894,0.8515508137933767,0.08951727143946824,0.05893191476715504,0,0,0,0,0.0,0.0,0.0,153850,0,0.7620335423539085,0.0
1455,11001,District of Columbia,District of Columbia,2004,202970,21256,3360,227586,0.8918386895503239,0.09339766066454,0.014763649785136168,31047,-8538,3183,25692,0.040287875756947145,-0.044168264982018875,0.0038803892250717648,181714,27864,0.7984410288857838,0.03640748653187531
1456,11001,District of Columbia,District of Columbia,2008,245800,17367,2686,265853,0.9245710975614343,0.06532557465968035,0.010103327778885323,42830,-674,-3889,38267,0.032732408011110437,-0.004660322006250845,-0.02807208600485965,228433,46719,0.8592455229017539,0.0608044940159701
1457,11001,District of Columbia,District of Columbia,2012,267070,21381,5313,293764,0.9091311392818725,0.07278291417600523,0.01808594654212225,21270,2627,4014,27911,-0.015439958279561794,0.007982618763236925,0.007457339516324879,245689,17256,0.8363482251058673,-0.022897297795886673
1458,11001,District of Columbia,District of Columbia,2016,282830,12723,15715,311268,0.9086382152999987,0.040874744593083774,0.05048704010691751,15760,10402,-8658,17504,-0.0004929239818738385,0.032401093564795265,-0.031908169582921454,270107,24418,0.8677634707069148,0.03141524560104758
1459,12001,Alachua,Florida,2000,47380,34135,4242,85757,0.5524913418146623,0.3980433084179717,0.049465349767365926,0,0,0,0,0.0,0.0,0.0,13245,0,0.1544480333966906,0.0
1460,12001,Alachua,Florida,2004,62504,47762,1062,111328,0.5614400689853406,0.4290205518827249,0.009539379131934464,15124,-3180,13627,25571,0.008948727170678294,-0.03992597063543146,0.030977243464753224,14742,1497,0.13241951710261568,-0.02202851629407493
1461,12001,Alachua,Florida,2008,75565,48513,1889,125967,0.5998793334762279,0.3851246755102527,0.014995991013519413,13061,827,751,14639,0.038439264490887304,0.005456611881584949,-0.04389587637247222,27052,12310,0.2147546579659752,0.08233514086335952
1462,12001,Alachua,Florida,2012,69699,48797,2266,120762,0.5771600337854623,0.4040757854291913,0.018764180785346384,-5866,377,284,-5205,-0.022719299690765582,0.0037681897718269703,0.018951109918938613,20902,-6150,0.173084248356271,-0.041670409609704195
1463,12001,Alachua,Florida,2016,75820,46834,7446,130100,0.582782475019216,0.3599846272098386,0.05723289777094542,6121,5180,-1963,9338,0.005622441233753661,0.03846871698559904,-0.04409115821935272,28986,8084,0.2227978478093774,0.04971359945310638
1464,12003,Baker,Florida,2000,2392,5611,152,8155,0.2933169834457388,0.6880441446965052,0.01863887185775598,0,0,0,0,0.0,0.0,0.0,-3219,0,-0.3947271612507664,0.0
1465,12003,Baker,Florida,2004,2180,7738,37,9955,0.21898543445504773,0.7772978402812657,0.0037167252636865896,-212,-115,2127,1800,-0.07433154899069108,-0.014922146594069388,0.08925369558476048,-5558,-2339,-0.558312405826218,-0.1635852445754516
1466,12003,Baker,Florida,2008,2327,8672,88,11087,0.20988545142960224,0.7821773247948047,0.007937223775593036,147,51,934,1132,-0.009099983025445485,0.0042204985119064465,0.004879484513539034,-6345,-787,-0.5722918733652025,-0.013979467538984491
1467,12003,Baker,Florida,2012,2311,8975,104,11390,0.20289727831431079,0.7879719051799824,0.009130816505706761,-16,16,303,303,-0.006988173115291457,0.001193592730113725,0.005794580385177661,-6664,-319,-0.5850746268656716,-0.01278275350046909
1468,12003,Baker,Florida,2016,2112,10294,299,12705,0.16623376623376623,0.8102321920503739,0.023534041715859898,-199,195,1319,1315,-0.03666351208054455,0.014403225210153137,0.0222602868703915,-8182,-1518,-0.6439984258166076,-0.058923798950936024
1469,12005,Bay,Florida,2000,18873,38682,1321,58876,0.32055506488212515,0.6570079489095727,0.022436986208302194,0,0,0,0,0.0,0.0,0.0,-19809,0,-0.33645288402744755,0.0
1470,12005,Bay,Florida,2004,21068,53404,552,75024,0.2808168052889742,0.7118255491576029,0.007357645553422905,2195,-769,14722,16148,-0.03973825959315097,-0.01507934065487929,0.054817600248030174,-32336,-12527,-0.4310087438686287,-0.09455585984118114
1471,12005,Bay,Florida,2008,23653,56683,1030,81366,0.2906988176879778,0.6966423321780596,0.012658850133962589,2585,478,3279,6342,0.009882012399003604,0.0053012045805396835,-0.01518321697954328,-33030,-694,-0.4059435144900818,0.025065229378546883
1472,12005,Bay,Florida,2012,22051,56876,1162,80089,0.27533119404662315,0.710159947058897,0.01450885889447989,-1602,132,193,-1277,-0.015367623641354633,0.0018500087605173021,0.013517614880837359,-34825,-1795,-0.4348287530122738,-0.02888523852219199
1473,12005,Bay,Florida,2016,21797,62194,4231,88222,0.24706989186370745,0.704971549046723,0.047958559089569495,-254,3069,5318,8133,-0.0282613021829157,0.0334497001950896,-0.005188398012173967,-40397,-5572,-0.45790165718301556,-0.02307290417074176
1474,12007,Bradford,Florida,2000,3075,5416,184,8675,0.35446685878962536,0.6243227665706051,0.021210374639769453,0,0,0,0,0.0,0.0,0.0,-2341,0,-0.2698559077809798,0.0
1475,12007,Bradford,Florida,2004,3244,7557,54,10855,0.2988484569322893,0.6961768770152004,0.004974666052510364,169,-130,2141,2180,-0.055618401857336075,-0.01623570858725909,0.07185411044459522,-4313,-1972,-0.3973284200829111,-0.1274725123019313
1476,12007,Bradford,Florida,2008,3430,8136,137,11703,0.29308724258737073,0.6952063573442707,0.01170640006835854,186,83,579,848,-0.005761214344918553,0.006731734015848176,-0.0009705196709296482,-4706,-393,-0.4021191147569,-0.0047906946739889045
1477,12007,Bradford,Florida,2012,3325,8219,118,11662,0.2851140456182473,0.704767621334248,0.010118333047504716,-105,-19,83,-41,-0.007973196969123408,-0.0015880670208538242,0.009561263989977253,-4894,-188,-0.41965357571600065,-0.01753446095910066
1478,12007,Bradford,Florida,2016,2924,8913,321,12158,0.24050008225037012,0.7330975489389703,0.02640236881065965,-401,203,694,496,-0.04461396336787721,0.016284035763154934,0.028329927604722305,-5989,-1095,-0.49259746668860016,-0.07294389097259951
1479,12009,Brevard,Florida,2000,97341,115253,5894,218488,0.44552103548020944,0.5275026546080334,0.026976309911757167,0,0,0,0,0.0,0.0,0.0,-17912,0,-0.08198161912782392,0.0
1480,12009,Brevard,Florida,2004,110309,153068,2085,265462,0.4155359335799474,0.5766098349292931,0.007854231490759506,12968,-3809,37815,46974,-0.029985101900262046,-0.01912207842099766,0.049107180321259714,-42759,-24847,-0.16107390134934568,-0.07909228222152176
1481,12009,Brevard,Florida,2008,127620,157589,3718,288927,0.4417032676073887,0.5454284300186553,0.012868302373956052,17311,1633,4521,23465,0.026167334027441314,0.005014070883196546,-0.03118140491063781,-29969,12790,-0.10372516241126656,0.057348738938079125
1482,12009,Brevard,Florida,2012,122993,159300,4101,286394,0.42945382934000015,0.5562267365936437,0.014319434066356138,-4627,383,1711,-2533,-0.012249438267388557,0.0014511316924000865,0.010798306574988481,-36307,-6338,-0.1267729072536436,-0.023047744842377038
1483,12009,Brevard,Florida,2016,119679,181848,16614,318141,0.376182258809773,0.5715956132658161,0.052222127924410874,-3314,12513,22548,31747,-0.05327157053022713,0.03790269385805474,0.015368876672172349,-62169,-25862,-0.19541335445604308,-0.06864044720239948
1484,12011,Broward,Florida,2000,387760,177939,9540,575239,0.6740850324821509,0.3093305565165088,0.016584411001340314,0,0,0,0,0.0,0.0,0.0,209821,0,0.3647544759656421,0.0
1485,12011,Broward,Florida,2004,453873,244674,8325,706872,0.6420865446643805,0.3461362170237327,0.011777238311886734,66113,-1215,66735,131633,-0.03199848781777037,-0.0048071726894535795,0.03680566050722389,209199,-622,0.2959503276406478,-0.06880414832499426
1486,12011,Broward,Florida,2008,492640,237729,4722,735091,0.6701755292882106,0.3234007762304259,0.006423694481363532,38767,-3603,-6945,28219,0.028088984623830027,-0.005353543830523202,-0.022735440793306805,254911,45712,0.34677475305778466,0.05082442541713683
1487,12011,Broward,Florida,2012,508312,244101,4883,757296,0.6712197080137753,0.32233235089053686,0.006447941095687816,15672,161,6372,22205,0.0010441787255647261,2.424661432428362e-05,-0.0010684253398890453,264211,9300,0.34888735712323843,0.0021126040654537714
1488,12011,Broward,Florida,2016,553320,260951,23117,837388,0.6607689625358854,0.3116249576062709,0.027606079857843677,45008,18234,16850,80092,-0.010450745477889933,0.02115813876215586,-0.010707393284265954,292369,28158,0.34914400492961445,0.00025664780637602025
1489,12013,Calhoun,Florida,2000,2156,2873,146,5175,0.4166183574879227,0.5551690821256039,0.02821256038647343,0,0,0,0,0.0,0.0,0.0,-717,0,-0.1385507246376812,0.0
1490,12013,Calhoun,Florida,2004,2116,3782,65,5963,0.35485493878920005,0.6342445077980882,0.010900553412711723,-40,-81,909,788,-0.06176341869872265,-0.017312006973761708,0.07907542567248427,-1666,-949,-0.2793895690088881,-0.14083884437120692
1491,12013,Calhoun,Florida,2008,1821,4345,98,6264,0.2907088122605364,0.6936462324393359,0.015644955300127713,-295,33,563,301,-0.06414612652866364,0.00474440188741599,0.05940172464124771,-2524,-858,-0.40293742017879947,-0.12354785116991135
1492,12013,Calhoun,Florida,2012,1664,4366,149,6179,0.2692992393591196,0.7065868263473054,0.02411393429357501,-157,51,21,-85,-0.021409572901416818,0.008468978993447299,0.012940593907969533,-2702,-178,-0.4372875869881858,-0.03435016680938635
1493,12013,Calhoun,Florida,2016,1241,4655,232,6128,0.2025130548302872,0.7596279373368147,0.037859007832898174,-423,83,289,-51,-0.06678618452883239,0.013745073539323163,0.053041110989509255,-3414,-712,-0.5571148825065275,-0.1198272955183417
1494,12015,Charlotte,Florida,2000,29646,35428,1826,66900,0.4431390134529148,0.5295665171898356,0.027294469357249627,0,0,0,0,0.0,0.0,0.0,-5782,0,-0.08642750373692082,0.0
1495,12015,Charlotte,Florida,2004,34256,44428,1102,79786,0.42934850725691226,0.5568395457849749,0.013811946958112952,4610,-724,9000,12886,-0.013790506196002528,-0.013482522399136675,0.027273028595139248,-10172,-4390,-0.1274910385280626,-0.041063534791141776
1496,12015,Charlotte,Florida,2008,39031,45205,1263,85499,0.45650826325454097,0.5287196341477678,0.0147721025976912,4775,161,777,5713,0.02715975599762871,0.0009601556395782487,-0.028119911637207062,-6174,3998,-0.07221137089322682,0.05527966763483577
1497,12015,Charlotte,Florida,2012,35906,47996,1017,84919,0.4228264581542411,0.5651974234270305,0.011976118418728435,-3125,-246,2791,-580,-0.03368180510029989,-0.002795984178962766,0.03647778927926271,-12090,-5916,-0.14237096527278942,-0.0701595943795626
1498,12015,Charlotte,Florida,2016,33445,60218,3524,97187,0.3441303878090691,0.6196096185703849,0.03625999362054596,-2461,2507,12222,12268,-0.07869607034517195,0.024283875201817524,0.05441219514335438,-26773,-14683,-0.27547923076131575,-0.13310826548852633
1499,12017,Citrus,Florida,2000,25531,29801,1916,57248,0.4459719116825042,0.5205596702068195,0.03346841811067636,0,0,0,0,0.0,0.0,0.0,-4270,0,-0.07458775852431526,0.0
1500,12017,Citrus,Florida,2004,29277,39500,690,69467,0.4214519124188464,0.5686153137460953,0.009932773835058374,3746,-1226,9699,12219,-0.024519999263657832,-0.02353564427561798,0.04805564353927583,-10223,-5953,-0.14716340132724892,-0.07257564280293366
1501,12017,Citrus,Florida,2008,31460,43706,1343,76509,0.41119345436484595,0.5712530551961207,0.017553490439033315,2183,653,4206,7042,-0.010258458054000441,0.007620716603974941,0.002637741450025377,-12246,-2023,-0.16005960083127474,-0.012896199504025818
1502,12017,Citrus,Florida,2012,28460,44662,1038,74160,0.383764832793959,0.6022384034519956,0.013996763754045308,-3000,-305,956,-2349,-0.027428621570886935,-0.003556726684988007,0.030985348255874956,-16202,-3956,-0.21847357065803663,-0.05841396982676189
1503,12017,Citrus,Florida,2016,22789,54456,3167,80412,0.28340297468039594,0.6772123563647217,0.03938466895488236,-5671,2129,9794,6252,-0.10036185811356307,0.02538790520083705,0.07497395291272602,-31667,-15465,-0.3938093816843257,-0.1753358110262891
1504,12019,Clay,Florida,2000,14668,41903,988,57559,0.2548341701558401,0.7280008339269272,0.017164995917232754,0,0,0,0,0.0,0.0,0.0,-27235,0,-0.47316666377108707,0.0
1505,12019,Clay,Florida,2004,18971,62078,446,81495,0.23278728756365422,0.7617399840481011,0.005472728388244677,4303,-542,20175,23936,-0.022046882592185874,-0.011692267528988077,0.0337391501211739,-43107,-15872,-0.5289526964844469,-0.0557860327133598
1506,12019,Clay,Florida,2008,26697,67203,823,94723,0.2818428470382061,0.7094686612543943,0.00868849170739947,7726,377,5125,13228,0.049055559474551896,0.003215763319154793,-0.05227132279370672,-40506,2601,-0.4276258142161882,0.10132688226825864
1507,12019,Clay,Florida,2012,25759,70022,1013,96794,0.2661218670578755,0.7234126082195177,0.010465524722606773,-938,190,2819,2071,-0.01572097998033062,0.0017770330152073032,0.013943946965123355,-44263,-3757,-0.4572907411616422,-0.029664926945453973
1508,12019,Clay,Florida,2016,27822,74963,4532,107317,0.2592506313072486,0.69851933989955,0.04223002879320145,2063,3519,4941,10523,-0.0068712357506268695,0.03176450407059468,-0.024893268319967743,-47141,-2878,-0.4392687085923013,0.018022032569340873
1509,12021,Collier,Florida,2000,29939,60467,1796,92202,0.32471096071668726,0.655810069195896,0.01947897008741676,0,0,0,0,0.0,0.0,0.0,-30528,0,-0.33109910847920876,0.0
1510,12021,Collier,Florida,2004,43892,83631,1160,128683,0.3410862351670384,0.649899365106502,0.009014399726459595,13953,-636,23164,36481,0.01637527445035114,-0.010464570360957165,-0.005910704089393981,-39739,-9211,-0.30881312993946364,0.02228597853974512
1511,12021,Collier,Florida,2008,54450,86379,1159,141988,0.38348311124883794,0.6083542271177846,0.008162661633377468,10558,-1,2748,13305,0.04239687608179954,-0.0008517380930821265,-0.041545137988717395,-31929,7810,-0.2248711158689467,0.08394201407051693
1512,12021,Collier,Florida,2012,51698,96520,1096,149314,0.3462367895843658,0.6464229744029361,0.007340236012698073,-2752,-63,10141,7326,-0.037246321664472115,-0.0008224256206793958,0.038068747285151416,-44822,-12893,-0.30018618481857023,-0.07531506894962353
1513,12021,Collier,Florida,2016,61085,105423,6002,172510,0.3540954147585647,0.6111123992812011,0.03479218596023419,9387,4906,8903,23196,0.007858625174198886,0.027451949947536115,-0.035310575121734966,-44338,484,-0.2570169845226364,0.04316920029593385
1514,12023,Columbia,Florida,2000,7049,10968,497,18514,0.3807389002916712,0.5924165496381117,0.026844550070217132,0,0,0,0,0.0,0.0,0.0,-3919,0,-0.21167764934644057,0.0
1515,12023,Columbia,Florida,2004,8031,16758,202,24991,0.32135568804769715,0.6705614021047577,0.008082909847545117,982,-295,5790,6477,-0.059383212243974026,-0.018761640222672016,0.07814485246664593,-8727,-4808,-0.3492057140570605,-0.13752806471061996
1516,12023,Columbia,Florida,2008,9171,18670,374,28215,0.32503987240829346,0.6617047669679249,0.013255360623781676,1140,172,1912,3224,0.00368418436059631,0.00517245077623656,-0.008856635136832769,-9499,-772,-0.33666489455963144,0.012540819497429079
1517,12023,Columbia,Florida,2012,8462,18429,333,27224,0.3108286805759624,0.6769394651777844,0.012231854246253306,-709,-41,-241,-991,-0.01421119183233105,-0.00102350637752837,0.015234698209859454,-9967,-468,-0.36611078460182195,-0.029445890042190503
1518,12023,Columbia,Florida,2016,7601,20368,895,28864,0.26333841463414637,0.7056541019955654,0.031007483370288247,-861,562,1939,1640,-0.047490265941816046,0.01877562912403494,0.02871463681778108,-12767,-2800,-0.4423156873614191,-0.07620490275959713
1519,12027,DeSoto,Florida,2000,3321,4256,235,7812,0.4251152073732719,0.5448028673835126,0.030081925243215565,0,0,0,0,0.0,0.0,0.0,-935,0,-0.11968766001024067,0.0
1520,12027,DeSoto,Florida,2004,3913,5524,73,9510,0.4114616193480547,0.5808622502628812,0.007676130389064143,592,-162,1268,1698,-0.013653588025217211,-0.022405794854151423,0.03605938287936861,-1611,-676,-0.1694006309148265,-0.04971297090458582
1521,12027,DeSoto,Florida,2008,4383,5632,149,10164,0.4312278630460449,0.5541125541125541,0.014659582841401023,470,76,108,654,0.019766243697990182,0.00698345245233688,-0.026749696150327074,-1249,362,-0.12288469106650923,0.046515939848317256
1522,12027,DeSoto,Florida,2012,4174,5587,124,9885,0.42225594334850786,0.5651997976732422,0.012544258978249874,-209,-25,-45,-279,-0.008971919697537023,-0.0021153238631511483,0.011087243560688131,-1413,-164,-0.1429438543247344,-0.020059163258225154
1523,12027,DeSoto,Florida,2016,3781,6778,344,10903,0.34678528845271944,0.6216637622672659,0.03155094928001467,-393,220,1191,1018,-0.07547065489578841,0.0190066903017648,0.0564639645940237,-2997,-1584,-0.2748784738145465,-0.1319346194898121
1524,12029,Dixie,Florida,2000,1827,2697,143,4667,0.391472037711592,0.5778872937647311,0.03064066852367688,0,0,0,0,0.0,0.0,0.0,-870,0,-0.18641525605313913,0.0
1525,12029,Dixie,Florida,2004,1960,4434,48,6442,0.3042533374728345,0.6882955603849736,0.007451102142191866,133,-95,1737,1775,-0.0872187002387575,-0.023189566381485012,0.1104082666202425,-2474,-1604,-0.38404222291213913,-0.197626966859
1526,12029,Dixie,Florida,2008,1925,5194,174,7293,0.26395173453996984,0.7121897710133004,0.02385849444672974,-35,126,760,851,-0.040301602932864666,0.016407392304537874,0.02389421062832675,-3269,-795,-0.44823803647333055,-0.06419581356119142
1527,12029,Dixie,Florida,2012,1798,5052,109,6959,0.25837045552521914,0.7259663744790918,0.015663169995689036,-127,-65,-142,-334,-0.005581279014750695,-0.008195324451040705,0.01377660346579146,-3254,15,-0.4675959189538727,-0.019357882480542155
1528,12029,Dixie,Florida,2016,1270,5822,154,7246,0.1752691139939277,0.803477780844604,0.021253105161468396,-528,45,770,287,-0.08310134153129145,0.00558993516577936,0.07751140636551213,-4552,-1298,-0.6282086668506763,-0.16061274789680363
1529,12031,Duval,Florida,2000,108039,152460,4682,265181,0.4074160667619475,0.5749280679988386,0.01765586523921397,0,0,0,0,0.0,0.0,0.0,-44421,0,-0.16751200123689103,0.0
1530,12031,Duval,Florida,2004,158610,220190,2261,381061,0.41623257168799743,0.5778339950821522,0.0059334332298503385,50571,-2421,67730,115880,0.008816504926049906,-0.011722432009363633,0.0029059270833136086,-61580,-17159,-0.16160142339415473,0.005910577842736298
1531,12031,Duval,Florida,2008,202618,210537,3538,416693,0.48625246884396905,0.5052568677659572,0.008490663390073747,44008,1277,-9653,35632,0.07001989715597162,0.002557230160223408,-0.07257712731619492,-7919,53661,-0.019004398921988186,0.14259702447216654
1532,12031,Duval,Florida,2012,196737,211615,4339,412691,0.47671744719414766,0.51276863319045,0.010513919615402323,-5881,801,1078,-4002,-0.009535021649821396,0.0020232562253285763,0.007511765424492722,-14878,-6959,-0.036051185996302304,-0.017046787074314118
1533,12031,Duval,Florida,2016,205704,211672,19197,436573,0.47117893227478563,0.4848490401376173,0.04397202758759704,8967,14858,57,23882,-0.005538514919362025,0.033458107972194714,-0.027919593052832647,-5968,8910,-0.013670107862831682,0.022381078133470622
1534,12033,Escambia,Florida,2000,40990,73171,2695,116856,0.35077360169781613,0.6261638255630861,0.023062572739097693,0,0,0,0,0.0,0.0,0.0,-32181,0,-0.27539022386527,0.0
1535,12033,Escambia,Florida,2004,48329,93566,1383,143278,0.3373092868409665,0.6530381496112453,0.009652563547788215,7339,-1312,20395,26422,-0.013464314856849624,-0.013410009191309477,0.02687432404815915,-45237,-13056,-0.3157288627702788,-0.04033863890500877
1536,12033,Escambia,Florida,2008,61572,91411,1891,154874,0.397561889019461,0.5902281854927232,0.012209925487815902,13243,508,-2155,11596,0.060252602178494485,0.002557361940027687,-0.06280996411852213,-29839,15398,-0.19266629647326217,0.12306256629701662
1537,12033,Escambia,Florida,2012,58185,88711,2053,148949,0.3906370636929419,0.595579695063411,0.013783241243647154,-3387,162,-2700,-5925,-0.006924825326519113,0.0015733157558312522,0.005351509570687862,-30526,-687,-0.20494263137046914,-0.012276334897206975
1538,12033,Escambia,Florida,2016,57461,88808,7903,154172,0.3727071063487533,0.5760319642996135,0.05126092935163324,-724,5850,97,5223,-0.017929957344188563,0.03747768810798609,-0.019547730763797566,-31347,-821,-0.20332485795086014,0.0016177734196090032
1539,12035,Flagler,Florida,2000,13897,12618,601,27116,0.5125018439297832,0.4653341200767075,0.022164035993509367,0,0,0,0,0.0,0.0,0.0,1279,0,0.04716772385307566,0.0
1540,12035,Flagler,Florida,2004,18578,19633,269,38480,0.4827962577962578,0.5102130977130978,0.006990644490644491,4681,-332,7015,11364,-0.029705586133525363,-0.015173391502864876,0.04487897763639026,-1055,-2334,-0.027416839916839963,-0.07458456376991562
1541,12035,Flagler,Florida,2008,24726,23951,540,49217,0.502387386472154,0.4866407948473089,0.010971818680537213,6148,271,4318,10737,0.019591128675896186,0.003981174189892722,-0.023572302865788874,775,1830,0.015746591624845097,0.04316343154168506
1542,12035,Flagler,Florida,2012,23207,26969,529,50705,0.4576866186766591,0.5318804851592545,0.010432896164086382,-1519,-11,3018,1488,-0.04470076779549487,-0.0005389225164508307,0.04523969031194558,-3762,-4537,-0.07419386648259535,-0.08994045810744045
1543,12035,Flagler,Florida,2016,22026,33850,2111,57987,0.3798437580837084,0.5837515305154604,0.03640471140083122,-1181,1582,6881,7282,-0.0778428605929507,0.02597181523674484,0.0518710453562059,-11824,-8062,-0.20390777243175195,-0.1297139059491566
1544,12037,Franklin,Florida,2000,2047,2454,144,4645,0.44068891280947253,0.5283100107642626,0.0310010764262648,0,0,0,0,0.0,0.0,0.0,-407,0,-0.08762109795479012,0.0
1545,12037,Franklin,Florida,2004,2401,3472,58,5931,0.40482212105884335,0.5853987523183274,0.009779126622829202,354,-86,1018,1286,-0.03586679175062918,-0.0212219498034356,0.05708874155406474,-1071,-664,-0.18057663125948403,-0.09295553330469392
1546,12037,Franklin,Florida,2008,2134,3818,97,6049,0.3527855843941147,0.6311787072243346,0.01603570838155067,-267,39,346,118,-0.05203653666472863,0.0062565817587214665,0.04577995490600717,-1684,-613,-0.27839312283021983,-0.0978164915707358
1547,12037,Franklin,Florida,2012,1845,3570,79,5494,0.3358208955223881,0.6497997815799054,0.01437932289770659,-289,-18,-248,-555,-0.01696468887172664,-0.0016563854838440792,0.01862107435557081,-1725,-41,-0.3139788860575173,-0.03558576322729745
1548,12037,Franklin,Florida,2016,1744,4125,190,6059,0.2878362766133025,0.6808054134345601,0.031358309952137314,-101,111,555,565,-0.047984618909085563,0.016978987054430725,0.03100563185465477,-2381,-656,-0.3929691368212576,-0.07899025076374033
1549,12039,Gadsden,Florida,2000,9736,4770,225,14731,0.6609191500916435,0.32380693775032243,0.015273912158034078,0,0,0,0,0.0,0.0,0.0,4966,0,0.33711221234132105,0.0
1550,12039,Gadsden,Florida,2004,14629,6253,102,20984,0.6971502096835684,0.2979889439573008,0.004860846359130766,4893,-123,1483,6253,0.03623105959192496,-0.01041306579890331,-0.025817993793021632,8376,3410,0.39916126572626764,0.062049053384946595
1551,12039,Gadsden,Florida,2008,15582,6811,145,22538,0.69136569349543,0.3022007276599521,0.0064335788446179785,953,43,558,1554,-0.005784516188138467,0.0015727324854872124,0.004211783702651295,8771,395,0.3891649658354779,-0.009996299890789762
1552,12039,Gadsden,Florida,2012,15770,6630,122,22522,0.700204244738478,0.2943788295888465,0.005416925672675606,188,-23,-181,-16,0.008838551243047998,-0.0010166531719423728,-0.007821898071105615,9140,369,0.4058254151496315,0.016660449314153614
1553,12039,Gadsden,Florida,2016,15020,6728,466,22214,0.676150175564959,0.3028720626631854,0.020977761771855587,-750,344,98,-308,-0.024054069173518933,0.015560836099179982,0.008493233074338913,8292,-848,0.37327811290177365,-0.032547302247857846
1554,12041,Gilchrist,Florida,2000,1910,3300,185,5395,0.3540315106580167,0.6116774791473587,0.03429101019462465,0,0,0,0,0.0,0.0,0.0,-1390,0,-0.257645968489342,0.0
1555,12041,Gilchrist,Florida,2004,2017,4936,62,7015,0.28752672843905913,0.7036350677120456,0.008838203848895224,107,-123,1636,1620,-0.06650478221895756,-0.02545280634572943,0.09195758856468694,-2919,-1529,-0.4161083392729865,-0.1584623707836445
1556,12041,Gilchrist,Florida,2008,1996,5656,167,7819,0.25527561069190435,0.7233661593554163,0.021358229952679372,-21,105,720,804,-0.03225111774715478,0.012520026103784148,0.019731091643370613,-3660,-741,-0.4680905486635119,-0.05198220939052539
1557,12041,Gilchrist,Florida,2012,1885,5917,135,7937,0.23749527529293185,0.7454957792616858,0.017008945445382385,-111,-32,261,118,-0.017780335398972502,-0.0043492845072969875,0.022129619906269493,-4032,-372,-0.5080005039687538,-0.03990995530524194
1558,12041,Gilchrist,Florida,2016,1458,6740,274,8472,0.17209631728045327,0.795561850802644,0.032341831916902736,-427,139,823,535,-0.06539895801247858,0.015332886471520351,0.05006607154095821,-5282,-1250,-0.6234655335221907,-0.11546502955343685
1559,12043,Glades,Florida,2000,1442,1841,82,3365,0.42852897473997026,0.5471025260029718,0.02436849925705795,0,0,0,0,0.0,0.0,0.0,-399,0,-0.11857355126300156,0.0
1560,12043,Glades,Florida,2004,1718,2443,27,4188,0.4102196752626552,0.5833333333333334,0.0064469914040114614,276,-55,602,823,-0.018309299477315077,-0.017921507853046487,0.03623080733036155,-725,-326,-0.1731136580706782,-0.054540106807676625
1561,12043,Glades,Florida,2008,1674,2533,54,4261,0.3928655245247594,0.594461394038958,0.012673081436282563,-44,27,90,73,-0.017354150737895757,0.006226090032271102,0.011128060705624665,-859,-134,-0.2015958695141986,-0.028482211443520422
1562,12043,Glades,Florida,2012,1603,2344,57,4004,0.40034965034965037,0.5854145854145855,0.014235764235764236,-71,3,-189,-257,0.0074841258248909415,0.0015626827994816728,-0.009046808624372571,-741,118,-0.1850649350649351,0.016530934449263512
1563,12043,Glades,Florida,2016,1271,2996,115,4382,0.29005020538566867,0.6837060702875399,0.02624372432679142,-332,58,652,378,-0.1102994449639817,0.012007960091027184,0.09829148487295447,-1725,-984,-0.39365586490187127,-0.20859092983693617
1564,12045,Gulf,Florida,2000,2398,3553,197,6148,0.3900455432661028,0.5779115159401431,0.03204294079375407,0,0,0,0,0.0,0.0,0.0,-1155,0,-0.18786597267404032,0.0
1565,12045,Gulf,Florida,2004,2407,4805,65,7277,0.3307681736979525,0.6602995740002748,0.00893225230177271,9,-132,1252,1129,-0.05927736956815033,-0.02311068849198136,0.08238805806013172,-2398,-1243,-0.32953140030232236,-0.14166542762828205
1566,12045,Gulf,Florida,2008,2149,4980,89,7218,0.29772790246605707,0.6899418121363259,0.012330285397617068,-258,24,175,-59,-0.0330402712318954,0.0033980330958443584,0.029642238136051047,-2831,-433,-0.3922139096702688,-0.06268250936794645
1567,12045,Gulf,Florida,2012,2014,4995,116,7125,0.2826666666666667,0.7010526315789474,0.016280701754385965,-135,27,15,-93,-0.015061235799390393,0.003950416356768897,0.011110819442621489,-2981,-150,-0.4183859649122807,-0.026172055242011882
1568,12045,Gulf,Florida,2016,1720,5329,282,7331,0.23462010639749012,0.7269131087164098,0.03846678488610012,-294,166,334,206,-0.04804656026917656,0.022186083131714156,0.025860477137462423,-3609,-628,-0.4922930023189197,-0.07390703740663901
1569,12047,Hamilton,Florida,2000,1723,2147,96,3966,0.43444276348966215,0.5413514876449823,0.024205748865355523,0,0,0,0,0.0,0.0,0.0,-424,0,-0.10690872415532016,0.0
1570,12047,Hamilton,Florida,2004,2260,2792,27,5079,0.4449694821815318,0.5497145107304587,0.005316007088009451,537,-69,645,1113,0.010526718691869663,-0.01888974177734607,0.008363023085476429,-532,-108,-0.10474502854892692,0.0021636956063932344
1571,12047,Hamilton,Florida,2008,2364,3179,53,5596,0.4224446032880629,0.568084345961401,0.009471050750536097,104,26,387,517,-0.022524878893468936,0.004155043662526646,0.018369835230942266,-815,-283,-0.14563974267333812,-0.0408947141244112
1572,12047,Hamilton,Florida,2012,2228,3138,52,5418,0.4112218530823182,0.5791805094130675,0.009597637504614249,-136,-1,-41,-178,-0.011222750205744703,0.00012658675407815206,0.01109616345166653,-910,-95,-0.16795865633074936,-0.022318913657411232
1573,12047,Hamilton,Florida,2016,1904,3443,144,5491,0.34674922600619196,0.6270260426151885,0.02622473137861956,-324,92,305,73,-0.06447262707612622,0.01662709387400531,0.04784553320212093,-1539,-629,-0.2802768166089965,-0.11231816027824715
1574,12049,Hardee,Florida,2000,2342,3765,129,6236,0.37556125721616423,0.6037524053880693,0.020686337395766516,0,0,0,0,0.0,0.0,0.0,-1423,0,-0.22819114817190506,0.0
1575,12049,Hardee,Florida,2004,2149,5049,51,7249,0.2964546834046075,0.6965098634294385,0.007035453165953925,-193,-78,1284,1013,-0.07910657381155672,-0.013650884229812591,0.09275745804136926,-2900,-1477,-0.40005518002483104,-0.17186403185292598
1576,12049,Hardee,Florida,2008,2568,4763,111,7442,0.34506852996506315,0.6400161246976619,0.014915345337274927,419,60,-286,193,0.04861384656045564,0.007879892171321002,-0.056493738731776655,-2195,705,-0.29494759473259874,0.1051075852922323
1577,12049,Hardee,Florida,2012,2463,4696,85,7244,0.34000552181115407,0.6482606294864716,0.011733848702374379,-105,-26,-67,-198,-0.005063008153909088,-0.0031814966349005477,0.00824450478880967,-2233,-38,-0.3082551076753175,-0.013307512942718758
1578,12049,Hardee,Florida,2016,2149,5242,254,7645,0.28109875735775014,0.6856769130150425,0.033224329627207325,-314,169,546,401,-0.058906764453403926,0.021490480924832946,0.03741628352857096,-3093,-860,-0.4045781556572924,-0.09632304798197489
1579,12051,Hendry,Florida,2000,3240,4747,152,8139,0.3980833026170291,0.5832411844206905,0.01867551296228038,0,0,0,0,0.0,0.0,0.0,-1507,0,-0.18515788180366138,0.0
1580,12051,Hendry,Florida,2004,3960,5757,58,9775,0.4051150895140665,0.5889514066496163,0.005933503836317136,720,-94,1010,1636,0.007031786897037373,-0.012742009125963242,0.00571022222892581,-1797,-290,-0.18383631713554982,0.0013215646681115634
1581,12051,Hendry,Florida,2008,4998,5780,139,10917,0.4578180818906293,0.5294494824585508,0.012732435650819822,1038,81,23,1142,0.052702992376562785,0.006798931814502686,-0.05950192419106548,-782,1015,-0.07163140056792155,0.11220491656762827
1582,12051,Hendry,Florida,2012,4751,5355,107,10213,0.4651914226965632,0.5243317340644277,0.010476843239009105,-247,-32,-425,-704,0.007373340805933937,-0.0022555924118107164,-0.005117748394123156,-604,178,-0.05914031136786446,0.012491089200057093
1583,12051,Hendry,Florida,2016,4615,6195,372,11182,0.4127168663924164,0.5540153818637096,0.033267751743874086,-136,265,840,969,-0.052474556304146824,0.022790908504864982,0.029683647799281898,-1580,-976,-0.14129851547129318,-0.08215820410342872
1584,12053,Hernando,Florida,2000,32648,30658,1930,65236,0.500459868784107,0.46995523943834694,0.02958489177754614,0,0,0,0,0.0,0.0,0.0,1990,0,0.030504629345760037,0.0
1585,12053,Hernando,Florida,2004,37187,42635,725,80547,0.46168075781841655,0.5293182862179845,0.009000955963598893,4539,-1205,11977,15311,-0.03877911096569042,-0.020583935813947248,0.05936304677963755,-5448,-7438,-0.06763752839956794,-0.09814215774532797
1586,12053,Hernando,Florida,2008,41886,45021,1350,88257,0.4745912505523641,0.5101125123219687,0.015296237125667085,4699,625,2386,7710,0.012910492733947565,0.006295281162068192,-0.019205773896015743,-3135,2313,-0.03552126176960463,0.03211626662996331
1587,12053,Hernando,Florida,2012,37830,44938,1150,83918,0.45079720679711144,0.5354989394408828,0.013703853762005768,-4056,-200,-83,-4339,-0.02379404375525268,-0.0015923833636613174,0.025386427118914034,-7108,-3973,-0.08470173264377134,-0.049180470874166715
1588,12053,Hernando,Florida,2016,31795,58970,3886,94651,0.3359182681640976,0.6230256415674424,0.041056090268459924,-6035,2736,14032,10733,-0.11487893863301385,0.02735223650645416,0.08752670212655966,-27175,-20067,-0.28710737340334486,-0.2024056407595735
1589,12055,Highlands,Florida,2000,14169,20207,776,35152,0.4030780609922622,0.5748463814292216,0.022075557578516158,0,0,0,0,0.0,0.0,0.0,-6038,0,-0.17176832043695944,0.0
1590,12055,Highlands,Florida,2004,15347,25878,271,41496,0.3698428764218238,0.6236263736263736,0.0065307499518025836,1178,-505,5671,6344,-0.03323518457043839,-0.015544807626713574,0.04877999219715201,-10531,-4493,-0.25378349720454985,-0.0820151767675904
1591,12055,Highlands,Florida,2008,18135,26221,566,44922,0.4036997462267931,0.583700636659098,0.0125996171141089,2788,295,343,3426,0.033856869804969325,0.006068867162306316,-0.03992573696727564,-8086,2445,-0.18000089043230488,0.07378260677224496
1592,12055,Highlands,Florida,2012,16148,25915,472,42535,0.37964029622663686,0.6092629599153638,0.011096743857999294,-1987,-94,-306,-2387,-0.024059450000156246,-0.0015028732561096058,0.02556232325626584,-9767,-1681,-0.22962266368872697,-0.049621773256422086
1593,12055,Highlands,Florida,2016,14937,29565,1509,46011,0.3246397600573776,0.6425637347590794,0.032796505183543066,-1211,1037,3650,3476,-0.05500053616925926,0.02169976132554377,0.03330077484371552,-14628,-4861,-0.31792397470170175,-0.08830131101297478
1594,12057,Hillsborough,Florida,2000,169576,180794,9984,360354,0.4705817057671068,0.5017122052204221,0.02770608901247107,0,0,0,0,0.0,0.0,0.0,-11218,0,-0.031130499453315363,0.0
1595,12057,Hillsborough,Florida,2004,214132,245576,3514,463222,0.46226647266321547,0.5301475318529776,0.007585995483806901,44556,-6470,64782,102868,-0.008315233103891317,-0.020120093528664167,0.028435326632555435,-31444,-20226,-0.06788105918976212,-0.03675055973644675
1596,12057,Hillsborough,Florida,2008,272963,236355,5183,514501,0.5305392992433445,0.4593868622218421,0.010073838534813343,58831,1669,-9221,51279,0.06827282658012906,0.002487843051006442,-0.07076066963113548,36608,68052,0.07115243702150242,0.13903349621126454
1597,12057,Hillsborough,Florida,2012,286467,250186,6720,543373,0.5272013883648985,0.46043141635671997,0.012367195278381517,13504,1537,13831,28872,-0.0033379108784460376,0.002293356743568174,0.001044554134877862,36281,-327,0.06676997200817852,-0.0043824650133239
1598,12057,Hillsborough,Florida,2016,307896,266870,29124,603890,0.509854443690076,0.44191823014125087,0.048227326168673104,21429,22404,16684,60517,-0.01734694467482245,0.03586013089029159,-0.018513186215469102,41026,4745,0.06793621354882518,0.0011662415406466509
1599,12059,Holmes,Florida,2000,2177,5012,207,7396,0.2943482963764197,0.6776636019469984,0.027988101676581938,0,0,0,0,0.0,0.0,0.0,-2835,0,-0.3833153055705787,0.0
1600,12059,Holmes,Florida,2004,1810,6412,78,8300,0.21807228915662652,0.7725301204819277,0.009397590361445784,-367,-129,1400,904,-0.07627600721979316,-0.018590511315136154,0.09486651853492933,-4602,-1767,-0.5544578313253012,-0.17114252575472255
1601,12059,Holmes,Florida,2008,1446,7033,137,8616,0.16782729805013927,0.8162720519962859,0.015900649953574746,-364,59,621,316,-0.05024499110648725,0.0065030595921289625,0.043741931514358234,-5587,-985,-0.6484447539461466,-0.0939869226208454
1602,12059,Holmes,Florida,2012,1264,6919,102,8285,0.15256487628243814,0.8351237175618588,0.012311406155703078,-182,-35,-114,-331,-0.015262421767701123,-0.0035892437978716687,0.018851665565572828,-5655,-68,-0.6825588412794206,-0.034114087333273924
1603,12059,Holmes,Florida,2016,853,7483,220,8556,0.09969611968209444,0.874590930341281,0.025712949976624593,-411,118,564,271,-0.05286875660034371,0.013401543820921515,0.03946721277942222,-6630,-975,-0.7748948106591865,-0.09233596937976596
1604,12061,Indian River,Florida,2000,19769,28639,1219,49627,0.39835170370967415,0.5770850545066194,0.02456324178370645,0,0,0,0,0.0,0.0,0.0,-8870,0,-0.17873335079694525,0.0
1605,12061,Indian River,Florida,2004,23956,36938,520,61414,0.3900739245123262,0.601458950727847,0.00846712475982675,4187,-699,8299,11787,-0.008277779197347956,-0.0160961170238797,0.024373896221227653,-12982,-4112,-0.21138502621552085,-0.03265167541857561
1606,12061,Indian River,Florida,2008,29710,40176,916,70802,0.4196209146634276,0.5674415976949804,0.012937487641592046,5754,396,3238,9388,0.029546990151101404,0.0044703628817652965,-0.03401735303286668,-10466,2516,-0.14782068303155277,0.06356434318396809
1607,12061,Indian River,Florida,2012,27492,43450,634,71576,0.3840952274505421,0.6070470548787303,0.008857717670727619,-2218,-282,3274,774,-0.035525687212885515,-0.0040797699708644275,0.03960545718374997,-15958,-5492,-0.22295182742818825,-0.07513114439663549
1608,12061,Indian River,Florida,2016,29043,48620,3106,80769,0.3595810273743639,0.6019636246579753,0.03845534796766086,1551,2472,5170,9193,-0.02451420007617816,0.02959763029693324,-0.005083430220755081,-19577,-3619,-0.24238259728361133,-0.01943076985542308
1609,12063,Jackson,Florida,2000,6870,9139,294,16303,0.42139483530638533,0.5605716739250445,0.018033490768570203,0,0,0,0,0.0,0.0,0.0,-2269,0,-0.13917683861865915,0.0
1610,12063,Jackson,Florida,2004,7555,12122,130,19807,0.3814308072903519,0.6120058565153733,0.006563336194274751,685,-164,2983,3504,-0.03996402801603344,-0.011470154574295451,0.051434182590328836,-4567,-2298,-0.23057504922502142,-0.09139821060636227
1611,12063,Jackson,Florida,2008,7671,13717,225,21613,0.354925276453986,0.6346643223985564,0.01041040114745755,116,95,1595,1806,-0.026505530836365865,0.003847064953182798,0.0226584658831831,-6046,-1479,-0.2797390459445704,-0.049163996719548964
1612,12063,Jackson,Florida,2012,7342,13418,198,20958,0.3503196869930337,0.6402328466456723,0.009447466361294017,-329,-27,-299,-655,-0.004605589460952353,-0.0009629347861635322,0.005568524247115847,-6076,-30,-0.2899131596526386,-0.0101741137080682
1613,12063,Jackson,Florida,2016,6397,14257,505,21159,0.30232997778723003,0.6738031097877971,0.023866912424972825,-945,307,839,201,-0.04798970920580364,0.014419446063678808,0.033570263142124857,-7860,-1784,-0.3714731320005671,-0.0815599723479285
1614,12065,Jefferson,Florida,2000,3041,2478,124,5643,0.5388977494240652,0.43912812333864965,0.021974127237285132,0,0,0,0,0.0,0.0,0.0,563,0,0.09976962608541556,0.0
1615,12065,Jefferson,Florida,2004,4135,3298,45,7478,0.5529553356512437,0.44102701257020593,0.006017651778550415,1094,-79,820,1835,0.014057586227178454,-0.015956475458734718,0.0018988892315562889,837,274,0.11192832308103773,0.012158696995622165
1616,12065,Jefferson,Florida,2008,4088,3797,93,7978,0.5124091250940085,0.47593381799949863,0.011657056906492855,-47,48,499,500,-0.040546210557235174,0.005639405127942441,0.0349068054292927,291,-546,0.03647530709450986,-0.07545301598652787
1617,12065,Jefferson,Florida,2012,3945,3808,67,7820,0.5044757033248082,0.48695652173913045,0.008567774936061381,-143,-26,11,-158,-0.00793342176920031,-0.003089281970431474,0.011022703739631823,137,-154,0.017519181585677723,-0.018956125508832133
1618,12065,Jefferson,Florida,2016,3541,3930,218,7689,0.4605280270516322,0.5111197815060476,0.028352191442320197,-404,151,122,-131,-0.04394767627317597,0.019784416506258815,0.02416325976691719,-389,-526,-0.05059175445441544,-0.06811093604009316
1619,12067,Lafayette,Florida,2000,789,1670,46,2505,0.3149700598802395,0.6666666666666666,0.018363273453093812,0,0,0,0,0.0,0.0,0.0,-881,0,-0.3516966067864271,0.0
1620,12067,Lafayette,Florida,2004,845,2460,20,3325,0.25413533834586466,0.7398496240601504,0.006015037593984963,56,-26,790,820,-0.06083472153437486,-0.012348235859108849,0.0731829573934838,-1615,-734,-0.48571428571428577,-0.13401767892785865
1621,12067,Lafayette,Florida,2008,642,2679,56,3377,0.1901095647023986,0.7933076695291679,0.01658276576843352,-203,36,219,52,-0.06402577364346607,0.010567728174448558,0.053458045469017446,-2037,-422,-0.6031981048267693,-0.11748381911248351
1622,12067,Lafayette,Florida,2012,687,2668,51,3406,0.20170287727539635,0.7833235466823253,0.014973576042278332,45,-5,-11,29,0.011593312572997755,-0.0016091897261551885,-0.00998412284684258,-1981,56,-0.5816206694069289,0.021577435419840363
1623,12067,Lafayette,Florida,2016,518,2809,84,3411,0.15186162415713866,0.8235121665200821,0.024626209322779244,-169,33,141,5,-0.04984125311825768,0.009652633280500911,0.04018861983775679,-2291,-310,-0.6716505423629434,-0.0900298729560145
1624,12069,Lake,Florida,2000,36571,50010,2030,88611,0.41271399713353873,0.5643768832312015,0.022909119635259732,0,0,0,0,0.0,0.0,0.0,-13439,0,-0.15166288609766276,0.0
1625,12069,Lake,Florida,2004,48221,74389,1340,123950,0.389035901573215,0.6001532876159742,0.010810810810810811,11650,-690,24379,35339,-0.023678095560323742,-0.012098308824448921,0.0357764043847727,-26168,-12729,-0.2111173860427592,-0.05945449994509644
1626,12069,Lake,Florida,2008,62948,82802,1621,147371,0.4271396679129544,0.5618608817202841,0.010999450366761438,14727,281,8413,23421,0.03810376633973939,0.00018863955595062668,-0.03829240589569005,-19854,6314,-0.13472121380732976,0.07639617223542944
1627,12069,Lake,Florida,2012,61799,87643,1687,151129,0.40891556220182756,0.579921788670606,0.011162649127566517,-1149,66,4841,3758,-0.018224105711126815,0.00016319876080507847,0.01806090695032181,-25844,-5990,-0.1710062264687784,-0.036285012661448623
1628,12069,Lake,Florida,2016,62838,102188,6773,171799,0.3657646435660277,0.5948113784131456,0.039423978020826665,1039,5086,14545,20670,-0.04315091863579984,0.02826132889326015,0.014889589742539622,-39350,-13506,-0.22904673484711785,-0.05804050837833946
1629,12071,Lee,Florida,2000,73571,106151,4678,184400,0.3989750542299349,0.5756561822125813,0.025368763557483732,0,0,0,0,0.0,0.0,0.0,-32580,0,-0.1766811279826464,0.0
1630,12071,Lee,Florida,2004,93860,144176,2631,240667,0.38999945983454315,0.5990684223429054,0.010932117822551492,20289,-2047,38025,56267,-0.00897559439539175,-0.01443664573493224,0.023412240130324058,-50316,-17736,-0.2090689625083622,-0.03238783452571581
1631,12071,Lee,Florida,2008,119701,147608,2668,269977,0.44337480600199275,0.5467428706889846,0.00988232330902262,25841,37,3432,29310,0.0533753461674496,-0.001049794513528872,-0.05232555165392072,-27907,22409,-0.10336806468699189,0.10570089782137032
1632,12071,Lee,Florida,2012,110157,154163,2256,266576,0.41322924794430105,0.5783078746773903,0.008462877378308625,-9544,-412,6555,-3401,-0.0301455580576917,-0.0014194459307139955,0.03156500398840567,-44006,-16099,-0.16507862673308926,-0.06171056204609737
1633,12071,Lee,Florida,2016,124908,191551,13303,329762,0.37878227327587777,0.5808765109381918,0.04034121578593046,14751,11047,37388,63186,-0.03444697466842328,0.03187833840762183,0.0025686362608015045,-66643,-22637,-0.20209423766231405,-0.037015610929224785
1634,12073,Leon,Florida,2000,61444,39073,2637,103154,0.5956531011885142,0.37878317854857785,0.025563720262907885,0,0,0,0,0.0,0.0,0.0,22371,0,0.21686992263993637,0.0
1635,12073,Leon,Florida,2004,83873,51615,891,136379,0.6149993767368876,0.3784673593441806,0.0065332639189318005,22429,-1746,12542,33225,0.019346275548373426,-0.019030456343976085,-0.00031581920439727185,32258,9887,0.23653201739270707,0.019662094752770698
1636,12073,Leon,Florida,2008,91747,55705,1483,148935,0.6160204115889482,0.37402222446033506,0.009957363950716756,7874,592,4090,12556,0.0010210348520605095,0.003424100031784955,-0.004445134883845514,36042,3784,0.2419981871286131,0.0054661697359060235
1637,12073,Leon,Florida,2012,90881,55805,1977,148663,0.6113222523425466,0.37537921338867103,0.013298534268782414,-866,494,100,-272,-0.004698159246401601,0.003341170318065658,0.001356988928335967,35076,-966,0.23594303895387553,-0.006055148174737568
1638,12073,Leon,Florida,2016,92068,53821,7992,153881,0.5983064835814688,0.3497572799760854,0.051936236442445785,1187,6015,-1984,5218,-0.013015768761077795,0.03863770217366337,-0.025621933412585618,38247,3171,0.24854920360538335,0.012606164651507823
1639,12075,Levy,Florida,2000,5398,6863,469,12730,0.42403770620581305,0.539120188531029,0.03684210526315789,0,0,0,0,0.0,0.0,0.0,-1465,0,-0.115082482325216,0.0
1640,12075,Levy,Florida,2004,6074,10410,168,16652,0.3647609896709104,0.6251501321162624,0.010088878212827288,676,-301,3547,3922,-0.05927671653490263,-0.026753227050330605,0.0860299435852333,-4336,-2871,-0.26038914244535194,-0.14530666012013593
1641,12075,Levy,Florida,2008,6711,11754,324,18789,0.357177071690883,0.6255787961041035,0.01724413220501357,637,156,1344,2137,-0.007583917980027444,0.007155253992186283,0.000428663987841138,-5043,-707,-0.2684017244132205,-0.008012581967868582
1642,12075,Levy,Florida,2012,6119,12054,280,18453,0.33159919796239096,0.6532271175418631,0.01517368449574595,-592,-44,300,-336,-0.025577873728492018,-0.0020704477092676216,0.027648321437759638,-5935,-892,-0.3216279195794722,-0.053226195166251655
1643,12075,Levy,Florida,2016,5101,13775,623,19499,0.26160315913636595,0.7064464844350993,0.0319503564285348,-1018,343,1721,1046,-0.06999603882602501,0.016776671932788846,0.05321936689323614,-8674,-2739,-0.4448433252987333,-0.12321540571926115
1644,12077,Liberty,Florida,2000,1017,1317,76,2410,0.4219917012448133,0.5464730290456431,0.03153526970954357,0,0,0,0,0.0,0.0,0.0,-300,0,-0.12448132780082982,0.0
1645,12077,Liberty,Florida,2004,1070,1927,24,3021,0.35418735518040384,0.6378682555445216,0.007944389275074478,53,-52,610,611,-0.06780434606440944,-0.023590880434469087,0.09139522649887855,-857,-557,-0.2836809003641178,-0.15919957256328798
1646,12077,Liberty,Florida,2008,895,2339,52,3286,0.27236762020693855,0.7118076688983567,0.01582471089470481,-175,28,412,265,-0.08181973497346529,0.00788032161963033,0.07393941335383503,-1444,-587,-0.4394400486914181,-0.1557591483273003
1647,12077,Liberty,Florida,2012,942,2301,46,3289,0.2864092429309821,0.6996047430830039,0.013986013986013986,47,-6,-38,3,0.014041622724043523,-0.001838696908690823,-0.012202925815352761,-1359,85,-0.41319550015202183,0.026244548539396284
1648,12077,Liberty,Florida,2016,651,2543,118,3312,0.19655797101449277,0.7678140096618358,0.035628019323671496,-291,72,242,23,-0.08985127191648931,0.021642005337657512,0.06820926657883186,-1892,-533,-0.571256038647343,-0.15806053849532115
1649,12079,Madison,Florida,2000,3015,3038,110,6163,0.48920980042187245,0.49294174914814215,0.017848450429985396,0,0,0,0,0.0,0.0,0.0,-23,0,-0.003731948726269696,0.0
1650,12079,Madison,Florida,2004,4050,4191,63,8304,0.4877167630057804,0.5046965317919075,0.007586705202312138,1035,-47,1153,2141,-0.00149303741609208,-0.010261745227673258,0.011754782643765394,-141,-118,-0.01697976878612717,-0.013247820059857474
1651,12079,Madison,Florida,2008,4270,4544,93,8907,0.4793982261142921,0.510160547883687,0.010441226002020883,220,30,353,603,-0.00831853689148826,0.0028545207997087447,0.005464016091779489,-274,-133,-0.030762321769394918,-0.013782552983267748
1652,12079,Madison,Florida,2012,4176,4474,77,8727,0.4785149535922998,0.5126618540162713,0.008823192391428899,-94,-16,-70,-180,-0.0008832725219923288,-0.0016180336105919846,0.002501306132584258,-298,-24,-0.034146900423971505,-0.0033845786545765866
1653,12079,Madison,Florida,2016,3526,4851,163,8540,0.4128805620608899,0.5680327868852459,0.01908665105386417,-650,86,377,-187,-0.06563439153140987,0.010263458662435271,0.055370932868974654,-1325,-1027,-0.15515222482435603,-0.12100532440038453
1654,12081,Manatee,Florida,2000,49226,58023,3095,110344,0.4461139708547814,0.5258373812803596,0.028048647864858986,0,0,0,0,0.0,0.0,0.0,-8797,0,-0.07972341042557823,0.0
1655,12081,Manatee,Florida,2004,61262,81318,1041,143621,0.42655321993301815,0.5661985364257316,0.007248243641250235,12036,-2054,23295,33277,-0.019560750921763237,-0.02080040422360875,0.040361155145371974,-20056,-11259,-0.13964531649271344,-0.05992190606713521
1656,12081,Manatee,Florida,2008,70034,80721,1712,152467,0.4593387421540399,0.5294325985295179,0.011228659316442246,8772,671,-597,8846,0.03278552222102177,0.003980415675192011,-0.03676593789621374,-10687,9369,-0.07009385637547794,0.06955146011723551
1657,12081,Manatee,Florida,2012,66503,85627,1728,153858,0.43223621781122856,0.5565326469861821,0.0112311352025894,-3531,16,4906,1391,-0.02710252434281135,2.475886147153966e-06,0.02710004845666425,-19124,-8437,-0.12429642917495354,-0.0542025727994756
1658,12081,Manatee,Florida,2016,71224,101944,7589,180757,0.39403176640462056,0.5639836908114209,0.04198454278395857,4721,5861,16317,26899,-0.038204451406608,0.03075340758136917,0.007451043825238757,-30720,-11596,-0.1699519244068003,-0.045655495231846754
1659,12083,Marion,Florida,2000,44674,55146,3151,102971,0.43385030736809393,0.5355488438492391,0.030600848782666966,0,0,0,0,0.0,0.0,0.0,-10472,0,-0.10169853648114513,0.0
1660,12083,Marion,Florida,2004,57271,81283,1123,139677,0.4100245566557128,0.5819354653951617,0.008039977949125482,12597,-2028,26137,36706,-0.023825750712381133,-0.022560870833541483,0.04638662154592266,-24012,-13540,-0.17191090873944892,-0.07021237225830379
1661,12083,Marion,Florida,2008,70839,89628,2075,162542,0.4358196650711816,0.5514144036618228,0.012765931266995607,13568,952,8345,22865,0.02579510841546878,0.004725953317870126,-0.030521061733338906,-18789,5223,-0.11559473859064123,0.05631617014880769
1662,12083,Marion,Florida,2012,66831,93043,1849,161723,0.4132436326311038,0.5753232378820576,0.011433129486838606,-4008,-226,3415,-819,-0.022576032440077776,-0.0013328017801570013,0.02390883422023482,-26212,-7423,-0.16207960525095383,-0.046484866660312596
1663,12083,Marion,Florida,2016,62041,107833,6026,175900,0.35270608300170553,0.6130358158044343,0.03425810119386015,-4790,4177,14790,14177,-0.06053754962939828,0.022824971707021545,0.0377125779223767,-45792,-19580,-0.2603297328027288,-0.09825012755177498
1664,12085,Martin,Florida,2000,26621,33972,1423,62016,0.4292601909184727,0.5477941176470589,0.022945691434468524,0,0,0,0,0.0,0.0,0.0,-7351,0,-0.1185339267285862,0.0
1665,12085,Martin,Florida,2004,30208,41362,883,72453,0.41693235614812363,0.5708804328323189,0.012187211019557507,3587,-540,7390,10437,-0.012327834770349044,-0.010758480414911018,0.023086315185260053,-11154,-3803,-0.1539480766841953,-0.0354141499556091
1666,12085,Martin,Florida,2008,33508,44143,871,78522,0.42673390896818725,0.5621736583377906,0.011092432694022058,3300,-12,2781,6069,0.00980155282006362,-0.0010947783255354487,-0.00870677449452828,-10635,519,-0.1354397493696034,0.0185083273145919
1667,12085,Martin,Florida,2012,30107,48183,743,79033,0.3809421380942138,0.6096567256715549,0.00940113623423127,-3401,-128,4040,511,-0.04579177087397346,-0.0016912964597907872,0.047483067333764284,-18076,-7441,-0.22871458757734114,-0.09327483820773774
1668,12085,Martin,Florida,2016,30185,53204,3244,86633,0.3484238107880369,0.614130873916406,0.03744531529555712,78,2501,5021,7600,-0.032518327306176875,0.02804417906132585,0.0044741482448510395,-23019,-4943,-0.26570706312836906,-0.036992475551027915
1669,12086,Miami-Dade,Florida,2000,328867,289574,7111,625552,0.5257228815510141,0.46290955827812874,0.0113675601708571,0,0,0,0,0.0,0.0,0.0,39293,0,0.06281332327288536,0.0
1670,12086,Miami-Dade,Florida,2004,409732,361095,3899,774726,0.528873433962459,0.4660938189759993,0.005032747061541758,80865,-3212,71521,149174,0.003150552411444907,-0.006334813109315341,0.0031842606978705335,48637,9344,0.06277961498645973,-3.370828642562662e-05
1671,12086,Miami-Dade,Florida,2008,499831,360551,4254,864636,0.5780825688497818,0.41699744169800934,0.004919989452208791,90099,355,-544,89910,0.049209134887322814,-0.00011275760933296755,-0.04909637727798993,139280,90643,0.16108512715177248,0.09830551216531275
1672,12086,Miami-Dade,Florida,2012,541440,332981,4688,879109,0.6158963222990551,0.37877100564321375,0.00533267205773118,41609,434,-27570,14473,0.03781375344927329,0.00041268260552238933,-0.03822643605479559,208459,69179,0.23712531665584136,0.07604018950406888
1673,12086,Miami-Dade,Florida,2016,624146,333999,29046,987191,0.6322444187598955,0.33833270360041773,0.029422877639686748,82706,24358,1018,108082,0.016348096460840345,0.024090205581955567,-0.040438302042796026,290147,81688,0.2939117151594777,0.05678639850363637
1674,12087,Monroe,Florida,2000,16487,16063,1345,33895,0.4864139253577224,0.4739047057088066,0.03968136893347101,0,0,0,0,0.0,0.0,0.0,424,0,0.01250921964891577,0.0
1675,12087,Monroe,Florida,2004,19654,19467,414,39535,0.4971291260908056,0.4923991400025294,0.01047173390666498,3167,-931,3404,5640,0.010715200733083241,-0.02920963502680603,0.018494434293722772,187,-237,0.004729986088276239,-0.007779233560639531
1676,12087,Monroe,Florida,2008,20907,18933,563,40403,0.5174615746355469,0.4686038165482761,0.013934608816177016,1253,149,-534,868,0.020332448544741255,0.0034628749095120363,-0.02379532345425328,1974,1787,0.048857758087270775,0.044127771998994536
1677,12087,Monroe,Florida,2012,19404,19234,514,39152,0.4956068655496526,0.49126481405803024,0.013128320392317124,-1503,-49,301,-1251,-0.021854709085894264,-0.0008062884238598921,0.022660997509754144,170,-1804,0.004342051491622367,-0.04451570659564841
1678,12087,Monroe,Florida,2016,18971,21904,2102,42977,0.44142215603695,0.509667961933127,0.04890988202992298,-433,1588,2670,3825,-0.0541847095127026,0.03578156163760586,0.01840314787509678,-2933,-3103,-0.06824580589617701,-0.07258785738779938
1679,12089,Nassau,Florida,2000,6955,16408,424,23787,0.2923865977214445,0.6897885399588011,0.017824862319754487,0,0,0,0,0.0,0.0,0.0,-9453,0,-0.3974019422373566,0.0
1680,12089,Nassau,Florida,2004,8573,23783,387,32743,0.26182695537977585,0.72635372446019,0.011819320160034206,1618,-37,7375,8956,-0.030559642341668636,-0.006005542159720281,0.0365651845013889,-15210,-5757,-0.4645267690804141,-0.06712482684305754
1681,12089,Nassau,Florida,2008,10618,27403,371,38392,0.2765680350072932,0.7137684934361326,0.009663471556574287,2045,-16,3620,5649,0.014741079627517362,-0.0021558486034599193,-0.012585231024057397,-16785,-1575,-0.43720045842883937,0.02732631065157476
1682,12089,Nassau,Florida,2012,10251,29929,434,40614,0.25240065002215983,0.7369133796227901,0.010685970355049982,-367,63,2526,2222,-0.024167384985133378,0.0010224987984756954,0.023144886186657554,-19678,-2893,-0.4845127296006303,-0.04731227117179093
1683,12089,Nassau,Florida,2016,10869,34266,1857,46992,0.2312946884576098,0.7291879468845761,0.039517364657814094,618,1423,4337,6378,-0.021105961564550024,0.028831394302764112,-0.007725432738214022,-23397,-3719,-0.4978932584269663,-0.013380528826336002
1684,12091,Okaloosa,Florida,2000,16989,52186,1644,70819,0.23989324898685382,0.7368926418051652,0.02321410920798091,0,0,0,0,0.0,0.0,0.0,-35197,0,-0.4969993928183114,0.0
1685,12091,Okaloosa,Florida,2004,19368,69693,695,89756,0.21578501715762735,0.7764717679040956,0.007743214938277107,2379,-949,17507,18937,-0.024108231829226473,-0.015470894269703803,0.03957912609893033,-50325,-15128,-0.5606867507464682,-0.06368735792815683
1686,12091,Okaloosa,Florida,2008,25872,68789,1120,95781,0.27011620258715197,0.7181904553095082,0.01169334210333991,6504,425,-904,6025,0.054331185429524614,0.003950127165062803,-0.05828131259458735,-42917,7408,-0.44807425272235624,0.112612498024112
1687,12091,Okaloosa,Florida,2012,23421,70168,1470,95059,0.2463838247825035,0.738152095014675,0.015464080202821405,-2451,350,1379,-722,-0.023732377804648458,0.003770738099481495,0.019961639705166845,-46747,-3830,-0.4917682702321715,-0.043694017509815275
1688,12091,Okaloosa,Florida,2016,23780,71893,6423,102096,0.2329180379250901,0.7041705845478765,0.06291137752703338,359,4953,1725,7037,-0.013465786857413398,0.047447297324211976,-0.03398151046679854,-48113,-1366,-0.4712525466227864,0.02051572360938514
1689,12093,Okeechobee,Florida,2000,4589,5057,208,9854,0.4656992084432718,0.5131926121372031,0.021108179419525065,0,0,0,0,0.0,0.0,0.0,-468,0,-0.047493403693931346,0.0
1690,12093,Okeechobee,Florida,2004,5153,6978,59,12190,0.42272354388843314,0.5724364232977851,0.004840032813781789,564,-149,1921,2336,-0.042975664554838644,-0.016268146605743276,0.05924381116058197,-1825,-1357,-0.14971287940935196,-0.10221947571542062
1691,12093,Okeechobee,Florida,2008,5108,7561,170,12839,0.3978502998675909,0.5889087935197446,0.013240906612664537,-45,111,583,649,-0.024873244020842233,0.008400873798882748,0.016472370221959465,-2453,-628,-0.19105849365215366,-0.0413456142428017
1692,12093,Okeechobee,Florida,2012,4856,7328,181,12365,0.3927213910230489,0.5926405175899717,0.014638091386979378,-252,11,-233,-474,-0.0051289088445419795,0.0013971847743148406,0.0037317240702271492,-2472,-19,-0.1999191265669228,-0.008860632914769129
1693,12093,Okeechobee,Florida,2016,3959,9356,446,13761,0.28769711503524453,0.6798924496766223,0.03241043528813313,-897,265,2028,1396,-0.1050242759878044,0.017772343901153752,0.08725193208665061,-5397,-2925,-0.3921953346413778,-0.192276208074455
1694,12095,Orange,Florida,2000,140236,134531,5388,280155,0.5005657582409737,0.4802020310185433,0.019232210740482945,0,0,0,0,0.0,0.0,0.0,5705,0,0.020363727222430406,0.0
1695,12095,Orange,Florida,2004,193354,192539,2151,388044,0.4982785457319273,0.4961782684437847,0.005543185824287968,53118,-3237,58008,107889,-0.002287212509046399,-0.013689024916194979,0.015976237425241402,815,-4890,0.0021002772881426046,-0.0182634499342878
1696,12095,Orange,Florida,2008,273009,186832,3198,463039,0.5896026036683735,0.40349085066268714,0.006906545668939334,79655,1047,-5707,74995,0.09132405793644616,0.001363359844651366,-0.09268741778109757,86177,85362,0.18611175300568633,0.18401147571754373
1697,12095,Orange,Florida,2012,273665,188589,4986,467240,0.5857054190565876,0.4036234055303484,0.01067117541306395,656,1788,1757,4201,-0.0038971846117858977,0.003764629744124617,0.0001325548676612831,85076,-1101,0.18208201352623915,-0.004029739479447181
1698,12095,Orange,Florida,2016,329894,195216,26792,551902,0.5977401785099529,0.35371497113618,0.04854485035386717,56229,21806,6627,84662,0.012034759453365296,0.03787367494080322,-0.04990843439416842,134678,49602,0.24402520737377287,0.06194319384753372
1699,12097,Osceola,Florida,2000,28187,26237,1266,55690,0.5061411384449632,0.4711258753815766,0.022732986173460226,0,0,0,0,0.0,0.0,0.0,1950,0,0.03501526306338665,0.0
1700,12097,Osceola,Florida,2004,38633,43117,454,82204,0.46996496520850567,0.5245121891878741,0.005522845603620262,10446,-812,16880,26514,-0.036176173236457554,-0.017210140569839966,0.05338631380629755,-4484,-6434,-0.05454722397936845,-0.0895624870427551
1701,12097,Osceola,Florida,2008,59962,40086,877,100925,0.5941243497646768,0.397186029229626,0.0086896210056973,21329,423,-3031,18721,0.12415938455617109,0.0031667754020770385,-0.12732615995824814,19876,24360,0.19693832053505078,0.25148554451441923
1702,12097,Osceola,Florida,2012,67239,40592,1078,108909,0.6173869928105116,0.3727148353212315,0.009898171868256984,7277,201,506,7984,0.023262643045834808,0.0012085508625596843,-0.024471193908394473,26647,6771,0.24467215748928006,0.04773383695422928
1703,12097,Osceola,Florida,2016,85458,50301,5709,141468,0.6040800746458563,0.3555645092883196,0.040355416065824073,18219,4631,9709,32559,-0.013306918164655235,0.03045724419756709,-0.01715032603291189,35157,8510,0.24851556535753672,0.003843407868256654
1704,12099,Palm Beach,Florida,2000,269754,152964,10504,433222,0.6226692088582759,0.3530845617258588,0.02424622941586531,0,0,0,0,0.0,0.0,0.0,116790,0,0.26958464713241714,0.0
1705,12099,Palm Beach,Florida,2004,328687,212688,3247,544622,0.6035139968638799,0.39052406990536553,0.005961933230754541,58933,-7257,59724,111400,-0.01915521199439607,-0.018284296185110765,0.03743950817950675,115999,-791,0.21298992695851432,-0.056594720173902824
1706,12099,Palm Beach,Florida,2008,361271,226037,4128,591436,0.6108370136413745,0.38218336388045365,0.006979622478171772,32584,881,13349,46814,0.007323016777494695,0.0010176892474172304,-0.008340706024911881,135234,19235,0.2286536497609209,0.015663722802406577
1707,12099,Palm Beach,Florida,2012,349651,247398,4349,601398,0.5813970116295698,0.4113715043947602,0.0072314839756700226,-11620,221,21361,9962,-0.029440002011804745,0.00025186149749825085,0.02918814051430657,102253,-32981,0.17002550723480958,-0.058628142526111315
1708,12099,Palm Beach,Florida,2016,374673,272402,19137,666212,0.5623930520615059,0.408881857426765,0.028725090511728998,25022,14788,25004,64814,-0.01900395956806389,0.021493606536058973,-0.002489646967995196,102271,18,0.1535111946347409,-0.016514312600068692
1709,12101,Pasco,Florida,2000,69576,68607,4586,142769,0.48733268426619225,0.48054549657138457,0.03212181916242322,0,0,0,0,0.0,0.0,0.0,969,0,0.006787187694807684,0.0
1710,12101,Pasco,Florida,2004,84749,103230,2937,190916,0.44390726811791575,0.5407090029122755,0.015383728969808712,15173,-1649,34623,48147,-0.0434254161482765,-0.016738090192614505,0.06016350634089096,-18481,-19450,-0.09680173479435977,-0.10358892248916746
1711,12101,Pasco,Florida,2008,102417,110104,3068,215589,0.4750567051194634,0.5107125131616177,0.014230781718918869,17668,131,6874,24673,0.031149437001547653,-0.0011529472508898433,-0.02999648975065783,-7687,10794,-0.03565580804215429,0.06114592675220548
1712,12101,Pasco,Florida,2012,98263,112427,3528,214218,0.4587056176418415,0.5248251780896096,0.01646920426854886,-4154,460,2323,-1371,-0.01635108747762193,0.002238422549629993,0.014112664927991903,-14164,-6477,-0.06611956044776812,-0.03046375240561383
1713,12101,Pasco,Florida,2016,90142,142101,11022,243265,0.37055063408217376,0.5841407518549729,0.04530861406285327,-8121,7494,29674,29047,-0.08815498355966772,0.028839409794304407,0.05931557376536334,-51959,-37795,-0.21359011777279918,-0.14747055732503106
1714,12103,Pinellas,Florida,2000,200657,184849,13020,398526,0.5034978897236316,0.4638317198877865,0.032670390388581924,0,0,0,0,0.0,0.0,0.0,15808,0,0.039666169835845144,0.0
1715,12103,Pinellas,Florida,2004,225460,225686,4211,455357,0.49512799847152894,0.49562431235272547,0.009247689175745625,24803,-8809,40837,56831,-0.00836989125210269,-0.0234227012128363,0.031792592464938985,-226,-16034,-0.0004963138811965306,-0.040162483717041675
1716,12103,Pinellas,Florida,2008,248299,210066,6787,465152,0.5338018540176115,0.45160721656576774,0.014590929416620803,22839,2576,-15620,9795,0.03867385554608255,0.005343240240875178,-0.04401709578695773,38233,38459,0.08219463745184374,0.08269095133304027
1717,12103,Pinellas,Florida,2012,239104,213258,6709,459071,0.5208431811201317,0.46454252174500243,0.01461429713486585,-9195,-78,3192,-6081,-0.012958672897479762,2.3367718245046604e-05,0.01293530517923469,25846,-12387,0.05630065937512929,-0.025893978076714452
1718,12103,Pinellas,Florida,2016,233701,239201,24583,497485,0.46976491753520205,0.48082052725207797,0.04941455521271998,-5403,17874,25943,38414,-0.05107826358492967,0.034800258077854127,0.016278005507075533,-5500,-31346,-0.011055609716875914,-0.0673562690920052
1719,12105,Polk,Florida,2000,75207,90310,3112,168629,0.4459909031068203,0.5355543826981124,0.01845471419506728,0,0,0,0,0.0,0.0,0.0,-15103,0,-0.08956347959129207,0.0
1720,12105,Polk,Florida,2004,86009,123559,1262,210830,0.4079542759569321,0.5860598586538918,0.005985865389176113,10802,-1850,33249,42201,-0.0380366271498882,-0.012468848805891166,0.050505475955779366,-37550,-22447,-0.17810558269695964,-0.08854210310566757
1721,12105,Polk,Florida,2008,113865,128878,2961,245704,0.4634234688893954,0.5245254452511966,0.012051085859408069,27856,1699,5319,34874,0.055469192932463274,0.0060652204702319554,-0.061534413402695165,-15013,22537,-0.0611019763618012,0.11700360633515844
1722,12105,Polk,Florida,2012,114622,131577,3213,249412,0.45956890606706974,0.5275487947652879,0.012882299167642294,757,252,2699,3708,-0.003854562822325658,0.0008312133082342254,0.0030233495140913336,-16955,-1942,-0.0679798886982182,-0.006877912336416991
1723,12105,Polk,Florida,2016,117433,157430,12106,286969,0.40921841732033776,0.5485958413626559,0.042185741317006364,2811,8893,25853,37557,-0.05035048874673198,0.02930344214936407,0.021047046597368002,-39997,-23042,-0.13937742404231818,-0.07139753534409998
1724,12107,Putnam,Florida,2000,12107,13457,675,26239,0.461412401387248,0.5128625328709173,0.025725065741834672,0,0,0,0,0.0,0.0,0.0,-1350,0,-0.05145013148366934,0.0
1725,12107,Putnam,Florida,2004,12412,18311,250,30973,0.4007361250121073,0.5911923288025054,0.008071546185387272,305,-425,4854,4734,-0.06067627637514067,-0.0176535195564474,0.07832979593158806,-5899,-4549,-0.19045620379039807,-0.13900607230672873
1726,12107,Putnam,Florida,2008,13236,19637,406,33279,0.3977282971243126,0.5900718170618108,0.01219988581387662,824,156,1326,2306,-0.0030078278877946896,0.004128339628489347,-0.0011205117406946075,-6401,-502,-0.19234351993749815,-0.0018873161471000821
1727,12107,Putnam,Florida,2012,11667,19326,423,31416,0.37137127578304047,0.6151642475171887,0.013464476699770817,-1569,17,-311,-1863,-0.026357021341272158,0.0012645908858941977,0.0250924304553779,-7659,-1258,-0.2437929717341482,-0.05144945179665006
1728,12107,Putnam,Florida,2016,10094,22138,1069,33301,0.303114020599982,0.6647848412960572,0.03210113810396084,-1573,646,2812,1885,-0.06825725518305847,0.018636661404190024,0.049620593778868516,-12044,-4385,-0.3616708206960752,-0.11787784896192699
1729,12109,St. Johns,Florida,2000,19509,39564,1698,60771,0.321024830922644,0.6510342103964062,0.027940958680949795,0,0,0,0,0.0,0.0,0.0,-20055,0,-0.3300093794737622,0.0
1730,12109,St. Johns,Florida,2004,26399,59196,695,86290,0.30593348012515936,0.6860122841580716,0.008054235716769035,6890,-1003,19632,25519,-0.015091350797484637,-0.01988672296418076,0.034978073761665396,-32797,-12742,-0.3800788040329122,-0.05006942455915003
1731,12109,St. Johns,Florida,2008,35791,69222,1068,106081,0.33739312412213307,0.6525390974821127,0.010067778395754188,9392,373,10026,19791,0.03145964399697371,0.002013542678985153,-0.03347318667595889,-33431,-634,-0.3151459733599796,0.0649328306729326
1732,12109,St. Johns,Florida,2012,35190,78513,1327,115030,0.3059201947318091,0.682543684256281,0.011536121011909936,-601,259,9291,8949,-0.03147292939032398,0.001468342616155749,0.030004586774168285,-43323,-9892,-0.3766234895244719,-0.06147751616449226
1733,12109,St. Johns,Florida,2016,43099,88684,6063,137846,0.3126605052014567,0.6433556287451214,0.04398386605342194,7909,4736,10171,22816,0.006740310469647626,0.032447745041512,-0.03918805551115956,-45585,-2262,-0.3306951235436647,0.045928365980807184
1734,12111,St. Lucie,Florida,2000,41560,34705,1725,77990,0.5328888319015258,0.44499294781382226,0.02211822028465188,0,0,0,0,0.0,0.0,0.0,6855,0,0.08789588408770355,0.0
1735,12111,St. Lucie,Florida,2004,51835,47592,636,100063,0.5180236451035848,0.47562035917372053,0.006355995722694702,10275,-1089,12887,22073,-0.014865186797941021,-0.015762224561957177,0.03062741135989827,4243,-2612,0.042403285929864254,-0.04549259815783929
1736,12111,St. Lucie,Florida,2008,67125,52512,1337,120974,0.5548712946583564,0.43407674376312266,0.011051961578521004,15290,701,4920,20911,0.0368476495547716,0.004695965855826302,-0.04154361541059787,14613,10370,0.12079455089523372,0.07839126496536947
1737,12111,St. Lucie,Florida,2012,65869,56202,1219,123290,0.5342606861870387,0.4558520561278287,0.009887257685132614,-1256,-118,3690,2316,-0.020610608471317682,-0.0011647038933883906,0.021775312364706034,9667,-4946,0.07840863005921,-0.042385920836023716
1738,12111,St. Lucie,Florida,2016,66881,70289,4823,141993,0.47101617685378855,0.49501736001070473,0.03396646313550668,1012,3604,14087,18703,-0.06324450933325015,0.024079205450374064,0.039165303882876035,-3408,-13075,-0.024001183156916184,-0.10240981321612619
1739,12113,Santa Rosa,Florida,2000,12818,36339,1245,50402,0.25431530494821636,0.7209832943137177,0.02470140073806595,0,0,0,0,0.0,0.0,0.0,-23521,0,-0.4666679893655013,0.0
1740,12113,Santa Rosa,Florida,2004,14659,52059,589,67307,0.21779309730042937,0.7734559555469713,0.008750947152599284,1841,-656,15720,16905,-0.03652220764778699,-0.015950453585466665,0.05247266123325367,-37400,-13879,-0.5556628582465419,-0.08899486888104063
1741,12113,Santa Rosa,Florida,2008,19470,55972,935,76377,0.25491967477120075,0.7328384199431766,0.012241905285622636,4811,346,3913,9070,0.03712657747077139,0.0034909581330233516,-0.040617535603794774,-36502,898,-0.4779187451719758,0.07774411307456613
1742,12113,Santa Rosa,Florida,2012,17768,58186,1098,77052,0.2305975185588953,0.7551523646368686,0.0142501168042361,-1702,163,2214,675,-0.024322156212305462,0.002008211518613464,0.022313944693692078,-40418,-3916,-0.5245548460779733,-0.04663610090599751
1743,12113,Santa Rosa,Florida,2016,18464,65339,4881,88684,0.20819990077127778,0.7367619863786027,0.055038112850119524,696,3783,7153,11632,-0.022397617787617508,0.04078799604588342,-0.01839037825826595,-46875,-6457,-0.5285620856073249,-0.004007239529351558
1744,12115,Sarasota,Florida,2000,72869,83117,4991,160977,0.45266715120793655,0.5163284195878914,0.031004429204172023,0,0,0,0,0.0,0.0,0.0,-10248,0,-0.0636612683799549,0.0
1745,12115,Sarasota,Florida,2004,88442,104692,2518,195652,0.45203729069981397,0.5350929200825957,0.012869789217590416,15573,-2473,21575,34675,-0.0006298605081225817,-0.01813463998658161,0.01876450049470424,-16250,-6002,-0.08305562938278171,-0.01939436100282682
1746,12115,Sarasota,Florida,2008,102686,102897,2422,208005,0.49367082522054756,0.4946852239128867,0.011643950866565708,14244,-96,-1795,12353,0.041633534520733595,-0.0012258383510247075,-0.04040769616970896,-211,16039,-0.001014398692339158,0.08204123069044256
1747,12115,Sarasota,Florida,2012,95119,110504,2328,207951,0.45741064000654,0.5313944150304639,0.011194944962996091,-7567,-94,7607,-54,-0.036260185214007534,-0.0004490059035696173,0.0367091911175772,-15385,-15174,-0.07398377502392389,-0.07296937633158473
1748,12115,Sarasota,Florida,2016,97870,124438,9045,231353,0.4230332003475209,0.537870699753191,0.0390960998992881,2751,6717,13934,23402,-0.03437743965901913,0.027901154936292007,0.006476284722727099,-26568,-11183,-0.11483749940567012,-0.040853724381746226
1749,12117,Seminole,Florida,2000,59227,75790,2788,137805,0.4297884692137441,0.5499800442654476,0.02023148652080839,0,0,0,0,0.0,0.0,0.0,-16563,0,-0.12019157505170347,0.0
1750,12117,Seminole,Florida,2004,76971,108172,1052,186195,0.41338918875372593,0.5809608206450227,0.0056499906012513765,17744,-1736,32382,48390,-0.01639928046001815,-0.014581495919557014,0.030980776379575192,-31201,-14638,-0.1675716318912968,-0.04738005683959334
1751,12117,Seminole,Florida,2008,99335,105070,2021,206426,0.4812136068130953,0.5089959598112641,0.009790433375640666,22364,969,-3102,20231,0.06782441805936934,0.004140442774389289,-0.07196486083375864,-5735,25466,-0.027782352998168836,0.13978927889312798
1752,12117,Seminole,Florida,2012,96445,109943,2714,209102,0.461234230184312,0.5257864582835171,0.012979311532170901,-2890,693,4873,2676,-0.019979376628783296,0.003188878156530236,0.016790498472253,-13498,-7763,-0.06455222809920513,-0.0367698751010363
1753,12117,Seminole,Florida,2016,105914,109443,12169,227526,0.46550284363105754,0.4810131589356821,0.05348399743326038,9469,9455,-500,18424,0.004268613446745562,0.04050468590108948,-0.04477329934783503,-3529,9969,-0.015510315304624545,0.04904191279458059
1754,12119,Sumter,Florida,2000,9637,12127,497,22261,0.4329095727954719,0.544764386146175,0.022326041058353174,0,0,0,0,0.0,0.0,0.0,-2490,0,-0.11185481335070308,0.0
1755,12119,Sumter,Florida,2004,11584,19800,458,31842,0.3637962439545255,0.6218202374222724,0.01438351862320206,1947,-39,7673,9581,-0.0691133288409464,-0.007942522435151114,0.07705585127609749,-8216,-5726,-0.25802399346774696,-0.14616918011704388
1756,12119,Sumter,Florida,2008,17655,30866,462,48983,0.3604311699977543,0.6301369863013698,0.009431843700875815,6071,4,11066,17141,-0.0033650739567711585,-0.004951674922326246,0.008316748879097391,-13211,-4995,-0.2697058163036155,-0.01168182283586855
1757,12119,Sumter,Florida,2012,19524,40646,375,60545,0.32247088942109176,0.6713353703856636,0.006193740193244694,1869,-87,9780,11562,-0.037960280576662564,-0.0032381035076311203,0.04119838408429377,-21122,-7911,-0.34886448096457184,-0.07915866466095633
1758,12119,Sumter,Florida,2016,22638,52730,1870,77238,0.2930940728656879,0.682695046479712,0.024210880654600066,3114,1495,12084,16693,-0.029376816555403862,0.01801714046135537,0.011359676094048421,-30092,-8970,-0.3896009736140241,-0.04073649264945228
1759,12121,Suwannee,Florida,2000,4076,8009,376,12461,0.3271005537276302,0.642725302945189,0.030174143327180804,0,0,0,0,0.0,0.0,0.0,-3933,0,-0.31562474921755884,0.0
1760,12121,Suwannee,Florida,2004,4522,11153,127,15802,0.2861663080622706,0.7057967345905581,0.008036957347171244,446,-249,3144,3341,-0.04093424566535958,-0.02213718598000956,0.0630714316453691,-6631,-2698,-0.4196304265282875,-0.10400567731072868
1761,12121,Suwannee,Florida,2008,4916,12534,261,17711,0.2775676133476371,0.7076957822821975,0.014736604370165433,394,134,1381,1909,-0.008598694714633537,0.006699647022994189,0.0018990476916393995,-7618,-987,-0.43012816893456046,-0.010497742406272936
1762,12121,Suwannee,Florida,2012,4751,12672,263,17686,0.2686305552414339,0.7164989257039466,0.014870519054619473,-165,2,138,-25,-0.008937058106203155,0.0001339146844540392,0.008803143421749038,-7921,-303,-0.44786837046251265,-0.017740201527952193
1763,12121,Suwannee,Florida,2016,3964,14287,536,18787,0.21099696598711876,0.7604726672699207,0.02853036674296056,-787,273,1615,1101,-0.057633589254315165,0.013659847688341087,0.04397374156597411,-10323,-2402,-0.549475701282802,-0.10160733082028933
1764,12123,Taylor,Florida,2000,2649,4058,103,6810,0.38898678414096916,0.5958883994126285,0.01512481644640235,0,0,0,0,0.0,0.0,0.0,-1409,0,-0.20690161527165934,0.0
1765,12123,Taylor,Florida,2004,3049,5467,65,8581,0.35531989278638854,0.6371052324903858,0.007574874723225732,400,-38,1409,1771,-0.03366689135458062,-0.0075499417231766185,0.04121683307775725,-2418,-1009,-0.2817853397039972,-0.07488372443233787
1766,12123,Taylor,Florida,2008,2803,6457,127,9387,0.29860445296686905,0.687866197933312,0.0135293490998189,-246,62,990,806,-0.056715439819519486,0.005954474376593168,0.0507609654429263,-3654,-1236,-0.389261744966443,-0.10747640526244578
1767,12123,Taylor,Florida,2012,2764,6249,126,9139,0.30244009191377613,0.6837728416675785,0.013787066418645366,-39,-1,-208,-248,0.003835638946907083,0.0002577173188264663,-0.004093356265733594,-3485,169,-0.3813327497538023,0.007928995212640677
1768,12123,Taylor,Florida,2016,2152,6930,266,9348,0.23020967051775781,0.7413350449293966,0.028455284552845527,-612,140,681,209,-0.07223042139601832,0.014668218134200162,0.05756220326181816,-4778,-1293,-0.5111253744116389,-0.12979262465783653
1769,12125,Union,Florida,2000,1407,2332,87,3826,0.36774699424986934,0.6095138525875589,0.022739153162571878,0,0,0,0,0.0,0.0,0.0,-925,0,-0.24176685833768952,0.0
1770,12125,Union,Florida,2004,1251,3396,28,4675,0.2675935828877005,0.7264171122994653,0.005989304812834224,-156,-59,1064,849,-0.10015341136216882,-0.016749848349737653,0.1169032597119064,-2145,-1220,-0.45882352941176474,-0.21705667107407522
1771,12125,Union,Florida,2008,1300,3940,70,5310,0.2448210922787194,0.7419962335216572,0.013182674199623353,49,42,544,635,-0.022772490608981122,0.007193369386789128,0.01557912122219196,-2640,-495,-0.4971751412429378,-0.03835161183117308
1772,12125,Union,Florida,2012,1339,3980,86,5405,0.24773358001850138,0.7363552266419982,0.015911193339500463,39,16,40,95,0.002912487739781977,0.0027285191398771103,-0.005641006879659072,-2641,-1,-0.4886216466234968,0.008553494619441049
1773,12125,Union,Florida,2016,1014,4568,140,5722,0.17721076546662007,0.7983222649423278,0.02446696959105208,-325,54,588,317,-0.07052281455188131,0.008555776251551617,0.06196703830032968,-3554,-913,-0.6211114994757078,-0.132489852852211
1774,12127,Volusia,Florida,2000,97313,82368,3993,183674,0.5298136916493352,0.4484467044872981,0.021739603863366617,0,0,0,0,0.0,0.0,0.0,14945,0,0.08136698716203711,0.0
1775,12127,Volusia,Florida,2004,115519,111924,1496,228939,0.5045841905485741,0.48888131773092397,0.006534491720501968,18206,-2497,29556,45265,-0.025229501100761165,-0.01520511214286465,0.04043461324362585,3595,-11350,0.015702872817650093,-0.06566411434438701
1776,12127,Volusia,Florida,2008,127795,113938,3122,244855,0.5219211369994486,0.46532845970063913,0.012750403299912193,12276,1626,2014,15916,0.01733694645087458,0.006215911579410225,-0.02355285803028484,13857,10262,0.05659267729880951,0.04088980448115942
1777,12127,Volusia,Florida,2012,114748,117490,2993,235231,0.487809854993602,0.4994664818837653,0.012723663122632647,-13047,-129,3552,-9624,-0.03411128200584662,-2.6740177279546e-05,0.03413802218312617,-2742,-16599,-0.01165662689016328,-0.06824930418897279
1778,12127,Volusia,Florida,2016,109091,143007,11180,263278,0.41435668760777583,0.5431786932444033,0.04246461914782093,-5657,8187,25517,28047,-0.07345316738582619,0.029740956025188284,0.043712211360637965,-33916,-31174,-0.12882200563662743,-0.11716537874646415
1779,12129,Wakulla,Florida,2000,3838,4512,237,8587,0.44695469896354956,0.5254454407825783,0.027599860253872132,0,0,0,0,0.0,0.0,0.0,-674,0,-0.07849074181902871,0.0
1780,12129,Wakulla,Florida,2004,4896,6777,90,11763,0.4162203519510329,0.5761285386381025,0.0076511094108645756,1058,-147,2265,3176,-0.03073434701251665,-0.019948750843007557,0.05068309785552427,-1881,-1207,-0.15990818668706963,-0.08141744486804092
1781,12129,Wakulla,Florida,2008,5311,8877,188,14376,0.3694351697273233,0.6174874791318865,0.013077351140790205,415,98,2100,2613,-0.04678518222370959,0.0054262417299256295,0.04135894049378397,-3566,-1685,-0.2480523094045632,-0.08814412271749356
1782,12129,Wakulla,Florida,2012,5175,9290,227,14692,0.3522325074870678,0.6323169071603594,0.015450585352572828,-136,39,413,316,-0.017202662240255517,0.002373234211782623,0.014829428028472869,-4115,-549,-0.2800843996732916,-0.032032090268728386
1783,12129,Wakulla,Florida,2016,4348,10512,584,15444,0.28153328153328155,0.6806526806526807,0.03781403781403781,-827,357,1222,752,-0.07069922595378625,0.022363452461464983,0.04833577349232132,-6164,-2049,-0.39911939911939914,-0.11903499944610757
1784,12131,Walton,Florida,2000,5643,12186,494,18323,0.3079735851116084,0.6650657643399007,0.026960650548490967,0,0,0,0,0.0,0.0,0.0,-6543,0,-0.35709217922829234,0.0
1785,12131,Walton,Florida,2004,6213,17555,208,23976,0.2591341341341341,0.7321905238571905,0.008675342008675343,570,-286,5369,5653,-0.048839450977474275,-0.018285308539815623,0.0671247595172898,-11342,-4799,-0.4730563897230564,-0.11596421049476408
1786,12131,Walton,Florida,2008,7174,19561,404,27139,0.26434282766498396,0.7207708463834335,0.014886325951582593,961,196,2006,3163,0.0052086935308498505,0.00621098394290725,-0.01141967747375705,-12387,-1045,-0.4564280187184495,0.0166283710046069
1787,12131,Walton,Florida,2012,6671,21490,418,28579,0.23342314286714022,0.7519507330557402,0.014626124077119563,-503,14,1929,1440,-0.03091968479784374,-0.0002602018744630296,0.031179886672306756,-14819,-2432,-0.5185275901886,-0.06209957147015044
1788,12131,Walton,Florida,2016,6876,25756,1266,33898,0.20284382559443034,0.7598088382795445,0.03734733612602514,205,848,4266,5319,-0.030579317272709877,0.02272121204890557,0.007858105223804257,-18880,-4061,-0.5569650126851141,-0.03843742249651416
1789,12133,Washington,Florida,2000,2798,4995,233,8026,0.34861699476700725,0.6223523548467481,0.029030650386244704,0,0,0,0,0.0,0.0,0.0,-2197,0,-0.27373536007974086,0.0
1790,12133,Washington,Florida,2004,2912,7369,85,10366,0.280918387034536,0.7108817287285356,0.00819988423692842,114,-148,2374,2340,-0.06769860773247127,-0.020830766149316282,0.0885293738817875,-4457,-2260,-0.42996334169399963,-0.15622798161425877
1791,12133,Washington,Florida,2008,2863,8178,126,11167,0.2563804065550282,0.7323363481687114,0.01128324527626041,-49,41,809,801,-0.02453798047950778,0.003083361039331989,0.021454619440175793,-5315,-858,-0.4759559416136832,-0.045992599919683574
1792,12133,Washington,Florida,2012,2820,8038,178,11036,0.25552736498731426,0.7283436027546213,0.016129032258064516,-43,52,-140,-131,-0.0008530415677139302,0.004845786981804106,-0.003992745414090115,-5218,97,-0.472816237767307,0.003139703846376185
1793,12133,Washington,Florida,2016,2264,8637,310,11211,0.20194451877620195,0.7704040674337704,0.02765141379002765,-556,132,599,175,-0.05358284621111231,0.011522381531963135,0.042060464679149145,-6373,-1155,-0.5684595486575685,-0.09564331089026151
1794,13001,Appling,Georgia,2000,2093,3940,66,6099,0.3431710116412527,0.6460075422200361,0.010821446138711265,0,0,0,0,0.0,0.0,0.0,-1847,0,-0.3028365305787834,0.0
1795,13001,Appling,Georgia,2004,1848,4494,31,6373,0.2899733249646948,0.7051624038914169,0.004864271143888279,-245,-35,554,274,-0.05319768667655789,-0.005957174994822986,0.05915486167138084,-2646,-799,-0.41518907892672213,-0.11235254834793873
1796,13001,Appling,Georgia,2008,1846,5085,71,7002,0.26363896029705797,0.7262210796915167,0.010139960011425307,-2,40,591,629,-0.026334364667636834,0.005275688867537028,0.02105867580009979,-3239,-593,-0.46258211939445876,-0.047393040467736625
1797,13001,Appling,Georgia,2012,1758,5233,102,7093,0.24784999295079657,0.7377696320315804,0.014380375017623008,-88,31,148,91,-0.015788967346261396,0.004240415006197701,0.01154855234006369,-3475,-236,-0.48991963908078384,-0.027337519686325085
1798,13001,Appling,Georgia,2016,1434,5494,84,7012,0.2045065601825442,0.7835139760410724,0.011979463776383342,-324,-18,261,-81,-0.043343432768252366,-0.0024009112412396658,0.04574434400949201,-4060,-585,-0.5790074158585282,-0.08908777677774438
1799,13003,Atkinson,Georgia,2000,821,1228,22,2071,0.3964268469338484,0.5929502655721873,0.010622887493964268,0,0,0,0,0.0,0.0,0.0,-407,0,-0.19652341863833894,0.0
1800,13003,Atkinson,Georgia,2004,799,1666,8,2473,0.32308936514355036,0.6736756975333603,0.003234937323089365,-22,-14,438,402,-0.07333748179029803,-0.0073879501708749035,0.08072543196117299,-867,-460,-0.35058633238980996,-0.15406291375147102
1801,13003,Atkinson,Georgia,2008,938,1941,28,2907,0.3226694186446508,0.6676986584107327,0.009631922944616443,139,20,275,434,-0.00041994649889953717,0.006396985621527079,-0.005977039122627592,-1003,-136,-0.3450292397660819,0.005557092623728055
1802,13003,Atkinson,Georgia,2012,930,1938,39,2907,0.31991744066047473,0.6666666666666666,0.013415892672858616,-8,11,-3,0,-0.0027519779841760905,0.003783969728242173,-0.0010319917440660964,-1008,-5,-0.3467492260061919,-0.0017199862401099941
1803,13003,Atkinson,Georgia,2016,697,1878,35,2610,0.2670498084291188,0.7195402298850575,0.013409961685823755,-233,-4,-60,-297,-0.05286763223135593,-5.930987034861307e-06,0.05287356321839087,-1181,-173,-0.4524904214559387,-0.1057411954497468
1804,13005,Bacon,Georgia,2000,956,2010,29,2995,0.3191986644407346,0.671118530884808,0.009682804674457429,0,0,0,0,0.0,0.0,0.0,-1054,0,-0.3519198664440734,0.0
1805,13005,Bacon,Georgia,2004,930,2853,9,3792,0.24525316455696203,0.752373417721519,0.0023734177215189874,-26,-20,843,797,-0.07394549988377255,-0.007309386952938441,0.081254886836711,-1923,-869,-0.507120253164557,-0.15520038672048359
1806,13005,Bacon,Georgia,2008,817,3089,36,3942,0.20725520040588533,0.7836123795027905,0.0091324200913242,-113,27,236,150,-0.0379979641510767,0.0067590023698052126,0.0312389617812715,-2272,-349,-0.5763571790969052,-0.0692369259323482
1807,13005,Bacon,Georgia,2012,791,3093,52,3936,0.20096544715447154,0.7858231707317073,0.013211382113821139,-26,16,4,-6,-0.006289753251413788,0.0040789620224969386,0.002210791228916764,-2302,-30,-0.5848577235772358,-0.008500544480330552
1808,13005,Bacon,Georgia,2016,608,3364,48,4020,0.15124378109452735,0.83681592039801,0.011940298507462687,-183,-4,271,84,-0.049721666059944186,-0.0012710836063584523,0.05099274966630274,-2756,-454,-0.6855721393034826,-0.10071441572624684
1809,13007,Baker,Georgia,2000,893,615,11,1519,0.5878867676102699,0.4048716260697828,0.007241606319947334,0,0,0,0,0.0,0.0,0.0,278,0,0.18301514154048715,0.0
1810,13007,Baker,Georgia,2004,936,821,8,1765,0.5303116147308782,0.4651558073654391,0.004532577903682719,43,-3,206,246,-0.057575152879391744,-0.0027090284162646144,0.060284181295656325,115,-163,0.06515580736543908,-0.11785933417504807
1811,13007,Baker,Georgia,2008,846,828,15,1689,0.5008880994671403,0.49023090586145646,0.008880994671403197,-90,7,7,-76,-0.029423515263737876,0.004348416767720477,0.025075098496017356,18,-97,0.010657193605683846,-0.05449861375975523
1812,13007,Baker,Georgia,2012,794,785,12,1591,0.49905719673161536,0.49340037712130735,0.00754242614707731,-52,-3,-43,-98,-0.0018309027355249419,-0.0013385685243258866,0.003169471259850898,9,-9,0.005656819610308006,-0.00500037399537584
1813,13007,Baker,Georgia,2016,650,775,15,1440,0.4513888888888889,0.5381944444444444,0.010416666666666666,-144,3,-10,-151,-0.047668307842726465,0.002874240519589356,0.044794067323137066,-125,-134,-0.08680555555555552,-0.09246237516586353
1814,13009,Baldwin,Georgia,2000,5893,6041,192,12126,0.4859805376876134,0.49818571664192646,0.01583374567046017,0,0,0,0,0.0,0.0,0.0,-148,0,-0.012205178954313056,0.0
1815,13009,Baldwin,Georgia,2004,6775,7709,91,14575,0.4648370497427101,0.5289193825042882,0.006243567753001715,882,-101,1668,2449,-0.021143487944903283,-0.009590177917458455,0.030733665862361703,-934,-786,-0.06408233276157804,-0.051877153807264986
1816,13009,Baldwin,Georgia,2008,8587,7823,154,16564,0.5184134267085245,0.4722893021009418,0.009297271190533687,1812,63,114,1989,0.05357637696581441,0.003053703437531972,-0.05663008040334638,764,1698,0.04612412460758275,0.11020645736916079
1817,13009,Baldwin,Georgia,2012,8483,7589,198,16270,0.5213890596189306,0.4664413030116779,0.012169637369391518,-104,44,-234,-294,0.002975632910406034,0.002872366178857831,-0.005847999089263867,894,130,0.05494775660725265,0.0088236319996699
1818,13009,Baldwin,Georgia,2016,7970,7697,449,16116,0.4945395879870936,0.4775999007197816,0.027860511293124845,-513,251,108,-154,-0.026849471631836985,0.015690873923733327,0.011158597708103679,273,-621,0.016939687267311987,-0.038008069339940664
1819,13011,Banks,Georgia,2000,1220,3202,111,4533,0.26913743657621886,0.7063754687844694,0.024487094639311716,0,0,0,0,0.0,0.0,0.0,-1982,0,-0.4372380322082506,0.0
1820,13011,Banks,Georgia,2004,1149,4410,33,5592,0.20547210300429183,0.7886266094420601,0.005901287553648069,-71,-78,1208,1059,-0.06366533357192702,-0.018585807085663646,0.08225114065759065,-3261,-1279,-0.5831545064377682,-0.14591647422951765
1821,13011,Banks,Georgia,2008,1027,5120,102,6249,0.16434629540726517,0.8193310929748759,0.01632261161785886,-122,69,710,657,-0.041125807597026665,0.010421324064210789,0.03070448353281585,-4093,-832,-0.6549847975676107,-0.07183029112984252
1822,13011,Banks,Georgia,2012,780,5354,70,6204,0.12572533849129594,0.8629916183107672,0.011283043197936816,-247,-32,234,-45,-0.03862095691596923,-0.005039568419922043,0.043660525335891265,-4574,-481,-0.7372662798194712,-0.0822814822518605
1823,13011,Banks,Georgia,2016,684,6134,157,6975,0.09806451612903226,0.879426523297491,0.0225089605734767,-96,87,780,771,-0.02766082236226368,0.011225917375539886,0.01643490498672384,-5450,-876,-0.7813620071684588,-0.04409572734898759
1824,13013,Barrow,Georgia,2000,3657,7925,520,12102,0.30218145761031234,0.6548504379441414,0.04296810444554619,0,0,0,0,0.0,0.0,0.0,-4268,0,-0.3526689803338291,0.0
1825,13013,Barrow,Georgia,2004,4095,13520,135,17750,0.23070422535211269,0.7616901408450705,0.007605633802816901,438,-385,5595,5648,-0.07147723225819966,-0.035362470642729286,0.10683970290092903,-9425,-5157,-0.5309859154929578,-0.17831693515912872
1826,13013,Barrow,Georgia,2008,6657,17625,351,24633,0.27024722932651324,0.7155035927414444,0.014249177932042383,2562,216,4105,6883,0.039543003974400553,0.006643544129225481,-0.0461865481036261,-10968,-1543,-0.44525636341493113,0.08572955207802668
1827,13013,Barrow,Georgia,2012,6028,18725,517,25270,0.23854372774040364,0.7409972299168975,0.020459042342698852,-629,166,1100,637,-0.0317035015861096,0.00620986441065647,0.025493637175453165,-12697,-1729,-0.5024535021764939,-0.05719713876156274
1828,13013,Barrow,Georgia,2016,6580,21108,1373,29061,0.22642028835896907,0.7263342624135439,0.04724544922748701,552,856,2383,3791,-0.012123439381434564,0.026786406884788158,-0.014662967503353608,-14528,-1831,-0.49991397405457483,0.0025395281219190435
1829,13015,Bartow,Georgia,2000,7508,14720,553,22781,0.32957288968877574,0.6461524955006365,0.02427461481058777,0,0,0,0,0.0,0.0,0.0,-7212,0,-0.31657960581186073,0.0
1830,13015,Bartow,Georgia,2004,7741,22311,239,30291,0.25555445511868213,0.736555412498762,0.007890132382555875,233,-314,7591,7510,-0.0740184345700936,-0.016384482428031893,0.09040291699812553,-14570,-7358,-0.48100095738007986,-0.16442135156821913
1831,13015,Bartow,Georgia,2008,9662,25976,537,36175,0.26709053213545264,0.7180649619903248,0.014844505874222529,1921,298,3665,5884,0.011536077016770507,0.006954373491666653,-0.01849045050843723,-16314,-1744,-0.4509744298548721,0.030026527525207736
1832,13015,Bartow,Georgia,2012,8396,26876,625,35897,0.23389141153856868,0.7486976627573335,0.017410925704097836,-1266,88,900,-278,-0.03319912059688396,0.0025664198298753077,0.030632700767008747,-18480,-2166,-0.5148062512187648,-0.06383182136389265
1833,13015,Bartow,Georgia,2016,8212,29911,1610,39733,0.2066795862381396,0.7527999395968087,0.04052047416505172,-184,985,3035,3836,-0.027211825300429093,0.023109548460953887,0.004102276839475172,-21699,-3219,-0.5461203533586692,-0.031314102139904376
1834,13017,Ben Hill,Georgia,2000,2234,2381,46,4661,0.47929628835013943,0.5108345848530358,0.009869126796824716,0,0,0,0,0.0,0.0,0.0,-147,0,-0.03153829650289636,0.0
1835,13017,Ben Hill,Georgia,2004,2180,3331,34,5545,0.3931469792605951,0.6007213706041479,0.0061316501352569885,-54,-12,950,884,-0.08614930908954432,-0.0037374766615677277,0.08988678575111209,-1151,-1004,-0.20757439134355277,-0.1760360948406564
1836,13017,Ben Hill,Georgia,2008,2590,3417,45,6052,0.42795769993390614,0.5646067415730337,0.007435558493060146,410,11,86,507,0.034810720673311035,0.0013039083578031572,-0.036114629031114176,-827,324,-0.13664904163912756,0.07092534970442521
1837,13017,Ben Hill,Georgia,2012,2512,3396,62,5970,0.4207705192629816,0.5688442211055277,0.010385259631490788,-78,17,-21,-82,-0.007187180670924553,0.002949701138430642,0.004237479532493982,-884,-57,-0.1480737018425461,-0.011424660203418535
1838,13017,Ben Hill,Georgia,2016,2101,3739,96,5936,0.3539420485175202,0.6298854447439353,0.016172506738544475,-411,34,343,-34,-0.06682847074546139,0.005787247107053688,0.06104122363840758,-1638,-754,-0.27594339622641506,-0.12786969438386897
1839,13019,Berrien,Georgia,2000,1640,2718,52,4410,0.37188208616780044,0.6163265306122448,0.011791383219954649,0,0,0,0,0.0,0.0,0.0,-1078,0,-0.2444444444444444,0.0
1840,13019,Berrien,Georgia,2004,1638,3917,51,5606,0.2921869425615412,0.6987156617909382,0.009097395647520514,-2,-1,1199,1196,-0.07969514360625923,-0.002693987572434135,0.0823891311786934,-2279,-1201,-0.40652871922939704,-0.16208427478495263
1841,13019,Berrien,Georgia,2008,1471,4901,81,6453,0.2279559894622656,0.7594917092825043,0.012552301255230125,-167,30,984,847,-0.0642309530992756,0.0034549056077096112,0.060776047491566065,-3430,-1151,-0.5315357198202387,-0.1250070005908417
1842,13019,Berrien,Georgia,2012,1273,4843,108,6224,0.20453084832904883,0.7781169665809768,0.017352185089974295,-198,27,-58,-229,-0.02342514113321678,0.004799883834744169,0.01862525729847253,-3570,-140,-0.573586118251928,-0.04205039843168923
1843,13019,Berrien,Georgia,2016,1047,5422,121,6590,0.15887708649468893,0.8227617602427921,0.018361153262518966,-226,13,579,366,-0.0456537618343599,0.001008968172544672,0.044644793661815285,-4375,-805,-0.6638846737481032,-0.09029855549617527
1844,13021,Bibb,Georgia,2000,24996,24071,709,49776,0.5021697203471552,0.48358646737383476,0.014243812279009964,0,0,0,0,0.0,0.0,0.0,925,0,0.018583252973320474,0.0
1845,13021,Bibb,Georgia,2004,29322,28107,359,57788,0.5074063819478092,0.48638125562400497,0.006212362428185783,4326,-350,4036,8012,0.005236661600653947,-0.008031449850824181,0.0027947882501702104,1215,290,0.02102512632380421,0.0024418733504837364
1846,13021,Bibb,Georgia,2008,38987,27037,424,66448,0.5867294726703588,0.40688959788104984,0.00638092944859138,9665,65,-1070,8660,0.07932309072254962,0.00016856702040559703,-0.07949165774295514,11950,10735,0.17983987478930896,0.15881474846550475
1847,13021,Bibb,Georgia,2012,38585,25623,595,64803,0.5954199651250713,0.3953983611869821,0.009181673687946547,-402,171,-1414,-1645,0.00869049245471254,0.0028007442393551667,-0.011491236694067763,12962,1012,0.20002160393808927,0.020181729148780303
1848,13021,Bibb,Georgia,2016,36787,24043,1766,62596,0.5876893092210365,0.38409802543293503,0.0282126653460285,-1798,1171,-1580,-2207,-0.007730655904034878,0.019030991658081954,-0.011300335754047042,12744,-218,0.20359128378810143,0.003569679850012164
1849,13023,Bleckley,Georgia,2000,1273,2436,40,3749,0.33955721525740196,0.6497732728727661,0.010669511869831956,0,0,0,0,0.0,0.0,0.0,-1163,0,-0.31021605761536414,0.0
1850,13023,Bleckley,Georgia,2004,1281,3167,23,4471,0.28651308432118094,0.7083426526504137,0.005144263028405279,8,-17,731,722,-0.05304413093622101,-0.005525248841426677,0.058569379777647645,-1886,-723,-0.4218295683292328,-0.11161351071386866
1851,13023,Bleckley,Georgia,2008,1380,3657,47,5084,0.27143981117230526,0.719315499606609,0.00924468922108576,99,24,490,613,-0.015073273148875688,0.004100426192680481,0.01097284695619527,-2277,-391,-0.44787568843430375,-0.026046120105070958
1852,13023,Bleckley,Georgia,2012,1269,3587,64,4920,0.2579268292682927,0.7290650406504066,0.013008130081300813,-111,17,-70,-164,-0.013512981904012566,0.0037634408602150535,0.00974954104379755,-2318,-41,-0.47113821138211387,-0.023262522947810116
1853,13023,Bleckley,Georgia,2016,1101,3719,154,4974,0.22135102533172496,0.7476879774829112,0.03096099718536389,-168,90,132,54,-0.03657580393656773,0.01795286710406308,0.0186229368325046,-2618,-300,-0.5263369521511863,-0.055198740769072385
1854,13025,Brantley,Georgia,2000,1372,3118,76,4566,0.3004818221638195,0.6828734121769602,0.016644765659220323,0,0,0,0,0.0,0.0,0.0,-1746,0,-0.38239159001314066,0.0
1855,13025,Brantley,Georgia,2004,1258,4333,35,5626,0.22360469249911127,0.7701741912548881,0.006221116246000711,-114,-41,1215,1060,-0.07687712966470825,-0.010423649413219611,0.08730077907792788,-3075,-1329,-0.5465694987557768,-0.1641779087426361
1856,13025,Brantley,Georgia,2008,1119,5080,89,6288,0.17795801526717558,0.8078880407124682,0.014153944020356234,-139,54,747,662,-0.04564667723193569,0.007932827774355524,0.03771384945758016,-3961,-886,-0.6299300254452926,-0.08336052668951588
1857,13025,Brantley,Georgia,2012,939,4964,117,6020,0.15598006644518272,0.8245847176079735,0.019435215946843856,-180,28,-116,-268,-0.02197794882199286,0.005281271926487622,0.016696676895505247,-4025,-64,-0.6686046511627908,-0.038674625717498134
1858,13025,Brantley,Georgia,2016,619,5567,115,6301,0.09823837486113315,0.8835105538803365,0.018251071258530392,-320,-2,603,281,-0.05774169158404957,-0.0011841446883134633,0.05892583627236303,-4948,-923,-0.7852721790192033,-0.11666752785641255
1859,13027,Brooks,Georgia,2000,2096,2406,49,4551,0.46055811909470445,0.5286750164798946,0.01076686442540101,0,0,0,0,0.0,0.0,0.0,-310,0,-0.06811689738519011,0.0
1860,13027,Brooks,Georgia,2004,2193,2912,12,5117,0.42857142857142855,0.5690834473324213,0.002345124096150088,97,-37,506,566,-0.03198669052327591,-0.008421740329250922,0.04040843085252677,-719,-409,-0.14051201876099279,-0.07239512137580267
1861,13027,Brooks,Georgia,2008,2669,3507,29,6205,0.4301369863013699,0.5651893634165995,0.004673650282030621,476,17,595,1088,0.0015655577299413248,0.002328526185880533,-0.0038940839158218,-838,-119,-0.13505237711522966,0.005459641645763125
1862,13027,Brooks,Georgia,2012,3138,3554,62,6754,0.46461356233343204,0.5262066923304708,0.009179745336097127,469,33,47,549,0.03447657603206217,0.004506095054066506,-0.03898267108612874,-416,422,-0.061593129997038754,0.0734592471181909
1863,13027,Brooks,Georgia,2016,2528,3701,107,6336,0.398989898989899,0.5841224747474747,0.016887626262626264,-610,45,147,-418,-0.06562366334353303,0.007707880926529137,0.0579157824170039,-1173,-757,-0.1851325757575757,-0.12353944576053694
1864,13029,Bryan,Georgia,2000,2172,4835,52,7059,0.3076923076923077,0.6849412098030883,0.007366482504604052,0,0,0,0,0.0,0.0,0.0,-2663,0,-0.37724890211078055,0.0
1865,13029,Bryan,Georgia,2004,2590,7363,41,9994,0.2591554932959776,0.7367420452271363,0.004102461476886132,418,-11,2528,2935,-0.04853681439633012,-0.0032640210277179197,0.05180083542404801,-4773,-2110,-0.4775865519311587,-0.10033764982037813
1866,13029,Bryan,Georgia,2008,3636,9112,119,12867,0.28258335276288177,0.7081681821714463,0.009248465065671873,1046,78,1749,2873,0.023427859466904177,0.005146003588785741,-0.028573863055689985,-5476,-703,-0.4255848294085645,0.05200172252259416
1867,13029,Bryan,Georgia,2012,3707,9560,209,13476,0.2750816265954289,0.709409320273078,0.015509053131493025,71,90,448,609,-0.007501726167452871,0.006260588065821152,0.0012411381016317335,-5853,-377,-0.4343276936776491,-0.008742864269084605
1868,13029,Bryan,Georgia,2016,4014,10529,630,15173,0.2645488697027615,0.6939300072497199,0.04152112304751862,307,421,969,1697,-0.010532756892667416,0.026012069916025594,-0.015479313023358143,-6515,-662,-0.4293811375469584,0.004946556130690727
1869,13031,Bulloch,Georgia,2000,5561,8990,231,14782,0.3762007847381951,0.6081721012041672,0.015627114057637666,0,0,0,0,0.0,0.0,0.0,-3429,0,-0.23197131646597208,0.0
1870,13031,Bulloch,Georgia,2004,6840,12252,120,19212,0.3560274828232355,0.6377264209868831,0.006246096189881324,1279,-111,3262,4430,-0.02017330191495964,-0.009381017867756343,0.029554319782715943,-5412,-1983,-0.28169893816364766,-0.049727621697675584
1871,13031,Bulloch,Georgia,2008,9586,14174,216,23976,0.3998164831498165,0.5911745078411745,0.009009009009009009,2746,96,1922,4764,0.04378900032658101,0.002762912819127685,-0.04655191314570861,-4588,824,-0.19135802469135804,0.09034091347228962
1872,13031,Bulloch,Georgia,2012,9593,14174,366,24133,0.3975054904073261,0.5873285542617992,0.015165955330874736,7,150,0,157,-0.002310992742490414,0.006156946321865727,-0.0038459535793753385,-4581,7,-0.18982306385447312,0.0015349608368849244
1873,13031,Bulloch,Georgia,2016,9261,15097,958,25316,0.3658160846895244,0.5963422341602149,0.0378416811502607,-332,592,923,1183,-0.031689405717801655,0.022675725819385966,0.009013679898415727,-5836,-1255,-0.2305261494706905,-0.04070308561621738
1874,13033,Burke,Georgia,2000,3720,3381,34,7135,0.5213735108619482,0.47386124737210933,0.004765241765942537,0,0,0,0,0.0,0.0,0.0,339,0,0.047512263489838835,0.0
1875,13033,Burke,Georgia,2004,4213,4232,42,8487,0.49640626841051017,0.4986449864498645,0.00494874513962531,493,8,851,1352,-0.024967242451438,0.00018350337368277288,0.024783739077755162,-19,-358,-0.002238718039354326,-0.04975098152919316
1876,13033,Burke,Georgia,2008,5233,4344,60,9637,0.54301131057383,0.45076268548303416,0.006226003943135831,1020,18,112,1150,0.04660504216331984,0.001277258803510521,-0.04788230096683033,889,908,0.09224862509079584,0.09448734313015017
1877,13033,Burke,Georgia,2012,5405,4301,87,9793,0.551924844276524,0.4391912590625957,0.00888389666088022,172,27,-43,156,0.008913533702693988,0.00265789271774439,-0.011571426420438458,1104,215,0.11273358521392829,0.020484960123132445
1878,13033,Burke,Georgia,2016,4731,4491,129,9351,0.505935194096888,0.480269489894129,0.013795316008982997,-674,42,190,-442,-0.045989650179635966,0.004911419348102776,0.04107823083153328,240,-864,0.025665704202759043,-0.08706788101116925
1879,13035,Butts,Georgia,2000,2281,3198,156,5635,0.40479148181011537,0.5675244010647738,0.027684117125110912,0,0,0,0,0.0,0.0,0.0,-917,0,-0.16273291925465838,0.0
1880,13035,Butts,Georgia,2004,2572,5119,51,7742,0.33221389821751485,0.661198656677861,0.006587445104624128,291,-105,1921,2107,-0.07257758359260053,-0.021096672020486783,0.09367425561308729,-2547,-1630,-0.3289847584603462,-0.1662518392056878
1881,13035,Butts,Georgia,2008,3065,5947,92,9104,0.3366652021089631,0.6532293497363796,0.010105448154657293,493,41,828,1362,0.004451303891448266,0.0035180030500331656,-0.007969306941481458,-2882,-335,-0.31656414762741647,0.012420610832929724
1882,13035,Butts,Georgia,2012,2968,6306,126,9400,0.31574468085106383,0.6708510638297872,0.013404255319148937,-97,34,359,296,-0.020920521257899283,0.0032988071644916434,0.017621714093407626,-3338,-456,-0.3551063829787234,-0.03854223535130691
1883,13035,Butts,Georgia,2016,2566,6717,231,9514,0.269707799033004,0.7060121925583351,0.02428000840866092,-402,105,411,114,-0.046036881818059816,0.010875753089511983,0.03516112872854793,-4151,-813,-0.4363043935253311,-0.08119801054660775
1884,13037,Calhoun,Georgia,2000,1107,768,12,1887,0.5866454689984102,0.4069952305246423,0.006359300476947536,0,0,0,0,0.0,0.0,0.0,339,0,0.17965023847376788,0.0
1885,13037,Calhoun,Georgia,2004,1119,890,10,2019,0.5542347696879644,0.4408122833085686,0.004952947003467063,12,-2,122,132,-0.03241069931044582,-0.0014063534734804735,0.03381705278392627,229,-110,0.11342248637939578,-0.0662277520943721
1886,13037,Calhoun,Georgia,2008,1342,862,8,2212,0.6066907775768535,0.3896925858951175,0.003616636528028933,223,-2,-28,193,0.052456007888889156,-0.0013363104754381297,-0.05111969741345107,480,251,0.216998191681736,0.10357570530234023
1887,13037,Calhoun,Georgia,2012,1298,883,8,2189,0.592964824120603,0.403380539058931,0.003654636820465966,-44,0,21,-23,-0.013725953456250495,3.8000292437033196e-05,0.013687953163813493,415,-65,0.18958428506167202,-0.027413906620063988
1888,13037,Calhoun,Georgia,2016,1179,830,16,2025,0.5822222222222222,0.40987654320987654,0.007901234567901235,-119,8,-53,-164,-0.010742601898380832,0.004246597747435269,0.0064960041509455335,349,-66,0.17234567901234565,-0.017238606049326366
1889,13039,Camden,Georgia,2000,3636,6371,112,10119,0.35932404387785355,0.6296076687419706,0.011068287380175906,0,0,0,0,0.0,0.0,0.0,-2735,0,-0.27028362486411706,0.0
1890,13039,Camden,Georgia,2004,4637,9488,68,14193,0.3267103501726203,0.6684985556260128,0.004791094201366871,1001,-44,3117,4074,-0.03261369370523326,-0.006277193178809035,0.038890886884042186,-4851,-2116,-0.3417882054533925,-0.07150458058927545
1891,13039,Camden,Georgia,2008,6482,10502,124,17108,0.3788870703764321,0.6138648585457096,0.007248071077858312,1845,56,1014,2915,0.05217672020381181,0.0024569768764914407,-0.05463369708030319,-4020,831,-0.2349777881692775,0.106810417284115
1892,13039,Camden,Georgia,2012,6377,11343,330,18050,0.35329639889196673,0.628421052631579,0.018282548476454295,-105,206,841,942,-0.025590671484465366,0.011034477398595983,0.01455619408586939,-4966,-946,-0.27512465373961226,-0.040146865570334755
1893,13039,Camden,Georgia,2016,5930,12310,829,19069,0.3109759295191148,0.6455503697100006,0.04347370077088468,-447,499,967,1019,-0.04232046937285194,0.025191152294430384,0.01712931707842158,-6380,-1414,-0.3345744401908858,-0.05944978645127352
1894,13043,Candler,Georgia,2000,1053,1643,26,2722,0.38684790595150625,0.603600293901543,0.009551800146950772,0,0,0,0,0.0,0.0,0.0,-590,0,-0.21675238795003676,0.0
1895,13043,Candler,Georgia,2004,1096,2048,11,3155,0.3473851030110935,0.6491283676703645,0.003486529318541997,43,-15,405,433,-0.03946280294041277,-0.006065270828408775,0.04552807376882151,-952,-362,-0.30174326465927104,-0.08499087670923428
1896,13043,Candler,Georgia,2008,1209,2286,27,3522,0.3432708688245315,0.6490630323679727,0.007666098807495741,113,16,238,367,-0.0041142341865619825,0.004179569488953744,-6.53353023918335e-05,-1077,-125,-0.3057921635434412,-0.004048898884170149
1897,13043,Candler,Georgia,2012,1157,2344,30,3531,0.3276692155196828,0.6638346077598414,0.008496176720475786,-52,3,58,9,-0.015601653304848695,0.0008300779129800451,0.014771575391868685,-1187,-110,-0.33616539224015857,-0.03037322869671738
1898,13043,Candler,Georgia,2016,1026,2664,73,3763,0.27265479670475684,0.7079457879351582,0.019399415360085038,-131,43,320,232,-0.05501441881492597,0.010903238639609252,0.04411118017531679,-1638,-451,-0.4352909912304013,-0.09912559899024276
1899,13045,Carroll,Georgia,2000,8752,16326,663,25741,0.340002330911775,0.634241093974593,0.025756575113631948,0,0,0,0,0.0,0.0,0.0,-7574,0,-0.29423876306281804,0.0
1900,13045,Carroll,Georgia,2004,10224,24837,286,35347,0.28924661215944775,0.7026621778368745,0.008091210003677823,1472,-377,8511,9606,-0.05075571875232726,-0.017665365109954125,0.0684210838622814,-14613,-7039,-0.4134155656774267,-0.11917680261460867
1901,13045,Carroll,Georgia,2008,14334,28661,588,43583,0.3288897047013744,0.6576187963196659,0.013491498978959687,4110,302,3824,8236,0.03964309254192666,0.0054002889752818636,-0.04504338151720855,-14327,286,-0.3287290916182915,0.08468647405913521
1902,13045,Carroll,Georgia,2012,12688,28280,704,41672,0.30447302745248606,0.6786331349587252,0.016893837588788634,-1646,116,-381,-1911,-0.024416677248888352,0.0034023386098289473,0.021014338639059327,-15592,-1265,-0.3741601075062392,-0.04543101588794768
1903,13045,Carroll,Georgia,2016,12464,30029,1966,44459,0.2803481859690951,0.6754312962504779,0.04422051778042691,-224,1262,1749,2787,-0.024124841483390946,0.027326680191638277,-0.0032018387082473065,-17565,-1973,-0.3950831102813828,-0.02092300277514364
1904,13047,Catoosa,Georgia,2000,5470,12033,218,17721,0.308673325433102,0.6790248857287964,0.012301788838101688,0,0,0,0,0.0,0.0,0.0,-6563,0,-0.3703515602956944,0.0
1905,13047,Catoosa,Georgia,2004,5807,16406,128,22341,0.25992569714874,0.7343449263685601,0.005729376482699969,337,-90,4373,4620,-0.04874762828436202,-0.006572412355401719,0.0553200406397637,-10599,-4036,-0.4744192292198201,-0.10406766892412572
1906,13047,Catoosa,Georgia,2008,6025,18218,362,24605,0.2448689290794554,0.7404186141028246,0.014712456817719976,218,234,1812,2264,-0.015056768069284576,0.008983080335020006,0.006073687734264532,-12193,-1594,-0.4955496850233692,-0.02113045580354911
1907,13047,Catoosa,Georgia,2012,5365,17858,568,23791,0.2255054432348367,0.7506199823462654,0.0238745744188979,-660,206,-360,-814,-0.019363485844618694,0.009162117601177926,0.010201368243440756,-12493,-300,-0.5251145391114287,-0.029564854088059478
1908,13047,Catoosa,Georgia,2016,4771,20876,1293,26940,0.17709725315515962,0.7749072011878247,0.04799554565701559,-594,725,3018,3149,-0.04840819007967709,0.024120971238117687,0.024287218841559377,-16105,-3612,-0.5978099480326651,-0.07269540892123638
1909,13049,Charlton,Georgia,2000,1015,1770,31,2816,0.3604403409090909,0.6285511363636364,0.011008522727272728,0,0,0,0,0.0,0.0,0.0,-755,0,-0.26811079545454547,0.0
1910,13049,Charlton,Georgia,2004,1064,2311,16,3391,0.3137717487466824,0.6815098790917133,0.004718372161604247,49,-15,541,575,-0.046668592162408484,-0.006290150565668481,0.05295874272807699,-1247,-492,-0.36773813034503094,-0.09962733489048547
1911,13049,Charlton,Georgia,2008,1197,2466,34,3697,0.323776034622667,0.6670273194482013,0.009196645929131728,133,18,155,306,0.01000428587598462,0.004478273767527481,-0.014482559643512083,-1269,-22,-0.34325128482553424,0.024486845519496703
1912,13049,Charlton,Georgia,2012,1197,2527,41,3765,0.3179282868525896,0.6711819389110226,0.010889774236387782,0,7,61,68,-0.005847747770077405,0.0016931283072560543,0.004154619462821363,-1330,-61,-0.353253652058433,-0.010002367232898768
1913,13049,Charlton,Georgia,2016,1004,2951,61,4016,0.25,0.7348107569721115,0.015189243027888447,-193,20,424,251,-0.06792828685258961,0.004299468791500664,0.06362881806108889,-1947,-617,-0.4848107569721115,-0.1315571049136785
1914,13051,Chatham,Georgia,2000,37590,37847,1038,76475,0.49153318077803204,0.4948937561294541,0.013573063092513894,0,0,0,0,0.0,0.0,0.0,-257,0,-0.003360575351422035,0.0
1915,13051,Chatham,Georgia,2004,45630,45484,557,91671,0.49775828779003173,0.49616563580630735,0.006076076403660918,8040,-481,7637,15196,0.0062251070119996865,-0.007496986688852976,0.0012718796768532714,146,403,0.0015926519837243802,0.004953227335146415
1916,13051,Chatham,Georgia,2008,62755,46829,858,110442,0.5682168015791094,0.4240144148059615,0.007768783614929103,17125,301,1345,18771,0.07045851378907764,0.0016927072112681851,-0.07215122100034582,15926,15780,0.14420238677314784,0.14260973478942346
1917,13051,Chatham,Georgia,2012,60246,47204,1371,108821,0.5536247599268523,0.43377656886078975,0.01259867121235791,-2509,513,375,-1621,-0.014592041652257026,0.004829887597428807,0.00976215405482822,13042,-2884,0.11984819106606259,-0.024354195707085247
1918,13051,Chatham,Georgia,2016,62290,45688,5073,113051,0.5509902610326313,0.404136186322987,0.04487355264438174,2044,3702,-1516,4230,-0.002634498894221071,0.03227488143202383,-0.029640382537802767,16602,3560,0.1468540747096443,0.027005883643581696
1919,13053,Chattahoochee,Georgia,2000,600,590,17,1207,0.4971002485501243,0.4888152444076222,0.014084507042253521,0,0,0,0,0.0,0.0,0.0,10,0,0.008285004142502106,0.0
1920,13053,Chattahoochee,Georgia,2004,773,905,12,1690,0.457396449704142,0.5355029585798816,0.007100591715976331,173,-5,315,483,-0.0397037988459823,-0.00698391532627719,0.04668771417225942,-132,-142,-0.07810650887573961,-0.08639151301824172
1921,13053,Chattahoochee,Georgia,2008,830,811,15,1656,0.501207729468599,0.4897342995169082,0.009057971014492754,57,3,-94,-34,0.043811279764457034,0.001957379298516423,-0.045768659062973394,19,151,0.011473429951690817,0.08957993882743043
1922,13053,Chattahoochee,Georgia,2012,729,735,29,1493,0.4882786336235767,0.49229738780977894,0.01942397856664434,-101,14,-76,-163,-0.012929095845022331,0.010366007552151587,0.002563088292870719,-6,-25,-0.004018754186202234,-0.01549218413789305
1923,13053,Chattahoochee,Georgia,2016,594,751,45,1390,0.4273381294964029,0.5402877697841727,0.03237410071942446,-135,16,16,-103,-0.060940504127173833,0.01295012215278012,0.04799038197439376,-157,-151,-0.11294964028776983,-0.10893088610156759
1924,13055,Chattooga,Georgia,2000,2729,3640,108,6477,0.4213370387525089,0.5619885749575421,0.01667438628994905,0,0,0,0,0.0,0.0,0.0,-911,0,-0.14065153620503318,0.0
1925,13055,Chattooga,Georgia,2004,2809,4992,61,7862,0.35728822182650727,0.6349529381836683,0.007758839989824472,80,-47,1352,1385,-0.06404881692600162,-0.008915546300124578,0.0729643632261262,-2183,-1272,-0.277664716357161,-0.13701318015212782
1926,13055,Chattooga,Georgia,2008,2596,5572,169,8337,0.31138299148374715,0.6683459277917716,0.02027108072448123,-213,108,580,475,-0.04590523034276012,0.012512240734656756,0.03339298960810333,-2976,-793,-0.35696293630802445,-0.07929821995086345
1927,13055,Chattooga,Georgia,2012,2232,5452,185,7869,0.28364468166221884,0.6928453424831618,0.02350997585461939,-364,16,-120,-468,-0.027738309821528306,0.0032388951301381627,0.024499414691390164,-3220,-244,-0.4092006608209429,-0.05223772451291847
1928,13055,Chattooga,Georgia,2016,1613,6462,177,8252,0.19546776539020844,0.7830828889966068,0.02144934561318468,-619,-8,1010,383,-0.08817691627201041,-0.00206063024143471,0.09023754651344507,-4849,-1629,-0.5876151236063984,-0.17841446278545553
1929,13057,Cherokee,Georgia,2000,12295,38033,2020,52348,0.23487048215786657,0.7265416061740658,0.03858791166806755,0,0,0,0,0.0,0.0,0.0,-25738,0,-0.4916711240161993,0.0
1930,13057,Cherokee,Georgia,2004,14824,58238,665,73727,0.2010660951890081,0.7899141427156944,0.009019762095297517,2529,-1355,20205,21379,-0.033804386968858485,-0.02956814957277003,0.06337253654162855,-43414,-17676,-0.5888480475266863,-0.09717692351048701
1931,13057,Cherokee,Georgia,2008,22350,70279,1344,93973,0.2378342715460824,0.7478637480978579,0.014301980356059719,7526,679,12041,20246,0.0367681763570743,0.005282218260762202,-0.04205039461783644,-47929,-4515,-0.5100294765517756,0.07881857097491074
1932,13057,Cherokee,Georgia,2012,19841,76514,2084,98439,0.20155629374536516,0.7772732352014954,0.021170471053139506,-2509,740,6235,4466,-0.03627797780071723,0.006868490697079788,0.029409487103637444,-56673,-8744,-0.5757169414561303,-0.06568746490435473
1933,13057,Cherokee,Georgia,2016,25231,80649,6904,112784,0.22371081004397786,0.7150748333096894,0.06121435664633281,5390,4820,4135,14345,0.022154516298612703,0.0400438855931933,-0.06219840189180603,-55418,1255,-0.4913640232657115,0.08435291819041879
1934,13059,Clarke,Georgia,2000,15167,11850,1887,28904,0.5247370606144478,0.4099778577359535,0.06528508164959868,0,0,0,0,0.0,0.0,0.0,3317,0,0.11475920287849428,0.0
1935,13059,Clarke,Georgia,2004,21718,15052,673,37443,0.5800283096974067,0.40199770317549344,0.01797398712709986,6551,-1214,3202,8539,0.055291249082958904,-0.04731109452249882,-0.007980154560460084,6666,3349,0.17803060652191327,0.06327140364341899
1936,13059,Clarke,Georgia,2008,29591,15333,742,45666,0.647987561862217,0.33576402575220077,0.01624841238558227,7873,69,281,8223,0.06795925216481025,-0.0017255747415175875,-0.06623367742329267,14258,7592,0.3122235361100162,0.13419292958810292
1937,13059,Clarke,Georgia,2012,25431,13815,1269,40515,0.6276934468715291,0.3409848204368752,0.0313217326915957,-4160,527,-1518,-5151,-0.020294114990687895,0.015073320306013431,0.005220794684674457,11616,-2642,0.28670862643465383,-0.02551490967536235
1938,13059,Clarke,Georgia,2016,29603,12717,3156,45476,0.6509587474711936,0.27964200897176533,0.06939924355704108,4172,1887,-1098,4961,0.023265300599664585,0.03807751086544538,-0.06134281146510989,16886,5270,0.3713167384994283,0.08460811206477448
1939,13061,Clay,Georgia,2000,821,448,8,1277,0.6429130775254502,0.350822239624119,0.006264682850430697,0,0,0,0,0.0,0.0,0.0,373,0,0.2920908379013312,0.0
1940,13061,Clay,Georgia,2004,798,509,3,1310,0.6091603053435114,0.3885496183206107,0.0022900763358778627,-23,-5,61,33,-0.03375277218193884,-0.003974606514552835,0.037727378696491676,289,-84,0.2206106870229007,-0.07148015087843052
1941,13061,Clay,Georgia,2008,879,558,3,1440,0.6104166666666667,0.3875,0.0020833333333333333,81,0,49,130,0.0012563613231553195,-0.00020674300254452938,-0.001049618320610679,321,32,0.2229166666666667,0.0023059796437659985
1942,13061,Clay,Georgia,2012,862,537,4,1403,0.6143977191732003,0.3827512473271561,0.002851033499643621,-17,1,-21,-37,0.003981052506533578,0.0007677001663102877,-0.0047487526728439144,325,4,0.2316464718460442,0.008729805179377492
1943,13061,Clay,Georgia,2016,697,566,10,1273,0.5475255302435192,0.44461901021209743,0.007855459544383346,-165,6,29,-130,-0.06687218892968105,0.005004426044739725,0.061867762884941335,131,-194,0.10290652003142181,-0.1287399518146224
1944,13063,Clayton,Georgia,2000,40042,19966,1394,61402,0.6521285951597667,0.3251685612846487,0.02270284355558451,0,0,0,0,0.0,0.0,0.0,20076,0,0.326960033875118,0.0
1945,13063,Clayton,Georgia,2004,56113,23106,424,79643,0.7045565837550067,0.2901196589781902,0.005323757266803109,16071,-970,3140,18241,0.052427988595240005,-0.0173790862887814,-0.03504890230645852,33007,12931,0.41443692477681654,0.08747689090169852
1946,13063,Clayton,Georgia,2008,82527,16506,481,99514,0.8293003999437265,0.165866109291155,0.004833490765118476,26414,57,-6600,19871,0.12474381618871977,-0.0004902665016846336,-0.1242535496870352,66021,33014,0.6634342906525715,0.248997365875755
1947,13063,Clayton,Georgia,2012,81479,14164,587,96230,0.8467110048841318,0.1471890262911774,0.006099968824690845,-1048,106,-2342,-3284,0.01741060494040525,0.0012664780595723693,-0.018677082999977612,67315,1294,0.6995219785929544,0.03608768794038286
1948,13063,Clayton,Georgia,2016,78220,12645,2715,93580,0.8358623637529387,0.13512502671511006,0.029012609531951273,-3259,2128,-1519,-2650,-0.010848641131193104,0.02291264070726043,-0.012063999576067325,65575,-1740,0.7007373370378286,0.0012153584448741928
1949,13065,Clinch,Georgia,2000,816,1091,22,1929,0.4230171073094868,0.5655780196993261,0.011404872991187144,0,0,0,0,0.0,0.0,0.0,-275,0,-0.1425609123898393,0.0
1950,13065,Clinch,Georgia,2004,750,1501,17,2268,0.3306878306878307,0.6618165784832452,0.007495590828924162,-66,-5,410,339,-0.09232927662165608,-0.003909282162262983,0.09623855878391907,-751,-476,-0.33112874779541446,-0.18856783540557515
1951,13065,Clinch,Georgia,2008,989,1678,35,2702,0.36602516654330125,0.6210214655810511,0.012953367875647668,239,18,177,434,0.03533733585547055,0.005457777046723506,-0.040795112902194064,-689,62,-0.25499629903774984,0.07613244875766462
1952,13065,Clinch,Georgia,2012,852,1598,25,2475,0.34424242424242424,0.6456565656565657,0.010101010101010102,-137,-10,-80,-227,-0.02178274230087701,-0.0028523577746375657,0.024635100075514615,-746,-57,-0.30141414141414147,-0.04641784237639163
1953,13065,Clinch,Georgia,2016,686,1727,42,2455,0.2794297352342159,0.7034623217922606,0.017107942973523423,-166,17,129,-20,-0.06481268900820836,0.007006932872513321,0.05780575613569494,-1041,-295,-0.42403258655804477,-0.1226184451439033
1954,13067,Cobb,Georgia,2000,86676,140494,7857,235027,0.3687916707442124,0.5977781276193799,0.03343020163640773,0,0,0,0,0.0,0.0,0.0,-53818,0,-0.2289864568751675,0.0
1955,13067,Cobb,Georgia,2004,103955,173467,2639,280061,0.3711869914054438,0.6193900614508981,0.00942294714365799,17279,-5218,32973,45034,0.002395320661231437,-0.024007254492749742,0.02161193383151827,-69512,-15694,-0.24820307004545433,-0.019216613170286834
1956,13067,Cobb,Georgia,2008,141216,170957,3951,316124,0.4467107843757513,0.5407909554478623,0.01249826017638648,37261,1312,-2510,36063,0.07552379297030748,0.0030753130327284914,-0.07859910600303588,-29741,39771,-0.09408017107211097,0.15412289897334336
1957,13067,Cobb,Georgia,2012,133124,171722,5989,310835,0.4282786687470845,0.5524538742419611,0.019267457010954364,-8092,2038,765,-5289,-0.018432115628666812,0.0067691968345678834,0.011662918794098864,-38598,-8857,-0.12417520549487665,-0.030095034422765676
1958,13067,Cobb,Georgia,2016,160121,152912,21025,334058,0.4793209562411318,0.45774087134569447,0.06293817241317376,26997,15036,-18810,23223,0.05104228749404732,0.043670715402219396,-0.09471300289626666,7209,45807,0.021580084895437335,0.14575529039031399
1959,13069,Coffee,Georgia,2000,3593,5756,81,9430,0.38101802757158004,0.6103923647932131,0.008589607635206787,0,0,0,0,0.0,0.0,0.0,-2163,0,-0.22937433722163308,0.0
1960,13069,Coffee,Georgia,2004,3979,8306,48,12333,0.32263034136057733,0.6734776615584205,0.0038919970810021892,386,-33,2550,2903,-0.05838768621100271,-0.0046976105542045985,0.06308529676520735,-4327,-2164,-0.35084732019784315,-0.12147298297621006
1961,13069,Coffee,Georgia,2008,4811,8872,75,13758,0.34968745457188544,0.6448611716819305,0.005451373746184038,832,27,566,1425,0.027057113211308104,0.0015593766651818487,-0.028616489876490014,-4061,266,-0.29517371711004503,0.05567360308779812
1962,13069,Coffee,Georgia,2012,5057,9248,169,14474,0.34938510432499653,0.6389387867901064,0.011676108884897056,246,94,376,716,-0.000302350246888905,0.006224735138713018,-0.005922384891824062,-4191,-130,-0.2895536824651099,0.005620034644935157
1963,13069,Coffee,Georgia,2016,4094,9588,233,13915,0.29421487603305785,0.6890406036651096,0.016744520301832554,-963,64,340,-559,-0.05517022829193868,0.005068411416935498,0.05010181687500315,-5494,-1303,-0.3948257276320517,-0.10527204516694183
1964,13071,Colquitt,Georgia,2000,3297,6589,86,9972,0.3306257521058965,0.6607501002807862,0.008624147613317288,0,0,0,0,0.0,0.0,0.0,-3292,0,-0.33012434817488967,0.0
1965,13071,Colquitt,Georgia,2004,3378,8296,78,11752,0.2874404356705242,0.7059223961878829,0.00663716814159292,81,-8,1707,1780,-0.04318531643537232,-0.0019869794717243677,0.045172295907096705,-4918,-1626,-0.4184819605173587,-0.08835761234246903
1966,13071,Colquitt,Georgia,2008,4139,9185,130,13454,0.3076408503047421,0.6826965958079382,0.009662553887319757,761,52,889,1702,0.0202004146342179,0.0030253857457268364,-0.023225800379944705,-5046,-128,-0.3750557455031961,0.043426215014162606
1967,13071,Colquitt,Georgia,2012,3973,9243,131,13347,0.2976698883644265,0.6925151719487526,0.009814939686821008,-166,1,58,-107,-0.009970961940315604,0.00015238579950125133,0.009818576140814383,-5270,-224,-0.3948452835843261,-0.019789538081129987
1968,13071,Colquitt,Georgia,2016,3463,9898,263,13624,0.2541837933059307,0.7265120375807399,0.019304169113329418,-510,132,655,277,-0.043486095058495766,0.00948922942650841,0.03399686563198734,-6435,-1165,-0.4723282442748092,-0.0774829606904831
1969,13073,Columbia,Georgia,2000,8969,26660,379,36008,0.2490835369917796,0.7403910242168407,0.010525438791379694,0,0,0,0,0.0,0.0,0.0,-17691,0,-0.49130748722506107,0.0
1970,13073,Columbia,Georgia,2004,11442,35549,212,47203,0.242399847467322,0.7531089125691164,0.004491239963561638,2473,-167,8889,11195,-0.006683689524457609,-0.0060341988278180565,0.012717888352275719,-24107,-6416,-0.5107090651017944,-0.0194015778767333
1971,13073,Columbia,Georgia,2008,15703,39322,441,55466,0.2831103739227635,0.7089388093606894,0.007950816716547075,4261,229,3773,8263,0.040710526455441515,0.003459576752985437,-0.04417010320842696,-23619,488,-0.4258284354379259,0.08488062966386845
1972,13073,Columbia,Georgia,2012,16451,41765,855,59071,0.27849536997850044,0.7070305225914577,0.014474107430041815,748,414,2443,3605,-0.004615003944263063,0.00652329071349474,-0.0019082867692317151,-25314,-1695,-0.42853515261295727,-0.002706717175031348
1973,13073,Columbia,Georgia,2016,18887,43085,3235,65207,0.28964681705951817,0.660741944883218,0.04961123805726379,2436,2380,1320,6136,0.011151447081017729,0.03513713062722198,-0.04628857770823969,-24198,1116,-0.37109512782369986,0.057440024789257416
1974,13075,Cook,Georgia,2000,1639,2279,26,3944,0.4155679513184584,0.5778397565922921,0.006592292089249493,0,0,0,0,0.0,0.0,0.0,-640,0,-0.16227180527383372,0.0
1975,13075,Cook,Georgia,2004,1733,3065,24,4822,0.3593944421401908,0.6356283699709664,0.004977187888842804,94,-2,786,878,-0.05617350917826763,-0.0016151042004066887,0.05778861337867425,-1332,-692,-0.2762339278307756,-0.11396212255694188
1976,13075,Cook,Georgia,2008,2075,3782,52,5909,0.3511592486038247,0.640040616009477,0.008800135386698257,342,28,717,1087,-0.008235193536366092,0.003822947497855453,0.004412246038510648,-1707,-375,-0.28888136740565235,-0.01264743957487674
1977,13075,Cook,Georgia,2012,2042,3935,64,6041,0.338023506042046,0.6513822214865088,0.010594272471445124,-33,12,153,132,-0.013135742561778685,0.001794137084746867,0.01134160547703178,-1893,-186,-0.3133587154444628,-0.024477348038810465
1978,13075,Cook,Georgia,2016,1753,4176,128,6057,0.2894172032359254,0.6894502228826151,0.02113257388145947,-289,64,241,16,-0.048606302806120605,0.010538301410014345,0.03806800139610633,-2423,-530,-0.40003301964668975,-0.08667430420222694
1979,13077,Coweta,Georgia,2000,9056,21327,843,31226,0.29001473131364885,0.6829885351950298,0.026996733491321336,0,0,0,0,0.0,0.0,0.0,-12271,0,-0.3929738038813809,0.0
1980,13077,Coweta,Georgia,2004,10647,31682,280,42609,0.24987678659438148,0.7435518317726302,0.006571381632988336,1591,-563,10355,11383,-0.04013794471926738,-0.020425351858333,0.0605632965776004,-21035,-8764,-0.4936750451782487,-0.10070124129686775
1981,13077,Coweta,Georgia,2008,15521,37571,543,53635,0.2893819334389857,0.7004940803579752,0.010123986203039061,4874,263,5889,11026,0.03950514684460424,0.0035526045700507254,-0.043057751414654954,-22050,-1015,-0.4111121469189895,0.08256289825925917
1982,13077,Coweta,Georgia,2012,15168,39653,897,55718,0.2722280053124663,0.7116730679493162,0.016098926738217452,-353,354,2082,2083,-0.01715392812651939,0.005974940535178391,0.01117898759134095,-24485,-2435,-0.43944506263684985,-0.02833291571786034
1983,13077,Coweta,Georgia,2016,16583,42533,3094,62210,0.2665648609548304,0.6837003697154799,0.04973476932968976,1415,2197,2880,6492,-0.00566314435763593,0.03363584259147231,-0.0279726982338363,-25950,-1465,-0.4171355087606495,0.022309553876200372
1984,13079,Crawford,Georgia,2000,1513,1987,67,3567,0.42416596579758903,0.5570507429212224,0.018783291281188674,0,0,0,0,0.0,0.0,0.0,-474,0,-0.13288477712363334,0.0
1985,13079,Crawford,Georgia,2004,1552,2830,26,4408,0.35208711433756806,0.6420145190562614,0.005898366606170599,39,-41,843,841,-0.07207885146002097,-0.012884924675018075,0.08496377613503903,-1278,-804,-0.2899274047186933,-0.15704262759506
1986,13079,Crawford,Georgia,2008,1832,3358,58,5248,0.3490853658536585,0.6398628048780488,0.011051829268292682,280,32,528,840,-0.00300174848390955,0.005153462662122083,-0.0021517141782125826,-1526,-248,-0.2907774390243903,-0.0008500343056969673
1987,13079,Crawford,Georgia,2012,1706,3368,70,5144,0.33164852255054433,0.6547433903576982,0.013608087091757388,-126,12,10,-104,-0.01743684330311418,0.0025562578234647054,0.014880585479649433,-1662,-136,-0.3230948678071539,-0.03231742878276361
1988,13079,Crawford,Georgia,2016,1421,3635,120,5176,0.2745363214837713,0.7022797527047914,0.023183925811437404,-285,50,267,32,-0.05711220106677306,0.009575838719680017,0.04753636234709313,-2214,-552,-0.4277434312210201,-0.10464856341386619
1989,13081,Crisp,Georgia,2000,2268,3285,56,5609,0.40435015154216436,0.5856658940987698,0.009983954359065787,0,0,0,0,0.0,0.0,0.0,-1017,0,-0.18131574255660543,0.0
1990,13081,Crisp,Georgia,2004,2357,3865,32,6254,0.3768787975695555,0.6180044771346338,0.005116725295810681,89,-24,580,645,-0.02747135397260886,-0.004867229063255106,0.03233858303586401,-1508,-491,-0.2411256795650783,-0.05980993700847287
1991,13081,Crisp,Georgia,2008,3085,4424,45,7554,0.40839290442149856,0.5856499867619804,0.005957108816521049,728,13,559,1300,0.03151410685194306,0.0008403835207103673,-0.032354490372653366,-1339,169,-0.17725708234048188,0.06386859722459642
1992,13081,Crisp,Georgia,2012,3167,4182,51,7400,0.427972972972973,0.5651351351351351,0.006891891891891892,82,6,-242,-154,0.019580068551474428,0.000934783075370843,-0.0205148516268453,-1015,324,-0.13716216216216215,0.040094920178319726
1993,13081,Crisp,Georgia,2016,2837,4549,126,7512,0.37766240681576146,0.6055644302449414,0.016773162939297124,-330,75,367,112,-0.05031056615721152,0.009881271047405233,0.04042929510980631,-1712,-697,-0.22790202342917998,-0.09073986126701783
1994,13083,Dade,Georgia,2000,1628,3333,88,5049,0.3224400871459695,0.6601307189542484,0.017429193899782137,0,0,0,0,0.0,0.0,0.0,-1705,0,-0.33769063180827885,0.0
1995,13083,Dade,Georgia,2004,1823,4368,64,6255,0.29144684252597924,0.6983213429256595,0.010231814548361312,195,-24,1035,1206,-0.030993244619990257,-0.007197379351420825,0.03819062397141115,-2545,-840,-0.40687450039968026,-0.06918386859140141
1996,13083,Dade,Georgia,2008,1612,4703,127,6442,0.2502328469419435,0.7300527786401738,0.019714374417882645,-211,63,335,187,-0.04121399558403577,0.009482559869521333,0.03173143571451431,-3091,-546,-0.47981993169823034,-0.07294543129855008
1997,13083,Dade,Georgia,2012,1411,4471,165,6047,0.23333884570861585,0.7393748966429634,0.027286257648420704,-201,38,-232,-395,-0.016894001233327627,0.007571883230538059,0.009322118002789592,-3060,31,-0.5060360509343476,-0.02621611923611722
1998,13083,Dade,Georgia,2016,965,5051,226,6242,0.15459788529317525,0.8091957705863505,0.03620634412047421,-446,61,580,195,-0.0787409604154406,0.008920086472053505,0.0698208739433871,-4086,-1026,-0.6545978852931753,-0.14856183435882775
1999,13085,Dawson,Georgia,2000,1458,4210,230,5898,0.24720244150559512,0.7138012885723974,0.038996269922007464,0,0,0,0,0.0,0.0,0.0,-2752,0,-0.4665988470668023,0.0
2000,13085,Dawson,Georgia,2004,1407,6649,65,8121,0.17325452530476543,0.8187415342938061,0.008003940401428395,-51,-165,2439,2223,-0.07394791620082969,-0.03099232952057907,0.1049402457214087,-5242,-2490,-0.6454870089890408,-0.17888816192223844
2001,13085,Dawson,Georgia,2008,1632,8242,112,9986,0.16342880032044863,0.8253554976967755,0.011215701982775887,225,47,1593,1865,-0.009825724984316803,0.0032117615813474915,0.006613963402969381,-6610,-1368,-0.6619266973763269,-0.016439688387286155
2002,13085,Dawson,Georgia,2012,1241,8847,176,10264,0.12090802805923616,0.8619446609508964,0.0171473109898675,-391,64,605,278,-0.04252077226121247,0.005931609007091613,0.03658916325412087,-7606,-996,-0.7410366328916602,-0.0791099355153333
2003,13085,Dawson,Georgia,2016,1448,9900,472,11820,0.12250423011844332,0.8375634517766497,0.03993231810490694,207,296,1053,1556,0.001596202059207158,0.02278500711503944,-0.024381209174246687,-8452,-846,-0.7150592216582063,0.025977411233453873
2004,13087,Decatur,Georgia,2000,3398,4187,63,7648,0.4442991631799163,0.547463389121339,0.00823744769874477,0,0,0,0,0.0,0.0,0.0,-789,0,-0.10316422594142266,0.0
2005,13087,Decatur,Georgia,2004,3577,5348,31,8956,0.3993970522554712,0.5971415810629745,0.0034613666815542653,179,-32,1161,1308,-0.04490211092444513,-0.004776081017190506,0.049678191941635585,-1771,-982,-0.19774452880750337,-0.09458030286608071
2006,13087,Decatur,Georgia,2008,4424,5890,71,10385,0.42599903707270104,0.5671641791044776,0.006836783822821377,847,40,542,1429,0.026601984817229862,0.0033754171412671116,-0.029977401958496963,-1466,305,-0.14116514203177655,0.056579386775726825
2007,13087,Decatur,Georgia,2012,4591,5824,85,10500,0.43723809523809526,0.5546666666666666,0.008095238095238095,167,14,-66,115,0.011239058165394222,0.0012584542724167177,-0.012497512437810943,-1233,233,-0.11742857142857138,0.023736570603205165
2008,13087,Decatur,Georgia,2016,4124,6020,142,10286,0.40093330740812755,0.585261520513319,0.013805172078553373,-467,57,196,-214,-0.03630478782996771,0.0057099339833152785,0.030594853846652392,-1896,-663,-0.18432821310519149,-0.0668996416766201
2009,13089,DeKalb,Georgia,2000,154509,58807,6664,219980,0.7023774888626239,0.2673288480770979,0.030293663060278208,0,0,0,0,0.0,0.0,0.0,95702,0,0.43504864078552596,0.0
2010,13089,DeKalb,Georgia,2004,200787,73570,2414,276771,0.7254625665261173,0.2658154214133706,0.00872201206051212,46278,-4250,14763,56791,0.023085077663493436,-0.021571650999766087,-0.0015134266637272797,127217,31515,0.4596471451127467,0.024598504327220716
2011,13089,DeKalb,Georgia,2008,254594,65581,2671,322846,0.7885927036419841,0.2031340019699795,0.008273294388036402,53807,257,-7989,46075,0.06313013711586679,-0.0004487176724757187,-0.06268141944339112,189013,61796,0.5854587016720045,0.12581155655925785
2012,13089,DeKalb,Georgia,2012,238224,64392,4242,306858,0.7763330270027179,0.2098429892653931,0.013823983731889018,-16370,1571,-1189,-15988,-0.012259676639266193,0.005550689343852616,0.00670898729541361,173832,-15181,0.5664900377373248,-0.018968663934679775
2013,13089,DeKalb,Georgia,2016,251370,51468,15011,317849,0.7908472261986037,0.161925945968054,0.04722682783334225,13146,10769,-12924,10991,0.014514199195885813,0.03340284410145323,-0.04791704329733909,199902,26070,0.6289212802305497,0.06243124249322496
2014,13091,Dodge,Georgia,2000,2326,3472,79,5877,0.39578015994555044,0.5907776076229369,0.013442232431512676,0,0,0,0,0.0,0.0,0.0,-1146,0,-0.19499744767738642,0.0
2015,13091,Dodge,Georgia,2004,2384,4584,28,6996,0.3407661520869068,0.6552315608919382,0.004002287021154946,58,-51,1112,1119,-0.05501400785864363,-0.00943994541035773,0.06445395326900138,-2200,-1054,-0.31446540880503143,-0.11946796112764502
2016,13091,Dodge,Georgia,2008,2595,5543,86,8224,0.3155398832684825,0.6740029182879378,0.010457198443579766,211,58,959,1228,-0.025226268818424324,0.00645491142242482,0.018771357395999555,-2948,-748,-0.3584630350194553,-0.04399762621442388
2017,13091,Dodge,Georgia,2012,2442,5214,98,7754,0.3149342274954862,0.6724271343822543,0.01263863812225948,-153,12,-329,-470,-0.0006056557729962608,0.0021814396786797134,-0.00157578390568347,-2772,176,-0.3574929068867681,0.0009701281326872091
2018,13091,Dodge,Georgia,2016,1839,5021,149,7009,0.26237694392923383,0.7163646739905836,0.021258382080182624,-603,51,-193,-745,-0.05255728356625239,0.008619743957923144,0.043937539608329246,-3182,-410,-0.45398773006134974,-0.09649482317458163
2019,13093,Dooly,Georgia,2000,1901,1588,31,3520,0.5400568181818182,0.4511363636363636,0.008806818181818181,0,0,0,0,0.0,0.0,0.0,313,0,0.08892045454545455,0.0
2020,13093,Dooly,Georgia,2004,1973,1853,20,3846,0.5130005200208009,0.48179927197087885,0.005200208008320333,72,-11,265,326,-0.02705629816101729,-0.0036066101734978486,0.030662908334515238,120,-193,0.031201248049922026,-0.05771920649553253
2021,13093,Dooly,Georgia,2008,2138,1991,32,4161,0.5138187935592405,0.4784907474164864,0.007690459024273011,165,12,138,315,0.0008182735384396622,0.002490251015952678,-0.0033085245543924557,147,27,0.035328046142754144,0.004126798092832118
2022,13093,Dooly,Georgia,2012,2285,1985,32,4302,0.5311483031148303,0.4614132961413296,0.007438400743840074,147,0,-6,141,0.01732950955558976,-0.00025205828043293674,-0.017077451275156807,300,153,0.06973500697350071,0.03440696083074657
2023,13093,Dooly,Georgia,2016,1872,1951,36,3859,0.4850997667789583,0.5055713915522156,0.00932884166882612,-413,4,-34,-443,-0.046048536335872026,0.0018904409249860463,0.044158095410886056,-79,-379,-0.02047162477325737,-0.09020663174675808
2024,13095,Dougherty,Georgia,2000,16650,12248,166,29064,0.5728736581337738,0.4214148086980457,0.005711533168180567,0,0,0,0,0.0,0.0,0.0,4402,0,0.15145884943572807,0.0
2025,13095,Dougherty,Georgia,2004,19805,13711,171,33687,0.5879122510167126,0.4070116068513076,0.005076142131979695,3155,5,1463,4623,0.01503859288293885,-0.0006353910362008721,-0.0144032018467381,6094,1692,0.18090064416540502,0.02944179472967695
2026,13095,Dougherty,Georgia,2008,26135,12547,204,38886,0.6720927840353855,0.32266111196831765,0.005246103996296868,6330,33,-1164,5199,0.0841805330186729,0.0001699618643171731,-0.08435049488298996,13588,7494,0.3494316720670679,0.16853102790166286
2027,13095,Dougherty,Georgia,2012,26295,11449,231,37975,0.6924292297564187,0.30148782093482557,0.00608294930875576,160,27,-1098,-911,0.020336445721033214,0.0008368453124588922,-0.02117329103349208,14846,1258,0.3909414088215932,0.041509736754525295
2028,13095,Dougherty,Georgia,2016,23311,10232,544,34087,0.6838677501686861,0.3001730865139203,0.015959163317393728,-2984,313,-1217,-3888,-0.008561479587732679,0.009876214008637967,-0.0013147344209052947,13079,-1767,0.3836946636547658,-0.007246745166827384
2029,13097,Douglas,Georgia,2000,11162,18893,909,30964,0.360483141712957,0.6101601860224777,0.0293566722645653,0,0,0,0,0.0,0.0,0.0,-7731,0,-0.2496770443095207,0.0
2030,13097,Douglas,Georgia,2004,15997,25846,281,42124,0.37975975690817587,0.6135694615895926,0.006670781502231507,4835,-628,6953,11160,0.019276615195218894,-0.022685890762333794,0.0034092755671149,-9849,-2118,-0.2338097046814167,0.015867339628103994
2031,13097,Douglas,Georgia,2008,27825,26812,560,55197,0.5041034838849937,0.4857510371940504,0.01014547892095585,11828,279,966,13073,0.12434372697681784,0.003474697418724342,-0.1278184243955422,1013,10862,0.018352446690943325,0.25216215137236003
2032,13097,Douglas,Georgia,2012,28441,26241,697,55379,0.5135701258599831,0.4738438758374113,0.012585998302605681,616,137,-571,182,0.009466641974989365,0.002440519381649832,-0.011907161356639107,2200,1187,0.039726250022571796,0.02137380333162847
2033,13097,Douglas,Georgia,2016,31005,24817,1916,57738,0.5369947001974437,0.4298209151685199,0.03318438463403651,2564,1219,-1424,2359,0.02342457433746059,0.020598386331430827,-0.04402296066889139,6188,3988,0.10717378502892377,0.06744753500635198
2034,13099,Early,Georgia,2000,1622,1938,25,3585,0.45244072524407253,0.5405857740585774,0.00697350069735007,0,0,0,0,0.0,0.0,0.0,-316,0,-0.08814504881450491,0.0
2035,13099,Early,Georgia,2004,1701,2495,23,4219,0.403176108082484,0.5913723631192226,0.005451528798293435,79,-2,557,634,-0.04926461716158853,-0.0015219718990566351,0.05078658906064515,-794,-478,-0.1881962550367386,-0.10005120622223368
2036,13099,Early,Georgia,2008,2603,2711,29,5343,0.48717948717948717,0.5073928504585439,0.005427662361968931,902,6,216,1124,0.08400337909700317,-2.386643632450343e-05,-0.08397951266067871,-108,686,-0.020213363279056706,0.16798289175768188
2037,13099,Early,Georgia,2012,2765,2557,37,5359,0.5159544691173726,0.47714125769733157,0.006904273185295764,162,8,-154,16,0.02877498193788547,0.0014766108233268327,-0.03025159276121231,208,316,0.03881321142004107,0.05902657469909778
2038,13099,Early,Georgia,2016,2168,2552,65,4785,0.45308254963427375,0.5333333333333333,0.013584117032392894,-597,28,-5,-574,-0.06287191948309889,0.00667984384709713,0.05619207563600176,-384,-592,-0.08025078369905958,-0.11906399511910065
2039,13101,Echols,Georgia,2000,272,614,12,898,0.3028953229398664,0.6837416481069042,0.013363028953229399,0,0,0,0,0.0,0.0,0.0,-342,0,-0.3808463251670378,0.0
2040,13101,Echols,Georgia,2004,231,757,3,991,0.2330978809283552,0.763874873864783,0.0030272452068617556,-41,-9,143,93,-0.06979744201151117,-0.010335783746367642,0.08013322575787885,-526,-184,-0.5307769929364279,-0.14993066776939007
2041,13101,Echols,Georgia,2008,201,981,6,1188,0.1691919191919192,0.8257575757575758,0.005050505050505051,-30,3,224,197,-0.063905961736436,0.0020232598436432953,0.06188270189279277,-780,-254,-0.6565656565656566,-0.1257886636292287
2042,13101,Echols,Georgia,2012,173,917,15,1105,0.15656108597285068,0.8298642533936652,0.013574660633484163,-28,9,-64,-83,-0.012630833219068521,0.008524155582979111,0.004106677636089406,-744,36,-0.6733031674208145,-0.016737510855157955
2043,13101,Echols,Georgia,2016,156,1007,19,1182,0.1319796954314721,0.8519458544839256,0.016074450084602367,-17,4,90,77,-0.02458139054137859,0.002499789451118204,0.02208160109026036,-851,-107,-0.7199661590524535,-0.046662991631639006
2044,13103,Effingham,Georgia,2000,3232,7326,92,10650,0.30347417840375585,0.6878873239436619,0.00863849765258216,0,0,0,0,0.0,0.0,0.0,-4094,0,-0.3844131455399061,0.0
2045,13103,Effingham,Georgia,2004,3613,12503,66,16182,0.22327277221604253,0.7726486219255964,0.004078605858361142,381,-26,5177,5532,-0.08020140618771332,-0.004559891794221019,0.08476129798193444,-8890,-4796,-0.5493758497095538,-0.1649627041696477
2046,13103,Effingham,Georgia,2008,4936,15230,175,20341,0.24266260262523967,0.7487340838700163,0.008603313504744112,1323,109,2727,4159,0.019389830409197145,0.004524707646382971,-0.02391453805558008,-10294,-1404,-0.5060714812447766,0.04330436846477714
2047,13103,Effingham,Georgia,2012,4947,15596,311,20854,0.2372206770883284,0.7478661168121223,0.014913206099549247,11,136,366,513,-0.0054419255369112796,0.006309892594805135,-0.0008679670578939369,-10649,-355,-0.510645439723794,-0.004573958479017315
2048,13103,Effingham,Georgia,2016,4853,17874,731,23458,0.20688038195924632,0.7619575411373518,0.031162076903401826,-94,420,2278,2604,-0.030340295129082068,0.01624887080385258,0.014091424325229474,-13021,-2372,-0.5550771591781055,-0.04443171945431157
2049,13105,Elbert,Georgia,2000,2527,3262,64,5853,0.43174440457884844,0.5573210319494276,0.010934563471723903,0,0,0,0,0.0,0.0,0.0,-735,0,-0.12557662737057917,0.0
2050,13105,Elbert,Georgia,2004,2984,4626,58,7668,0.38914971309337504,0.6032863849765259,0.007563901930099113,457,-6,1364,1815,-0.0425946914854734,-0.0033706615416247898,0.045965353027098255,-1642,-907,-0.21413667188315083,-0.08856004451257166
2051,13105,Elbert,Georgia,2008,3366,4868,98,8332,0.4039846375420067,0.5842534805568891,0.011761881901104177,382,40,242,664,0.014834924448631659,0.004197979971005065,-0.019032904419636787,-1502,140,-0.18026884301488239,0.033867828868268446
2052,13105,Elbert,Georgia,2012,3181,4859,116,8156,0.390019617459539,0.5957577243746934,0.014222658165767533,-185,18,-9,-176,-0.013965020082467694,0.002460776264663355,0.01150424381780435,-1678,-176,-0.20573810691515443,-0.025469263900272043
2053,13105,Elbert,Georgia,2016,2539,5292,156,7987,0.3178915738074371,0.6625766871165644,0.0195317390759985,-642,40,433,-169,-0.0721280436521019,0.005309080910230966,0.06681896274187094,-2753,-1075,-0.34468511330912727,-0.13894700639397284
2054,13107,Emanuel,Georgia,2000,2835,3343,85,6263,0.4526584703816063,0.5337697589014849,0.01357177071690883,0,0,0,0,0.0,0.0,0.0,-508,0,-0.08111128851987864,0.0
2055,13107,Emanuel,Georgia,2004,2774,4666,33,7473,0.37120299745751373,0.6243811053124582,0.004415897230028101,-61,-52,1323,1210,-0.08145547292409255,-0.009155873486880729,0.09061134641097324,-1892,-1384,-0.25317810785494443,-0.1720668193350658
2056,13107,Emanuel,Georgia,2008,3068,5110,74,8252,0.37178865729520116,0.6192438196800776,0.00896752302472128,294,41,444,779,0.0005856598376874356,0.004551625794693179,-0.005137285632380584,-2042,-150,-0.24745516238487641,0.005722945470068019
2057,13107,Emanuel,Georgia,2012,2927,5100,62,8089,0.361849425145259,0.630485844974657,0.007664729880084065,-141,-12,-10,-163,-0.00993923214994219,-0.0013027931446372154,0.011242025294579405,-2173,-131,-0.268636419829398,-0.021181257444521595
2058,13107,Emanuel,Georgia,2016,2435,5335,90,7860,0.3097964376590331,0.6787531806615776,0.011450381679389313,-492,28,235,-229,-0.05205298748622589,0.003785651799305248,0.048267335686920654,-2900,-727,-0.36895674300254455,-0.10032032317314654
2059,13109,Evans,Georgia,2000,1217,1841,22,3080,0.3951298701298701,0.5977272727272728,0.007142857142857143,0,0,0,0,0.0,0.0,0.0,-624,0,-0.20259740259740266,0.0
2060,13109,Evans,Georgia,2004,1213,2291,12,3516,0.3449943117178612,0.6515927189988624,0.0034129692832764505,-4,-10,450,436,-0.050135558412008896,-0.003729887859580692,0.05386544627158962,-1078,-454,-0.3065984072810012,-0.10400100468359852
2061,13109,Evans,Georgia,2008,1374,2462,20,3856,0.35632780082987553,0.6384854771784232,0.005186721991701245,161,8,171,340,0.011333489112014317,0.001773752708424794,-0.013107241820439208,-1088,-10,-0.28215767634854766,0.024440730932453525
2062,13109,Evans,Georgia,2012,1268,2268,29,3565,0.35568022440392705,0.6361851332398317,0.008134642356241234,-106,9,-194,-291,-0.0006475764259484817,0.002947920364539989,-0.002300343938591465,-1000,88,-0.2805049088359047,0.001652767512642983
2063,13109,Evans,Georgia,2016,1130,2404,79,3613,0.3127594796567949,0.6653750345972875,0.02186548574591752,-138,50,136,48,-0.042920744747132145,0.013730843389676286,0.029189901357455805,-1274,-274,-0.3526155549404926,-0.07211064610458795
2064,13111,Fannin,Georgia,2000,2736,5463,191,8390,0.3261025029797378,0.6511323003575685,0.022765196662693683,0,0,0,0,0.0,0.0,0.0,-2727,0,-0.3250297973778307,0.0
2065,13111,Fannin,Georgia,2004,2727,6862,77,9666,0.28212290502793297,0.7099110283467825,0.007966066625284502,-9,-114,1399,1276,-0.04397959795180484,-0.01479913003740918,0.05877872798921402,-4135,-1408,-0.4277881233188496,-0.10275832594101886
2066,13111,Fannin,Georgia,2008,2611,7807,225,10643,0.2453255660997839,0.733533778070093,0.021140655830123086,-116,148,945,977,-0.03679733892814907,0.013174589204838584,0.023622749723310466,-5196,-1061,-0.4882082119703091,-0.060420088651459536
2067,13111,Fannin,Georgia,2012,2028,7857,175,10060,0.20159045725646124,0.781013916500994,0.01739562624254473,-583,-50,50,-583,-0.043735108843322656,-0.0037450295875783544,0.04748013843090104,-5829,-633,-0.5794234592445329,-0.09121524727422375
2068,13111,Fannin,Georgia,2016,1923,9632,321,11876,0.16192320646682384,0.8110474907376221,0.027029302795554058,-105,146,1775,1816,-0.0396672507896374,0.009633676553009327,0.030033574236628002,-7709,-1880,-0.6491242842707983,-0.0697008250262654
2069,13113,Fayette,Georgia,2000,11912,29338,1199,42449,0.2806190958562039,0.691135244646517,0.02824565949727909,0,0,0,0,0.0,0.0,0.0,-17426,0,-0.41051614879031306,0.0
2070,13113,Fayette,Georgia,2004,14887,37346,391,52624,0.28289373669808454,0.7096761933718455,0.00743006993006993,2975,-808,8008,10175,0.002274640841880615,-0.020815589567209157,0.01854094872532852,-22459,-5033,-0.42678245667376097,-0.016266307883447906
2071,13113,Fayette,Georgia,2008,20313,38501,627,59441,0.3417338200905099,0.6477179051496442,0.010548274759845898,5426,236,1155,6817,0.05884008339242536,0.003118204829775968,-0.061958288222201285,-18188,4271,-0.3059840850591343,0.12079837161462664
2072,13113,Fayette,Georgia,2012,19736,38075,917,58728,0.33605775779866504,0.6483278844844027,0.015614357716932299,-577,290,-426,-713,-0.005676062291844863,0.005066082957086401,0.0006099793347584814,-18339,-151,-0.31227012668573767,-0.006286041626603345
2073,13113,Fayette,Georgia,2016,23284,35048,3179,61511,0.3785339207621401,0.5697842662288046,0.05168181300905529,3548,2262,-3027,2783,0.04247616296347506,0.03606745529212299,-0.07854361825559808,-11764,6575,-0.19125034546666453,0.12101978121907314
2074,13115,Floyd,Georgia,2000,10282,16194,349,26825,0.3832991612301957,0.603690587138863,0.013010251630941286,0,0,0,0,0.0,0.0,0.0,-5912,0,-0.22039142590866734,0.0
2075,13115,Floyd,Georgia,2004,10038,21400,238,31676,0.31689607273645665,0.6755903523172118,0.007513574946331607,-244,-111,5206,4851,-0.06640308849373905,-0.005496676684609679,0.07189976517834873,-11362,-5450,-0.3586942795807551,-0.13830285367208778
2076,13115,Floyd,Georgia,2008,10691,23132,499,34322,0.3114911718431327,0.6739700483654799,0.014538779791387449,653,261,1732,2646,-0.005404900893323961,0.0070252048450558414,-0.0016203039517318496,-12441,-1079,-0.3624788765223472,-0.003784596941592111
2077,13115,Floyd,Georgia,2012,9640,22733,554,32927,0.2927688523096547,0.6904060497464087,0.016825097943936586,-1051,55,-399,-1395,-0.01872231953347797,0.0022863181525491372,0.016436001380928822,-13093,-652,-0.397637197436754,-0.03515832091440679
2078,13115,Floyd,Georgia,2016,9159,24114,1587,34860,0.262736660929432,0.6917383820998279,0.045524956970740105,-481,1033,1381,1933,-0.030032191380222728,0.02869985902680352,0.001332332353419119,-14955,-1862,-0.42900172117039587,-0.03136452373364185
2079,13117,Forsyth,Georgia,2000,6694,27769,1292,35755,0.18721857082925464,0.776646622849951,0.03613480632079429,0,0,0,0,0.0,0.0,0.0,-21075,0,-0.5894280520206964,0.0
2080,13117,Forsyth,Georgia,2004,9201,47267,451,56919,0.16165076687924945,0.8304256926509601,0.007923540469790404,2507,-841,19498,21164,-0.025567803950005186,-0.028211265851003888,0.053779069801009105,-38066,-16991,-0.6687749257717106,-0.07934687375101424
2081,13117,Forsyth,Georgia,2008,15406,59166,931,75503,0.2040448723891766,0.78362449174205,0.012330635868773426,6205,480,11899,18584,0.042394105509927144,0.004407095398983022,-0.04680120090891016,-43760,-5694,-0.5795796193528734,0.08919530641883722
2082,13117,Forsyth,Georgia,2012,14571,65908,1421,81900,0.1779120879120879,0.8047374847374847,0.017350427350427352,-835,490,6742,6397,-0.026132784477088694,0.005019791481653926,0.021112992995434787,-51337,-7577,-0.6268253968253968,-0.047245777472523454
2083,13117,Forsyth,Georgia,2016,23462,69851,5651,98964,0.23707610848389313,0.7058223192271937,0.05710157228891314,8891,4230,3943,17064,0.059164020571805226,0.03975114493848579,-0.098915165510291,-46389,4948,-0.4687462107433006,0.15807918608209626
2084,13119,Franklin,Georgia,2000,2040,3659,63,5762,0.35404373481430057,0.6350225616105519,0.010933703575147518,0,0,0,0,0.0,0.0,0.0,-1619,0,-0.28097882679625136,0.0
2085,13119,Franklin,Georgia,2004,2245,5218,52,7515,0.2987358616101131,0.6943446440452429,0.006919494344644045,205,-11,1559,1753,-0.05530787320418745,-0.0040142092305034726,0.05932208243469095,-2973,-1354,-0.39560878243512976,-0.1146299556388784
2086,13119,Franklin,Georgia,2008,1914,6069,120,8103,0.2362088115512773,0.7489818585708997,0.014809329877823029,-331,68,851,588,-0.06252705005883583,0.007889835533178985,0.05463721452565684,-4155,-1182,-0.5127730470196225,-0.1171642645844927
2087,13119,Franklin,Georgia,2012,1499,6114,164,7777,0.19274784621319274,0.7861643307187862,0.021087823068021087,-415,44,45,-326,-0.04346096533808455,0.006278493190198058,0.0371824721478865,-4615,-460,-0.5934164845055935,-0.08064343748597103
2088,13119,Franklin,Georgia,2016,1243,7054,253,8550,0.14538011695906433,0.8250292397660819,0.029590643274853803,-256,89,940,773,-0.04736772925412841,0.008502820206832715,0.03886490904729567,-5811,-1196,-0.6796491228070176,-0.08623263830142414
2089,13121,Fulton,Georgia,2000,152039,104870,6303,263212,0.577629439387262,0.3984240840083279,0.023946476604410134,0,0,0,0,0.0,0.0,0.0,47169,0,0.17920535537893406,0.0
2090,13121,Fulton,Georgia,2004,199436,134372,2933,336741,0.59225339355766,0.3990366483439795,0.00870995809836046,47397,-3370,29502,73529,0.014623954170398079,-0.015236518506049674,0.0006125643356515997,65064,17895,0.19321674521368054,0.01401138983474648
2091,13121,Fulton,Georgia,2008,272000,130136,3489,405625,0.6705701078582434,0.3208283513097072,0.008601540832049307,72564,556,-4236,68884,0.0783167143005834,-0.00010841726631115323,-0.07820829703427229,141864,76800,0.34974175654853623,0.1565250113348557
2092,13121,Fulton,Georgia,2012,255470,137124,5752,398346,0.6413268866764069,0.34423340513021344,0.014439708193379626,-16530,2263,6988,-7279,-0.029243221181836532,0.005838167361330318,0.023405053820506228,118346,-23518,0.29709348154619347,-0.05264827500234276
2093,13121,Fulton,Georgia,2016,297051,117783,23917,438751,0.6770377731332806,0.2684506701979027,0.054511556668816706,41581,18165,-19341,40405,0.0357108864568737,0.04007184847543708,-0.07578273493231075,179268,60922,0.4085871029353779,0.11149362138918445
2094,13123,Gilmer,Georgia,2000,2230,4941,199,7370,0.30257801899592945,0.6704206241519675,0.02700135685210312,0,0,0,0,0.0,0.0,0.0,-2711,0,-0.367842605156038,0.0
2095,13123,Gilmer,Georgia,2004,2510,7414,99,10023,0.2504240247430909,0.739698693006086,0.009877282250823106,280,-100,2473,2653,-0.052153994252838565,-0.017124074601280015,0.06927806885411858,-4904,-2193,-0.48927466826299515,-0.12143206310695714
2096,13123,Gilmer,Georgia,2008,2614,8408,164,11186,0.23368496334704095,0.751653853030574,0.014661183622385124,104,65,994,1163,-0.016739061396049942,0.004783901371562017,0.011955160024487932,-5794,-890,-0.517968889683533,-0.028694221420537902
2097,13123,Gilmer,Georgia,2012,1958,8926,169,11053,0.1771464760698453,0.8075635574052293,0.01528996652492536,-656,5,518,-133,-0.056538487277195654,0.0006287829025402366,0.05590970437465537,-6968,-1174,-0.630417081335384,-0.11244819165185094
2098,13123,Gilmer,Georgia,2016,1965,10477,331,12773,0.1538401315274407,0.8202458310498708,0.025914037422688482,7,162,1551,1720,-0.0233063445424046,0.010624070897763122,0.012682273644641473,-8512,-1544,-0.6664056995224301,-0.03598861818704613
2099,13125,Glascock,Georgia,2000,249,763,8,1020,0.24411764705882352,0.7480392156862745,0.00784313725490196,0,0,0,0,0.0,0.0,0.0,-514,0,-0.503921568627451,0.0
2100,13125,Glascock,Georgia,2004,250,1016,4,1270,0.1968503937007874,0.8,0.0031496062992125984,1,-4,253,250,-0.04726725335803611,-0.004693530955689362,0.05196078431372553,-766,-252,-0.6031496062992127,-0.09922803767176169
2101,13125,Glascock,Georgia,2008,210,1202,16,1428,0.14705882352941177,0.8417366946778712,0.011204481792717087,-40,12,186,158,-0.04979157017137564,0.008054875493504489,0.04173669467787111,-992,-226,-0.6946778711484594,-0.0915282648492467
2102,13125,Glascock,Georgia,2012,176,1135,25,1336,0.1317365269461078,0.8495508982035929,0.0187125748502994,-34,9,-67,-92,-0.015322296583303974,0.007508093057582313,0.007814203525721708,-959,33,-0.717814371257485,-0.02313650010902568
2103,13125,Glascock,Georgia,2016,138,1235,17,1390,0.09928057553956834,0.8884892086330936,0.01223021582733813,-38,-8,100,54,-0.03245595140653945,-0.00648235902296127,0.03893831042950069,-1097,-138,-0.7892086330935252,-0.07139426183604014
2104,13127,Glynn,Georgia,2000,7778,14346,260,22384,0.34748034310221587,0.64090421729807,0.011615439599714082,0,0,0,0,0.0,0.0,0.0,-6568,0,-0.29342387419585414,0.0
2105,13127,Glynn,Georgia,2004,8962,18608,169,27739,0.3230830239013663,0.6708244709614622,0.006092505137171491,1184,-91,4262,5355,-0.024397319200849588,-0.005522934462542591,0.029920253663392238,-9646,-3078,-0.34774144706009597,-0.054317572864241825
2106,13127,Glynn,Georgia,2008,12676,20479,248,33403,0.3794868724366075,0.613088644732509,0.007424482830883454,3714,79,1871,5664,0.05640384853524122,0.0013319776937119627,-0.057735826228953235,-7803,1843,-0.2336017722959015,0.11413967476419445
2107,13127,Glynn,Georgia,2012,11950,20893,348,33191,0.36003735952517246,0.6294778705070652,0.010484769967762346,-726,100,414,-212,-0.01944951291143504,0.003060287136878892,0.01638922577455615,-8943,-1140,-0.2694405109818927,-0.03583873868599119
2108,13127,Glynn,Georgia,2016,11775,21512,1150,34437,0.34192873943723323,0.6246769463077504,0.033394314255016405,-175,802,619,1246,-0.01810862008793923,0.022909544287254058,-0.004800924199314771,-9737,-794,-0.28274820687051716,-0.01330769588862446
2109,13129,Gordon,Georgia,2000,4032,7944,229,12205,0.33035641130684146,0.6508807865628841,0.018762802130274477,0,0,0,0,0.0,0.0,0.0,-3912,0,-0.3205243752560426,0.0
2110,13129,Gordon,Georgia,2004,4028,11671,98,15797,0.2549851237576755,0.7388111666772172,0.006203709565107299,-4,-131,3727,3592,-0.07537128754916594,-0.012559092565167178,0.08793038011433318,-7643,-3731,-0.48382604291954173,-0.16330166766349913
2111,13129,Gordon,Georgia,2008,4268,13113,274,17655,0.24174454828660435,0.7427357689039932,0.015519682809402436,240,176,1442,1858,-0.013240575471071159,0.009315973244295138,0.003924602226775931,-8845,-1202,-0.5009912206173888,-0.017165177697847034
2112,13129,Gordon,Georgia,2012,3440,13197,302,16939,0.20308164590589764,0.7790896747151543,0.01782867937894799,-828,28,84,-716,-0.038662902380706715,0.0023089965695455555,0.03635390581116116,-9757,-912,-0.5760080288092567,-0.07501680819186796
2113,13129,Gordon,Georgia,2016,3181,15191,690,19062,0.1668765082362816,0.7969258210051411,0.03619767075857727,-259,388,1994,2123,-0.03620513766961603,0.01836899137962928,0.017836146289986754,-12010,-2253,-0.6300493127688594,-0.054041283959602726
2114,13131,Grady,Georgia,2000,2721,3894,88,6703,0.405937639862748,0.5809339101894674,0.013128449947784573,0,0,0,0,0.0,0.0,0.0,-1173,0,-0.17499627032671938,0.0
2115,13131,Grady,Georgia,2004,3092,5068,41,8201,0.37702719180587735,0.6179734178758688,0.004999390318253871,371,-47,1174,1498,-0.028910448056870652,-0.008129059629530703,0.03703950768640141,-1976,-803,-0.24094622606999144,-0.06594995574327206
2116,13131,Grady,Georgia,2008,3539,5775,57,9371,0.377654465905453,0.616262938853911,0.006082595240636005,447,16,707,1170,0.0006272740995756365,0.0010832049223821333,-0.001710479021957756,-2236,-260,-0.23860847294845805,0.0023377531215333924
2117,13131,Grady,Georgia,2012,3419,5924,70,9413,0.3632210772336131,0.6293423988101562,0.007436523956230744,-120,13,149,42,-0.014433388671839908,0.0013539287155947396,0.013079459956245154,-2505,-269,-0.2661213215765431,-0.027512848628085063
2118,13131,Grady,Georgia,2016,3013,6053,147,9213,0.32703788125474875,0.6570064039943558,0.015955714750895474,-406,77,129,-200,-0.036183195978864324,0.00851919079466473,0.027664005184199647,-3040,-535,-0.3299685227396071,-0.06384720116306397
2119,13133,Greene,Georgia,2000,2137,2980,80,5197,0.4111987685203002,0.5734077352318645,0.01539349624783529,0,0,0,0,0.0,0.0,0.0,-843,0,-0.16220896671156432,0.0
2120,13133,Greene,Georgia,2004,2774,4069,34,6877,0.40337356405409336,0.5916824196597353,0.004944016286171296,637,-46,1089,1680,-0.007825204466206825,-0.010449479961663994,0.018274684427870835,-1295,-452,-0.18830885560564198,-0.02609988889407766
2121,13133,Greene,Georgia,2008,3339,4532,50,7921,0.4215376846357783,0.5721499810629971,0.006312334301224593,565,16,463,1044,0.01816412058168493,0.0013683180150532975,-0.019532438596738255,-1193,102,-0.1506122964272188,0.037696559178423183
2122,13133,Greene,Georgia,2012,3201,5071,55,8327,0.3844121532364597,0.6089828269484808,0.0066050198150594455,-138,5,539,406,-0.03712553139931857,0.00029268551383485227,0.036832845885483745,-1870,-677,-0.2245706737120211,-0.07395837728480231
2123,13133,Greene,Georgia,2016,3199,5490,163,8852,0.3613872571170357,0.6201988251242657,0.0184139177586986,-2,108,419,525,-0.023024896119424043,0.011808897943639153,0.011215998175784891,-2291,-421,-0.25881156800723004,-0.034240894295208935
2124,13135,Gwinnett,Georgia,2000,61434,121756,7921,191111,0.32145716363788585,0.6370957192416973,0.04144711712041693,0,0,0,0,0.0,0.0,0.0,-60322,0,-0.31563855560381143,0.0
2125,13135,Gwinnett,Georgia,2004,81708,160445,2190,244343,0.3343987754918291,0.6566384140327327,0.008962810475438216,20274,-5731,38689,53232,0.012941611853943269,-0.032484306644978714,0.01954269479103543,-78737,-18415,-0.3222396385409036,-0.006601082937092162
2126,13135,Gwinnett,Georgia,2008,129025,158746,3167,290938,0.4434793667379304,0.5456351525067197,0.010885480755349937,47317,977,-1699,46595,0.10908059124610131,0.0019226702799117201,-0.11100326152601303,-29721,49016,-0.10215578576878925,0.22008385277211434
2127,13135,Gwinnett,Georgia,2012,132509,159855,4992,297356,0.44562410040490186,0.5375879417264154,0.016787957868682656,3484,1825,1109,6418,0.0021447336669714323,0.00590247711333272,-0.008047210780304237,-27346,2375,-0.09196384132151358,0.01019194444727567
2128,13135,Gwinnett,Georgia,2016,166153,146989,17808,330950,0.5020486478319988,0.4441426197310772,0.05380873243692401,33644,12816,-12866,33594,0.056424547427096905,0.03702077456824135,-0.09344532199533823,19164,46510,0.05790602810092155,0.14986986942243513
2129,13137,Habersham,Georgia,2000,2530,6964,197,9691,0.26106696935300794,0.7186048911361057,0.02032813951088639,0,0,0,0,0.0,0.0,0.0,-4434,0,-0.45753792178309777,0.0
2130,13137,Habersham,Georgia,2004,2750,10434,92,13276,0.20714070503163604,0.7859294968363965,0.00692979813196746,220,-105,3470,3585,-0.0539262643213719,-0.01339834137891893,0.06732460570029075,-7684,-3250,-0.5787887918047604,-0.12125087002166263
2131,13137,Habersham,Georgia,2008,2900,11766,193,14859,0.19516791170334477,0.7918433272763982,0.012988761020257084,150,101,1332,1583,-0.011972793328291265,0.0060589628882896235,0.0059138304400017105,-8866,-1182,-0.5966754155730534,-0.017886623768292975
2132,13137,Habersham,Georgia,2012,2301,12166,209,14676,0.15678659035159445,0.8289724720632324,0.014240937585173072,-599,16,400,-183,-0.03838132135175032,0.001252176564915988,0.03712914478683427,-9865,-999,-0.672185881711638,-0.07551046613858459
2133,13137,Habersham,Georgia,2016,2483,13190,660,16333,0.1520235106838915,0.8075675013775792,0.04040898793852936,182,451,1024,1657,-0.004763079667702952,0.026168050353356287,-0.02140497068565328,-10707,-842,-0.6555439906936876,0.016641891017950328
2134,13139,Hall,Georgia,2000,10259,26841,1050,38150,0.2689121887287025,0.703564875491481,0.027522935779816515,0,0,0,0,0.0,0.0,0.0,-16582,0,-0.43465268676277846,0.0
2135,13139,Hall,Georgia,2004,10514,38883,395,49792,0.21115841902313626,0.7809085796915167,0.007933001285347043,255,-655,12042,11642,-0.05775376970556623,-0.019589934494469472,0.07734370420003578,-28369,-11787,-0.5697501606683805,-0.135097473905602
2136,13139,Hall,Georgia,2008,14457,44962,711,60130,0.24042907034758024,0.7477465491435223,0.011824380508897388,3943,316,6079,10338,0.02927065132444398,0.0038913792235503453,-0.03316203054799438,-30505,-2136,-0.5073174787959421,0.062432681872438334
2137,13139,Hall,Georgia,2012,12999,47481,1032,61512,0.21132461958642215,0.7718981662114709,0.016777214202106906,-1458,321,2519,1382,-0.029104450761158085,0.004952833693209518,0.02415161706794855,-34482,-3977,-0.5605735466250488,-0.053256067829106635
2138,13139,Hall,Georgia,2016,16180,51733,3229,71142,0.22743245902561074,0.7271794439290433,0.04538809704534593,3181,2197,4252,9630,0.016107839439188587,0.028610882843239024,-0.04471872228242757,-35553,-1071,-0.4997469849034326,0.06082656172161616
2139,13141,Hancock,Georgia,2000,2414,662,10,3086,0.7822423849643552,0.21451717433570966,0.0032404406999351912,0,0,0,0,0.0,0.0,0.0,1752,0,0.5677252106286454,0.0
2140,13141,Hancock,Georgia,2004,2715,822,18,3555,0.7637130801687764,0.23122362869198312,0.005063291139240506,301,8,160,469,-0.018529304795578794,0.0018228504393053152,0.016706454356273465,1893,141,0.5324894514767933,-0.035235759151852175
2141,13141,Hancock,Georgia,2008,3535,795,18,4348,0.813017479300828,0.1828426862925483,0.004139834406623735,820,0,-27,793,0.049304399132051646,-0.0009234567326167715,-0.04838094239943483,2740,847,0.6301747930082797,0.09768534153148645
2142,13141,Hancock,Georgia,2012,3308,769,13,4090,0.8088019559902201,0.18801955990220048,0.003178484107579462,-227,-5,-26,-258,-0.004215523310607927,-0.000961350299044273,0.005176873609652188,2539,-201,0.6207823960880197,-0.00939239692026006
2143,13141,Hancock,Georgia,2016,2701,843,36,3580,0.7544692737430168,0.23547486033519552,0.01005586592178771,-607,23,74,-510,-0.054332682247203334,0.006877381814208248,0.047455300432995035,1858,-681,0.5189944134078213,-0.1017879826801984
2144,13143,Haralson,Georgia,2000,2869,5153,145,8167,0.35129178400881594,0.6309538386188319,0.017754377372352147,0,0,0,0,0.0,0.0,0.0,-2284,0,-0.279662054610016,0.0
2145,13143,Haralson,Georgia,2004,2434,7703,72,10209,0.23841708296601039,0.7545303163875012,0.007052600646488392,-435,-73,2550,2042,-0.11287470104280556,-0.010701776725863754,0.12357647776866931,-5269,-2985,-0.5161132334214908,-0.23645117881147487
2146,13143,Haralson,Georgia,2008,2248,8658,224,11130,0.20197663971248878,0.7778975741239892,0.02012578616352201,-186,152,955,921,-0.03644044325352161,0.013073185517033618,0.023367257736487956,-6410,-1141,-0.5759209344115004,-0.05980770099000954
2147,13143,Haralson,Georgia,2012,1789,8446,172,10407,0.17190352647256654,0.8115691361583549,0.016527337369078503,-459,-52,-212,-723,-0.030073113239922233,-0.003598448794443508,0.03367156203436572,-6657,-247,-0.6396656096857883,-0.06374467527428795
2148,13143,Haralson,Georgia,2016,1475,9585,297,11357,0.12987584749493705,0.8439728801620147,0.02615127234304834,-314,125,1139,950,-0.04202767897762949,0.009623934973969836,0.03240374400365975,-8110,-1453,-0.7140970326670776,-0.07443142298128924
2149,13145,Harris,Georgia,2000,2912,5554,96,8562,0.34010745153001637,0.64868021490306,0.011212333566923615,0,0,0,0,0.0,0.0,0.0,-2642,0,-0.3085727633730437,0.0
2150,13145,Harris,Georgia,2004,3400,8878,84,12362,0.27503640187671896,0.7181685811357386,0.006795016987542469,488,-12,3324,3800,-0.06507104965329741,-0.0044173165793811465,0.06948836623267851,-5478,-2836,-0.4431321792590196,-0.13455941588597592
2151,13145,Harris,Georgia,2008,4184,10648,113,14945,0.27995985279357644,0.7124790899966544,0.007561057209769154,784,29,1770,2583,0.004923450916857475,0.0007660402222266849,-0.005689491139084124,-6464,-986,-0.432519237203078,0.010612942055941599
2152,13145,Harris,Georgia,2012,4145,11197,179,15521,0.2670575349526448,0.7214097029830552,0.01153276206429998,-39,66,549,576,-0.012902317840931654,0.003971704854530827,0.008930612986400743,-7052,-588,-0.4543521680304104,-0.021832930827332397
2153,13145,Harris,Georgia,2016,4086,11936,480,16502,0.2476063507453642,0.7233062659071627,0.029087383347473034,-59,301,739,981,-0.019451184207280592,0.017554621283173054,0.0018965629241075588,-7850,-798,-0.47569991516179855,-0.02134774713138815
2154,13147,Hart,Georgia,2000,3192,4242,102,7536,0.42356687898089174,0.5628980891719745,0.013535031847133758,0,0,0,0,0.0,0.0,0.0,-1050,0,-0.13933121019108274,0.0
2155,13147,Hart,Georgia,2004,3479,5500,53,9032,0.38518600531443753,0.6089459698848538,0.005868024800708592,287,-49,1258,1496,-0.03838087366645421,-0.007667007046425167,0.04604788071287935,-2021,-971,-0.2237599645704163,-0.08442875437933356
2156,13147,Hart,Georgia,2008,3365,6537,122,10024,0.3356943335993615,0.6521348762968875,0.012170790103750998,-114,69,1037,992,-0.04949167171507601,0.006302765303042406,0.043188906412033656,-3172,-1151,-0.316440542697526,-0.09268057812710967
2157,13147,Hart,Georgia,2012,2870,6517,142,9529,0.3011858537097282,0.6839122678140414,0.014901878476230455,-495,20,-20,-495,-0.03450847988963329,0.0027310883724794566,0.03177739151715386,-3647,-475,-0.38272641410431313,-0.06628587140678716
2158,13147,Hart,Georgia,2016,2585,7286,246,10117,0.2555105268360186,0.7201739646140161,0.024315508549965406,-285,104,769,588,-0.04567532687370962,0.009413630073734951,0.03626169679997471,-4701,-1054,-0.46466343777799746,-0.08193702367368433
2159,13149,Heard,Georgia,2000,1178,1947,73,3198,0.3683552220137586,0.6088180112570356,0.022826766729205753,0,0,0,0,0.0,0.0,0.0,-769,0,-0.24046278924327702,0.0
2160,13149,Heard,Georgia,2004,1148,2788,20,3956,0.2901921132457027,0.704752275025278,0.005055611729019211,-30,-53,841,758,-0.07816310876805588,-0.017771155000186542,0.09593426376824243,-1640,-871,-0.41456016177957533,-0.1740973725362983
2161,13149,Heard,Georgia,2008,1042,3133,56,4231,0.24627747577404868,0.74048688253368,0.01323564169227133,-106,36,345,275,-0.04391463747165403,0.008180029963252119,0.03573460750840196,-2091,-451,-0.4942094067596313,-0.07964924498005599
2162,13149,Heard,Georgia,2012,948,3160,70,4178,0.22690282431785544,0.7563427477261848,0.01675442795595979,-94,14,27,-53,-0.019374651456193243,0.0035187862636884594,0.015855865192504814,-2212,-121,-0.5294399234083293,-0.03523051664869803
2163,13149,Heard,Georgia,2016,743,3370,110,4223,0.17594127397584655,0.7980108927302866,0.02604783329386692,-205,40,210,45,-0.05096155034200889,0.00929340533790713,0.041668145004101764,-2627,-415,-0.62206961875444,-0.09262969534611065
2164,13151,Henry,Georgia,2000,11971,25815,1081,38867,0.30799907376437596,0.6641881287467517,0.027812797488872307,0,0,0,0,0.0,0.0,0.0,-13844,0,-0.35618905498237574,0.0
2165,13151,Henry,Georgia,2004,21096,42759,380,64235,0.32841908616797694,0.6656651358293765,0.005915778002646532,9125,-701,16944,25368,0.020420012403600973,-0.021897019486225775,0.0014770070826247705,-21663,-7819,-0.33724604966139954,0.018943005320976203
2166,13151,Henry,Georgia,2008,40567,47157,762,88486,0.4584567050154827,0.53293176321678,0.00861153176773727,19471,382,4398,24251,0.13003761884750575,0.0026957537650907377,-0.13273337261259643,-6590,15073,-0.07447505820129735,0.2627709914601022
2167,13151,Henry,Georgia,2012,43761,46774,996,91531,0.4781003157400225,0.5110181250068283,0.010881559253149205,3194,234,-383,3045,0.019643610724539795,0.0022700274854119355,-0.021913638209951736,-3013,3577,-0.03291780926680582,0.04155724893449153
2168,13151,Henry,Georgia,2016,50057,45724,3586,99367,0.5037587931607073,0.46015276701520624,0.036088439824086466,6296,2590,-1050,7836,0.025658477420684778,0.02520688057093726,-0.05086535799162206,4333,7346,0.04360602614550102,0.07652383541230684
2169,13153,Houston,Georgia,2000,13301,23174,513,36988,0.3596031145236293,0.6265275224397102,0.013869363036660538,0,0,0,0,0.0,0.0,0.0,-9873,0,-0.2669244079160809,0.0
2170,13153,Houston,Georgia,2004,15054,29862,310,45226,0.3328616282669261,0.6602839074868438,0.006854464246230044,1753,-203,6688,8238,-0.026741486256703195,-0.007014898790430494,0.03375638504713363,-14808,-4935,-0.32742227921991773,-0.060497871303836825
2171,13153,Houston,Georgia,2008,22094,33392,548,56034,0.3942963200913731,0.595923903344398,0.00977977656422886,7040,238,3530,10808,0.061434691824446996,0.002925312317998816,-0.0643600041424458,-11298,3510,-0.20162758325302493,0.1257946959668928
2172,13153,Houston,Georgia,2012,22702,34662,811,58175,0.390236355822948,0.595822948001719,0.013940696175333047,608,263,1270,2141,-0.004059964268425087,0.004160919611104187,-0.00010095534267906547,-11960,-662,-0.20558659217877095,-0.0039590089257460215
2173,13153,Houston,Georgia,2016,22553,35430,2096,60079,0.37538907105644237,0.5897235306845986,0.034887398258959035,-149,1285,768,1904,-0.014847284766505653,0.020946702083625986,-0.006099417317120381,-12877,-917,-0.21433445962815623,-0.008747867449385271
2174,13155,Irwin,Georgia,2000,1105,1720,27,2852,0.38744740532959326,0.603085553997195,0.009467040673211781,0,0,0,0,0.0,0.0,0.0,-615,0,-0.21563814866760173,0.0
2175,13155,Irwin,Georgia,2004,1051,2347,20,3418,0.307489760093622,0.6866588648332358,0.005851375073142188,-54,-7,627,566,-0.07995764523597126,-0.0036156656000695927,0.0835733108360408,-1296,-681,-0.3791691047396138,-0.16353095607201207
2176,13155,Irwin,Georgia,2008,1197,2605,38,3840,0.31171875,0.6783854166666666,0.009895833333333333,146,18,258,422,0.004228989906377989,0.004044458260191145,-0.008273448166569164,-1408,-112,-0.36666666666666664,0.012502438072947153
2177,13155,Irwin,Georgia,2012,1141,2538,35,3714,0.3072159396876683,0.6833602584814217,0.00942380183091007,-56,-3,-67,-126,-0.004502810312331684,-0.0004720315024232622,0.004974841814755049,-1397,11,-0.3761443187937534,-0.009477652127086733
2178,13155,Irwin,Georgia,2016,891,2716,63,3670,0.24277929155313352,0.7400544959128066,0.017166212534059946,-250,28,178,-44,-0.06443664813453479,0.007742410703149875,0.05669423743138491,-1825,-428,-0.4972752043596731,-0.12113088556591972
2179,13157,Jackson,Georgia,2000,3420,7878,337,11635,0.293940696175333,0.6770949720670391,0.028964331757627845,0,0,0,0,0.0,0.0,0.0,-4458,0,-0.38315427589170603,0.0
2180,13157,Jackson,Georgia,2004,3468,12611,123,16202,0.21404764843846438,0.7783606962103444,0.007591655351191211,48,-214,4733,4567,-0.07989304773686864,-0.021372676406436635,0.10126572414330537,-9143,-4685,-0.5643130477718801,-0.18115877188017404
2181,13157,Jackson,Georgia,2008,4950,17776,290,23016,0.21506777893639206,0.7723322905804657,0.012599930483142162,1482,167,5165,6814,0.0010201304979276793,0.0050082751319509514,-0.006028405629878719,-12826,-3683,-0.5572645116440736,0.007048536127806426
2182,13157,Jackson,Georgia,2012,4238,19135,372,23745,0.1784796799326174,0.8058538639713624,0.015666456096020215,-712,82,1359,729,-0.03658809900377466,0.0030665256128780526,0.033521573390896675,-14897,-2071,-0.627374184038745,-0.07010967239467136
2183,13157,Jackson,Georgia,2016,4491,21784,1146,27421,0.1637795849896065,0.7944276284599394,0.041792786550454035,253,774,2649,3676,-0.014700094943010888,0.02612633045443382,-0.011426235511422966,-17293,-2396,-0.6306480434703329,-0.0032738594315878666
2184,13159,Jasper,Georgia,2000,1558,2298,87,3943,0.3951306112097388,0.5828049708343901,0.022064417955871163,0,0,0,0,0.0,0.0,0.0,-740,0,-0.1876743596246513,0.0
2185,13159,Jasper,Georgia,2004,1558,3157,28,4743,0.3284840818047649,0.6656124815517604,0.0059034366434745945,0,-59,859,800,-0.0666465294049739,-0.01616098131239657,0.08280751071737036,-1599,-859,-0.33712839974699554,-0.14945404012234426
2186,13159,Jasper,Georgia,2008,1935,3916,60,5911,0.32735577736423616,0.6624936558957876,0.010150566739976316,377,32,759,1168,-0.001128304440528749,0.0042471300965017215,-0.003118825655972879,-1981,-382,-0.3351378785315514,0.00199052121544413
2187,13159,Jasper,Georgia,2012,1845,4136,61,6042,0.30536246276067525,0.6845415425355842,0.010095994703740483,-90,1,220,131,-0.02199331460356091,-5.457203623583304e-05,0.02204788663979662,-2291,-310,-0.37917907977490894,-0.04404120124335753
2188,13159,Jasper,Georgia,2016,1544,4360,141,6045,0.2554177005789909,0.7212572373862697,0.023325062034739455,-301,80,224,3,-0.049944762181684366,0.013229067330998972,0.03671569485068549,-2816,-525,-0.4658395368072788,-0.08666045703236985
2189,13161,Jeff Davis,Georgia,2000,1379,2797,45,4221,0.32669983416252074,0.6626391850272447,0.010660980810234541,0,0,0,0,0.0,0.0,0.0,-1418,0,-0.335939350864724,0.0
2190,13161,Jeff Davis,Georgia,2004,1277,3549,19,4845,0.26357069143446854,0.7325077399380805,0.00392156862745098,-102,-26,752,624,-0.0631291427280522,-0.006739412182783561,0.06986855491083577,-2272,-854,-0.46893704850361195,-0.13299769763888797
2191,13161,Jeff Davis,Georgia,2008,1356,3867,63,5286,0.2565266742338252,0.7315550510783201,0.01191827468785471,79,44,318,441,-0.007044017200643349,0.00799670606040373,-0.0009526888597604088,-2511,-239,-0.4750283768444949,-0.00609132834088294
2192,13161,Jeff Davis,Georgia,2012,1275,3996,68,5339,0.23880876568645815,0.7484547668102641,0.012736467503277768,-81,5,129,53,-0.017717908547367045,0.0008181928154230578,0.016899715731944043,-2721,-210,-0.509646001123806,-0.03461762427931109
2193,13161,Jeff Davis,Georgia,2016,901,4104,91,5096,0.17680533751962324,0.8053375196232339,0.017857142857142856,-374,23,108,-243,-0.062003428166834906,0.005120675353865088,0.05688275281296973,-3203,-482,-0.6285321821036106,-0.11888618097980463
2194,13163,Jefferson,Georgia,2000,2973,2559,34,5566,0.5341358246496587,0.45975565936040247,0.006108515989938915,0,0,0,0,0.0,0.0,0.0,414,0,0.07438016528925623,0.0
2195,13163,Jefferson,Georgia,2004,3447,3066,26,6539,0.5271448233674874,0.4688790334913595,0.003976143141153081,474,-8,507,973,-0.0069910012821713385,-0.0021323728487858337,0.00912337413095704,381,-33,0.05826578987612785,-0.01611437541312838
2196,13163,Jefferson,Georgia,2008,4149,3061,25,7235,0.5734623358673117,0.4230822391154112,0.0034554250172771253,702,-1,-5,696,0.0463175124998243,-0.0005207181238759558,-0.0457967943759483,1088,707,0.15038009675190045,0.0921143068757726
2197,13163,Jefferson,Georgia,2012,4261,2999,41,7301,0.5836186823722778,0.4107656485412957,0.005615669086426517,112,16,-62,66,0.010156346504966107,0.002160244069149392,-0.012316590574115494,1262,174,0.17285303383098205,0.0224729370790816
2198,13163,Jefferson,Georgia,2016,3821,3063,84,6968,0.5483639494833524,0.4395809414466131,0.012055109070034443,-440,43,64,-333,-0.03525473288892533,0.006439439983607926,0.02881529290531737,758,-504,0.10878300803673935,-0.0640700257942427
2199,13165,Jenkins,Georgia,2000,1250,1317,26,2593,0.4820671037408407,0.5079059005013498,0.010026995757809487,0,0,0,0,0.0,0.0,0.0,-67,0,-0.025838796760509042,0.0
2200,13165,Jenkins,Georgia,2004,1494,1898,13,3405,0.43876651982378856,0.5574155653450807,0.0038179148311306903,244,-13,581,812,-0.04330058391705216,-0.006209080926678797,0.04950966484373098,-404,-337,-0.11864904552129218,-0.09281024876078314
2201,13165,Jenkins,Georgia,2008,1482,1936,24,3442,0.4305636257989541,0.5624636839047066,0.006972690296339338,-12,11,38,37,-0.008202894024834484,0.0031547754652086475,0.005048118559625836,-454,-50,-0.1319000581057525,-0.01325101258446032
2202,13165,Jenkins,Georgia,2012,1488,1887,19,3394,0.4384207424867413,0.5559811431938715,0.005598114319387153,6,-5,-49,-48,0.007857116687787213,-0.0013745759769521844,-0.006482540710835094,-399,55,-0.1175604007071302,0.014339657398622307
2203,13165,Jenkins,Georgia,2016,1123,1895,38,3056,0.36747382198952877,0.6200916230366492,0.012434554973821989,-365,19,8,-338,-0.07094692049721252,0.006836440654434835,0.06411047984277773,-772,-373,-0.25261780104712045,-0.13505740033999025
2204,13167,Johnson,Georgia,2000,1065,1797,21,2883,0.36940686784599375,0.6233090530697191,0.007284079084287201,0,0,0,0,0.0,0.0,0.0,-732,0,-0.2539021852237253,0.0
2205,13167,Johnson,Georgia,2004,1263,2279,13,3555,0.35527426160337555,0.6410689170182841,0.0036568213783403658,198,-8,482,672,-0.014132606242618195,-0.0036272577059468353,0.01775986394856499,-1016,-284,-0.2857946554149085,-0.031892470191183186
2206,13167,Johnson,Georgia,2008,1198,2426,26,3650,0.32821917808219175,0.6646575342465754,0.007123287671232876,-65,13,147,95,-0.027055083521183798,0.0034664662928925107,0.02358861722829131,-1228,-212,-0.3364383561643836,-0.05064370074947511
2207,13167,Johnson,Georgia,2012,1305,2440,31,3776,0.345603813559322,0.6461864406779662,0.008209745762711865,107,5,14,126,0.01738463547713026,0.0010864580914789887,-0.01847109356860921,-1135,93,-0.30058262711864414,0.03585572904573947
2208,13167,Johnson,Georgia,2016,1136,2519,31,3686,0.3081931633206728,0.6833966359196961,0.008410200759631037,-169,0,79,-90,-0.0374106502386492,0.00020045499691917143,0.03721019524172997,-1383,-248,-0.3752034725990233,-0.07462084548037917
2209,13169,Jones,Georgia,2000,3102,4850,116,8068,0.3844819038175508,0.6011403073872087,0.014377788795240456,0,0,0,0,0.0,0.0,0.0,-1748,0,-0.21665840356965788,0.0
2210,13169,Jones,Georgia,2004,3855,6939,64,10858,0.35503776017682814,0.6390679683182907,0.005894271504881194,753,-52,2089,2790,-0.029444143640722675,-0.008483517290359262,0.03792766093108202,-3084,-1336,-0.28403020814146257,-0.0673718045718047
2211,13169,Jones,Georgia,2008,4572,7782,106,12460,0.3669341894060995,0.6245585874799358,0.008507223113964686,717,42,843,1602,0.011896429229271366,0.0026129516090834925,-0.014509380838354957,-3210,-126,-0.25762439807383625,0.026405810067626323
2212,13169,Jones,Georgia,2012,4274,7744,101,12119,0.35266936215859396,0.638996616882581,0.008334020958824986,-298,-5,-38,-341,-0.014264827247505552,-0.00017320215513970047,0.01443802940264527,-3470,-260,-0.28632725472398707,-0.02870285665015082
2213,13169,Jones,Georgia,2016,3961,8305,285,12551,0.3155923830770457,0.6617002629272568,0.022707353995697555,-313,184,561,432,-0.03707697908154828,0.01437333303687257,0.022703646044675785,-4344,-874,-0.34610787985021113,-0.05978062512622406
2214,13171,Lamar,Georgia,2000,2194,2912,124,5230,0.41950286806883363,0.5567877629063097,0.023709369024856597,0,0,0,0,0.0,0.0,0.0,-718,0,-0.13728489483747608,0.0
2215,13171,Lamar,Georgia,2004,2432,4027,40,6499,0.3742114171410986,0.6196337898138176,0.006154793045083859,238,-84,1115,1269,-0.04529145092773501,-0.017554575979772738,0.06284602690750785,-1595,-877,-0.24542237267271894,-0.10813747783524286
2216,13171,Lamar,Georgia,2008,2752,4873,80,7705,0.35717066839714473,0.6324464633354965,0.010382868267358857,320,40,846,1206,-0.017040748743953893,0.004228075222274998,0.012812673521678919,-2121,-526,-0.27527579493835175,-0.029853422265632812
2217,13171,Lamar,Georgia,2012,2602,4899,111,7612,0.3418286915396742,0.6435890698896479,0.014582238570677877,-150,31,26,-93,-0.015341976857470518,0.00419937030331902,0.011142606554151446,-2297,-176,-0.3017603783499737,-0.026484583411621965
2218,13171,Lamar,Georgia,2016,2270,5190,152,7612,0.29821334734629534,0.6818181818181818,0.019968470835522858,-332,41,291,0,-0.04361534419337887,0.0053862322648449805,0.03822911192853384,-2920,-623,-0.3836048344718864,-0.08184445612191271
2219,13173,Lanier,Georgia,2000,832,1048,24,1904,0.4369747899159664,0.5504201680672269,0.012605042016806723,0,0,0,0,0.0,0.0,0.0,-216,0,-0.11344537815126055,0.0
2220,13173,Lanier,Georgia,2004,931,1641,17,2589,0.3595983005021244,0.6338354577056778,0.00656624179219776,99,-7,593,685,-0.07737648941384201,-0.006038800224608963,0.0834152896384509,-710,-494,-0.27423715720355346,-0.16079177905229292
2221,13173,Lanier,Georgia,2008,1062,1787,31,2880,0.36875,0.6204861111111111,0.010763888888888889,131,14,146,291,0.009151699497875643,0.004197647096691129,-0.013349346594566769,-725,-15,-0.25173611111111105,0.02250104609244241
2222,13173,Lanier,Georgia,2012,1114,1820,44,2978,0.374076561450638,0.6111484217595702,0.014775016789791807,52,13,33,98,0.005326561450637979,0.004011127900902918,-0.00933768935154089,-706,19,-0.23707186030893218,0.014664250802178869
2223,13173,Lanier,Georgia,2016,806,1984,81,2871,0.28073841866945315,0.6910484151863462,0.02821316614420063,-308,37,164,-107,-0.09333814278118485,0.013438149354408822,0.079899993426776,-1178,-472,-0.41030999651689304,-0.17323813620796086
2224,13175,Laurens,Georgia,2000,5724,8133,179,14036,0.4078084924479909,0.5794385864918781,0.012752921060131091,0,0,0,0,0.0,0.0,0.0,-2409,0,-0.17163009404388718,0.0
2225,13175,Laurens,Georgia,2004,6281,10883,97,17261,0.36388390012166155,0.6304964949887029,0.005619604889635595,557,-82,2750,3225,-0.04392459232632934,-0.007133316170495497,0.05105790849682479,-4602,-2193,-0.2666125948670413,-0.09498250082315413
2226,13175,Laurens,Georgia,2008,7769,12052,142,19963,0.38916996443420326,0.6037168762210089,0.007113159344787858,1488,45,1169,2702,0.02528606431254171,0.0014935544551522633,-0.02677961876769397,-4283,319,-0.21454691178680563,0.05206568308023568
2227,13175,Laurens,Georgia,2012,7513,11950,176,19639,0.38255511991445595,0.6084831203218086,0.008961759763735424,-256,34,-102,-324,-0.006614844519747309,0.0018486004189475656,0.0047662441007997325,-4437,-154,-0.22592800040735267,-0.011381088620547042
2228,13175,Laurens,Georgia,2016,6752,12411,367,19530,0.34572452636968765,0.635483870967742,0.018791602662570406,-761,191,461,-109,-0.03683059354476831,0.009829842898834982,0.027000750645933325,-5659,-1222,-0.2897593445980543,-0.06383134419070163
2229,13177,Lee,Georgia,2000,1936,5872,76,7884,0.24556062912227294,0.7447995941146626,0.009639776763064434,0,0,0,0,0.0,0.0,0.0,-3936,0,-0.4992389649923896,0.0
2230,13177,Lee,Georgia,2004,2182,8201,45,10428,0.20924434215573456,0.7864403528960491,0.00431530494821634,246,-31,2329,2544,-0.03631628696653838,-0.005324471814848093,0.04164075878138651,-6019,-2083,-0.5771960107403145,-0.07795704574792484
2231,13177,Lee,Georgia,2008,3100,9925,87,13112,0.23642464917632702,0.7569402074435632,0.006635143380109823,918,42,1724,2684,0.02718030702059246,0.002319838431893483,-0.029500145452485915,-6825,-806,-0.5205155582672362,0.05668045247307829
2232,13177,Lee,Georgia,2012,3196,10314,136,13646,0.23420782646929503,0.7558258830426499,0.009966290488055108,96,49,389,534,-0.0022168227070319957,0.0033311471079452842,-0.0011143244009133024,-7118,-293,-0.5216180565733548,-0.0011024983061186377
2233,13177,Lee,Georgia,2016,3170,10646,327,14143,0.22413915010959484,0.7527398713144312,0.02312097857597398,-26,191,332,497,-0.010068676359700185,0.013154688087918873,-0.0030860117282186517,-7476,-358,-0.5286007212048364,-0.006982664631481561
2234,13179,Liberty,Georgia,2000,5347,4455,170,9972,0.5362013638186923,0.44675090252707583,0.017047733654231848,0,0,0,0,0.0,0.0,0.0,892,0,0.08945046129161649,0.0
2235,13179,Liberty,Georgia,2004,6619,6131,59,12809,0.516746037942072,0.4786478257475213,0.004606136310406745,1272,-111,1676,2837,-0.019455325876620355,-0.012441597343825102,0.03189692322044546,488,-404,0.038098212194550674,-0.051352249097065816
2236,13179,Liberty,Georgia,2008,10474,5828,98,16400,0.6386585365853659,0.35536585365853657,0.005975609756097561,3855,39,-303,3591,0.1219124986432939,0.0013694734456908162,-0.12328197208898473,4646,4158,0.2832926829268293,0.24519447073227862
2237,13179,Liberty,Georgia,2012,10457,5565,173,16195,0.6456931151589997,0.3436245754862612,0.010682309354739117,-17,75,-263,-205,0.007034578573633876,0.004706699598641556,-0.011741278172275382,4892,246,0.30206853967273856,0.01877585674590926
2238,13179,Liberty,Georgia,2016,9556,6134,453,16143,0.5919593631914761,0.3799789382394846,0.02806169856903921,-901,280,569,-52,-0.05373375196752361,0.017379389214300094,0.0363543627532234,3422,-1470,0.21198042495199154,-0.09008811472074701
2239,13181,Lincoln,Georgia,2000,1275,1807,21,3103,0.41089268449887206,0.5823396712858524,0.00676764421527554,0,0,0,0,0.0,0.0,0.0,-532,0,-0.17144698678698034,0.0
2240,13181,Lincoln,Georgia,2004,1337,2309,12,3658,0.3655002733734281,0.6312192454893384,0.0032804811372334607,62,-9,502,555,-0.045392411125443954,-0.0034871630780420795,0.04887957420348599,-972,-440,-0.2657189721159103,-0.09427198532892994
2241,13181,Lincoln,Georgia,2008,1650,2731,43,4424,0.3729656419529837,0.6173146473779385,0.009719710669077758,313,31,422,766,0.007465368579555598,0.006439229531844297,-0.01390459811139988,-1081,-109,-0.2443490054249548,0.021369966690955478
2242,13181,Lincoln,Georgia,2012,1586,2807,37,4430,0.3580135440180587,0.6336343115124153,0.008352144469525959,-64,-6,76,6,-0.014952097934925024,-0.0013675661995517993,0.01631966413447683,-1221,-140,-0.27562076749435666,-0.031271762069401854
2243,13181,Lincoln,Georgia,2016,1273,2759,70,4102,0.310336421257923,0.6725987323256948,0.017064846416382253,-313,33,-48,-328,-0.04767712276013569,0.008712701946856295,0.03896442081327944,-1486,-265,-0.3622623110677718,-0.08664154357341514
2244,13183,Long,Georgia,2000,975,1320,19,2314,0.42134831460674155,0.5704407951598963,0.008210890233362144,0,0,0,0,0.0,0.0,0.0,-345,0,-0.14909248055315477,0.0
2245,13183,Long,Georgia,2004,1033,1994,14,3041,0.33969089115422557,0.6557053600789214,0.0046037487668530086,58,-5,674,727,-0.08165742345251598,-0.0036071414665091355,0.08526456491902512,-961,-616,-0.31601446892469587,-0.1669219883715411
2246,13183,Long,Georgia,2008,1288,2119,53,3460,0.3722543352601156,0.6124277456647399,0.015317919075144508,255,39,125,419,0.032563444105890016,0.010714170308291499,-0.04327761441418154,-831,130,-0.2401734104046243,0.07584105852007156
2247,13183,Long,Georgia,2012,1442,2306,67,3815,0.3779816513761468,0.6044560943643512,0.017562254259501964,154,14,187,355,0.0057273161160312225,0.0022443351843574565,-0.007971651300388682,-864,-33,-0.2264744429882044,0.013698967416419905
2248,13183,Long,Georgia,2016,1360,2626,131,4117,0.33033762448384746,0.6378430896283702,0.031819285887782364,-82,64,320,302,-0.04764402689229935,0.0142570316282804,0.033386995264019004,-1266,-402,-0.30750546514452276,-0.08103102215631836
2249,13185,Lowndes,Georgia,2000,10616,14462,354,25432,0.4174268637936458,0.5686536646744259,0.01391947153192828,0,0,0,0,0.0,0.0,0.0,-3846,0,-0.1512268008807801,0.0
2250,13185,Lowndes,Georgia,2004,12516,18981,187,31684,0.39502588057063504,0.59907208685772,0.005902032571644994,1900,-167,4519,6252,-0.022400983223010762,-0.008017438960283285,0.030418422183294047,-6465,-2619,-0.20404620628708492,-0.05281940540630481
2251,13185,Lowndes,Georgia,2008,17597,21269,384,39250,0.4483312101910828,0.5418853503184713,0.00978343949044586,5081,197,2288,7566,0.05330532962044776,0.0038814069188008666,-0.05718673653924866,-3672,2793,-0.0935541401273885,0.11049206615969642
2252,13185,Lowndes,Georgia,2012,17470,21327,424,39221,0.44542464496060785,0.5437648198669081,0.010810535172484129,-127,40,58,-29,-0.0029065652304749445,0.0010270956820382683,0.001879469548436763,-3857,-185,-0.0983401749063002,-0.0047860347789117075
2253,13185,Lowndes,Georgia,2016,15064,21635,1106,37805,0.3984658114006084,0.572278799100648,0.029255389498743553,-2406,682,308,-1416,-0.04695883355999947,0.018444854326259426,0.028513979233739994,-6571,-2714,-0.17381298770003967,-0.07547281279373946
2254,13187,Lumpkin,Georgia,2000,2121,4427,202,6750,0.31422222222222224,0.6558518518518518,0.029925925925925925,0,0,0,0,0.0,0.0,0.0,-2306,0,-0.34162962962962956,0.0
2255,13187,Lumpkin,Georgia,2004,2091,6690,105,8886,0.2353139770425388,0.7528696826468603,0.011816340310600946,-30,-97,2263,2136,-0.07890824517968342,-0.01810958561532498,0.09701783079500848,-4599,-2293,-0.5175557056043214,-0.17592607597469184
2256,13187,Lumpkin,Georgia,2008,2586,8326,196,11108,0.23280518545192655,0.7495498739647101,0.01764494058336334,495,91,1636,2222,-0.0025087915906122638,0.005828600272762396,-0.003319808682150205,-5740,-1141,-0.5167446885127835,0.0008110170915378578
2257,13187,Lumpkin,Georgia,2012,2055,8647,246,10948,0.18770551698940446,0.7898246255023749,0.02246985750822068,-531,50,321,-160,-0.045099668462522086,0.0048249169248573386,0.0402747515376648,-6592,-852,-0.6021191085129705,-0.08537442000018691
2258,13187,Lumpkin,Georgia,2016,2220,9619,678,12517,0.17735879204282176,0.7684748741711273,0.05416633378605097,165,432,972,1569,-0.010346724946582703,0.03169647627783029,-0.021349751331247613,-7399,-807,-0.5911160821283055,0.011003026384664993
2259,13189,McDuffie,Georgia,2000,2580,3926,44,6550,0.3938931297709924,0.5993893129770992,0.006717557251908397,0,0,0,0,0.0,0.0,0.0,-1346,0,-0.2054961832061068,0.0
2260,13189,McDuffie,Georgia,2004,2899,4846,35,7780,0.3726221079691517,0.622879177377892,0.004498714652956298,319,-9,920,1230,-0.021271021801840706,-0.0022188425989520984,0.023489864400792815,-1947,-601,-0.2502570694087403,-0.04476088620263352
2261,13189,McDuffie,Georgia,2008,3989,5400,66,9455,0.42189317821258593,0.5711263881544156,0.0069804336329984135,1090,31,554,1675,0.049271070243434245,0.002481718980042115,-0.05175278922347637,-1411,536,-0.1492332099418297,0.10102385946691061
2262,13189,McDuffie,Georgia,2012,4044,5475,86,9605,0.42103071317022384,0.5700156168662155,0.008953669963560645,55,20,75,150,-0.0008624650423620928,0.001973236330562232,-0.0011107712882001408,-1431,-20,-0.14898490369599166,0.00024830624583804806
2263,13189,McDuffie,Georgia,2016,3699,5432,137,9268,0.3991152352179543,0.5861027190332326,0.01478204574881312,-345,51,-43,-337,-0.021915477952269558,0.005828375785252474,0.016087102167017142,-1733,-302,-0.18698748381527835,-0.0380025801192867
2264,13191,McIntosh,Georgia,2000,2047,1766,24,3837,0.5334897054990878,0.4602554078707323,0.006254886630179828,0,0,0,0,0.0,0.0,0.0,281,0,0.07323429762835548,0.0
2265,13191,McIntosh,Georgia,2004,2523,2837,22,5382,0.46878483835005574,0.5271274619100706,0.004087699739873653,476,-2,1071,1545,-0.06470486714903206,-0.002167186890306175,0.06687205403933832,-314,-595,-0.058342623560014906,-0.1315769211883704
2266,13191,McIntosh,Georgia,2008,2905,3282,49,6236,0.4658434894162925,0.5262989095574085,0.00785760102629891,382,27,445,854,-0.0029413489337632437,0.0037699012864252568,-0.0008285523526621041,-377,-63,-0.060455420141116045,-0.0021127965811011395
2267,13191,McIntosh,Georgia,2012,2864,3409,81,6354,0.4507396915328927,0.5365124331129997,0.012747875354107648,-41,32,127,118,-0.015103797883399828,0.0048902743278087385,0.01021352355559113,-545,-168,-0.085772741580107,-0.02531732143899096
2268,13191,McIntosh,Georgia,2016,2303,3487,113,5903,0.3901406064712858,0.5907165847873962,0.019142808741317973,-561,32,78,-451,-0.06059908506160688,0.006394933387210325,0.05420415167439652,-1184,-639,-0.2005759783161104,-0.1148032367360034
2269,13193,Macon,Georgia,2000,2757,1566,32,4355,0.633065442020666,0.3595866819747417,0.0073478760045924225,0,0,0,0,0.0,0.0,0.0,1191,0,0.27347876004592425,0.0
2270,13193,Macon,Georgia,2004,2906,1851,23,4780,0.6079497907949791,0.3872384937238494,0.004811715481171548,149,-9,285,425,-0.02511565122568682,-0.0025361605234208743,0.02765181174910769,1055,-136,0.22071129707112974,-0.05276746297479451
2271,13193,Macon,Georgia,2008,3251,1712,21,4984,0.6522873194221509,0.3434991974317817,0.004213483146067416,345,-2,-139,204,0.044337528627171774,-0.0005982323351041326,-0.043739296292067686,1539,484,0.3087881219903692,0.08807682491923946
2272,13193,Macon,Georgia,2012,3211,1545,30,4786,0.6709151692436273,0.32281654826577516,0.0062682824905975765,-40,9,-167,-198,0.01862784982147636,0.002054799344530161,-0.02068264916600654,1666,127,0.3480986209778521,0.0393104989874829
2273,13193,Macon,Georgia,2016,2705,1540,42,4287,0.6309773734546302,0.3592255656636342,0.00979706088173548,-506,12,-5,-499,-0.03993779578899703,0.003528778391137903,0.03640901739785907,1165,-501,0.271751807790996,-0.0763468131868561
2274,13195,Madison,Georgia,2000,2285,5529,179,7993,0.2858751407481546,0.6917302639809834,0.022394595270862003,0,0,0,0,0.0,0.0,0.0,-3244,0,-0.40585512323282874,0.0
2275,13195,Madison,Georgia,2004,2527,7254,75,9856,0.25639204545454547,0.7359983766233766,0.007609577922077922,242,-104,1725,1863,-0.02948309529360915,-0.01478501734878408,0.044268112642393276,-4727,-1483,-0.47960633116883117,-0.07375120793600243
2276,13195,Madison,Georgia,2008,2965,8226,174,11365,0.2608886933567972,0.7238011438627364,0.015310162780466345,438,99,972,1509,0.004496647902251738,0.007700584858388423,-0.01219723276064022,-5261,-534,-0.4629124505059392,0.016693880662891958
2277,13195,Madison,Georgia,2012,2494,8443,196,11133,0.22401868319410762,0.7583759992814156,0.01760531752447678,-471,22,217,-232,-0.03687001016268959,0.0022951547440104355,0.03457485541867922,-5949,-688,-0.5343573160873081,-0.07144486558136887
2278,13195,Madison,Georgia,2016,2425,9201,455,12081,0.20072841652181111,0.7616091383163646,0.037662445161824355,-69,259,758,948,-0.0232902666722965,0.020057127637347575,0.0032331390349489286,-6776,-827,-0.5608807217945535,-0.02652340570724543
2279,13197,Marion,Georgia,2000,982,1187,15,2184,0.44963369963369965,0.5434981684981685,0.006868131868131868,0,0,0,0,0.0,0.0,0.0,-205,0,-0.09386446886446881,0.0
2280,13197,Marion,Georgia,2004,1275,1670,12,2957,0.43118025025363543,0.5647615826851539,0.004058167061210686,293,-3,483,773,-0.018453449380064213,-0.0028099648069211816,0.021263414186985408,-395,-190,-0.13358133243151843,-0.03971686356704962
2281,13197,Marion,Georgia,2008,1381,1772,35,3188,0.43318695106649935,0.5558343789209536,0.010978670012547051,106,23,102,231,0.0020067008128639152,0.006920502951336365,-0.008927203764200309,-391,4,-0.1226474278544542,0.010933904577064224
2282,13197,Marion,Georgia,2012,1412,1733,34,3179,0.4441648317080843,0.5451399811261403,0.0106951871657754,31,-1,-39,-9,0.010977880641584947,-0.0002834828467716509,-0.010694397794813293,-321,70,-0.10097514941805597,0.02167227843639824
2283,13197,Marion,Georgia,2016,1213,1921,56,3190,0.38025078369905957,0.6021943573667712,0.01755485893416928,-199,22,188,11,-0.06391404800902473,0.006859671768393879,0.05705437624063092,-708,-387,-0.2219435736677116,-0.12096842424965565
2284,13199,Meriwether,Georgia,2000,3441,3162,106,6709,0.5128931286331793,0.4713071992845432,0.015799672082277536,0,0,0,0,0.0,0.0,0.0,279,0,0.041585929348636086,0.0
2285,13199,Meriwether,Georgia,2004,3709,4402,44,8155,0.45481299816063764,0.5397915389331699,0.00539546290619252,268,-62,1240,1446,-0.058080130472541625,-0.010404209176085016,0.06848433964862671,-693,-972,-0.08497854077253225,-0.12656447012116834
2286,13199,Meriwether,Georgia,2008,4465,4982,71,9518,0.46911115780626184,0.5234292918680395,0.007459550325698676,756,27,580,1363,0.014298159645624198,0.0020640874195061564,-0.016362247065130342,-517,176,-0.05431813406177771,0.03066040671075454
2287,13199,Meriwether,Georgia,2012,4331,4856,87,9274,0.4670045287901661,0.5236144058658615,0.009381065343972397,-134,16,-126,-244,-0.0021066290160957624,0.0019215150182737206,0.0001851139978219507,-525,-8,-0.056609877075695425,-0.002291743013917713
2288,13199,Meriwether,Georgia,2016,3804,5222,191,9217,0.41271563415428014,0.566561788000434,0.020722577845285885,-527,104,366,-57,-0.05428889463588593,0.011341512501313489,0.0429473821345725,-1418,-893,-0.15384615384615385,-0.09723627677045843
2289,13201,Miller,Georgia,2000,783,1349,18,2150,0.3641860465116279,0.6274418604651163,0.008372093023255815,0,0,0,0,0.0,0.0,0.0,-566,0,-0.2632558139534884,0.0
2290,13201,Miller,Georgia,2004,736,1694,12,2442,0.3013923013923014,0.6936936936936937,0.004914004914004914,-47,-6,345,292,-0.0627937451193265,-0.0034580881092509006,0.06625183322857742,-958,-392,-0.3923013923013923,-0.12904557834790392
2291,13201,Miller,Georgia,2008,818,1899,23,2740,0.29854014598540146,0.6930656934306569,0.008394160583941606,82,11,205,298,-0.0028521554068999255,0.0034801556699366925,-0.0006280002630367765,-1081,-123,-0.3945255474452555,-0.002224155143863149
2292,13201,Miller,Georgia,2012,852,1905,23,2780,0.3064748201438849,0.685251798561151,0.008273381294964029,34,0,6,40,0.007934674158483424,-0.00012077928897757766,-0.0078138948695059,-1053,28,-0.37877697841726615,0.015748569027989323
2293,13201,Miller,Georgia,2016,623,1891,30,2544,0.24488993710691823,0.7433176100628931,0.01179245283018868,-229,7,-14,-236,-0.06158488303696666,0.0035190715352246514,0.05806581150174206,-1268,-215,-0.4984276729559749,-0.11965069453870875
2294,13205,Mitchell,Georgia,2000,2971,2790,38,5799,0.5123297120193137,0.4811174340403518,0.00655285394033454,0,0,0,0,0.0,0.0,0.0,181,0,0.031212277978961867,0.0
2295,13205,Mitchell,Georgia,2004,3360,3885,27,7272,0.46204620462046203,0.5342409240924092,0.0037128712871287127,389,-11,1095,1473,-0.05028350739885162,-0.0028399826532058275,0.05312349005205741,-525,-706,-0.07219471947194717,-0.10340699745090903
2296,13205,Mitchell,Georgia,2008,3872,4201,59,8132,0.47614363010329563,0.5166010821446139,0.007255287752090506,512,32,316,860,0.014097425482833603,0.0035424164649617935,-0.01763984194779533,-329,196,-0.04045745204131823,0.031737267430628935
2297,13205,Mitchell,Georgia,2012,4081,4155,45,8281,0.49281487743026203,0.5017509962564908,0.005434126313247192,209,-14,-46,149,0.0166712473269664,-0.001821161438843314,-0.014850085888123088,-74,255,-0.008936118826228745,0.031521333215089486
2298,13205,Mitchell,Georgia,2016,3493,4279,108,7880,0.4432741116751269,0.5430203045685279,0.013705583756345178,-588,63,124,-401,-0.04954076575513511,0.008271457443097985,0.04126930831203712,-786,-712,-0.09974619289340098,-0.09081007406717223
2299,13207,Monroe,Georgia,2000,2839,4561,141,7541,0.37647526853202495,0.6048269460283782,0.01869778543959687,0,0,0,0,0.0,0.0,0.0,-1722,0,-0.2283516774963532,0.0
2300,13207,Monroe,Georgia,2004,3216,6522,56,9794,0.32836430467633243,0.665917908923831,0.005717786399836635,377,-85,1961,2253,-0.04811096385569252,-0.012979999039760236,0.061090962895452794,-3306,-1584,-0.33755360424749853,-0.10920192675114532
2301,13207,Monroe,Georgia,2008,4106,7933,108,12147,0.3380258500041162,0.6530830657775583,0.008891084218325513,890,52,1411,2353,0.009661545327783794,0.0031732978184888776,-0.0128348431462727,-3827,-521,-0.31505721577344203,0.022496388474056495
2302,13207,Monroe,Georgia,2012,3785,8361,149,12295,0.30784871899145994,0.6800325335502236,0.01211874745831639,-321,41,428,148,-0.03017713101265629,0.0032276632399908765,0.02694946777266538,-4576,-749,-0.3721838145587637,-0.05712659878532167
2303,13207,Monroe,Georgia,2016,3571,8832,284,12687,0.2814692204618901,0.6961456609127453,0.022385118625364547,-214,135,471,392,-0.026379498529569834,0.010266371167048158,0.016113127362521684,-5261,-685,-0.4146764404508552,-0.04249262589209152
2304,13209,Montgomery,Georgia,2000,1013,1465,31,2509,0.4037465125548027,0.5838979673176564,0.012355520127540853,0,0,0,0,0.0,0.0,0.0,-452,0,-0.1801514547628537,0.0
2305,13209,Montgomery,Georgia,2004,1007,2150,13,3170,0.31766561514195585,0.6782334384858044,0.004100946372239748,-6,-18,685,661,-0.08608089741284686,-0.008254573755301104,0.094335471168148,-1143,-691,-0.36056782334384857,-0.18041636858099486
2306,13209,Montgomery,Georgia,2008,1045,2521,27,3593,0.29084330642916784,0.7016420818257724,0.0075146117450598385,38,14,371,423,-0.026822308712788012,0.0034136653728200905,0.02340864333996795,-1476,-333,-0.41079877539660453,-0.05023095205275596
2307,13209,Montgomery,Georgia,2012,1135,2662,38,3835,0.29595827900912647,0.6941329856584094,0.009908735332464147,90,11,141,242,0.005114972579958632,0.002394123587404308,-0.00750909616736295,-1527,-51,-0.39817470664928295,0.012624068747321582
2308,13209,Montgomery,Georgia,2016,847,2670,59,3576,0.23685682326621924,0.7466442953020134,0.016498881431767337,-288,21,8,-259,-0.05910145574290723,0.0065901460993031905,0.052511309643603954,-1823,-296,-0.5097874720357941,-0.11161276538651116
2309,13211,Morgan,Georgia,2000,2238,3524,140,5902,0.3791934937309387,0.5970857336496103,0.023720772619451033,0,0,0,0,0.0,0.0,0.0,-1286,0,-0.21789223991867157,0.0
2310,13211,Morgan,Georgia,2004,2304,4902,41,7247,0.3179246584793708,0.6764178280667863,0.00565751345384297,66,-99,1378,1345,-0.0612688352515679,-0.018063259165608064,0.07933209441717604,-2598,-1312,-0.3584931695874155,-0.14060092966874393
2311,13211,Morgan,Georgia,2008,3091,5987,87,9165,0.3372613202400436,0.6532460447354065,0.009492635024549919,787,46,1085,1918,0.019336661760672835,0.003835121570706949,-0.023171783331379814,-2896,-298,-0.31598472449536286,0.04250844509205265
2312,13211,Morgan,Georgia,2012,2753,6186,102,9041,0.30450171441212254,0.6842163477491428,0.011281937838734653,-338,15,199,-124,-0.03275960582792109,0.0017893028141847348,0.030970303013736267,-3433,-537,-0.3797146333370202,-0.06372990884165736
2313,13211,Morgan,Georgia,2016,2663,6559,253,9475,0.28105540897097625,0.6922427440633245,0.02670184696569921,-90,151,373,434,-0.023446305441146287,0.015419909126964556,0.008026396314181783,-3896,-463,-0.4111873350923483,-0.03147270175532807
2314,13213,Murray,Georgia,2000,2684,5539,149,8372,0.32059245102723366,0.6616101290014333,0.017797419971333016,0,0,0,0,0.0,0.0,0.0,-2855,0,-0.3410176779741997,0.0
2315,13213,Murray,Georgia,2004,2899,7745,56,10700,0.2709345794392523,0.7238317757009346,0.005233644859813084,215,-93,2206,2328,-0.04965787158798135,-0.012563775111519931,0.062221646699501254,-4846,-1991,-0.4528971962616823,-0.1118795182874826
2316,13213,Murray,Georgia,2008,3026,8180,241,11447,0.2643487376605224,0.714597711190705,0.021053551148772606,127,185,435,747,-0.006585841778729895,0.01581990628895952,-0.009234064510229567,-5154,-308,-0.4502489735301826,0.002648222731499672
2317,13213,Murray,Georgia,2012,2542,8443,270,11255,0.22585517547756553,0.7501554864504665,0.023989338071968014,-484,29,263,-192,-0.03849356218295688,0.0029357869231954083,0.03555777525976145,-5901,-747,-0.524300310972901,-0.07405133744271836
2318,13213,Murray,Georgia,2016,1800,10341,317,12458,0.14448547118317548,0.830069031947343,0.025445496869481457,-742,47,1898,1203,-0.08136970429439006,0.0014561587975134432,0.07991354549687657,-8541,-2640,-0.6855835607641676,-0.16128324979126663
2319,13215,Muscogee,Georgia,2000,28193,23479,491,52163,0.5404788834997987,0.45010831432241244,0.009412802177788854,0,0,0,0,0.0,0.0,0.0,4714,0,0.09037056917738623,0.0
2320,13215,Muscogee,Georgia,2004,32867,30850,335,64052,0.5131299569100106,0.4816399175669768,0.005230125523012552,4674,-156,7371,11889,-0.027348926589788047,-0.004182676654776302,0.03153160324456439,2017,-2697,0.03149003934303379,-0.058880529834352435
2321,13215,Muscogee,Georgia,2008,44158,29568,436,74162,0.5954262290660985,0.3986947493325423,0.005879021601359186,11291,101,-1282,10110,0.08229627215608792,0.0006488960783466342,-0.08294516823443454,14590,12573,0.19673147973355626,0.16524144039052246
2322,13215,Muscogee,Georgia,2012,42573,27510,632,70715,0.6020363430672417,0.389026373470975,0.008937283461783215,-1585,196,-2058,-3447,0.006610114001143197,0.0030582618604240285,-0.009668375861567269,15063,473,0.21300996959626672,0.016278489862710466
2323,13215,Muscogee,Georgia,2016,39851,26976,2698,69525,0.5731895001797914,0.38800431499460625,0.0388061848256023,-2722,2066,-534,-1190,-0.02884684288745032,0.02986890136381909,-0.0010220584763687701,12875,-2188,0.18518518518518517,-0.02782478441108155
2324,13217,Newton,Georgia,2000,6703,11127,545,18375,0.3647891156462585,0.6055510204081632,0.029659863945578232,0,0,0,0,0.0,0.0,0.0,-4424,0,-0.24076190476190473,0.0
2325,13217,Newton,Georgia,2004,10939,18095,157,29191,0.37473878935288274,0.6198828406015553,0.005378370045561989,4236,-388,6968,10816,0.009949673706624251,-0.024281493900016243,0.014331820193392075,-7156,-2732,-0.24514405124867256,-0.004382146486767824
2326,13217,Newton,Georgia,2008,20827,20337,318,41482,0.5020731883708597,0.490260836025264,0.0076659756038763805,9888,161,2242,12291,0.12733439901797694,0.002287605558314392,-0.1296220045762913,490,7646,0.01181235234559569,0.25695640359426825
2327,13217,Newton,Georgia,2012,21851,20982,476,43309,0.5045371631762451,0.484472049689441,0.010990787134313885,1024,158,645,1827,0.002463974805385405,0.0033248115304375042,-0.005788786335822971,869,379,0.020065113486804065,0.008252761141208376
2328,13217,Newton,Georgia,2016,21943,20913,1382,44238,0.4960215199602152,0.4727383697273837,0.031240110312401103,92,906,-69,929,-0.008515643216029878,0.020249323178087218,-0.01173367996205732,1030,161,0.023283150232831507,0.0032180367460274417
2329,13219,Oconee,Georgia,2000,3184,7611,373,11168,0.2851002865329513,0.6815007163323782,0.03339899713467049,0,0,0,0,0.0,0.0,0.0,-4427,0,-0.3964004297994269,0.0
2330,13219,Oconee,Georgia,2004,3789,10276,134,14199,0.26684977815339106,0.723712937530812,0.009437284315796888,605,-239,2665,3031,-0.018250508379560215,-0.023961712818873604,0.04221222119843382,-6487,-2060,-0.45686315937742095,-0.060462729577994034
2331,13219,Oconee,Georgia,2008,4825,12120,229,17174,0.28094794456736927,0.7057179457319204,0.013334109700710375,1036,95,1844,2975,0.014098166413978208,0.003896825384913488,-0.017994991798891635,-7295,-808,-0.4247700011645511,0.03209315821286984
2332,13219,Oconee,Georgia,2012,4421,13098,340,17859,0.24755025477350356,0.7334117251805812,0.019038020045915226,-404,111,978,685,-0.033397689793865704,0.00570391034520485,0.027693779448660805,-8677,-1382,-0.4858614704070776,-0.06109146924252651
2333,13219,Oconee,Georgia,2016,5581,13425,1143,20149,0.27698645094049335,0.6662861680480421,0.05672738101146459,1160,803,327,2290,0.02943619616698978,0.03768936096554936,-0.0671255571325391,-7844,833,-0.38929971710754874,0.09656175329952887
2334,13221,Oglethorpe,Georgia,2000,1519,2706,160,4385,0.34640820980615733,0.6171037628278221,0.036488027366020526,0,0,0,0,0.0,0.0,0.0,-1187,0,-0.27069555302166476,0.0
2335,13221,Oglethorpe,Georgia,2004,1899,3688,51,5638,0.3368215679318907,0.6541326711599859,0.009045760908123448,380,-109,982,1253,-0.00958664187426661,-0.027442266457897078,0.03702890833216377,-1789,-602,-0.31731110322809514,-0.04661555020643038
2336,13221,Oglethorpe,Georgia,2008,2232,4144,87,6463,0.3453504564443757,0.6411883026458302,0.013461240909794213,333,36,456,825,0.008528888512484956,0.004415480001670765,-0.012944368514155702,-1912,-123,-0.2958378462014545,0.021473257026640657
2337,13221,Oglethorpe,Georgia,2012,1914,4251,120,6285,0.3045346062052506,0.6763723150357995,0.01909307875894988,-318,33,107,-178,-0.040815850239125095,0.005631837849155668,0.03518401238996938,-2337,-425,-0.37183770883054895,-0.07599986262909447
2338,13221,Oglethorpe,Georgia,2016,1831,4625,218,6674,0.27434821696134254,0.6929877135151333,0.032664069523524124,-83,98,374,389,-0.03018638924390804,0.013570990764574242,0.0166153984793338,-2794,-457,-0.4186394965537908,-0.04680178772324184
2339,13223,Paulding,Georgia,2000,6743,16881,636,24260,0.2779472382522671,0.6958367683429514,0.026215993404781535,0,0,0,0,0.0,0.0,0.0,-10138,0,-0.4178895300906843,0.0
2340,13223,Paulding,Georgia,2004,9420,30843,251,40514,0.2325122179987165,0.7612923927531223,0.00619538924816113,2677,-385,13962,16254,-0.04543502025355059,-0.020020604156620405,0.06545562441017094,-21423,-11285,-0.5287801747544059,-0.11089064466372156
2341,13223,Paulding,Georgia,2008,17229,39192,655,57076,0.30186067699208075,0.686663396173523,0.011475926834396244,7809,404,8349,16562,0.06934845899336425,0.005280537586235114,-0.07462899657959932,-21963,-540,-0.38480271918144227,0.1439774555729636
2342,13223,Paulding,Georgia,2012,15825,40846,872,57543,0.27501173035816695,0.7098343847209913,0.015153884920841805,-1404,217,1654,467,-0.026848946633913795,0.003677958086445561,0.02317098854746824,-25021,-3058,-0.4348226543628243,-0.050019935181382036
2343,13223,Paulding,Georgia,2016,18025,44662,2791,65478,0.2752833012614924,0.6820916949204313,0.0426250038180763,2200,1919,3816,7935,0.00027157090332546874,0.027471118897234498,-0.02774268980055994,-26637,-1616,-0.4068083936589389,0.028014260703885407
2344,13225,Peach,Georgia,2000,3540,3525,72,7137,0.49600672551492225,0.4939050021017234,0.01008827238335435,0,0,0,0,0.0,0.0,0.0,15,0,0.002101723413198864,0.0
2345,13225,Peach,Georgia,2004,3961,4554,39,8554,0.4630582183773673,0.5323825111059154,0.004559270516717325,421,-33,1029,1417,-0.03294850713755493,-0.0055290018666370256,0.038477509004192,-593,-608,-0.06932429272854806,-0.07142601614174693
2346,13225,Peach,Georgia,2008,5927,5173,96,11196,0.5293854948195784,0.46204001429081815,0.00857449088960343,1966,57,619,2642,0.06632727644221109,0.004015220372886105,-0.07034249681509724,754,1347,0.06734548052876027,0.13666977325730834
2347,13225,Peach,Georgia,2012,6148,5287,102,11537,0.5328941665944353,0.4582647135303805,0.00884111987518419,221,6,114,341,0.0035086717748569196,0.00026662898558076076,-0.0037753007604376387,861,107,0.07462945306405483,0.007283972535294558
2348,13225,Peach,Georgia,2016,5100,5413,239,10752,0.47433035714285715,0.5034412202380952,0.02222842261904762,-1048,137,126,-785,-0.058563809451578186,0.01338730274386343,0.045176506707714725,-313,-1174,-0.029110863095238082,-0.10374031615929291
2349,13227,Pickens,Georgia,2000,2489,5488,224,8201,0.3034995732227777,0.6691866845506645,0.027313742226557736,0,0,0,0,0.0,0.0,0.0,-2999,0,-0.36568711132788684,0.0
2350,13227,Pickens,Georgia,2004,2444,8115,80,10639,0.22972083842466398,0.762759657862581,0.007519503712754958,-45,-144,2627,2438,-0.07377873479811373,-0.019794238513802777,0.0935729733119165,-5671,-2672,-0.5330388194379171,-0.16735170811003025
2351,13227,Pickens,Georgia,2008,2595,10004,214,12813,0.20252868180753922,0.7807695309451338,0.016701787247326932,151,134,1889,2174,-0.027192156617124763,0.009182283534571975,0.018009873082552752,-7409,-1738,-0.5782408491375945,-0.04520202969967746
2352,13227,Pickens,Georgia,2012,1975,10547,180,12702,0.15548732483073532,0.8303416784758306,0.014170996693434105,-620,-34,543,-111,-0.047041356976803894,-0.002530790553892827,0.04957214753069683,-8572,-1163,-0.6748543536450953,-0.09661350450750072
2353,13227,Pickens,Georgia,2016,1979,11651,428,14058,0.14077393654858444,0.8287807654004837,0.030445298050931855,4,248,1104,1356,-0.01471338828215088,0.01627430135749775,-0.0015609130753468925,-9672,-1100,-0.6880068288518992,-0.01315247520680396
2354,13229,Pierce,Georgia,2000,1300,3348,33,4681,0.27771843623157444,0.7152317880794702,0.007049775688955351,0,0,0,0,0.0,0.0,0.0,-2048,0,-0.43751335184789575,0.0
2355,13229,Pierce,Georgia,2004,1234,4680,11,5925,0.2082700421940928,0.789873417721519,0.0018565400843881857,-66,-22,1332,1244,-0.06944839403748163,-0.0051932356045671655,0.07464162964204879,-3446,-1398,-0.5816033755274261,-0.1440900236795304
2356,13229,Pierce,Georgia,2008,1253,5500,44,6797,0.184346035015448,0.809180520818008,0.006473444166544063,19,33,820,872,-0.02392400717864482,0.004616904082155877,0.019307103096488976,-4247,-801,-0.62483448580256,-0.04323111027513382
2357,13229,Pierce,Georgia,2012,1124,5667,64,6855,0.1639679066374909,0.8266958424507659,0.009336250911743253,-129,20,167,58,-0.020378128377957105,0.0028628067451991895,0.01751532163275793,-4543,-296,-0.6627279358132749,-0.03789345001071498
2358,13229,Pierce,Georgia,2016,903,6302,106,7311,0.12351251538777185,0.8619887840240733,0.014498700588154835,-221,42,635,456,-0.040455391249719044,0.0051624496764115825,0.035292941573307424,-5399,-856,-0.7384762686363014,-0.07574833282302651
2359,13231,Pike,Georgia,2000,1413,3358,114,4885,0.28925281473899694,0.6874104401228249,0.023336745138178096,0,0,0,0,0.0,0.0,0.0,-1945,0,-0.398157625383828,0.0
2360,13231,Pike,Georgia,2004,1506,5193,50,6749,0.22314416950659358,0.7694473255297081,0.007408504963698326,93,-64,1835,1864,-0.06610864523240337,-0.01592824017447977,0.08203688540688314,-3687,-1742,-0.5463031560231145,-0.14814553063928654
2361,13231,Pike,Georgia,2008,1575,6547,99,8221,0.1915825325386206,0.7963751368446661,0.012042330616713295,69,49,1354,1472,-0.031561636967972984,0.00463382565301497,0.026927811314958028,-4972,-1285,-0.6047926043060455,-0.05848944828293101
2362,13231,Pike,Georgia,2012,1356,6668,115,8139,0.1666052340582381,0.8192652660031945,0.014129499938567392,-219,16,121,-82,-0.024977298480382493,0.002087169321854097,0.022890129158528394,-5312,-340,-0.6526600319449564,-0.04786742763891083
2363,13231,Pike,Georgia,2016,1240,7278,207,8725,0.14212034383954156,0.8341547277936963,0.02372492836676218,-116,92,610,586,-0.024484890218696542,0.009595428428194787,0.014889461790501768,-6038,-726,-0.6920343839541547,-0.039374352009198366
2364,13233,Polk,Georgia,2000,4112,5841,163,10116,0.40648477659153814,0.5774021352313167,0.016113088177145116,0,0,0,0,0.0,0.0,0.0,-1729,0,-0.17091735863977853,0.0
2365,13233,Polk,Georgia,2004,3868,8467,85,12420,0.31143317230273754,0.6817230273752013,0.006843800322061192,-244,-78,2626,2304,-0.0950516042888006,-0.009269287855083925,0.10432089214388462,-4599,-2870,-0.37028985507246376,-0.19937249643268523
2366,13233,Polk,Georgia,2008,4052,9850,251,14153,0.28629972444004803,0.6959655196778068,0.01773475588214513,184,166,1383,1733,-0.025133447862689506,0.010890955560083938,0.014242492302605547,-5798,-1199,-0.4096657952377588,-0.039375940165295054
2367,13233,Polk,Georgia,2012,3615,9811,222,13648,0.26487397420867526,0.7188599062133646,0.01626611957796014,-437,-29,-39,-505,-0.021425750231372775,-0.0014686363041849886,0.022894386535557754,-6196,-398,-0.45398593200468934,-0.04432013676693053
2368,13233,Polk,Georgia,2016,2867,11014,334,14215,0.20168835736897645,0.7748153359127682,0.023496306718255363,-748,112,1203,567,-0.06318561683969881,0.007230187140295222,0.05595542969940359,-8147,-1951,-0.5731269785437918,-0.11914104653910246
2369,13235,Pulaski,Georgia,2000,1390,1922,34,3346,0.415421398684997,0.5744172145845786,0.010161386730424387,0,0,0,0,0.0,0.0,0.0,-532,0,-0.15899581589958162,0.0
2370,13235,Pulaski,Georgia,2004,1294,2202,21,3517,0.36792721069092976,0.6261017912994029,0.00597099800966733,-96,-13,280,171,-0.04749418799406724,-0.004190388720757057,0.05168457671482429,-908,-376,-0.25817458060847315,-0.09917876470889153
2371,13235,Pulaski,Georgia,2008,1377,2553,32,3962,0.3475517415446744,0.6443715295305401,0.008076728924785462,83,11,351,445,-0.020375469146255376,0.0021057309151181315,0.0182697382311372,-1176,-268,-0.2968197879858657,-0.038645207377392576
2372,13235,Pulaski,Georgia,2012,1219,2444,22,3685,0.33080054274084125,0.6632293080054275,0.005970149253731343,-158,-10,-109,-277,-0.016751198803833134,-0.0021065796710541184,0.018857778474887343,-1225,-49,-0.3324287652645862,-0.03560897727872048
2373,13235,Pulaski,Georgia,2016,1104,2437,64,3605,0.3062413314840499,0.676005547850208,0.017753120665742025,-115,42,-7,-80,-0.024559211256791336,0.011782971412010682,0.012776239844780601,-1333,-108,-0.36976421636615814,-0.03733545110157194
2374,13237,Putnam,Georgia,2000,2612,3596,91,6299,0.4146689950785839,0.5708842673440229,0.014446737577393237,0,0,0,0,0.0,0.0,0.0,-984,0,-0.15621527226543896,0.0
2375,13237,Putnam,Georgia,2004,2880,5188,50,8118,0.35476718403547675,0.6390736634639074,0.006159152500615915,268,-41,1592,1819,-0.059901811043107156,-0.00828758507677732,0.0681893961198845,-2308,-1324,-0.2843064794284306,-0.12809120716299166
2376,13237,Putnam,Georgia,2008,3102,5966,71,9139,0.3394244446876026,0.6528066528066528,0.007768902505744611,222,21,778,1021,-0.015342739347874168,0.0016097500051286961,0.013732989342745472,-2864,-556,-0.31338220811905027,-0.02907572869061964
2377,13237,Putnam,Georgia,2012,2926,6215,88,9229,0.3170441001191895,0.6734207389749702,0.009535160905840286,-176,17,249,90,-0.02238034456841309,0.0017662584000956742,0.02061408616831739,-3289,-425,-0.35637663885578075,-0.04299443073673048
2378,13237,Putnam,Georgia,2016,2758,6544,186,9488,0.2906829679595278,0.6897133220910624,0.01960370994940978,-168,98,329,259,-0.026361132159661682,0.010068549043569495,0.016292583116092163,-3786,-497,-0.3990303541315346,-0.042653715275753845
2379,13239,Quitman,Georgia,2000,542,348,14,904,0.5995575221238938,0.38495575221238937,0.015486725663716814,0,0,0,0,0.0,0.0,0.0,194,0,0.21460176991150443,0.0
2380,13239,Quitman,Georgia,2004,543,409,13,965,0.5626943005181347,0.42383419689119173,0.013471502590673576,1,-1,61,61,-0.036863221605759056,-0.002015223073043238,0.03887844467880236,134,-60,0.138860103626943,-0.07574166628456142
2381,13239,Quitman,Georgia,2008,597,509,10,1116,0.5349462365591398,0.4560931899641577,0.008960573476702509,54,-3,100,151,-0.027748063958994984,-0.004510929113971067,0.03225899307296598,88,-46,0.07885304659498205,-0.060007057031960964
2382,13239,Quitman,Georgia,2012,612,510,6,1128,0.5425531914893617,0.4521276595744681,0.005319148936170213,15,-4,1,12,0.007606954930221899,-0.003641424540532296,-0.003965530389689609,102,14,0.09042553191489355,0.011572485319911507
2383,13239,Quitman,Georgia,2016,461,575,8,1044,0.44157088122605365,0.5507662835249042,0.007662835249042145,-151,2,65,-84,-0.100982310263308,0.0023436863128719326,0.0986386239504361,-114,-216,-0.10919540229885055,-0.1996209342137441
2384,13241,Rabun,Georgia,2000,1776,3451,114,5341,0.3325219996255383,0.6461336828309305,0.021344317543531173,0,0,0,0,0.0,0.0,0.0,-1675,0,-0.31361168320539223,0.0
2385,13241,Rabun,Georgia,2004,1918,4650,75,6643,0.28872497365648053,0.699984946560289,0.011290079783230468,142,-39,1199,1302,-0.04379702596905777,-0.010054237760300705,0.053851263729358445,-2732,-1057,-0.41125997290380845,-0.09764828969841621
2386,13241,Rabun,Georgia,2008,2001,5487,145,7633,0.26215118564129436,0.7188523516310756,0.018996462727630028,83,70,837,990,-0.026573788015186173,0.00770638294439956,0.018867405070786658,-3486,-754,-0.4567011659897813,-0.04544119308597283
2387,13241,Rabun,Georgia,2012,1559,5754,152,7465,0.208841259209645,0.7707970529135968,0.020361687876758204,-442,7,267,-168,-0.05330992643164936,0.0013652251491281762,0.051944701282521155,-4195,-709,-0.5619557937039518,-0.10525462771417049
2388,13241,Rabun,Georgia,2016,1444,6287,261,7992,0.1806806806806807,0.7866616616616616,0.03265765765765766,-115,109,533,527,-0.02816057852896431,0.012295969780899453,0.015864608748064835,-4843,-648,-0.605980980980981,-0.0440251872770292
2389,13243,Randolph,Georgia,2000,1381,1174,14,2569,0.5375632541845076,0.45698715453483846,0.005449591280653951,0,0,0,0,0.0,0.0,0.0,207,0,0.08057609964966911,0.0
2390,13243,Randolph,Georgia,2004,1612,1418,20,3050,0.5285245901639344,0.46491803278688526,0.006557377049180328,231,6,244,481,-0.009038664020573184,0.001107785768526377,0.007930878252046802,194,-13,0.06360655737704912,-0.016969542272619986
2391,13243,Randolph,Georgia,2008,1833,1370,14,3217,0.5697855144544607,0.42586260491140815,0.004351880634131178,221,-6,-48,167,0.0412609242905263,-0.00220549641504915,-0.03905542787547711,463,269,0.14392290954305254,0.08031635216600341
2392,13243,Randolph,Georgia,2012,1770,1271,19,3060,0.5784313725490197,0.41535947712418303,0.006209150326797385,-63,5,-99,-157,0.008645858094558978,0.0018572696926662073,-0.01050312778722512,499,36,0.16307189542483663,0.019148985881784097
2393,13243,Randolph,Georgia,2016,1598,1271,30,2899,0.55122456019317,0.43842704380820974,0.010348395998620214,-172,11,0,-161,-0.027206812355849652,0.004139245671822829,0.023067566684026708,327,-172,0.11279751638496027,-0.05027437903987636
2394,13245,Richmond,Georgia,2000,31413,25485,640,57538,0.5459522402586117,0.44292467586638395,0.011123083875004346,0,0,0,0,0.0,0.0,0.0,5928,0,0.10302756439222771,0.0
2395,13245,Richmond,Georgia,2004,39262,29764,350,69376,0.5659305811808119,0.4290244464944649,0.005044972324723247,7849,-290,4279,11838,0.01997834092220019,-0.006078111550281098,-0.013900229371919037,9498,3570,0.13690613468634694,0.033878570294119226
2396,13245,Richmond,Georgia,2008,52100,26842,480,79422,0.6559895243131626,0.3379668102037219,0.0060436654831155096,12838,130,-2922,10046,0.09005894313235074,0.0009986931583922621,-0.09105763629074304,25258,15760,0.3180227141094407,0.18111657942309378
2397,13245,Richmond,Georgia,2012,52560,25845,769,79174,0.6638542956020916,0.3264329198979463,0.009712784499962109,460,289,-997,-248,0.00786477128892904,0.003669119016846599,-0.011533890305775563,26715,1457,0.3374213757041453,0.019398661594704603
2398,13245,Richmond,Georgia,2016,48814,24461,2750,76025,0.6420782637290365,0.32174942453140415,0.03617231173955936,-3746,1981,-1384,-3149,-0.0217760318730551,0.02645952723959725,-0.0046834953665421675,24353,-2362,0.3203288391976324,-0.017092536506512934
2399,13247,Rockdale,Georgia,2000,8295,15440,914,24649,0.3365248083086535,0.6263945799018216,0.03708061178952493,0,0,0,0,0.0,0.0,0.0,-7145,0,-0.28986977159316807,0.0
2400,13247,Rockdale,Georgia,2004,12136,18856,214,31206,0.3888995705953983,0.6042427738255464,0.00685765557905531,3841,-700,3416,6557,0.052374762286744814,-0.030222956210469623,-0.022151806076275204,-6720,425,-0.21534320323014805,0.07452656836302002
2401,13247,Rockdale,Georgia,2008,20526,16921,337,37784,0.5432458183358035,0.44783506246030064,0.008919119203895829,8390,123,-1935,6578,0.15434624774040523,0.002061463624840519,-0.15640771136524573,3605,10325,0.0954107558755029,0.31075395910565096
2402,13247,Rockdale,Georgia,2012,22023,15716,417,38156,0.577183142887095,0.41188803857846734,0.010928818534437572,1497,80,-1205,372,0.0339373245512915,0.0020096993305417435,-0.035947023881833295,6307,2702,0.1652951043086277,0.0698843484331248
2403,13247,Rockdale,Georgia,2016,23255,13478,1354,38087,0.6105757870139418,0.353874025257962,0.0355501877280962,1232,937,-2238,-69,0.03339264412684673,0.024621369193658628,-0.05801401332050532,9777,3470,0.25670176175597975,0.09140665744735205
2404,13249,Schley,Georgia,2000,460,706,10,1176,0.391156462585034,0.6003401360544217,0.008503401360544218,0,0,0,0,0.0,0.0,0.0,-246,0,-0.2091836734693877,0.0
2405,13249,Schley,Georgia,2004,464,1063,5,1532,0.3028720626631854,0.693864229765013,0.0032637075718015664,4,-5,357,356,-0.08828439992184861,-0.005239693788742652,0.09352409371059134,-599,-353,-0.39099216710182766,-0.18180849363243995
2406,13249,Schley,Georgia,2008,479,1252,8,1739,0.27544565842438185,0.7199539965497412,0.004600345025876941,15,3,189,207,-0.027426404238803548,0.0013366374540753744,0.026089766784728186,-773,-174,-0.4445083381253594,-0.05351617102353173
2407,13249,Schley,Georgia,2012,448,1286,18,1752,0.2557077625570776,0.7340182648401826,0.010273972602739725,-31,10,34,13,-0.019737895867304234,0.005673627576862785,0.014064268290441384,-838,-65,-0.478310502283105,-0.03380216415774562
2408,13249,Schley,Georgia,2016,401,1472,36,1909,0.21005762179151388,0.7710843373493976,0.01885804085908853,-47,18,186,157,-0.04565014076556373,0.008584068256348804,0.03706607250921501,-1071,-233,-0.5610267155578837,-0.08271621327477874
2409,13251,Screven,Georgia,2000,2233,2461,25,4719,0.4731934731934732,0.521508794236067,0.005297732570459843,0,0,0,0,0.0,0.0,0.0,-228,0,-0.048315321042593784,0.0
2410,13251,Screven,Georgia,2004,2534,3360,34,5928,0.4274628879892038,0.5668016194331984,0.005735492577597841,301,9,899,1209,-0.045730585204269425,0.00043776000713799824,0.0452928251971314,-826,-598,-0.1393387314439946,-0.09102341040140083
2411,13251,Screven,Georgia,2008,3024,3423,40,6487,0.46616309542161244,0.5276707260675196,0.006166178510867889,490,6,63,559,0.03870020743240865,0.00043068593327004814,-0.039130893365678765,-399,427,-0.061507630645907196,0.07783110079808742
2412,13251,Screven,Georgia,2012,2774,3287,50,6111,0.45393552610047455,0.5378825069546719,0.008181966944853543,-250,10,-136,-376,-0.012227569321137888,0.002015788433985654,0.010211780887152244,-513,-114,-0.08394698085419733,-0.022439350208290132
2413,13251,Screven,Georgia,2016,2300,3305,110,5715,0.40244969378827644,0.5783027121609798,0.019247594050743656,-474,60,18,-396,-0.05148583231219811,0.011065627105890112,0.04042020520630796,-1005,-492,-0.1758530183727034,-0.09190603751850607
2414,13253,Seminole,Georgia,2000,1313,1537,27,2877,0.45637817170663886,0.5342370524852277,0.009384775808133473,0,0,0,0,0.0,0.0,0.0,-224,0,-0.07785888077858882,0.0
2415,13253,Seminole,Georgia,2004,1278,1977,26,3281,0.38951539164888754,0.6025601950624809,0.007924413288631514,-35,-1,440,404,-0.06686278005775131,-0.0014603625195019586,0.06832314257725325,-699,-475,-0.2130448034135934,-0.13518592263500456
2416,13253,Seminole,Georgia,2008,1660,2315,32,4007,0.4142750187172448,0.5777389568255553,0.0079860244571999,382,6,338,726,0.02475962706835727,6.161116856838629e-05,-0.024821238236925613,-655,44,-0.1634639381083105,0.049580865305282884
2417,13253,Seminole,Georgia,2012,1478,2245,54,3777,0.3913158591474715,0.594387079692878,0.014297061159650517,-182,22,-70,-230,-0.02295915956977329,0.006311036702450616,0.016648122867322646,-767,-112,-0.20307122054540644,-0.039607282437095936
2418,13253,Seminole,Georgia,2016,1189,2345,54,3588,0.33138238573021184,0.6535674470457079,0.015050167224080268,-289,0,100,-189,-0.059933473417259686,0.0007531060644297514,0.05918036735282994,-1156,-389,-0.32218506131549607,-0.11911384077008963
2419,13255,Spalding,Georgia,2000,5831,9271,289,15391,0.3788577740237801,0.6023650185173153,0.018777207458904554,0,0,0,0,0.0,0.0,0.0,-3440,0,-0.22350724449353515,0.0
2420,13255,Spalding,Georgia,2004,7460,13461,115,21036,0.3546301578246815,0.6399030233884769,0.005466818786841605,1629,-174,4190,5645,-0.024227616199098634,-0.01331038867206295,0.037538004871161657,-6001,-2561,-0.28527286556379544,-0.06176562107026029
2421,13255,Spalding,Georgia,2008,10141,14885,269,25295,0.4009092706068393,0.5884562166436055,0.010634512749555248,2681,154,1424,4259,0.046279112782157794,0.005167693962713643,-0.051446806744871454,-4744,1257,-0.1875469460367662,0.09772591952702925
2422,13255,Spalding,Georgia,2012,9898,14911,330,25139,0.3937308564382036,0.5931421297585425,0.013127013803253908,-243,61,26,-156,-0.007178414168635683,0.0024925010536986595,0.004685913114937046,-5013,-269,-0.19941127332033892,-0.011864327283572729
2423,13255,Spalding,Georgia,2016,9357,15646,701,25704,0.36402894491129784,0.6086990351696234,0.02727201991907874,-541,371,735,565,-0.029701911526905767,0.014145006115824834,0.015556905411080901,-6289,-1276,-0.2446700902583256,-0.04525881693798667
2424,13257,Stephens,Georgia,2000,2869,5370,137,8376,0.34252626552053483,0.6411174785100286,0.016356255969436486,0,0,0,0,0.0,0.0,0.0,-2501,0,-0.2985912129894938,0.0
2425,13257,Stephens,Georgia,2004,2714,6904,56,9674,0.28054579284680586,0.7136654951416167,0.005788712011577424,-155,-81,1534,1298,-0.06198047267372897,-0.010567543957859062,0.07254801663158805,-4190,-1689,-0.43311970229481084,-0.13452848930531702
2426,13257,Stephens,Georgia,2008,2705,7689,158,10552,0.2563495072024261,0.7286770280515542,0.014973464746019712,-9,102,785,878,-0.024196285644379756,0.009184752734442289,0.015011532909937508,-4984,-794,-0.4723275208491281,-0.039207818554317264
2427,13257,Stephens,Georgia,2012,2131,7221,182,9534,0.22351583805328298,0.7573945877910636,0.01908957415565345,-574,24,-468,-1018,-0.032833669149143124,0.004116109409633738,0.028717559739509402,-5090,-106,-0.5338787497377806,-0.0615512288886525
2428,13257,Stephens,Georgia,2016,1837,7686,292,9815,0.18716250636780438,0.7830871115639327,0.029750382068262863,-294,110,465,281,-0.03635333168547861,0.010660807912609413,0.025692523772869125,-5849,-759,-0.5959246051961283,-0.06204585545834773
2429,13259,Stewart,Georgia,2000,1267,675,12,1954,0.6484135107471852,0.34544524053224157,0.006141248720573183,0,0,0,0,0.0,0.0,0.0,592,0,0.30296827021494366,0.0
2430,13259,Stewart,Georgia,2004,1220,797,15,2032,0.6003937007874016,0.3922244094488189,0.0073818897637795275,-47,3,122,78,-0.04801980995978361,0.0012406410432063445,0.04677916891657735,423,-169,0.2081692913385827,-0.09479897887636096
2431,13259,Stewart,Georgia,2008,1305,783,21,2109,0.6187766714082503,0.3712660028449502,0.00995732574679943,85,6,-14,77,0.018382970620848704,0.0025754359830199034,-0.020958406603868718,522,99,0.24751066856330012,0.03934137722471742
2432,13259,Stewart,Georgia,2012,1323,745,8,2076,0.6372832369942196,0.3588631984585742,0.0038535645472061657,18,-13,-38,-33,0.018506565585969303,-0.006103761199593265,-0.012402804386376032,578,56,0.27842003853564545,0.030909369972345335
2433,13259,Stewart,Georgia,2016,1222,805,31,2058,0.5937803692905733,0.391156462585034,0.015063168124392614,-101,23,60,-18,-0.04350286770364631,0.011209603577186448,0.03229326412645983,417,-161,0.20262390670553931,-0.07579613183010614
2434,13261,Sumter,Georgia,2000,4748,4847,102,9697,0.4896359698875941,0.4998453129833969,0.010518717129008972,0,0,0,0,0.0,0.0,0.0,-99,0,-0.010209343095802792,0.0
2435,13261,Sumter,Georgia,2004,5562,5688,48,11298,0.492299522039299,0.5034519383961763,0.004248539564524694,814,-54,841,1601,0.0026635521517048844,-0.006270177564484278,0.003606625412779396,-126,-27,-0.011152416356877304,-0.0009430732610745118
2436,13261,Sumter,Georgia,2008,6454,5717,84,12255,0.5266421868625051,0.4665034679722562,0.006854345165238678,892,36,29,957,0.03434266482320608,0.002605805600713984,-0.03694847042392008,737,863,0.060138718890248855,0.07129113524712616
2437,13261,Sumter,Georgia,2012,6375,5378,103,11856,0.5377024291497976,0.45360998650472334,0.008687584345479083,-79,19,-339,-399,0.011060242287292521,0.0018332391802404046,-0.012893481467532886,997,260,0.08409244264507426,0.023953723754825407
2438,13261,Sumter,Georgia,2016,5520,5276,178,10974,0.5030071077091307,0.4807727355567705,0.016220156734098778,-855,75,-102,-882,-0.03469532144066689,0.007532572388619695,0.027162749052047186,244,-753,0.022234372152360182,-0.06185807049271408
2439,13263,Talbot,Georgia,2000,1662,844,25,2531,0.6566574476491506,0.33346503358356383,0.009877518767285659,0,0,0,0,0.0,0.0,0.0,818,0,0.32319241406558674,0.0
2440,13263,Talbot,Georgia,2004,1830,1103,14,2947,0.6209704784526637,0.3742789277231082,0.004750593824228029,168,-11,259,416,-0.03568696919648684,-0.00512692494305763,0.04081389413954439,727,-91,0.2466915507295555,-0.07650086333603123
2441,13263,Talbot,Georgia,2008,2369,1301,31,3701,0.6400972710078358,0.35152661442853284,0.008376114563631451,539,17,198,754,0.019126792555172023,0.0036255207394034223,-0.022752313294575388,1068,341,0.2885706565793029,0.04187910584974741
2442,13263,Talbot,Georgia,2012,2265,1202,26,3493,0.6484397366160893,0.3441168050386487,0.007443458345261953,-104,-5,-99,-208,0.00834246560825358,-0.0009326562183694983,-0.007409809389884114,1063,-5,0.3043229315774406,0.015752274998137694
2443,13263,Talbot,Georgia,2016,2002,1196,48,3246,0.6167590881084412,0.36845348120764015,0.014787430683918669,-263,22,-6,-247,-0.03168064850764818,0.007343972338656716,0.024336676168991433,806,-257,0.248305606900801,-0.05601732467663961
2444,13265,Taliaferro,Georgia,2000,556,271,5,832,0.6682692307692307,0.32572115384615385,0.006009615384615385,0,0,0,0,0.0,0.0,0.0,285,0,0.34254807692307687,0.0
2445,13265,Taliaferro,Georgia,2004,612,335,4,951,0.6435331230283912,0.352260778128286,0.004206098843322818,56,-1,64,119,-0.024736107740839564,-0.001803516541292567,0.026539624282132135,277,-8,0.2912723449001052,-0.0512757320229717
2446,13265,Taliaferro,Georgia,2008,643,339,8,990,0.6494949494949495,0.3424242424242424,0.00808080808080808,31,4,4,39,0.005961826466558295,0.003874709237485263,-0.00983653570404358,304,27,0.30707070707070705,0.015798362170601876
2447,13265,Taliaferro,Georgia,2012,636,323,4,963,0.660436137071651,0.3354101765316719,0.004153686396677051,-7,-4,-16,-27,0.010941187576701594,-0.00392712168413103,-0.007014065892570531,313,9,0.3250259605399792,0.017955253469272126
2448,13265,Taliaferro,Georgia,2016,545,349,3,897,0.6075808249721293,0.3890746934225195,0.0033444816053511705,-91,-1,26,-66,-0.05285531209952177,-0.0008092047913258803,0.05366451689084761,196,-117,0.2185061315496098,-0.10651982899036938
2449,13267,Tattnall,Georgia,2000,1963,3597,50,5610,0.3499108734402852,0.6411764705882353,0.008912655971479501,0,0,0,0,0.0,0.0,0.0,-1634,0,-0.29126559714795014,0.0
2450,13267,Tattnall,Georgia,2004,1787,4657,30,6474,0.27602718566573986,0.7193388940376892,0.004633920296570899,-176,-20,1060,864,-0.07388368777454535,-0.004278735674908603,0.0781624234494539,-2870,-1236,-0.4433117083719494,-0.15204611122399925
2451,13267,Tattnall,Georgia,2008,1932,4730,64,6726,0.2872435325602141,0.7032411537317871,0.00951531370799881,145,34,73,252,0.01121634689447426,0.004881393411427911,-0.016097740305902164,-2798,72,-0.41599762117157296,0.027314087200376425
2452,13267,Tattnall,Georgia,2012,1897,4706,74,6677,0.28410963007338624,0.7048075483001348,0.011082821626478957,-35,10,-24,-49,-0.0031339024868278775,0.001567507918480147,0.0015663945683477287,-2809,-11,-0.42069791822674857,-0.004700297055175606
2453,13267,Tattnall,Georgia,2016,1681,5096,126,6903,0.2435173113139215,0.7382297551789078,0.018252933507170794,-216,52,390,226,-0.04059231875946476,0.007170111880691837,0.03342220687877295,-3415,-606,-0.49471244386498625,-0.07401452563823768
2454,13269,Taylor,Georgia,2000,1340,1412,28,2780,0.48201438848920863,0.5079136690647482,0.010071942446043165,0,0,0,0,0.0,0.0,0.0,-72,0,-0.025899280575539585,0.0
2455,13269,Taylor,Georgia,2004,1458,1912,13,3383,0.4309784215193615,0.5651788353532368,0.0038427431274017146,118,-15,500,603,-0.051035966969847135,-0.0062291993186414495,0.057265166288488545,-454,-382,-0.13420041383387527,-0.10830113325833568
2456,13269,Taylor,Georgia,2008,1536,2021,30,3587,0.42821299135768054,0.5634234736548648,0.008363534987454697,78,17,109,204,-0.0027654301616809596,0.004520791860052982,-0.0017553616983719822,-485,-31,-0.13521048229718424,-0.0010100684633089774
2457,13269,Taylor,Georgia,2012,1572,1948,20,3540,0.4440677966101695,0.5502824858757062,0.005649717514124294,36,-10,-73,-47,0.015854805252488946,-0.002713817473330403,-0.01314098777915862,-376,109,-0.10621468926553668,0.028995793031647565
2458,13269,Taylor,Georgia,2016,1296,2064,48,3408,0.38028169014084506,0.6056338028169014,0.014084507042253521,-276,28,116,-132,-0.06378610646932442,0.008434789528129228,0.05535131694119522,-768,-392,-0.22535211267605632,-0.11913742341051964
2459,13271,Telfair,Georgia,2000,1777,1693,23,3493,0.5087317492127111,0.48468365302032634,0.006584597766962496,0,0,0,0,0.0,0.0,0.0,84,0,0.024048096192384794,0.0
2460,13271,Telfair,Georgia,2004,1590,2171,15,3776,0.4210805084745763,0.574947033898305,0.003972457627118644,-187,-8,478,283,-0.08765124073813485,-0.0026121401398438524,0.0902633808779787,-581,-665,-0.15386652542372875,-0.17791462161611354
2461,13271,Telfair,Georgia,2008,1862,2486,28,4376,0.42550274223034734,0.5680987202925045,0.006398537477148081,272,13,315,600,0.0044222337557710545,0.002426079850029437,-0.006848313605800516,-624,-43,-0.14259597806215718,0.01127054736157157
2462,13271,Telfair,Georgia,2012,1805,2480,53,4338,0.4160903642231443,0.5716920239741816,0.012217611802674043,-57,25,-6,-38,-0.009412378007203015,0.0058190743255259626,0.003593303681677096,-675,-51,-0.1556016597510373,-0.01300568168888011
2463,13271,Telfair,Georgia,2016,1313,2450,33,3796,0.3458904109589041,0.6454162276080084,0.00869336143308746,-492,-20,-30,-542,-0.07019995326424022,-0.003524250369586583,0.07372420363382681,-1137,-462,-0.2995258166491043,-0.14392415689806703
2464,13273,Terrell,Georgia,2000,1584,1504,25,3113,0.508833922261484,0.4831352393189849,0.008030838419530999,0,0,0,0,0.0,0.0,0.0,80,0,0.025698682942499163,0.0
2465,13273,Terrell,Georgia,2004,1951,1859,17,3827,0.5097987980141103,0.4857590802194931,0.004442121766396656,367,-8,355,714,0.0009648757526262708,-0.003588716653134343,0.002623840900508212,92,12,0.02403971779461722,-0.0016589651478819412
2466,13273,Terrell,Georgia,2008,2501,1890,30,4421,0.5657091155847094,0.4275050893463017,0.006785795068988917,550,13,31,594,0.055910317570599055,0.0023436733025922613,-0.058253990873191386,611,519,0.13820402623840766,0.11416430844379044
2467,13273,Terrell,Georgia,2012,2544,1834,29,4407,0.5772634445200817,0.41615611527115953,0.006580440208758793,43,-1,-56,-14,0.011554328935372338,-0.00020535486023012372,-0.011348974075142182,710,99,0.16110732924892218,0.02290330301051452
2468,13273,Terrell,Georgia,2016,2267,1874,48,4189,0.5411792790642158,0.44736213893530674,0.011458582000477441,-277,19,40,-218,-0.0360841654558659,0.004878141791718648,0.03120602366414721,393,-317,0.09381714012890907,-0.06729018912001311
2469,13275,Thomas,Georgia,2000,4862,7093,103,12058,0.4032177807264886,0.5882401724995854,0.008542046773926025,0,0,0,0,0.0,0.0,0.0,-2231,0,-0.18502239177309676,0.0
2470,13275,Thomas,Georgia,2004,5997,9659,77,15733,0.381173329943431,0.613932498569885,0.0048941714866840395,1135,-26,2566,3675,-0.022044450783057612,-0.0036478752872419855,0.025692326070299587,-3662,-1431,-0.23275916862645396,-0.0477367768533572
2471,13275,Thomas,Georgia,2008,7720,10642,132,18494,0.41743268086947116,0.5754298691467503,0.007137449983778523,1723,55,983,2761,0.03625935092604016,0.0022432784970944832,-0.03850262942313465,-2922,740,-0.15799718827727915,0.0747619803491748
2472,13275,Thomas,Georgia,2012,7653,11156,183,18992,0.4029591406908172,0.5874052232518955,0.009635636057287279,-67,51,514,498,-0.014473540178653987,0.002498186073508756,0.011975354105145164,-3503,-581,-0.1844460825610783,-0.02644889428379915
2473,13275,Thomas,Georgia,2016,7142,11228,432,18802,0.3798532071056271,0.5971705137751303,0.022976279119242635,-511,249,72,-190,-0.023105933585190086,0.013340643061955357,0.009765290523234826,-4086,-583,-0.21731730666950322,-0.03287122410842491
2474,13277,Tift,Georgia,2000,3547,6678,103,10328,0.34343532145623545,0.6465917893106119,0.009972889233152595,0,0,0,0,0.0,0.0,0.0,-3131,0,-0.30315646785437644,0.0
2475,13277,Tift,Georgia,2004,3864,8619,54,12537,0.3082077051926298,0.6874850442689638,0.004307250538406317,317,-49,1941,2209,-0.035227616263605654,-0.005665638694746278,0.04089325495835194,-4755,-1624,-0.37927733907633404,-0.0761208712219576
2476,13277,Tift,Georgia,2008,4749,9431,89,14269,0.33281939869647487,0.6609433036652884,0.006237297638236737,885,35,812,1732,0.024611693503845067,0.0019300470998304198,-0.026541740603675423,-4682,73,-0.32812390496881355,0.05115343410752049
2477,13277,Tift,Georgia,2012,4660,9185,97,13942,0.33424185913068427,0.6588007459474968,0.0069573949218189645,-89,8,-246,-327,0.001422460434209405,0.0007200972835822274,-0.0021425577177915933,-4525,157,-0.32455888681681255,0.0035650181520009983
2478,13277,Tift,Georgia,2016,4347,9584,288,14219,0.30571770166678386,0.6740277094029116,0.02025458893030452,-313,191,399,277,-0.028524157463900413,0.013297194008485558,0.015226963455414744,-5237,-712,-0.3683100077361277,-0.043751120919315156
2479,13279,Toombs,Georgia,2000,2643,4487,80,7210,0.3665742024965326,0.6223300970873786,0.011095700416088766,0,0,0,0,0.0,0.0,0.0,-1844,0,-0.255755894590846,0.0
2480,13279,Toombs,Georgia,2004,2567,6196,57,8820,0.29104308390022676,0.7024943310657596,0.006462585034013605,-76,-23,1709,1610,-0.07553111859630585,-0.004633115382075161,0.08016423397838102,-3629,-1785,-0.4114512471655329,-0.15569535257468686
2481,13279,Toombs,Georgia,2008,2964,6658,82,9704,0.3054410552349547,0.6861088211046991,0.008450123660346249,397,25,462,884,0.014397971334727921,0.0019875386263326434,-0.016385509961060585,-3694,-65,-0.3806677658697444,0.030783481295788506
2482,13279,Toombs,Georgia,2012,2746,6524,87,9357,0.29347012931495137,0.6972320188094475,0.009297851875601153,-218,5,-134,-347,-0.011970925920003317,0.0008477282152549049,0.011123197704748455,-3778,-84,-0.40376188949449615,-0.023094123624751772
2483,13279,Toombs,Georgia,2016,2338,6615,185,9138,0.2558546727949223,0.7239001969796455,0.02024513022543226,-408,98,91,-219,-0.03761545652002907,0.010947278349831106,0.026668178170197954,-4277,-499,-0.46804552418472317,-0.06428363469022702
2484,13281,Towns,Georgia,2000,1495,2902,100,4497,0.33244385145652655,0.6453191016233044,0.022237046920169,0,0,0,0,0.0,0.0,0.0,-1407,0,-0.31287525016677786,0.0
2485,13281,Towns,Georgia,2004,1430,3823,32,5285,0.27057710501419113,0.723368022705771,0.006054872280037843,-65,-68,921,788,-0.06186674644233542,-0.016182174640131157,0.07804892108246664,-2393,-986,-0.4527909176915799,-0.13991566752480206
2486,13281,Towns,Georgia,2008,1391,4292,81,5764,0.24132546842470506,0.7446217904233171,0.014052741151977794,-39,49,469,479,-0.02925163658948607,0.00799786887193995,0.021253767717546057,-2901,-508,-0.5032963219986121,-0.05050540430703215
2487,13281,Towns,Georgia,2012,1273,4876,95,6244,0.2038757206918642,0.7809096732863549,0.015214606021780909,-118,14,584,480,-0.03744974773284088,0.0011618648698031152,0.036287882863037746,-3603,-702,-0.5770339525944906,-0.07373763059587857
2488,13281,Towns,Georgia,2016,1210,5383,171,6764,0.1788882318154938,0.7958308693081018,0.025280898876404494,-63,76,507,520,-0.024987488876370395,0.010066292854623585,0.014921196021746908,-4173,-570,-0.6169426374926079,-0.039908684898117275
2489,13283,Treutlen,Georgia,2000,879,1062,22,1963,0.4477840040753948,0.5410086602139582,0.011207335710646969,0,0,0,0,0.0,0.0,0.0,-183,0,-0.0932246561385634,0.0
2490,13283,Treutlen,Georgia,2004,1052,1691,19,2762,0.38088341781317886,0.612237509051412,0.0068790731354091235,173,-3,629,799,-0.06690058626221596,-0.0043282625752378455,0.07122884883745384,-639,-456,-0.2313540912382332,-0.1381294350996698
2491,13283,Treutlen,Georgia,2008,1112,1826,24,2962,0.37542201215395005,0.6164753544902093,0.008102633355840648,60,5,135,200,-0.005461405659228813,0.0012235602204315249,0.004237845438797239,-714,-75,-0.24105334233625925,-0.009699251098026052
2492,13283,Treutlen,Georgia,2012,1074,1652,25,2751,0.3904034896401309,0.6005089058524173,0.009087604507451835,-38,1,-174,-211,0.014981477486180839,0.0009849711516111866,-0.015966448637791952,-578,136,-0.21010541621228646,0.03094792612397279
2493,13283,Treutlen,Georgia,2016,862,1809,32,2703,0.3189049204587495,0.6692563817980022,0.011838697743248243,-212,7,157,-48,-0.07149856918138137,0.002751093235796408,0.06874747594558483,-947,-369,-0.35035146133925266,-0.1402460451269662
2494,13285,Troup,Georgia,2000,6379,11198,227,17804,0.3582902718490227,0.6289597843181307,0.012749943832846552,0,0,0,0,0.0,0.0,0.0,-4819,0,-0.27066951246910803,0.0
2495,13285,Troup,Georgia,2004,7630,14183,126,21939,0.3477824878071015,0.6464743151465426,0.005743197046355805,1251,-101,2985,4135,-0.010507784041921153,-0.007006746786490747,0.017514530828411923,-6553,-1734,-0.2986918273394411,-0.028022314870333076
2496,13285,Troup,Georgia,2008,10455,15391,222,26068,0.40106644161423965,0.590417369955501,0.008516188430259322,2825,96,1208,4129,0.05328395380713813,0.0027729913839035173,-0.05605694519104165,-4936,1617,-0.18935092834126133,0.10934089899817978
2497,13285,Troup,Georgia,2012,10547,15179,309,26035,0.4051085077779912,0.5830228538505857,0.011868638371423084,92,87,-212,-33,0.004042066163751523,0.003352449941163762,-0.007394516104915261,-4632,304,-0.17791434607259454,0.011436582268666784
2498,13285,Troup,Georgia,2016,9713,15750,648,26111,0.37198881697368924,0.6031940561449197,0.024817126881390986,-834,339,571,76,-0.03311969080430194,0.012948488509967902,0.020171202294334,-6037,-1405,-0.23120523917123048,-0.05329089309863594
2499,13287,Turner,Georgia,2000,1169,1258,29,2456,0.4759771986970684,0.512214983713355,0.011807817589576547,0,0,0,0,0.0,0.0,0.0,-89,0,-0.03623778501628666,0.0
2500,13287,Turner,Georgia,2004,1135,1815,15,2965,0.3827993254637437,0.612141652613828,0.00505902192242833,-34,-14,557,509,-0.09317787323332472,-0.006748795667148217,0.09992666890047297,-680,-591,-0.22934232715008435,-0.19310454213379769
2501,13287,Turner,Georgia,2008,1427,2096,33,3556,0.40129358830146233,0.5894263217097863,0.009280089988751405,292,18,281,591,0.018494262837718656,0.004221068066323075,-0.022715330904041764,-669,11,-0.18813273340832393,0.04120959374176042
2502,13287,Turner,Georgia,2012,1510,2028,29,3567,0.42332492290440144,0.5685449957947856,0.008130081300813009,83,-4,-68,11,0.0220313346029391,-0.0011500086879383965,-0.020881325915000692,-518,151,-0.14522007289038413,0.042912660517939794
2503,13287,Turner,Georgia,2016,1246,2095,57,3398,0.36668628605061804,0.6165391406709829,0.016774573278399058,-264,28,67,-169,-0.0566386368537834,0.00864449197758605,0.04799414487619735,-849,-331,-0.24985285462036488,-0.10463278172998075
2504,13289,Twiggs,Georgia,2000,1977,1570,68,3615,0.5468879668049793,0.4343015214384509,0.018810511756569847,0,0,0,0,0.0,0.0,0.0,407,0,0.1125864453665284,0.0
2505,13289,Twiggs,Georgia,2004,2220,2112,37,4369,0.5081254291599908,0.48340581368734264,0.008468757152666513,243,-31,542,754,-0.03876253764498849,-0.010341754603903333,0.049104292248891734,108,-299,0.02471961547264817,-0.08786682989388023
2506,13289,Twiggs,Georgia,2008,2402,2087,33,4522,0.5311808934099955,0.46152145068553735,0.00729765590446705,182,-4,-25,153,0.02305546425000471,-0.0011711012481994635,-0.021884363001805296,315,207,0.06965944272445818,0.044939827251810005
2507,13289,Twiggs,Georgia,2012,2270,1907,28,4205,0.539833531510107,0.4535077288941736,0.006658739595719381,-132,-5,-180,-317,0.00865263810011152,-0.0006389163087476687,-0.008013721791363726,363,48,0.08632580261593342,0.016666359891475246
2508,13289,Twiggs,Georgia,2016,1971,2035,53,4059,0.48558758314855877,0.5013550135501355,0.013057403301305741,-299,25,128,-146,-0.05424594836154828,0.00639866370558636,0.04784728465596183,-64,-427,-0.015767430401576688,-0.10209323301751011
2509,13291,Union,Georgia,2000,2230,4567,159,6956,0.32058654399079933,0.6565554916618747,0.022857964347326048,0,0,0,0,0.0,0.0,0.0,-2337,0,-0.3359689476710753,0.0
2510,13291,Union,Georgia,2004,2327,6847,71,9245,0.2517036235803137,0.7406165494862088,0.0076798269334775555,97,-88,2280,2289,-0.06888292041048566,-0.015178137413848491,0.08406105782433415,-4520,-2183,-0.48891292590589513,-0.1529439782348198
2511,13291,Union,Georgia,2008,2486,8013,191,10690,0.23255378858746492,0.749579045837231,0.017867165575304024,159,120,1166,1445,-0.019149834992848752,0.010187338641826468,0.008962496351022198,-5527,-1007,-0.5170252572497661,-0.028112331343870978
2512,13291,Union,Georgia,2012,2139,8773,197,11109,0.19254658385093168,0.7897200468088937,0.017733369340174634,-347,6,760,419,-0.04000720473653324,-0.00013379623512939018,0.04014100097166273,-6634,-1107,-0.597173462957962,-0.08014820570819592
2513,13291,Union,Georgia,2016,1963,9852,248,12063,0.16272900605156262,0.8167122606316837,0.02055873331675371,-176,51,1079,954,-0.029817577799369055,0.0028253639765790754,0.026992213822789934,-7889,-1255,-0.6539832545801211,-0.056809791622159045
2514,13293,Upson,Georgia,2000,3158,5019,105,8282,0.38130886259357644,0.6060130403284231,0.012678097078000484,0,0,0,0,0.0,0.0,0.0,-1861,0,-0.22470417773484663,0.0
2515,13293,Upson,Georgia,2004,3424,6634,36,10094,0.339211412720428,0.6572221121458292,0.0035664751337428175,266,-69,1615,1812,-0.04209744987314845,-0.009111621944257665,0.05120907181740608,-3210,-1349,-0.31801069942540117,-0.09330652169055453
2516,13293,Upson,Georgia,2008,4061,7291,82,11434,0.35516879482245933,0.6376596116844498,0.007171593493090782,637,46,657,1340,0.015957382102031348,0.0036051183593479646,-0.019562500461379306,-3230,-20,-0.2824908168619905,0.035519882563410654
2517,13293,Upson,Georgia,2012,3959,7230,90,11279,0.35100629488429824,0.6410142743150988,0.00797943080060289,-102,8,-61,-155,-0.0041624999381610905,0.0008078373075121083,0.0033546626306489857,-3271,-41,-0.2900079794308006,-0.007517162568810076
2518,13293,Upson,Georgia,2016,3475,7292,167,10934,0.31781598683007134,0.6669105542344979,0.015273458935430766,-484,77,62,-345,-0.0331903080542269,0.007294028134827876,0.025896279919399023,-3817,-546,-0.3490945674044265,-0.059086587973625926
2519,13295,Walker,Georgia,2000,6341,12326,228,18895,0.33559142630325484,0.6523418893887272,0.012066684308017994,0,0,0,0,0.0,0.0,0.0,-5985,0,-0.31675046308547233,0.0
2520,13295,Walker,Georgia,2004,5986,15340,176,21502,0.2783927076551019,0.713422007255139,0.008185285089759093,-355,-52,3014,2607,-0.05719871864815296,-0.003881399218258901,0.061080117866411876,-9354,-3369,-0.43502929960003717,-0.11827883651456483
2521,13295,Walker,Georgia,2008,6095,17110,449,23654,0.2576731208252304,0.7233448888137313,0.0189819903610383,109,273,1770,2152,-0.02071958682987146,0.010796705271279208,0.009922881558592223,-11015,-1661,-0.46567176798850085,-0.030642468388463684
2522,13295,Walker,Georgia,2012,5274,16247,475,21996,0.2397708674304419,0.7386342971449354,0.02159483542462266,-821,26,-863,-1658,-0.017902253394788514,0.002612845063584359,0.01528940833120418,-10973,42,-0.49886342971449354,-0.033191661725992694
2523,13295,Walker,Georgia,2016,4215,18950,791,23956,0.175947570546001,0.7910335615294707,0.0330188679245283,-1059,316,2703,1960,-0.06382329688444091,0.011424032499905642,0.05239926438453524,-14735,-3762,-0.6150859909834697,-0.11622256126897618
2524,13297,Walton,Georgia,2000,5484,12966,633,19083,0.28737619871089454,0.6794529162081434,0.033170885080962116,0,0,0,0,0.0,0.0,0.0,-7482,0,-0.39207671749724887,0.0
2525,13297,Walton,Georgia,2004,5887,21594,166,27647,0.2129344956053098,0.7810612363005027,0.006004268094187435,403,-467,8628,8564,-0.07444170310558473,-0.02716661698677468,0.10160832009235932,-15707,-8225,-0.5681267406951929,-0.176050023197944
2526,13297,Walton,Georgia,2008,8469,27253,357,36079,0.23473488733058012,0.7553701599268272,0.009894952742592644,2582,191,5659,8432,0.02180039172527032,0.003890684648405209,-0.025691076373675514,-18784,-3077,-0.5206352725962471,0.04749146809894578
2527,13297,Walton,Georgia,2012,8148,29036,493,37677,0.21625925631021578,0.7706558377790164,0.013084905910767842,-321,136,1783,1598,-0.01847563102036434,0.0031899531681751983,0.01528567785218915,-20888,-2104,-0.5543965814688006,-0.033761308872553464
2528,13297,Walton,Georgia,2016,8292,31125,1281,40698,0.20374465575703965,0.7647795960489459,0.03147574819401445,144,788,2089,3021,-0.01251460055317613,0.018390842283246604,-0.005876241730070508,-22833,-1945,-0.5610349402919061,-0.0066383588231055946
2529,13299,Ware,Georgia,2000,3480,6099,49,9628,0.3614457831325301,0.6334648940589946,0.00508932280847528,0,0,0,0,0.0,0.0,0.0,-2619,0,-0.2720191109264645,0.0
2530,13299,Ware,Georgia,2004,3449,7790,52,11291,0.3054645292711009,0.6899300327694624,0.00460543795943672,-31,3,1691,1663,-0.055981253861429214,-0.00048388484903856034,0.056465138710467766,-4341,-1722,-0.3844655034983615,-0.11244639257189698
2531,13299,Ware,Georgia,2008,4034,8311,91,12436,0.324380829848826,0.6683017047282084,0.007317465422965584,585,39,521,1145,0.018916300577725087,0.0027120274635288643,-0.02162832804125403,-4277,64,-0.3439208748793824,0.04054462861897912
2532,13299,Ware,Georgia,2012,3900,7941,112,11953,0.32627792186062077,0.664352045511587,0.009370032627792187,-134,21,-370,-483,0.0018970920117947765,0.0020525672048266027,-0.003949659216621382,-4041,236,-0.33807412365096623,0.005846751228416158
2533,13299,Ware,Georgia,2016,3440,8513,231,12184,0.28233749179251477,0.6987032173342088,0.018959290873276427,-460,119,572,231,-0.043940430068105996,0.00958925824548424,0.03435117182262182,-5073,-1032,-0.41636572554169404,-0.07829160189072781
2534,13301,Warren,Georgia,2000,1196,933,16,2145,0.5575757575757576,0.43496503496503497,0.007459207459207459,0,0,0,0,0.0,0.0,0.0,263,0,0.12261072261072264,0.0
2535,13301,Warren,Georgia,2004,1360,1121,8,2489,0.5464041783848935,0.45038167938931295,0.0032141422257934912,164,-8,188,344,-0.01117157919086409,-0.004245065233413968,0.015416644424277981,239,-24,0.09602249899558057,-0.02658822361514207
2536,13301,Warren,Georgia,2008,1554,1087,21,2662,0.5837716003005259,0.4083395942900075,0.007888805409466567,194,13,-34,173,0.03736742191563236,0.004674663183673076,-0.04204208509930546,467,228,0.1754320060105184,0.07940950701493782
2537,13301,Warren,Georgia,2012,1529,990,8,2527,0.6050652948159874,0.3917688959240206,0.0031658092599920855,-25,-13,-97,-135,0.02129369451546148,-0.0047229961494744815,-0.016570698365986902,539,72,0.21329639889196678,0.03786439288144838
2538,13301,Warren,Georgia,2016,1314,991,29,2334,0.5629820051413882,0.4245929734361611,0.012425021422450729,-215,21,1,-193,-0.04208328967459918,0.009259212162458643,0.032824077512140504,323,-216,0.1383890317052271,-0.07490736718673968
2539,13303,Washington,Georgia,2000,3476,3162,53,6691,0.5195038110895233,0.4725751008817815,0.007921088028695263,0,0,0,0,0.0,0.0,0.0,314,0,0.04692871020774175,0.0
2540,13303,Washington,Georgia,2004,3733,4081,44,7858,0.47505726648002033,0.5193433443624332,0.00559938915754645,257,-9,919,1167,-0.044446544609502925,-0.0023216988711488133,0.04676824348065173,-348,-662,-0.0442860778824129,-0.09121478809015465
2541,13303,Washington,Georgia,2008,4607,4216,55,8878,0.5189231808965983,0.4748817301193963,0.006195088984005406,874,11,135,1020,0.043865914416577945,0.0005956998264589567,-0.04446161424303696,391,739,0.04404145077720201,0.0883275286596149
2542,13303,Washington,Georgia,2012,4714,4035,68,8817,0.5346489735737779,0.4576386526029262,0.007712373823295905,107,13,-181,-61,0.015725792677179662,0.001517284839290499,-0.017243077516470084,679,288,0.07701032097085175,0.032968870193649746
2543,13303,Washington,Georgia,2016,4200,4149,112,8461,0.4963952251506914,0.49036756884529015,0.013237206004018438,-514,44,114,-356,-0.03825374842308654,0.005524832180722533,0.03272891624236396,51,-628,0.006027656305401252,-0.0709826646654505
2544,13305,Wayne,Georgia,2000,2736,5219,49,8004,0.34182908545727136,0.6520489755122438,0.006121939030484758,0,0,0,0,0.0,0.0,0.0,-2483,0,-0.31021989005497247,0.0
2545,13305,Wayne,Georgia,2004,2683,6819,60,9562,0.28058983476260196,0.7131353273373772,0.006274837900020916,-53,11,1600,1558,-0.0612392506946694,0.00015289886953615862,0.061086351825133334,-4136,-1653,-0.4325454925747752,-0.12232560251980273
2546,13305,Wayne,Georgia,2008,2858,7601,116,10575,0.27026004728132386,0.7187706855791962,0.010969267139479905,175,56,782,1013,-0.010329787481278108,0.004694429239458988,0.005635358241819044,-4743,-607,-0.44851063829787235,-0.01596514572309715
2547,13305,Wayne,Georgia,2012,2596,7557,135,10288,0.2523328149300155,0.734545101088647,0.013122083981337481,-262,19,-44,-287,-0.01792723235130833,0.002152816841857577,0.0157744155094508,-4961,-218,-0.4822122861586315,-0.03370164786075913
2548,13305,Wayne,Georgia,2016,2041,8153,219,10413,0.19600499375780275,0.7829636031883223,0.021031403053874964,-555,84,596,125,-0.05632782117221277,0.007909319072537483,0.04841850209967524,-6112,-1151,-0.5869586094305195,-0.10474632327188799
2549,13307,Webster,Georgia,2000,541,359,9,909,0.5951595159515951,0.3949394939493949,0.009900990099009901,0,0,0,0,0.0,0.0,0.0,182,0,0.20022002200220018,0.0
2550,13307,Webster,Georgia,2004,515,485,8,1008,0.5109126984126984,0.48115079365079366,0.007936507936507936,-26,-1,126,99,-0.08424681753889673,-0.001964482162501965,0.08621129970139874,30,-152,0.02976190476190471,-0.17045811724029547
2551,13307,Webster,Georgia,2008,515,588,8,1111,0.46354635463546356,0.5292529252925292,0.0072007200720072,0,0,103,103,-0.04736634377723481,-0.0007357878645007357,0.048102131641735546,-73,-103,-0.06570657065706564,-0.09546847541897036
2552,13307,Webster,Georgia,2012,582,601,5,1188,0.4898989898989899,0.5058922558922558,0.004208754208754209,67,-3,13,77,0.026352635263526325,-0.0029919658632529917,-0.02336066940027337,-19,54,-0.015993265993265948,0.049713304663799696
2553,13307,Webster,Georgia,2016,473,630,13,1116,0.42383512544802865,0.5645161290322581,0.011648745519713262,-109,8,29,-72,-0.06606386445096124,0.007439991310959054,0.05862387314000228,-157,-138,-0.14068100358422947,-0.12468773759096352
2554,13309,Wheeler,Georgia,2000,752,813,10,1575,0.4774603174603175,0.5161904761904762,0.006349206349206349,0,0,0,0,0.0,0.0,0.0,-61,0,-0.038730158730158726,0.0
2555,13309,Wheeler,Georgia,2004,847,1192,15,2054,0.4123661148977605,0.5803310613437196,0.007302823758519961,95,5,379,479,-0.06509420256255699,0.000953617409313612,0.06414058515324339,-345,-284,-0.1679649464459591,-0.12923478771580038
2556,13309,Wheeler,Georgia,2008,794,1408,12,2214,0.35862691960252935,0.6359530261969286,0.005420054200542005,-53,-3,216,160,-0.053739195295231135,-0.0018827695579779558,0.05562196485320903,-614,-269,-0.27732610659439927,-0.10936116014844016
2557,13309,Wheeler,Georgia,2012,772,1366,27,2165,0.3565819861431871,0.63094688221709,0.012471131639722863,-22,15,-42,-49,-0.0020449334593422575,0.007051077439180858,-0.005006143979838562,-594,20,-0.27436489607390296,0.0029612105204963046
2558,13309,Wheeler,Georgia,2016,646,1421,35,2102,0.3073263558515699,0.6760228353948621,0.01665080875356803,-126,8,55,-63,-0.04925563029161717,0.004179677113845167,0.04507595317777202,-775,-181,-0.36869647954329215,-0.09433158346938919
2559,13311,White,Georgia,2000,2014,4857,172,7043,0.28595768848502057,0.6896209001845804,0.024421411330398976,0,0,0,0,0.0,0.0,0.0,-2843,0,-0.4036632116995599,0.0
2560,13311,White,Georgia,2004,2016,7403,85,9504,0.21212121212121213,0.7789351851851852,0.008943602693602693,2,-87,2546,2461,-0.07383647636380844,-0.015477808636796283,0.08931428500060479,-5387,-2544,-0.5668139730639731,-0.1631507613644132
2561,13311,White,Georgia,2008,2174,8467,158,10799,0.20131493656820076,0.7840540790813965,0.014630984350402816,158,73,1064,1295,-0.010806275553011363,0.005687381656800123,0.00511889389621123,-6293,-906,-0.5827391425131957,-0.01592516944922262
2562,13311,White,Georgia,2012,1671,8651,201,10523,0.1587950204314359,0.8221039627482657,0.019101016820298394,-503,43,184,-276,-0.04251991613676487,0.004470032469895578,0.03804988366686923,-6980,-687,-0.6633089423168298,-0.0805697998036341
2563,13311,White,Georgia,2016,1674,9761,477,11912,0.14053055742108797,0.8194257891202149,0.040043653458697114,3,276,1110,1389,-0.018264463010347926,0.02094263663839872,-0.002678173628050784,-8087,-1107,-0.6788952316991269,-0.015586289382297114
2564,13313,Whitfield,Georgia,2000,7034,15852,416,23302,0.30186250107286927,0.6802849540811947,0.017852544845935972,0,0,0,0,0.0,0.0,0.0,-8818,0,-0.37842245300832544,0.0
2565,13313,Whitfield,Georgia,2004,6933,19297,169,26399,0.26262358422667526,0.7309746581309898,0.006401757642334937,-101,-247,3445,3097,-0.039238916846194016,-0.011450787203601036,0.050689704049795115,-12364,-3546,-0.4683510739043146,-0.08992862089598913
2566,13313,Whitfield,Georgia,2008,8167,19230,394,27791,0.29387211687236875,0.6919506314994063,0.014177251628224965,1234,225,-67,1392,0.031248532645693494,0.007775493985890028,-0.03902402663158355,-11063,1301,-0.3980785146270375,0.07027255927727705
2567,13313,Whitfield,Georgia,2012,7210,19305,453,26968,0.2673539009196084,0.7158484129338475,0.016797686146544054,-957,59,75,-823,-0.026518215952760327,0.0026204345183190886,0.023897781434441212,-12095,-1032,-0.44849451201423907,-0.05041599738720154
2568,13313,Whitfield,Georgia,2016,7937,21537,1184,30658,0.2588883814991193,0.7024920086111293,0.03861960988975145,727,731,2232,3690,-0.00846551942048912,0.0218219237432074,-0.01335640432271823,-13600,-1505,-0.44360362711200996,0.004890884902229109
2569,13315,Wilcox,Georgia,2000,962,1381,22,2365,0.40676532769556023,0.5839323467230444,0.009302325581395349,0,0,0,0,0.0,0.0,0.0,-419,0,-0.17716701902748416,0.0
2570,13315,Wilcox,Georgia,2004,902,1705,12,2619,0.3444062619320351,0.6510118365788469,0.004581901489117984,-60,-10,324,254,-0.06235906576352512,-0.0047204240922773645,0.06707948985580248,-803,-384,-0.30660557464681176,-0.1294385556193276
2571,13315,Wilcox,Georgia,2008,978,2159,27,3164,0.309102402022756,0.6823640960809102,0.008533501896333754,76,15,454,545,-0.03530385990927909,0.00395160040721577,0.03135225950206333,-1181,-378,-0.3732616940581542,-0.06665611941134242
2572,13315,Wilcox,Georgia,2012,1060,2053,19,3132,0.3384418901660281,0.6554916985951469,0.006066411238825032,82,-8,-106,-32,0.029339488143272086,-0.0024670906575087227,-0.02687239748576331,-993,188,-0.3170498084291188,0.056211885629035396
2573,13315,Wilcox,Georgia,2016,852,2096,28,2976,0.2862903225806452,0.7043010752688172,0.009408602150537635,-208,9,43,-156,-0.05215156758538292,0.003342190911712603,0.04880937667367036,-1244,-251,-0.41801075268817206,-0.10096094425905328
2574,13317,Wilkes,Georgia,2000,1940,2044,42,4026,0.48186785891703926,0.5076999503229012,0.010432190760059613,0,0,0,0,0.0,0.0,0.0,-104,0,-0.0258320914058619,0.0
2575,13317,Wilkes,Georgia,2004,2028,2490,30,4548,0.44591029023746703,0.5474934036939314,0.006596306068601583,88,-12,446,522,-0.03595756867957223,-0.00383588469145803,0.03979345337103024,-462,-358,-0.10158311345646437,-0.07575102205060247
2576,13317,Wilkes,Georgia,2008,2315,2705,40,5060,0.4575098814229249,0.5345849802371542,0.007905138339920948,287,10,215,512,0.011599591185457891,0.0013088322713193648,-0.01290842345677723,-390,72,-0.07707509881422925,0.02450801464223512
2577,13317,Wilkes,Georgia,2012,2087,2635,43,4765,0.4379853095487933,0.55299055613851,0.009024134312696747,-228,3,-70,-295,-0.019524571874131647,0.0011189959727757985,0.01840557590135583,-548,-158,-0.11500524658971673,-0.03793014777548748
2578,13317,Wilkes,Georgia,2016,1848,2572,66,4486,0.4119482835488186,0.5733392777530094,0.014712438698172091,-239,23,-63,-279,-0.026037025999974706,0.005688304385475344,0.02034872161449941,-724,-176,-0.16139099420419084,-0.046385747614474115
2579,13319,Wilkinson,Georgia,2000,1884,1800,56,3740,0.5037433155080214,0.48128342245989303,0.014973262032085561,0,0,0,0,0.0,0.0,0.0,84,0,0.0224598930481284,0.0
2580,13319,Wilkinson,Georgia,2004,2235,2261,22,4518,0.4946879150066401,0.5004426737494466,0.004869411243913236,351,-34,461,778,-0.009055400501381317,-0.010103850788172325,0.01915925128955359,-26,-110,-0.0057547587428065095,-0.028214651790934908
2581,13319,Wilkinson,Georgia,2008,2298,2349,31,4678,0.49123557075673363,0.5021376656690894,0.006626763574176998,63,9,88,160,-0.0034523442499064805,0.0017573523302637627,0.0016949919196427299,-51,-25,-0.01090209491235572,-0.00514733616954921
2582,13319,Wilkinson,Georgia,2012,2181,2246,29,4456,0.4894524236983842,0.5040394973070018,0.006508078994614004,-117,-2,-103,-222,-0.0017831470583494213,-0.0001186845795629948,0.0019018316379124656,-65,-14,-0.014587073608617607,-0.003684978696261887
2583,13319,Wilkinson,Georgia,2016,1894,2333,60,4287,0.4418007930954047,0.5442034056449732,0.013995801259622114,-287,31,87,-169,-0.0476516306029795,0.0074877222650081105,0.040163908337971344,-439,-374,-0.10240261254956845,-0.08781553894095084
2584,13321,Worth,Georgia,2000,2214,3792,55,6061,0.36528625639333445,0.6256393334433262,0.009074410163339383,0,0,0,0,0.0,0.0,0.0,-1578,0,-0.2603530770499918,0.0
2585,13321,Worth,Georgia,2004,2219,5105,32,7356,0.30165851005981514,0.6939912996193583,0.004350190320826536,5,-23,1313,1295,-0.06362774633351931,-0.004724219842512848,0.06835196617603212,-2886,-1308,-0.3923327895595432,-0.13197971250955143
2586,13321,Worth,Georgia,2008,2542,5780,60,8382,0.3032689095681222,0.6895728942973037,0.0071581961345740875,323,28,675,1026,0.0016103995083070477,0.0028080058137475517,-0.004418405322054619,-3238,-352,-0.38630398472918154,0.006028804830361667
2587,13321,Worth,Georgia,2012,2487,5869,80,8436,0.29480796586059743,0.6957088667614983,0.00948316737790422,-55,20,89,54,-0.00846094370752476,0.0023249712433301333,0.006135972464194617,-3382,-144,-0.4009009009009009,-0.014596916171719376
2588,13321,Worth,Georgia,2016,2020,6152,123,8295,0.2435201928872815,0.7416515973477998,0.014828209764918625,-467,43,283,-141,-0.05128777297331594,0.005345042387014404,0.045942730586301495,-4132,-750,-0.49813140446051835,-0.09723050355961743
2589,15001,Hawaii,Hawaii,2000,28670,17050,5140,50860,0.563704286276052,0.3352339756193472,0.10106173810460087,0,0,0,0,0.0,0.0,0.0,11620,0,0.22847031065670476,0.0
2590,15001,Hawaii,Hawaii,2004,35116,22032,554,57702,0.6085750927177568,0.38182385359259646,0.009601053689646807,6446,-4586,4982,6842,0.044870806441704825,-0.09146068441495406,0.04658987797324926,13084,1464,0.22675123912516032,-0.001719071531544436
2591,15001,Hawaii,Hawaii,2008,50819,14866,1231,66916,0.7594446769083627,0.22215912487297507,0.018396198218662202,15703,677,-7166,9214,0.15086958419060592,0.008795144529015395,-0.1596647287196214,35953,22869,0.5372855520353876,0.3105343129102273
2592,15001,Hawaii,Hawaii,2012,47224,14753,1477,63454,0.74422416238535,0.2324991332303716,0.023276704384278375,-3595,246,-113,-3462,-0.015220514523012652,0.004880506165616173,0.01034000835739654,32471,-3482,0.5117250291549784,-0.02556052288040922
2593,15001,Hawaii,Hawaii,2016,41259,17501,6107,64867,0.6360553131792746,0.2697982024758352,0.09414648434489031,-5965,4630,2748,1413,-0.1081688492060755,0.07086977996061194,0.037299069245463584,23758,-8713,0.36625711070343936,-0.14546791845153906
2594,15003,Honolulu,Hawaii,2000,139618,101310,15062,255990,0.5454041173483339,0.39575764678307745,0.05883823586858861,0,0,0,0,0.0,0.0,0.0,38308,0,0.14964647056525648,0.0
2595,15003,Honolulu,Hawaii,2004,152500,144157,1890,298547,0.5108073435673445,0.4828619949287717,0.006330661503883811,12882,-13172,42847,42557,-0.034596773780989465,-0.0525075743647048,0.08710434814569423,8343,-29965,0.027945348638572787,-0.1217011219266837
2596,15003,Honolulu,Hawaii,2008,214239,88164,4410,306813,0.6982722374866775,0.28735418642625965,0.014373576087062804,61739,2520,-55993,8266,0.18746489391933308,0.008042914583178993,-0.19550780850251204,126075,117732,0.4109180510604179,0.3829727024218451
2597,15003,Honolulu,Hawaii,2012,204349,88461,3932,296742,0.6886419852936221,0.29810744687304125,0.013250567833336703,-9890,-478,297,-10071,-0.009630252193055466,-0.0011230082537261009,0.010753260446781598,115888,-10187,0.39053453842058083,-0.020383512639837065
2598,15003,Honolulu,Hawaii,2016,175696,90326,19768,285790,0.6147730851324399,0.31605724483012004,0.06916967003744008,-28653,15836,1865,-10952,-0.0738689001611822,0.05591910220410338,0.017949797957078795,85370,-30518,0.29871584030231985,-0.09181869811826099
2599,15007,Kauai,Hawaii,2000,13470,6583,1720,21773,0.6186561337436274,0.30234694346208607,0.0789969227942865,0,0,0,0,0.0,0.0,0.0,6887,0,0.3163091902815413,0.0
2600,15007,Kauai,Hawaii,2004,14916,9740,220,24876,0.5996140858658948,0.3915420485608619,0.008843865573243287,1446,-1500,3157,3103,-0.01904204787773256,-0.0701530572210432,0.08919510509877582,5176,-1711,0.20807203730503293,-0.10823715297650838
2601,15007,Kauai,Hawaii,2008,20416,6245,563,27224,0.7499265354099324,0.22939318248604174,0.02068028210402586,5500,343,-3495,2348,0.15031244954403755,0.011836416530782571,-0.16214886607482015,14171,8995,0.5205333529238907,0.31246131561885776
2602,15007,Kauai,Hawaii,2012,18641,6121,610,25372,0.73470755163172,0.24125019706763362,0.024042251300646383,-1775,47,-124,-1852,-0.015218983778212403,0.003361969196620525,0.011857014581591885,12520,-1651,0.49345735456408635,-0.027075998359804343
2603,15007,Kauai,Hawaii,2016,16456,7574,2305,26335,0.6248718435542054,0.2876020505031327,0.08752610594266186,-2185,1695,1453,963,-0.10983570807751453,0.06348385464201547,0.04635185343549908,8882,-3638,0.33726979305107274,-0.1561875615130136
2604,15009,Maui,Hawaii,2000,23484,12876,2888,39248,0.5983489604565838,0.3280676722380758,0.0735833673053404,0,0,0,0,0.0,0.0,0.0,10608,0,0.270281288218508,0.0
2605,15009,Maui,Hawaii,2004,28803,18187,440,47430,0.6072738772928526,0.383449293695973,0.009276829011174362,5319,-2448,5311,8182,0.008924916836268837,-0.06430653829416604,0.05538162145789721,10616,8,0.22382458359687962,-0.046456704621628375
2606,15009,Maui,Hawaii,2008,39727,11154,908,51789,0.7670933982119755,0.2153739211029369,0.01753268068508757,10924,468,-7033,4359,0.15981952091912288,0.008255851673913206,-0.16807537259303612,28573,17957,0.5517194771090386,0.32789489351215895
2607,15009,Maui,Hawaii,2012,36052,11602,999,48653,0.7410026103220767,0.23846422625531827,0.02053316342260498,-3675,91,448,-3136,-0.026090787889898825,0.0030004827375174105,0.023090305152381363,24450,-4123,0.5025383840667584,-0.04918109304228013
2608,15009,Maui,Hawaii,2016,33480,13446,5019,51945,0.6445278660121282,0.2588507074790644,0.0966214265088074,-2572,4020,1844,3292,-0.09647474430994851,0.07608826308620242,0.020386481223746145,20034,-4416,0.3856771585330638,-0.11686122553369466
2609,16001,Ada,Idaho,2000,40650,75050,7785,123485,0.3291897801352391,0.6077661254403369,0.06304409442442402,0,0,0,0,0.0,0.0,0.0,-34400,0,-0.27857634530509784,0.0
2610,16001,Ada,Idaho,2004,58523,94641,1866,155030,0.3774946784493324,0.6104689414951945,0.012036380055473134,17873,-5919,19591,31545,0.04830489831409329,-0.051007714368950886,0.0027028160548575597,-36118,-1718,-0.2329742630458621,0.04560208225923573
2611,16001,Ada,Idaho,2008,82236,93328,5196,180760,0.45494578446558975,0.5163089179021908,0.02874529763221952,23713,3330,-1313,25730,0.07745110601625738,0.016708917576746384,-0.09416002359300368,-11092,25026,-0.06136313343660105,0.17161112960926106
2612,16001,Ada,Idaho,2012,77137,97554,7544,182235,0.4232831234395149,0.5353197794057124,0.04139709715477268,-5099,2348,4226,1475,-0.031662661026074845,0.012651799522553162,0.019010861503521603,-20417,-9325,-0.1120366559661975,-0.05067352252959645
2613,16001,Ada,Idaho,2016,75677,93752,26240,195669,0.3867602941702569,0.47913568322013195,0.13410402260961113,-1460,18696,-3802,13434,-0.036522829269257984,0.09270692545483844,-0.05618409618558046,-18075,2342,-0.09237538904987502,0.019661266916322473
2614,16003,Adams,Idaho,2000,336,1476,97,1909,0.17600838135149294,0.7731796752226296,0.05081194342587742,0,0,0,0,0.0,0.0,0.0,-1140,0,-0.5971712938711367,0.0
2615,16003,Adams,Idaho,2004,555,1468,40,2063,0.2690256907416384,0.7115850702859913,0.019389238972370333,219,-57,-8,154,0.09301730939014546,-0.03142270445350709,-0.061594604936638375,-913,227,-0.44255937954435287,0.15461191432678378
2616,16003,Adams,Idaho,2008,728,1517,75,2320,0.3137931034482759,0.6538793103448276,0.032327586206896554,173,35,49,257,0.04476741270663748,0.01293834723452622,-0.05770575994116367,-789,124,-0.3400862068965517,0.10247317264780115
2617,16003,Adams,Idaho,2012,577,1413,70,2060,0.28009708737864075,0.6859223300970874,0.03398058252427184,-151,-5,-104,-260,-0.033696016069635126,0.0016529963173752896,0.03204301975225976,-836,-47,-0.4058252427184466,-0.06573903582189489
2618,16003,Adams,Idaho,2016,415,1556,212,2183,0.19010535959688502,0.7127805771873569,0.09711406321575813,-162,142,143,123,-0.08999172778175574,0.06313348069148629,0.026858247090269516,-1141,-305,-0.5226752175904719,-0.11684997487202525
2619,16005,Bannock,Idaho,2000,10892,18223,1737,30852,0.35304032153507064,0.5906586282899001,0.05630105017502917,0,0,0,0,0.0,0.0,0.0,-7331,0,-0.23761830675482948,0.0
2620,16005,Bannock,Idaho,2004,12903,21479,462,34844,0.37030765698542073,0.6164332453220066,0.01325909769257261,2011,-1275,3256,3992,0.017267335450350085,-0.04304195248245656,0.025774617032106484,-8576,-1245,-0.24612558833658588,-0.008507281581756398
2621,16005,Bannock,Idaho,2008,14792,19356,1289,35437,0.4174168242232695,0.5462087648502977,0.03637441092643282,1889,827,-2123,593,0.04710916723784875,0.023115313233860214,-0.07022448047170893,-4564,4012,-0.1287919406270282,0.11733364770955768
2622,16005,Bannock,Idaho,2012,13214,21010,1298,35522,0.3719948201114802,0.5914644445695625,0.03654073531895727,-1578,9,1654,85,-0.04542200411178926,0.00016632439252444592,0.04525567971926481,-7796,-3232,-0.21946962445808227,-0.09067768383105407
2623,16005,Bannock,Idaho,2016,10342,17180,5894,33416,0.309492458702418,0.514124970074216,0.17638257122336606,-2872,4596,-3830,-2106,-0.06250236140906223,0.1398418359044088,-0.0773394744953465,-6838,958,-0.204632511371798,0.01483711308628427
2624,16007,Bear Lake,Idaho,2000,517,2296,86,2899,0.17833735770955503,0.7919972404277337,0.02966540186271128,0,0,0,0,0.0,0.0,0.0,-1779,0,-0.6136598827181786,0.0
2625,16007,Bear Lake,Idaho,2004,494,2506,40,3040,0.1625,0.8243421052631579,0.013157894736842105,-23,-46,210,141,-0.015837357709555022,-0.016507507125869174,0.0323448648354242,-2012,-233,-0.6618421052631579,-0.04818222254497928
2626,16007,Bear Lake,Idaho,2008,502,2377,64,2943,0.17057424396873938,0.8076792388718994,0.021746517159361198,8,24,-129,-97,0.008074243968739375,0.008588622422519093,-0.01666286639125847,-1875,137,-0.63710499490316,0.024737110359997927
2627,16007,Bear Lake,Idaho,2012,302,2489,31,2822,0.10701630049610206,0.8819985825655563,0.010985116938341602,-200,-33,112,-121,-0.06355794347263732,-0.010761400221019596,0.07431934369365689,-2187,-312,-0.7749822820694543,-0.13787728716629433
2628,16007,Bear Lake,Idaho,2016,255,2203,470,2928,0.08709016393442623,0.7523907103825137,0.16051912568306012,-47,439,-286,106,-0.019926136561675828,0.1495340087447185,-0.1296078721830426,-1948,239,-0.6653005464480874,0.10968173562136685
2629,16009,Benewah,Idaho,2000,895,2606,186,3687,0.2427447789530784,0.7068077027393544,0.05044751830756713,0,0,0,0,0.0,0.0,0.0,-1711,0,-0.46406292378627606,0.0
2630,16009,Benewah,Idaho,2004,1148,2823,79,4050,0.2834567901234568,0.697037037037037,0.01950617283950617,253,-107,217,363,0.040712011170378426,-0.030941345468060957,-0.009770665702317438,-1675,36,-0.4135802469135802,0.050482676872695864
2631,16009,Benewah,Idaho,2008,1407,2646,111,4164,0.33789625360230546,0.6354466858789626,0.026657060518731988,259,32,-177,114,0.05443946347884865,0.007150887679225816,-0.06159035115807443,-1239,436,-0.2975504322766571,0.11602981463692308
2632,16009,Benewah,Idaho,2012,1164,2596,125,3885,0.2996138996138996,0.6682110682110682,0.032175032175032175,-243,14,-50,-279,-0.03828235398840585,0.005517971656300188,0.03276438233210566,-1432,-193,-0.3685971685971686,-0.0710467363205115
2633,16009,Benewah,Idaho,2016,770,3103,312,4185,0.18399044205495818,0.741457586618877,0.07455197132616488,-394,187,507,300,-0.11562345755894143,0.042376939151132706,0.07324651840780871,-2333,-901,-0.5574671445639188,-0.18886997596675015
2634,16011,Bingham,Idaho,2000,3310,10628,527,14465,0.2288282060145178,0.7347390252333218,0.03643276875216039,0,0,0,0,0.0,0.0,0.0,-7318,0,-0.505910819218804,0.0
2635,16011,Bingham,Idaho,2004,3605,12734,226,16565,0.21762752792031392,0.7687292484153335,0.01364322366435255,295,-301,2106,2100,-0.011200678094203886,-0.02278954508780784,0.033990223182011725,-9129,-1811,-0.5511017204950196,-0.04519090127621561
2636,16011,Bingham,Idaho,2008,4424,12230,502,17156,0.257868967125204,0.7128701328981114,0.029260899976684542,819,276,-504,591,0.040241439204890095,0.015617676312331992,-0.05585911551722211,-7806,1323,-0.4550011657729074,0.09610055472211221
2637,16011,Bingham,Idaho,2012,3822,13440,415,17677,0.21621315834134752,0.7603100073541891,0.02347683430446343,-602,-87,1210,521,-0.041655808783856496,-0.0057840656722211135,0.04743987445607767,-9618,-1812,-0.5440968490128415,-0.08909568323993411
2638,16011,Bingham,Idaho,2016,2924,10907,2794,16625,0.1758796992481203,0.6560601503759399,0.16806015037593985,-898,2379,-2533,-1052,-0.04033345909322722,0.14458331607147643,-0.10424985697824918,-7983,1635,-0.4801804511278196,0.0639163978850219
2639,16013,Blaine,Idaho,2000,3748,3528,662,7938,0.47215923406399596,0.4444444444444444,0.08339632149155958,0,0,0,0,0.0,0.0,0.0,220,0,0.02771478961955154,0.0
2640,16013,Blaine,Idaho,2004,5992,4034,121,10147,0.5905193653296541,0.39755592786045135,0.011924706809894551,2244,-541,506,2209,0.11836013126565814,-0.07147161468166503,-0.04688851658399307,1958,1738,0.19296343746920275,0.1652486478496512
2641,16013,Blaine,Idaho,2008,6947,3439,187,10573,0.6570509789085406,0.3252624609855292,0.0176865601059302,955,66,-595,426,0.06653161357888648,0.005761853296035648,-0.07229346687492216,3508,1550,0.3317885179230114,0.13882508045380865
2642,16013,Blaine,Idaho,2012,5992,3939,263,10194,0.587796743182264,0.3864037669217187,0.025799489896017266,-955,76,500,-379,-0.06925423572627654,0.008112929790087067,0.061141305936189494,2053,-1455,0.20139297626054536,-0.13039554166246603
2643,16013,Blaine,Idaho,2016,6416,3340,968,10724,0.59828422230511,0.3114509511376352,0.09026482655725476,424,705,-599,530,0.010487479122845977,0.0644653366612375,-0.07495281578408347,3076,1023,0.2868332711674748,0.08544029490692945
2644,16015,Boise,Idaho,2000,745,2019,291,3055,0.24386252045826515,0.6608837970540098,0.09525368248772505,0,0,0,0,0.0,0.0,0.0,-1274,0,-0.4170212765957446,0.0
2645,16015,Boise,Idaho,2004,970,2501,56,3527,0.2750212645307627,0.7091012191664304,0.01587751630280692,225,-235,482,472,0.031158744072497552,-0.07937616618491813,0.04821742211242064,-1531,-257,-0.43407995463566773,-0.017058678039923114
2646,16015,Boise,Idaho,2008,1240,2433,100,3773,0.32865094089583885,0.6448449509673999,0.026504108136761198,270,44,-68,246,0.05362967636507615,0.010626591833954278,-0.06425626819903052,-1193,338,-0.31619401007156106,0.11788594456410667
2647,16015,Boise,Idaho,2012,1053,2284,108,3445,0.30566037735849055,0.6629898403483309,0.03134978229317852,-187,8,-149,-328,-0.022990563537348296,0.004845674156417325,0.01814488938093095,-1231,-38,-0.3573294629898403,-0.04113545291827925
2648,16015,Boise,Idaho,2016,777,2673,364,3814,0.2037231253277399,0.7008390141583639,0.09543786051389617,-276,256,389,369,-0.10193725203075066,0.06408807822071766,0.037849173810033054,-1896,-665,-0.497115888830624,-0.1397864258407837
2649,16017,Bonner,Idaho,2000,4318,8945,1274,14537,0.29703515168191513,0.615326408474926,0.08763843984315883,0,0,0,0,0.0,0.0,0.0,-4627,0,-0.3182912567930109,0.0
2650,16017,Bonner,Idaho,2004,6649,10697,338,17684,0.3759895951142275,0.6048970821081203,0.019113322777652115,2331,-936,1752,3147,0.0789544434323124,-0.06852511706550672,-0.010429326366805713,-4048,579,-0.2289074869938928,0.0893837697991181
2651,16017,Bonner,Idaho,2008,7840,11145,565,19550,0.4010230179028133,0.570076726342711,0.028900255754475704,1191,227,448,1866,0.02503342278858578,0.009786932976823589,-0.03482035576540932,-3305,743,-0.1690537084398977,0.059853778553995096
2652,16017,Bonner,Idaho,2012,6500,11367,936,18803,0.3456895176301654,0.6045311918310908,0.04977929053874382,-1340,371,222,-747,-0.055333500272647884,0.020879034784268113,0.034454465488379826,-4867,-1562,-0.2588416742009254,-0.08978796576102771
2653,16017,Bonner,Idaho,2016,5819,13343,1781,20943,0.2778494007544287,0.6371102516353913,0.08504034761018,-681,845,1976,2140,-0.06784011687573671,0.03526105707143619,0.032579059804300425,-7524,-2657,-0.35926085088096255,-0.10041917668003714
2654,16019,Bonneville,Idaho,2000,7235,24988,1333,33556,0.21560972702348313,0.7446656335677673,0.039724639408749554,0,0,0,0,0.0,0.0,0.0,-17753,0,-0.5290559065442841,0.0
2655,16019,Bonneville,Idaho,2004,8356,30048,467,38871,0.21496745645854234,0.7730184456278459,0.01201409791361169,1121,-866,5060,5315,-0.0006422705649407889,-0.027710541495137866,0.02835281206007867,-21692,-3939,-0.5580509891693036,-0.028995082625019486
2656,16019,Bonneville,Idaho,2008,11417,29334,952,41703,0.27376927319377503,0.7034026329041076,0.022828093902117354,3061,485,-714,2832,0.05880181673523269,0.010813995988505664,-0.06961581272373829,-17917,3775,-0.4296333597103326,0.128417629458971
2657,16019,Bonneville,Idaho,2012,9903,32276,1036,43215,0.22915654286706005,0.7468702996644684,0.023973157468471597,-1514,84,2942,1512,-0.04461273032671498,0.001145063566354243,0.043467666760360735,-22373,-4456,-0.5177137567974084,-0.08808039708707577
2658,16019,Bonneville,Idaho,2016,8930,26699,8592,44221,0.20194025463015308,0.6037629180705999,0.19429682729924697,-973,7556,-5577,1006,-0.02721628823690697,0.17032366983077538,-0.1431073815938685,-17769,4604,-0.4018226634404468,0.11589109335696157
2659,16021,Boundary,Idaho,2000,832,2797,255,3884,0.21421215242018538,0.7201338825952626,0.065653964984552,0,0,0,0,0.0,0.0,0.0,-1965,0,-0.5059217301750771,0.0
2660,16021,Boundary,Idaho,2004,1268,3012,99,4379,0.28956382735784425,0.6878282712948162,0.022607901347339577,436,-156,215,495,0.07535167493765887,-0.04304606363721243,-0.0323056113004464,-1744,221,-0.3982644439369719,0.10765728623810522
2661,16021,Boundary,Idaho,2008,1484,3078,172,4734,0.31347697507393324,0.6501901140684411,0.03633291085762569,216,73,66,355,0.02391314771608899,0.013725009510286112,-0.03763815722637509,-1594,150,-0.33671313899450783,0.06155130494246408
2662,16021,Boundary,Idaho,2012,1225,3138,181,4544,0.2695862676056338,0.690580985915493,0.03983274647887324,-259,9,60,-190,-0.04389070746829943,0.003499835621247553,0.04039087184705192,-1913,-319,-0.4209947183098592,-0.08428157931535135
2663,16021,Boundary,Idaho,2016,933,3789,441,5163,0.18070889018012784,0.7338756536897153,0.08541545613015689,-292,260,651,619,-0.08887737742550597,0.045582709651283644,0.043294667774222306,-2856,-943,-0.5531667635095875,-0.1321720451997283
2664,16023,Butte,Idaho,2000,354,1054,52,1460,0.24246575342465754,0.7219178082191781,0.03561643835616438,0,0,0,0,0.0,0.0,0.0,-700,0,-0.4794520547945205,0.0
2665,16023,Butte,Idaho,2004,321,1077,8,1406,0.2283072546230441,0.7660028449502134,0.005689900426742532,-33,-44,23,-54,-0.014158498801613434,-0.02992653792942185,0.044085036731035365,-756,-56,-0.5376955903271693,-0.05824353553264877
2666,16023,Butte,Idaho,2008,318,1056,36,1410,0.225531914893617,0.7489361702127659,0.02553191489361702,-3,28,-21,4,-0.00277533972942709,0.01984201446687449,-0.017066674737447496,-738,18,-0.5234042553191489,0.014291335008020378
2667,16023,Butte,Idaho,2012,258,1001,27,1286,0.2006220839813375,0.7783825816485226,0.020995334370139968,-60,-9,-55,-124,-0.024909830912279524,-0.004536580523477052,0.02944641143575666,-743,-5,-0.5777604976671851,-0.054356242348036155
2668,16023,Butte,Idaho,2016,160,914,156,1230,0.13008130081300814,0.7430894308943089,0.12682926829268293,-98,129,-87,-56,-0.07054078316832935,0.10583393392254296,-0.03529315075421369,-754,-11,-0.6130081300813007,-0.03524763241411566
2669,16025,Camas,Idaho,2000,113,359,35,507,0.22287968441814596,0.7080867850098619,0.06903353057199212,0,0,0,0,0.0,0.0,0.0,-246,0,-0.4852071005917159,0.0
2670,16025,Camas,Idaho,2004,139,450,6,595,0.23361344537815126,0.7563025210084033,0.010084033613445379,26,-29,91,88,0.010733760960005306,-0.05894949695854674,0.048215735998541454,-311,-65,-0.522689075630252,-0.03748197503853612
2671,16025,Camas,Idaho,2008,187,422,9,618,0.30258899676375406,0.6828478964401294,0.014563106796116505,48,3,-28,23,0.0689755513856028,0.004479073182671127,-0.0734546245682739,-235,76,-0.3802588996763754,0.14243017595387664
2672,16025,Camas,Idaho,2012,159,402,17,578,0.2750865051903114,0.6955017301038062,0.029411764705882353,-28,8,-20,-40,-0.027502491573442645,0.014848657909765847,0.012653833663676783,-243,-8,-0.4204152249134948,-0.04015632523711943
2673,16025,Camas,Idaho,2016,110,410,70,590,0.1864406779661017,0.6949152542372882,0.11864406779661017,-49,53,8,12,-0.08864582722420972,0.08923230309072783,-0.0005864758665180547,-300,-57,-0.5084745762711864,-0.0880593513576916
2674,16027,Canyon,Idaho,2000,10588,30560,1852,43000,0.24623255813953487,0.7106976744186047,0.04306976744186047,0,0,0,0,0.0,0.0,0.0,-19972,0,-0.4644651162790698,0.0
2675,16027,Canyon,Idaho,2004,13415,41599,684,55698,0.24085245430715646,0.7468670329275737,0.012280512765269848,2827,-1168,11039,12698,-0.005380103832378413,-0.03078925467659062,0.036169358508969074,-28184,-8212,-0.5060145786204173,-0.04154946234134754
2676,16027,Canyon,Idaho,2008,20147,42752,1807,64706,0.311362161159707,0.6607115259790437,0.027926312861249344,6732,1123,1153,9008,0.07050970685255054,0.015645800095979497,-0.08615550694853003,-22605,5579,-0.3493493648193367,0.15666521380108062
2677,16027,Canyon,Idaho,2012,19866,44369,2503,66738,0.2976714915040906,0.664823638706584,0.03750486978932542,-281,696,1617,2032,-0.013690669655616383,0.009578556928076076,0.004112112727540307,-24503,-1898,-0.3671521472024934,-0.01780278238315669
2678,16027,Canyon,Idaho,2016,16883,47222,8680,72785,0.23195713402486776,0.648787524902109,0.11925534107302328,-2983,6177,2853,6047,-0.06571435747922286,0.08175047128369786,-0.016036113804475005,-30339,-5836,-0.4168303908772413,-0.04967824367474788
2679,16029,Caribou,Idaho,2000,475,2601,101,3177,0.14951211835064526,0.8186968838526912,0.03179099779666352,0,0,0,0,0.0,0.0,0.0,-2126,0,-0.669184765502046,0.0
2680,16029,Caribou,Idaho,2004,491,2753,37,3281,0.14964949710454128,0.8390734532154831,0.011277049679975617,16,-64,152,104,0.0001373787538960225,-0.020513948116687906,0.020376569362791863,-2262,-136,-0.6894239561109419,-0.020239190608895896
2681,16029,Caribou,Idaho,2008,553,2656,93,3302,0.16747425802543914,0.8043609933373713,0.028164748637189582,62,56,-97,21,0.017824760920897853,0.016887698957213967,-0.03471245987811178,-2103,159,-0.6368867353119322,0.05253722079900969
2682,16029,Caribou,Idaho,2012,386,2608,58,3052,0.12647444298820446,0.854521625163827,0.019003931847968544,-167,-35,-48,-250,-0.04099981503723468,-0.009160816789221038,0.05016063182645569,-2222,-119,-0.7280471821756226,-0.0911604468636904
2683,16029,Caribou,Idaho,2016,271,2275,489,3035,0.08929159802306424,0.7495881383855024,0.16112026359143328,-115,431,-333,-17,-0.03718284496514021,0.14211633174346472,-0.10493348677832459,-2004,218,-0.6602965403624381,0.06775064181318446
2684,16031,Cassia,Idaho,2000,1087,5983,209,7279,0.14933369968402252,0.8219535650501443,0.02871273526583322,0,0,0,0,0.0,0.0,0.0,-4896,0,-0.6726198653661217,0.0
2685,16031,Cassia,Idaho,2004,1153,6562,106,7821,0.14742360311980565,0.8390231428206112,0.013553254059583174,66,-103,579,542,-0.0019100965642168677,-0.015159481206250046,0.017069577770466915,-5409,-513,-0.6915995397008056,-0.018979674334683838
2686,16031,Cassia,Idaho,2008,1332,6309,252,7893,0.16875712656784492,0.7993158494868872,0.03192702394526796,179,146,-253,72,0.021333523448039265,0.018373769885684788,-0.039707293333724025,-4977,432,-0.6305587229190422,0.06104081678176332
2687,16031,Cassia,Idaho,2012,1098,7154,180,8432,0.13021821631878558,0.8484345351043643,0.021347248576850095,-234,-72,845,539,-0.03853891024905934,-0.010579775368417865,0.04911868561747712,-6056,-1079,-0.7182163187855787,-0.08765759586653643
2688,16031,Cassia,Idaho,2016,1036,5949,1193,8178,0.12668134018097335,0.727439471753485,0.1458791880655417,-62,1013,-1205,-254,-0.003536876137812228,0.12453193948869161,-0.12099506335087928,-4913,1143,-0.6007581315725117,0.117458187213067
2689,16033,Clark,Idaho,2000,63,311,8,382,0.1649214659685864,0.8141361256544503,0.020942408376963352,0,0,0,0,0.0,0.0,0.0,-248,0,-0.6492146596858639,0.0
2690,16033,Clark,Idaho,2004,46,302,5,353,0.13031161473087818,0.8555240793201133,0.014164305949008499,-17,-3,-9,-29,-0.03460985123770821,-0.006778102427954853,0.04138795366566306,-256,-8,-0.7252124645892352,-0.07599780490337127
2691,16033,Clark,Idaho,2008,64,305,6,375,0.17066666666666666,0.8133333333333334,0.016,18,1,3,22,0.04035505193578848,0.0018356940509915015,-0.042190745986779965,-241,15,-0.6426666666666667,0.08254579792256844
2692,16033,Clark,Idaho,2012,66,235,27,328,0.20121951219512196,0.7164634146341463,0.08231707317073171,2,21,-70,-47,0.030552845528455302,0.06631707317073171,-0.09686991869918704,-169,72,-0.5152439024390243,0.12742276422764243
2693,16033,Clark,Idaho,2016,44,203,36,283,0.15547703180212014,0.7173144876325088,0.127208480565371,-22,9,-32,-45,-0.04574248039300183,0.0448914073946393,0.000851072998362512,-159,10,-0.5618374558303887,-0.046593553391364395
2694,16035,Clearwater,Idaho,2000,841,2885,170,3896,0.2158624229979466,0.7405030800821355,0.043634496919917866,0,0,0,0,0.0,0.0,0.0,-2044,0,-0.5246406570841888,0.0
2695,16035,Clearwater,Idaho,2004,1117,2839,78,4034,0.27689638076351014,0.7037679722359941,0.019335647000495785,276,-92,-46,138,0.06103395776556353,-0.02429884991942208,-0.036735107846141424,-1722,322,-0.42687159147248394,0.0977690656117049
2696,16035,Clearwater,Idaho,2008,1211,2569,126,3906,0.3100358422939068,0.6577060931899642,0.03225806451612903,94,48,-270,-128,0.03313946153039665,0.012922417515633246,-0.046061879046029874,-1358,364,-0.3476702508960574,0.07920134057642653
2697,16035,Clearwater,Idaho,2012,1032,2541,123,3696,0.2792207792207792,0.6875,0.033279220779220776,-179,-3,-28,-210,-0.03081506307312759,0.001021156263091745,0.029793906810035797,-1509,-151,-0.4082792207792208,-0.06060896988316339
2698,16035,Clearwater,Idaho,2016,704,2852,245,3801,0.18521441725861615,0.7503288608260984,0.06445672191528545,-328,122,311,105,-0.09400636196216305,0.031177501136064677,0.0628288608260984,-2148,-639,-0.5651144435674822,-0.1568352227882614
2699,16037,Custer,Idaho,2000,416,1794,120,2330,0.17854077253218884,0.7699570815450644,0.05150214592274678,0,0,0,0,0.0,0.0,0.0,-1378,0,-0.5914163090128756,0.0
2700,16037,Custer,Idaho,2004,559,1762,37,2358,0.23706530958439356,0.7472434266327396,0.015691263782866838,143,-83,-32,28,0.05852453705220473,-0.03581088213987994,-0.0227136549123248,-1203,175,-0.510178117048346,0.08123819196452953
2701,16037,Custer,Idaho,2008,611,1694,48,2353,0.2596685082872928,0.7199320016999575,0.020399490012749683,52,11,-68,-5,0.022603198702899258,0.004708226229882845,-0.027311424932782047,-1083,120,-0.4602634934126647,0.04991462363568133
2702,16037,Custer,Idaho,2012,530,1744,80,2354,0.22514868309260833,0.7408666100254885,0.033984706881903144,-81,32,50,1,-0.034519825194684495,0.013585216869153462,0.020934608325530957,-1214,-131,-0.5157179269328802,-0.05545443352021551
2703,16037,Custer,Idaho,2016,427,1777,210,2414,0.17688483844241923,0.7361226180613091,0.08699254349627175,-103,130,33,60,-0.0482638446501891,0.05300783661436861,-0.004743991964179406,-1350,-136,-0.5592377796188899,-0.043519852686009664
2704,16039,Elmore,Idaho,2000,1840,4891,235,6966,0.2641401091013494,0.7021246052253804,0.03373528567327017,0,0,0,0,0.0,0.0,0.0,-3051,0,-0.43798449612403106,0.0
2705,16039,Elmore,Idaho,2004,1959,6011,91,8061,0.24302195757350203,0.745689120456519,0.01128892196997891,119,-144,1120,1095,-0.02111815152784735,-0.022446363703291262,0.04356451523113858,-4052,-1001,-0.502667162883017,-0.06468266675898598
2706,16039,Elmore,Idaho,2008,2591,5665,230,8486,0.3053264199858591,0.6675701154843271,0.02710346452981381,632,139,-346,425,0.06230446241235704,0.0158145425598349,-0.07811900497219193,-3074,978,-0.362243695498468,0.14042346738454903
2707,16039,Elmore,Idaho,2012,2513,5227,261,8001,0.31408573928258965,0.6532933383327084,0.03262092238470191,-78,31,-438,-485,0.008759319296730572,0.005517457854888101,-0.01427677715161868,-2714,360,-0.33920759905011877,0.023036096448349253
2708,16039,Elmore,Idaho,2016,1814,5816,892,8522,0.21286083079089416,0.6824689040131424,0.10467026519596338,-699,631,589,521,-0.10122490849169549,0.07204934281126146,0.029175565680434,-4002,-1288,-0.4696080732222483,-0.13040047417212952
2709,16041,Franklin,Idaho,2000,513,3594,136,4243,0.12090502003299552,0.8470421871317464,0.032052792835258075,0,0,0,0,0.0,0.0,0.0,-3081,0,-0.7261371670987509,0.0
2710,16041,Franklin,Idaho,2004,456,4527,71,5054,0.09022556390977443,0.8957261574990106,0.01404827859121488,-57,-65,933,811,-0.030679456123221094,-0.018004514244043195,0.04868397036726424,-4071,-990,-0.8055005935892362,-0.07936342649048533
2711,16041,Franklin,Idaho,2008,600,4246,228,5074,0.11824990145841545,0.8368151359873867,0.04493496255419787,144,157,-281,20,0.028024337548641018,0.03088668396298299,-0.05891102151162397,-3646,425,-0.7185652345289713,0.08693535906026495
2712,16041,Franklin,Idaho,2012,325,5195,80,5600,0.05803571428571429,0.9276785714285715,0.014285714285714285,-275,-148,949,526,-0.06021418717270116,-0.030649248268483587,0.0908634354411848,-4870,-1224,-0.8696428571428572,-0.1510776226138859
2713,16041,Franklin,Idaho,2016,385,3901,1213,5499,0.07001272958719768,0.7094017094017094,0.22058556101109292,60,1133,-1294,-101,0.011977015301483387,0.20629984672537863,-0.21827686202686203,-3516,1354,-0.6393889798145118,0.23025387732834535
2714,16043,Fremont,Idaho,2000,699,4242,147,5088,0.13738207547169812,0.8337264150943396,0.028891509433962265,0,0,0,0,0.0,0.0,0.0,-3543,0,-0.6963443396226415,0.0
2715,16043,Fremont,Idaho,2004,741,4965,63,5769,0.12844513780551223,0.8606344253770151,0.0109204368174727,42,-84,723,681,-0.00893693766618589,-0.017971072616489565,0.02690801028267542,-4224,-681,-0.7321892875715028,-0.03584494794886128
2716,16043,Fremont,Idaho,2008,1065,4700,116,5881,0.18109165107974834,0.7991838122768237,0.01972453664342799,324,53,-265,112,0.05264651327423611,0.00880409982595529,-0.0614506131001914,-3635,589,-0.6180921611970753,0.11409712637442748
2717,16043,Fremont,Idaho,2012,810,4907,85,5802,0.13960703205791106,0.8457428472940366,0.014650120648052396,-255,-31,207,-79,-0.04148461902183728,-0.005074415995375593,0.046559035017212924,-4097,-462,-0.7061358152361256,-0.08804365403905023
2718,16043,Fremont,Idaho,2016,651,4090,974,5715,0.11391076115485564,0.715660542432196,0.1704286964129484,-159,889,-817,-87,-0.025696270903055415,0.15577857576489598,-0.13008230486184058,-3439,658,-0.6017497812773404,0.10438603395878521
2719,16045,Gem,Idaho,2000,1346,4376,261,5983,0.22497075045963563,0.7314056493397961,0.043623600200568276,0,0,0,0,0.0,0.0,0.0,-3030,0,-0.5064348988801605,0.0
2720,16045,Gem,Idaho,2004,1628,5416,90,7134,0.22820297168488926,0.7591813849172975,0.012615643397813289,282,-171,1040,1151,0.0032322212252536286,-0.031007956802754987,0.027775735577501348,-3788,-758,-0.5309784132324082,-0.024543514352247775
2721,16045,Gem,Idaho,2008,2166,5585,197,7948,0.27252138902868644,0.7026925012581782,0.02478610971313538,538,107,169,814,0.044318417343797184,0.012170466315322093,-0.056488883659119304,-3419,369,-0.4301711122294917,0.10080730100291652
2722,16045,Gem,Idaho,2012,1957,5311,222,7490,0.26128170894526037,0.7090787716955941,0.02963951935914553,-209,25,-274,-458,-0.011239680083426073,0.004853409646010148,0.0063862704374159085,-3354,65,-0.4477970627503337,-0.017625950520841982
2723,16045,Gem,Idaho,2016,1229,5980,745,7954,0.15451345235101835,0.7518229821473472,0.09366356550163439,-728,523,669,464,-0.10676825659424202,0.06402404614248886,0.04274421045175314,-4751,-1397,-0.5973095297963289,-0.1495124670459952
2724,16047,Gooding,Idaho,2000,1282,3502,242,5026,0.25507361719060884,0.6967767608436132,0.048149621965777954,0,0,0,0,0.0,0.0,0.0,-2220,0,-0.44170314365300434,0.0
2725,16047,Gooding,Idaho,2004,1278,3973,74,5325,0.24,0.7461032863849765,0.013896713615023475,-4,-168,471,299,-0.015073617190608846,-0.03425290835075448,0.0493265255413633,-2695,-475,-0.5061032863849765,-0.06440014273197214
2726,16047,Gooding,Idaho,2008,1489,3765,137,5391,0.27620107586718606,0.6983861992209237,0.025412724911890186,211,63,-208,66,0.03620107586718607,0.011516011296866711,-0.04771708716405276,-2276,419,-0.42218512335373765,0.08391816303123883
2727,16047,Gooding,Idaho,2012,1287,3696,135,5118,0.2514654161781946,0.7221570926143025,0.02637749120750293,-202,-2,-69,-273,-0.02473565968899144,0.0009647662956127449,0.02377089339337879,-2409,-133,-0.4706916764361079,-0.04850655308237023
2728,16047,Gooding,Idaho,2016,930,3743,518,5191,0.17915623193989597,0.7210556732806781,0.09978809477942593,-357,383,47,73,-0.07230918423829866,0.073410603571923,-0.0011014193336243983,-2813,-404,-0.5418994413407822,-0.07120776490467429
2729,16049,Idaho,Idaho,2000,1187,5806,459,7452,0.1592860976918948,0.7791196994095545,0.06159420289855073,0,0,0,0,0.0,0.0,0.0,-4619,0,-0.6198336017176597,0.0
2730,16049,Idaho,Idaho,2004,1689,6017,264,7970,0.21191969887076537,0.7549560853199498,0.03312421580928482,502,-195,211,518,0.05263360117887056,-0.02846998708926591,-0.024163614089604657,-4328,291,-0.5430363864491845,0.07679721526847516
2731,16049,Idaho,Idaho,2008,2017,5895,300,8212,0.24561617145640527,0.7178519240136386,0.03653190452995616,328,36,-122,242,0.0336964725856399,0.003407688720671341,-0.03710416130631122,-3878,450,-0.4722357525572334,0.07080063389195113
2732,16049,Idaho,Idaho,2012,1708,5921,209,7838,0.2179127328400102,0.755422301607553,0.026664965552436845,-309,-91,26,-374,-0.02770343861639507,-0.009866938977519314,0.03757037759391435,-4213,-335,-0.5375095687675427,-0.06527381621030937
2733,16049,Idaho,Idaho,2016,1196,6441,596,8233,0.1452690392323576,0.7823393659662334,0.07239159480140897,-512,387,520,395,-0.0726436936076526,0.045726629248972125,0.026917064358680465,-5245,-1032,-0.6370703267338759,-0.09956075796633312
2734,16051,Jefferson,Idaho,2000,1100,6480,256,7836,0.14037774374680959,0.8269525267993875,0.03266972945380296,0,0,0,0,0.0,0.0,0.0,-5380,0,-0.6865747830525779,0.0
2735,16051,Jefferson,Idaho,2004,1084,7703,119,8906,0.12171569728273074,0.8649225241410285,0.013361778576240737,-16,-137,1223,1070,-0.018662046464078846,-0.019307950877562225,0.03796999734164108,-6619,-1239,-0.7432068268582979,-0.056632043805719956
2736,16051,Jefferson,Idaho,2008,1641,8540,260,10441,0.1571688535580883,0.8179293171152189,0.024901829326692847,557,141,837,1535,0.035453156275357556,0.01154005075045211,-0.04699320702580967,-6899,-280,-0.6607604635571306,0.08244636330116728
2737,16051,Jefferson,Idaho,2012,1303,9895,183,11381,0.11448906071522713,0.8694315086547755,0.016079430629997365,-338,-77,1355,940,-0.042679792842861164,-0.008822398696695481,0.0515021915395566,-8592,-1693,-0.7549424479395483,-0.09418198438241776
2738,16051,Jefferson,Idaho,2016,976,8436,2063,11475,0.08505446623093682,0.7351633986928104,0.17978213507625274,-327,1880,-1459,94,-0.02943459448429031,0.16370270444625537,-0.13426810996196503,-7460,1132,-0.6501089324618736,0.10483351547767472
2739,16053,Jerome,Idaho,2000,1360,4418,229,6007,0.2264025303812219,0.7354752788413518,0.03812219077742634,0,0,0,0,0.0,0.0,0.0,-3058,0,-0.5090727484601298,0.0
2740,16053,Jerome,Idaho,2004,1344,5177,59,6580,0.20425531914893616,0.7867781155015198,0.008966565349544073,-16,-170,759,573,-0.022147211232285746,-0.029155625427882265,0.051302836660167994,-3833,-775,-0.5825227963525836,-0.0734500478924538
2741,16053,Jerome,Idaho,2008,1794,4897,156,6847,0.26201256024536296,0.7152037388637359,0.022783700890901124,450,97,-280,267,0.0577572410964268,0.01381713554135705,-0.07157437663778388,-3103,730,-0.45319117861837294,0.1293316177342107
2742,16053,Jerome,Idaho,2012,1699,4804,214,6717,0.2529403007294923,0.7152002382015781,0.03185946106892958,-95,58,-93,-130,-0.009072259515870651,0.009075760178028459,-3.5006621578181907e-06,-3105,-2,-0.46225993747208577,-0.009068758853712833
2743,16053,Jerome,Idaho,2016,1329,4644,778,6751,0.19685972448526146,0.6878980891719745,0.11524218634276404,-370,564,-160,34,-0.05608057624423085,0.08338272527383445,-0.027302149029603595,-3315,-210,-0.491038364686713,-0.028778427214627256
2744,16055,Kootenai,Idaho,2000,13488,28162,2162,43812,0.3078608600383457,0.6427919291518306,0.049347210809823794,0,0,0,0,0.0,0.0,0.0,-14674,0,-0.3349310691134849,0.0
2745,16055,Kootenai,Idaho,2004,17584,36173,846,54603,0.3220335878981008,0.6624727579070747,0.01549365419482446,4096,-1316,8011,10791,0.014172727859755152,-0.033853556614999336,0.01968082875524413,-18589,-3915,-0.3404391700089739,-0.0055081008954889765
2746,16055,Kootenai,Idaho,2008,22120,38387,2028,62535,0.35372191572719275,0.6138482449828097,0.032429839289997604,4536,1182,2214,7932,0.03168832782909192,0.016936185095173147,-0.04862451292426506,-16267,2322,-0.2601263292556169,0.08031284075335698
2747,16055,Kootenai,Idaho,2012,18851,39381,2268,60500,0.31158677685950414,0.6509256198347108,0.03748760330578512,-3269,240,994,-2035,-0.042135138867688604,0.0050577640157875164,0.0370773748519011,-20530,-4263,-0.3393388429752066,-0.0792125137195897
2748,16055,Kootenai,Idaho,2016,16264,44449,5597,66310,0.24527220630372493,0.6703212185190771,0.084406575177198,-2587,3329,5068,5810,-0.06631457055577922,0.04691897187141288,0.019395598684366355,-28185,-7655,-0.4250490122153522,-0.08571016924014557
2749,16057,Latah,Idaho,2000,5661,8161,1489,15311,0.36973417804193065,0.5330154790673373,0.09725034289073216,0,0,0,0,0.0,0.0,0.0,-2500,0,-0.1632813010254066,0.0
2750,16057,Latah,Idaho,2004,8430,8686,437,17553,0.4802597846521962,0.4948441861790007,0.024896029168803055,2769,-1052,525,2242,0.11052560661026556,-0.0723543137219291,-0.03817129288833654,-256,2244,-0.014584401526804514,0.1486968994986021
2751,16057,Latah,Idaho,2008,9195,7988,733,17916,0.5132283991962492,0.4458584505469971,0.04091315025675374,765,296,-698,363,0.03296861454405298,0.016017121087950684,-0.048985735632003646,1207,1463,0.06736994864925211,0.08195435017605662
2752,16057,Latah,Idaho,2012,8306,7589,1224,17119,0.48519189204976926,0.44330860447456044,0.07149950347567031,-889,491,-399,-797,-0.028036507146479928,0.030586353218916576,-0.0025498460724366345,717,-490,0.041883287575208816,-0.025486661074043293
2753,16057,Latah,Idaho,2016,8093,7265,2815,18173,0.44533098552798106,0.39976888791063664,0.15490012656138227,-213,1591,-324,1054,-0.0398609065217882,0.08340062308571196,-0.0435397165639238,828,111,0.04556209761734442,0.003678810042135605
2754,16059,Lemhi,Idaho,2000,660,2859,122,3641,0.18126888217522658,0.7852238396045043,0.03350727822026916,0,0,0,0,0.0,0.0,0.0,-2199,0,-0.6039549574292777,0.0
2755,16059,Lemhi,Idaho,2004,915,3079,61,4055,0.22564734895191121,0.7593094944512947,0.015043156596794081,255,-61,220,414,0.04437846677668464,-0.018464121623475077,-0.02591434515320956,-2164,35,-0.5336621454993835,0.07029281192989423
2756,16059,Lemhi,Idaho,2008,1061,2938,106,4105,0.2584652862362972,0.7157125456760048,0.02582216808769793,146,45,-141,50,0.032817937284386006,0.010779011490903847,-0.04359694877528986,-1877,287,-0.4572472594397076,0.07641488605967589
2757,16059,Lemhi,Idaho,2012,960,3029,121,4110,0.23357664233576642,0.7369829683698297,0.029440389294403894,-101,15,91,5,-0.024888643900530805,0.003618221206705966,0.021270422693824842,-2069,-192,-0.5034063260340633,-0.0461590665943557
2758,16059,Lemhi,Idaho,2016,733,3011,352,4096,0.178955078125,0.735107421875,0.0859375,-227,231,-18,-14,-0.054621564210766416,0.056497110705596106,-0.001875546494829683,-2278,-209,-0.55615234375,-0.05274601771593668
2759,16061,Lewis,Idaho,2000,335,1295,58,1688,0.19845971563981044,0.7671800947867299,0.034360189573459717,0,0,0,0,0.0,0.0,0.0,-960,0,-0.5687203791469194,0.0
2760,16061,Lewis,Idaho,2004,440,1359,21,1820,0.24175824175824176,0.7467032967032967,0.011538461538461539,105,-37,64,132,0.043298526118431324,-0.022821728034998177,-0.020476798083433168,-919,41,-0.5049450549450549,0.06377532420186449
2761,16061,Lewis,Idaho,2008,479,1275,50,1804,0.2655210643015521,0.7067627494456763,0.02771618625277162,39,29,-84,-16,0.02376282254331033,0.01617772471431008,-0.03994054725762042,-796,123,-0.4412416851441242,0.06370336980093072
2762,16061,Lewis,Idaho,2012,396,1173,45,1614,0.24535315985130113,0.7267657992565055,0.027881040892193308,-83,-5,-102,-190,-0.020167904450250962,0.0001648546394216882,0.020003049810829232,-777,19,-0.4814126394052044,-0.040170954261080194
2763,16061,Lewis,Idaho,2016,270,1202,118,1590,0.16981132075471697,0.7559748427672957,0.07421383647798742,-126,73,29,-24,-0.07554183909658416,0.04633279558579411,0.029209043510790123,-932,-155,-0.5861635220125787,-0.10475088260737431
2764,16063,Lincoln,Idaho,2000,437,1049,88,1574,0.2776365946632783,0.6664548919949174,0.05590851334180432,0,0,0,0,0.0,0.0,0.0,-612,0,-0.3888182973316391,0.0
2765,16063,Lincoln,Idaho,2004,466,1388,22,1876,0.2484008528784648,0.7398720682302772,0.011727078891257996,29,-66,339,302,-0.029235741784813474,-0.04418143445054633,0.07341717623535982,-922,-310,-0.4914712153518124,-0.10265291802017329
2766,16063,Lincoln,Idaho,2008,545,1232,93,1870,0.2914438502673797,0.6588235294117647,0.04973262032085562,79,71,-156,-6,0.04304299738891487,0.038005541429597625,-0.08104853881851248,-687,235,-0.367379679144385,0.12409153620742736
2767,16063,Lincoln,Idaho,2012,469,1141,53,1663,0.2820204449789537,0.6861094407696934,0.03187011425135298,-76,-40,-91,-207,-0.009423405288426001,-0.01786250606950264,0.027285911357928683,-672,15,-0.4040889957907397,-0.036709316646354684
2768,16063,Lincoln,Idaho,2016,360,1184,204,1748,0.20594965675057209,0.6773455377574371,0.11670480549199085,-109,151,43,85,-0.07607078822838159,0.08483469124063786,-0.008763903012256269,-824,-152,-0.471395881006865,-0.06730688521612532
2769,16065,Madison,Idaho,2000,816,7941,213,8970,0.09096989966555184,0.8852842809364548,0.02374581939799331,0,0,0,0,0.0,0.0,0.0,-7125,0,-0.794314381270903,0.0
2770,16065,Madison,Idaho,2004,826,10693,118,11637,0.07098049325427516,0.9188794362808284,0.01014007046489645,10,-95,2752,2667,-0.01998940641127668,-0.01360574893309686,0.03359515534437352,-9867,-2742,-0.8478989430265532,-0.053584561755650184
2771,16065,Madison,Idaho,2008,1627,11131,300,13058,0.12459794761831827,0.8524276305712973,0.02297442181038444,801,182,438,1421,0.05361745436404311,0.012834351345487988,-0.06645180570953102,-9504,363,-0.7278296829529791,0.1200692600735741
2772,16065,Madison,Idaho,2012,832,13445,135,14412,0.057729669719678044,0.9329031362753262,0.009367194004995838,-795,-165,2314,1354,-0.06686827789864022,-0.0136072278053886,0.08047550570402884,-12613,-3109,-0.8751734665556481,-0.14734378360266898
2773,16065,Madison,Idaho,2016,1201,8941,5546,15688,0.07655532891381948,0.5699260581336053,0.3535186129525752,369,5411,-4504,1276,0.01882565919414144,0.34415141894757934,-0.36297707814172087,-7740,4873,-0.4933707292197858,0.3818027373358623
2774,16067,Minidoka,Idaho,2000,1344,4907,267,6518,0.20619822031297944,0.752838293955201,0.04096348573181958,0,0,0,0,0.0,0.0,0.0,-3563,0,-0.5466400736422216,0.0
2775,16067,Minidoka,Idaho,2004,1331,5797,73,7201,0.18483543952228856,0.8050270795722816,0.010137480905429801,-13,-194,890,683,-0.021362780790690872,-0.030826004826389777,0.052188785617080624,-4466,-903,-0.620191640049993,-0.0735515664077715
2776,16067,Minidoka,Idaho,2008,1630,5087,173,6890,0.2365747460087083,0.7383164005805515,0.025108853410740203,299,100,-710,-311,0.05173930648641972,0.014971372505310401,-0.06671067899173011,-3457,1009,-0.5017416545718432,0.11844998547814989
2777,16067,Minidoka,Idaho,2012,1390,5442,141,6973,0.19934031263444715,0.7804388355083896,0.020220851857163345,-240,-32,355,83,-0.03723443337426113,-0.004888001553576857,0.04212243492783807,-4052,-595,-0.5810985228739424,-0.0793568683020992
2778,16067,Minidoka,Idaho,2016,1167,4887,817,6871,0.169844273031582,0.7112501819240286,0.11890554504438947,-223,676,-555,-102,-0.02949603960286515,0.09868469318722611,-0.06918865358436099,-3720,332,-0.5414059088924466,0.03969261398149582
2779,16069,Nez Perce,Idaho,2000,4995,10577,449,16021,0.3117782909930716,0.6601959927595031,0.028025716247425253,0,0,0,0,0.0,0.0,0.0,-5582,0,-0.34841770176643155,0.0
2780,16069,Nez Perce,Idaho,2004,6476,11009,215,17700,0.3658757062146893,0.6219774011299435,0.012146892655367232,1481,-234,432,1679,0.054097415221617706,-0.01587882359205802,-0.03821859162955965,-4533,1049,-0.2561016949152542,0.09231600685117736
2781,16069,Nez Perce,Idaho,2008,7123,10357,343,17823,0.39965213488189416,0.5811030690680581,0.01924479605004769,647,128,-652,123,0.03377642866720487,0.007097903394680458,-0.0408743320618854,-3234,1299,-0.18145093418616393,0.07465076072909027
2782,16069,Nez Perce,Idaho,2012,6451,9967,573,16991,0.3796715908422106,0.5866046730622094,0.03372373609558001,-672,230,-390,-832,-0.01998054403968358,0.014478940045532324,0.005501603994151338,-3516,-282,-0.20693308221999884,-0.025482148033834917
2783,16069,Nez Perce,Idaho,2016,4828,10699,1674,17201,0.2806813557351317,0.6219987210045927,0.09731992326027557,-1623,1101,732,210,-0.09899023510707888,0.06359618716469556,0.03539404794238332,-5871,-2355,-0.34131736526946105,-0.1343842830494622
2784,16071,Oneida,Idaho,2000,307,1426,65,1798,0.1707452725250278,0.7931034482758621,0.036151279199110126,0,0,0,0,0.0,0.0,0.0,-1119,0,-0.6223581757508343,0.0
2785,16071,Oneida,Idaho,2004,304,1789,40,2133,0.14252226910454757,0.8387248007501172,0.01875293014533521,-3,-25,363,335,-0.02822300342048023,-0.017398349053774916,0.04562135247425514,-1485,-366,-0.6962025316455697,-0.07384435589473537
2786,16071,Oneida,Idaho,2008,381,1724,57,2162,0.17622571692876965,0.7974098057354302,0.026364477335800184,77,17,-65,29,0.03370344782422208,0.007611547190464973,-0.04131499501468705,-1343,142,-0.6211840888066605,0.07501844283890913
2787,16071,Oneida,Idaho,2012,217,1838,34,2089,0.1038774533269507,0.8798468166586884,0.016275730014360938,-164,-23,114,-73,-0.07234826360181895,-0.010088747321439245,0.08243701092325817,-1621,-278,-0.7759693633317377,-0.15478527452507718
2788,16071,Oneida,Idaho,2016,184,1531,353,2068,0.08897485493230174,0.7403288201160542,0.1706963249516441,-33,319,-307,-21,-0.014902598394648955,0.15442059493728316,-0.1395179965426342,-1347,274,-0.6513539651837524,0.12461539814798528
2789,16073,Owyhee,Idaho,2000,623,2450,115,3188,0.19542032622333752,0.7685069008782937,0.03607277289836888,0,0,0,0,0.0,0.0,0.0,-1827,0,-0.5730865746549562,0.0
2790,16073,Owyhee,Idaho,2004,685,2859,46,3590,0.19080779944289694,0.7963788300835655,0.012813370473537604,62,-69,409,402,-0.004612526780440579,-0.02325940242483128,0.027871929205271817,-2174,-347,-0.6055710306406685,-0.03248445598571237
2791,16073,Owyhee,Idaho,2008,944,3024,90,4058,0.23262690980778708,0.7451946771808773,0.022178413011335635,259,44,165,468,0.04181911036489014,0.00936504253779803,-0.051184152902688185,-2080,94,-0.5125677673730902,0.09300326326757835
2792,16073,Owyhee,Idaho,2012,833,2794,97,3724,0.2236842105263158,0.7502685284640171,0.026047261009667026,-111,7,-230,-334,-0.008942699281471289,0.0038688479983313914,0.005073851283139863,-1961,119,-0.5265843179377013,-0.014016550564611152
2793,16073,Owyhee,Idaho,2016,591,3052,282,3925,0.1505732484076433,0.7775796178343949,0.07184713375796178,-242,185,258,201,-0.07311096211867249,0.04579987274829476,0.02731108937037774,-2461,-500,-0.6270063694267516,-0.10042205148905026
2794,16075,Payette,Idaho,2000,1643,4961,254,6858,0.2395742198891805,0.7233887430737824,0.037037037037037035,0,0,0,0,0.0,0.0,0.0,-3318,0,-0.48381452318460194,0.0
2795,16075,Payette,Idaho,2004,1848,6256,77,8181,0.2258892555922259,0.7646986920914314,0.009412052316342746,205,-177,1295,1323,-0.013684964296954621,-0.027624984720694287,0.04130994901764895,-4408,-1090,-0.5388094364992055,-0.0549949133146036
2796,16075,Payette,Idaho,2008,2415,5988,290,8693,0.2778097319682503,0.6888300931784194,0.03336017485333027,567,213,-268,512,0.05192047637602443,0.02394812253698752,-0.07586859891301201,-3573,835,-0.41102036121016905,0.1277890752890365
2797,16075,Payette,Idaho,2012,2271,6004,220,8495,0.2673337257210124,0.7067686874632136,0.025897586815773983,-144,-70,16,-198,-0.010476006247237934,-0.007462588037556284,0.017938594284794274,-3733,-160,-0.43943496174220126,-0.028414600532032208
2798,16075,Payette,Idaho,2016,1507,6489,708,8704,0.17313878676470587,0.7455193014705882,0.08134191176470588,-764,488,485,209,-0.09419493895630651,0.0554443249489319,0.03875061400737456,-4982,-1249,-0.5723805147058824,-0.1329455529636811
2799,16077,Power,Idaho,2000,755,1872,82,2709,0.27870062753783686,0.6910299003322259,0.030269472129937247,0,0,0,0,0.0,0.0,0.0,-1117,0,-0.412329272794389,0.0
2800,16077,Power,Idaho,2004,829,2105,24,2958,0.28025693035835025,0.7116294793779581,0.008113590263691683,74,-58,233,249,0.0015563028205133889,-0.022155881866245564,0.020599579045732175,-1276,-159,-0.4313725490196078,-0.019043276225218786
2801,16077,Power,Idaho,2008,1027,1754,61,2842,0.3613652357494722,0.6171710063335679,0.021463757916959886,198,37,-351,-116,0.08110830539112196,0.013350167653268203,-0.09445847304439015,-727,549,-0.2558057705840957,0.1755667784355121
2802,16077,Power,Idaho,2012,982,1870,51,2903,0.33827075439200827,0.644161212538753,0.01756803306923872,-45,-10,116,61,-0.023094481357463947,-0.0038957248477211673,0.026990206205185108,-888,-161,-0.30589045814674476,-0.050084687562649055
2803,16077,Power,Idaho,2016,699,1666,393,2758,0.2534445250181291,0.6040609137055838,0.14249456127628715,-283,342,-204,-145,-0.08482622937387918,0.12492652820704843,-0.040100298833169234,-967,-79,-0.3506163886874547,-0.044725930540709946
2804,16079,Shoshone,Idaho,2000,2225,2879,281,5385,0.41318477251624885,0.5346332404828227,0.052181987000928506,0,0,0,0,0.0,0.0,0.0,-654,0,-0.12144846796657383,0.0
2805,16079,Shoshone,Idaho,2004,2331,2922,84,5337,0.43676222596964587,0.5474985947161327,0.015739179314221474,106,-197,43,-48,0.023577453453397013,-0.03644280768670703,0.012865354233310033,-591,63,-0.11073636874648685,0.010712099220086979
2806,16079,Shoshone,Idaho,2008,2521,2953,193,5667,0.4448561849302982,0.521086994882654,0.03405682018704782,190,109,31,330,0.008093958960652348,0.01831764087282635,-0.02641159983347874,-432,159,-0.07623080995235576,0.034505558794131086
2807,16079,Shoshone,Idaho,2012,2277,2699,172,5148,0.4423076923076923,0.5242812742812742,0.03341103341103341,-244,-21,-254,-519,-0.0025484926226059246,-0.0006457867760144148,0.00319427939862027,-422,10,-0.08197358197358195,-0.005742772021226195
2808,16079,Shoshone,Idaho,2016,1384,3297,439,5120,0.2703125,0.6439453125,0.0857421875,-893,267,598,-28,-0.17199519230769228,0.05233115408896659,0.11966403821872573,-1913,-1491,-0.37363281249999997,-0.291659230526418
2809,16081,Teton,Idaho,2000,720,1745,206,2671,0.2695619618120554,0.6533133657806065,0.07712467240733807,0,0,0,0,0.0,0.0,0.0,-1025,0,-0.3837514039685511,0.0
2810,16081,Teton,Idaho,2004,1416,2235,39,3690,0.383739837398374,0.6056910569105691,0.01056910569105691,696,-167,490,1019,0.11417787558631859,-0.06655556671628116,-0.04762230887003738,-819,206,-0.22195121951219515,0.16180018445635597
2811,16081,Teton,Idaho,2008,2302,2263,94,4659,0.4940974458038206,0.4857265507619661,0.02017600343421335,886,55,28,969,0.11035760840544662,0.00960689774315644,-0.11996450614860305,39,858,0.00837089504185451,0.23032211455404966
2812,16081,Teton,Idaho,2012,1926,2458,139,4523,0.4258235684280345,0.5434446164050409,0.03073181516692461,-376,45,195,-136,-0.06827387737578611,0.010555811732711258,0.057718065643074856,-532,-571,-0.11762104797700645,-0.12599194301886096
2813,16081,Teton,Idaho,2016,2159,2167,650,4976,0.43388263665594856,0.4354903536977492,0.13062700964630225,233,511,-291,453,0.008059068227914079,0.09989519447937764,-0.10795426270729175,-8,524,-0.001607717041800627,0.11601333093520583
2814,16083,Twin Falls,Idaho,2000,5777,15794,959,22530,0.2564136706613404,0.7010208610741234,0.04256546826453617,0,0,0,0,0.0,0.0,0.0,-10017,0,-0.444607190412783,0.0
2815,16083,Twin Falls,Idaho,2004,6458,19672,305,26435,0.24429733308114243,0.7441649328541706,0.011537734064686968,681,-654,3878,3905,-0.012116337580197978,-0.031027734199849204,0.0431440717800472,-13214,-3197,-0.4998675997730282,-0.05526040936024518
2816,16083,Twin Falls,Idaho,2008,8621,19032,960,28613,0.30129661342746306,0.6651522035438437,0.033551183028693254,2163,655,-640,2178,0.056999280346320624,0.022013448964006286,-0.07901272931032688,-10411,2803,-0.3638555901163807,0.1360120096566475
2817,16083,Twin Falls,Idaho,2012,7541,19773,1052,28366,0.2658464358739336,0.6970669110907425,0.03708665303532398,-1080,92,741,-247,-0.03545017755352947,0.0035354700066307226,0.031914707546898735,-12232,-1821,-0.4312204752168089,-0.0673648851004282
2818,16083,Twin Falls,Idaho,2016,6233,19828,3813,29874,0.2086429671286068,0.6637209613710919,0.12763607150030126,-1308,2761,55,1508,-0.05720346874532678,0.09054941846497729,-0.03334594971965055,-13595,-1363,-0.45507799424248513,-0.023857519025676233
2819,16085,Valley,Idaho,2000,1129,2548,301,3978,0.2838109602815485,0.6405228758169934,0.07566616390145801,0,0,0,0,0.0,0.0,0.0,-1419,0,-0.3567119155354449,0.0
2820,16085,Valley,Idaho,2004,1843,2863,68,4774,0.3860494344365312,0.5997067448680352,0.014243820695433599,714,-233,315,796,0.10223847415498272,-0.06142234320602442,-0.040816130948958196,-1020,399,-0.213657310431504,0.1430546051039409
2821,16085,Valley,Idaho,2008,2405,2772,120,5297,0.4540305833490655,0.5233150840098169,0.022654332641117613,562,52,-91,523,0.06798114891253426,0.008410511945684014,-0.07639166085821836,-367,653,-0.06928450066075137,0.14437280977075262
2822,16085,Valley,Idaho,2012,2095,2664,160,4919,0.42589957308396015,0.5415734905468591,0.03252693636918073,-310,40,-108,-378,-0.02813101026510534,0.009872603728063114,0.01825840653704225,-569,-202,-0.11567391746289896,-0.04638941680214759
2823,16085,Valley,Idaho,2016,1913,2906,530,5349,0.3576369414843896,0.5432791175920733,0.0990839409235371,-182,370,242,430,-0.06826263159957052,0.06655700455435637,0.001705627045214153,-993,-424,-0.18564217610768363,-0.06996825864478468
2824,16087,Washington,Idaho,2000,980,2899,191,4070,0.24078624078624078,0.7122850122850123,0.04692874692874693,0,0,0,0,0.0,0.0,0.0,-1919,0,-0.4714987714987715,0.0
2825,16087,Washington,Idaho,2004,1033,3274,52,4359,0.23698095893553567,0.751089699472356,0.011929341592108282,53,-139,375,289,-0.003805281850705111,-0.034999405336638645,0.038804687187343756,-2241,-322,-0.5141087405368203,-0.04260996903804881
2826,16087,Washington,Idaho,2008,1241,3168,97,4506,0.275410563692854,0.7030625832223701,0.021526853084775855,208,45,-106,147,0.038429604757318325,0.009597511492667573,-0.0480271162499859,-1927,314,-0.42765201952951615,0.08645672100730417
2827,16087,Washington,Idaho,2012,1104,3128,98,4330,0.25496535796766745,0.7224018475750578,0.022632794457274827,-137,1,-40,-176,-0.020445205725186544,0.0011059413724989718,0.019339264352687624,-2024,-97,-0.4674364896073903,-0.03978447007787417
2828,16087,Washington,Idaho,2016,776,3283,396,4455,0.17418630751964084,0.7369248035914703,0.08888888888888889,-328,298,155,125,-0.08077905044802661,0.06625609443161407,0.014522956016412514,-2507,-483,-0.5627384960718295,-0.09530200646443915
2829,17001,Adams,Illinois,2000,12197,17331,581,30109,0.4050948221462021,0.5756086220067089,0.01929655584708891,0,0,0,0,0.0,0.0,0.0,-5134,0,-0.1705137998605068,0.0
2830,17001,Adams,Illinois,2004,10511,20834,132,31477,0.3339263589287416,0.6618801029322998,0.004193538138958604,-1686,-449,3503,1368,-0.07116846321746051,-0.015103017708130304,0.0862714809255909,-10323,-5189,-0.3279537440035582,-0.1574399441430514
2831,17001,Adams,Illinois,2008,11794,18711,397,30902,0.38165814510387674,0.605494789981231,0.01284706491489224,1283,265,-2123,-575,0.04773178617513513,0.008653526775933635,-0.056385312951068856,-6917,3406,-0.22383664487735422,0.10411709912620398
2832,17001,Adams,Illinois,2012,9648,20416,632,30696,0.31430805316653637,0.6651029450091217,0.020589001824341934,-2146,235,1705,-206,-0.06735009193734037,0.007741936909449694,0.05960815502789074,-10768,-3851,-0.35079489184258533,-0.12695824696523111
2833,17001,Adams,Illinois,2016,7676,22790,1844,32310,0.2375735066542866,0.705354379449087,0.057072113896626434,-1972,1212,2374,1614,-0.07673454651224978,0.036483112072284496,0.04025143443996526,-15114,-4346,-0.4677808727948004,-0.11698598095221507
2834,17003,Alexander,Illinois,2000,2357,1588,77,4022,0.5860268523122825,0.3948284435604177,0.01914470412729985,0,0,0,0,0.0,0.0,0.0,769,0,0.19119840875186478,0.0
2835,17003,Alexander,Illinois,2004,2016,1831,26,3873,0.5205267234701781,0.47276013426284536,0.006713142266976504,-341,-51,243,-149,-0.06550012884210432,-0.012431561860323345,0.07793169070242767,185,-584,0.04776658920733279,-0.143431819544532
2836,17003,Alexander,Illinois,2008,2189,1692,66,3947,0.5545984291867241,0.4286800101342792,0.016721560678996706,173,40,-139,74,0.03407170571654594,0.0100084184120202,-0.044080124128566156,497,312,0.12591841905244489,0.0781518298451121
2837,17003,Alexander,Illinois,2012,1965,1487,49,3501,0.5612682090831191,0.42473578977435017,0.013996001142530705,-224,-17,-205,-446,0.006669779896395056,-0.0027255595364660008,-0.003944220359929029,478,-19,0.13653241930876897,0.010614000256324085
2838,17003,Alexander,Illinois,2016,1262,1496,62,2820,0.4475177304964539,0.5304964539007092,0.02198581560283688,-703,13,9,-681,-0.11375047858666526,0.007989814460306175,0.10576066412635904,-234,-712,-0.08297872340425533,-0.2195111427130243
2839,17005,Bond,Illinois,2000,3060,3804,168,7032,0.4351535836177474,0.5409556313993175,0.023890784982935155,0,0,0,0,0.0,0.0,0.0,-744,0,-0.10580204778157004,0.0
2840,17005,Bond,Illinois,2004,3228,4068,73,7369,0.4380512959696024,0.5520423395304654,0.009906364499932149,168,-95,264,337,0.0028977123518549863,-0.013984420483003007,0.011086708131147982,-840,-96,-0.11399104356086304,-0.008188995779292996
2841,17005,Bond,Illinois,2008,3843,3947,170,7960,0.4827889447236181,0.4958542713567839,0.02135678391959799,615,97,-121,591,0.0447376487540157,0.01145041941966584,-0.05618806817368155,-104,736,-0.013065326633165786,0.10092571692769725
2842,17005,Bond,Illinois,2012,3020,4095,249,7364,0.4101032047800109,0.5560836501901141,0.03381314502987507,-823,79,148,-596,-0.07268573994360722,0.012456361110277082,0.06022937883333018,-1075,-971,-0.1459804454101032,-0.1329151187769374
2843,17005,Bond,Illinois,2016,2068,4888,614,7570,0.2731836195508586,0.6457067371202113,0.08110964332892999,-952,365,793,206,-0.13691958522915226,0.04729649829905492,0.08962308693009724,-2820,-1745,-0.3725231175693527,-0.2265426721592495
2844,17007,Boone,Illinois,2000,6481,8617,425,15523,0.4175095020292469,0.5551117696321587,0.027378728338594345,0,0,0,0,0.0,0.0,0.0,-2136,0,-0.13760226760291178,0.0
2845,17007,Boone,Illinois,2004,8286,11132,123,19541,0.42403152346348705,0.56967401872985,0.006294457806662914,1805,-302,2515,4018,0.006522021434240133,-0.02108427053193143,0.014562249097691327,-2846,-710,-0.14564249526636297,-0.008040227663451194
2846,17007,Boone,Illinois,2008,11333,10403,502,22238,0.5096231675510388,0.4678028599694217,0.022573972479539527,3047,379,-729,2697,0.08559164408755171,0.016279514672876614,-0.1018711587604283,930,3776,0.04182030758161703,0.18746280284798
2847,17007,Boone,Illinois,2012,9883,11096,457,21436,0.4610468370964732,0.5176338869192013,0.021319275984325432,-1450,-45,693,-802,-0.04857633045456555,-0.001254696495214095,0.04983102694977959,-1213,-2143,-0.05658704982272811,-0.09840735740434514
2848,17007,Boone,Illinois,2016,8986,12282,1733,23001,0.3906786661449502,0.5339767836181035,0.07534455023694622,-897,1276,1186,1565,-0.07036817095152298,0.05402527425262079,0.01634289669890221,-3296,-2083,-0.1432981174731533,-0.08671106765042519
2849,17009,Brown,Illinois,2000,1077,1529,54,2660,0.4048872180451128,0.574812030075188,0.02030075187969925,0,0,0,0,0.0,0.0,0.0,-452,0,-0.1699248120300752,0.0
2850,17009,Brown,Illinois,2004,895,1679,11,2585,0.34622823984526113,0.6495164410058027,0.00425531914893617,-182,-43,150,-75,-0.058658978199851664,-0.01604543273076308,0.07470441093061475,-784,-332,-0.3032882011605416,-0.13336338913046641
2851,17009,Brown,Illinois,2008,986,1544,47,2577,0.3826154443150951,0.5991462941404734,0.01823826154443151,91,36,-135,-8,0.036387204469833956,0.01398294239549534,-0.05037014686532937,-558,226,-0.2165308498253783,0.08675735133516332
2852,17009,Brown,Illinois,2012,787,1513,64,2364,0.3329103214890017,0.6400169204737732,0.02707275803722504,-199,17,-31,-213,-0.049705122826093406,0.008834496492793532,0.04087062633329985,-726,-168,-0.30710659898477155,-0.09057574915939326
2853,17009,Brown,Illinois,2016,476,1796,107,2379,0.20008406893652794,0.7549390500210172,0.044976881042454814,-311,43,283,15,-0.13282625255247374,0.017904123005229772,0.11492212954724401,-1320,-594,-0.5548549810844893,-0.24774838209971772
2854,17011,Bureau,Illinois,2000,7754,8526,543,16823,0.4609166022707008,0.5068061582357487,0.0322772394935505,0,0,0,0,0.0,0.0,0.0,-772,0,-0.0458895559650479,0.0
2855,17011,Bureau,Illinois,2004,7961,9822,119,17902,0.44469891632219866,0.5486537817003687,0.006647301977432689,207,-424,1296,1079,-0.016217685948502147,-0.02562993751611781,0.04184762346462001,-1861,-1089,-0.10395486537817006,-0.05806530941312216
2856,17011,Bureau,Illinois,2008,8889,7911,353,17153,0.5182183874540897,0.46120212207777067,0.020579490468139686,928,234,-1911,-749,0.073519471131891,0.013932188490706997,-0.08745165962259804,978,2839,0.057016265376318986,0.16097113075448904
2857,17011,Bureau,Illinois,2012,8134,8164,387,16685,0.4875037458795325,0.48930176805513936,0.02319448606532814,-755,34,253,-468,-0.030714641574557167,0.0026149955971884534,0.028099645977368692,-30,-1008,-0.0017980221756068726,-0.05881428755192586
2858,17011,Bureau,Illinois,2016,6029,9281,1261,16571,0.36382837487176395,0.5600748295214532,0.07609679560678294,-2105,874,1117,-114,-0.12367537100776854,0.0529023095414548,0.07077306146631379,-3252,-3222,-0.1962464546496892,-0.19444843247408233
2859,17013,Calhoun,Illinois,2000,1310,1229,63,2602,0.5034588777863183,0.47232897770945426,0.02421214450422752,0,0,0,0,0.0,0.0,0.0,81,0,0.031129900076864003,0.0
2860,17013,Calhoun,Illinois,2004,1367,1317,22,2706,0.5051736881005173,0.4866962305986696,0.008130081300813009,57,-41,88,104,0.0017148103141990667,-0.016082063203414508,0.014367252889215365,50,-31,0.018477457501847705,-0.012652442575016298
2861,17013,Calhoun,Illinois,2008,1423,1221,62,2706,0.5258684405025869,0.45121951219512196,0.022912047302291204,56,40,-96,0,0.020694752402069527,0.014781966001478195,-0.03547671840354766,202,152,0.07464892830746489,0.056171470805617185
2862,17013,Calhoun,Illinois,2012,1080,1440,56,2576,0.4192546583850932,0.5590062111801242,0.021739130434782608,-343,-6,219,-130,-0.10661378211749367,-0.0011729168675085958,0.1077866989850022,-360,-562,-0.139751552795031,-0.21440048110249588
2863,17013,Calhoun,Illinois,2016,739,1721,111,2571,0.28743679502139247,0.6693893426682225,0.043173862310385065,-341,55,281,-5,-0.13181786336370072,0.021434731875602457,0.11038313148809831,-982,-622,-0.38195254764683,-0.24220099485179902
2864,17015,Carroll,Illinois,2000,3113,3835,229,7177,0.43374669081789047,0.5343458269471925,0.031907482234917094,0,0,0,0,0.0,0.0,0.0,-722,0,-0.10059913612930199,0.0
2865,17015,Carroll,Illinois,2004,3537,4534,64,8135,0.4347879532882606,0.5573448063921328,0.007867240319606637,424,-165,699,958,0.001041262470370119,-0.024040241915310456,0.022998979444940337,-997,-275,-0.12255685310387221,-0.02195771697457022
2866,17015,Carroll,Illinois,2008,3965,3596,132,7693,0.5154036136747693,0.4674379305862472,0.017158455738983492,428,68,-938,-442,0.08061566038650869,0.009291215419376855,-0.08990687580588558,369,1366,0.04796568308852206,0.17052253619239427
2867,17015,Carroll,Illinois,2012,3665,3555,182,7402,0.495136449608214,0.48027560118886786,0.02458794920291813,-300,50,-41,-291,-0.020267164066555265,0.0074294934639346395,0.012837670602620643,110,-259,0.014860848419346151,-0.03310483466917591
2868,17015,Carroll,Illinois,2016,2447,4434,564,7445,0.32867696440564137,0.5955674949630625,0.07575554063129618,-1218,382,879,43,-0.16645948520257264,0.05116759142837805,0.11529189377419463,-1987,-2097,-0.2668905305574211,-0.2817513789767673
2869,17017,Cass,Illinois,2000,2789,2968,142,5899,0.4727919986438379,0.5031361247669096,0.024071876589252417,0,0,0,0,0.0,0.0,0.0,-179,0,-0.03034412612307169,0.0
2870,17017,Cass,Illinois,2004,2492,3163,45,5700,0.43719298245614036,0.5549122807017544,0.007894736842105263,-297,-97,195,-199,-0.03559901618769756,-0.016177139747147153,0.05177615593484475,-671,-492,-0.117719298245614,-0.08737517212254231
2871,17017,Cass,Illinois,2008,2690,2617,125,5432,0.4952135493372607,0.48177466863033874,0.02301178203240059,198,80,-546,-268,0.05802056688112034,0.015117045190295327,-0.07313761207141561,73,744,0.013438880706921952,0.13115817895253595
2872,17017,Cass,Illinois,2012,2053,2707,117,4877,0.4209555054336682,0.5550543366823867,0.023990157883945047,-637,-8,90,-555,-0.07425804390359247,0.0009783758515444566,0.07327966805204794,-654,-727,-0.13409883124871846,-0.14753771195564042
2873,17017,Cass,Illinois,2016,1621,3216,287,5124,0.3163544106167057,0.6276346604215457,0.056010928961748634,-432,170,509,247,-0.1046010948169625,0.032020771077803586,0.07258032373915901,-1595,-941,-0.31128024980484,-0.17718141855612152
2874,17019,Champaign,Illinois,2000,35515,34645,4125,74285,0.4780911354916874,0.4663794844181194,0.055529380090193176,0,0,0,0,0.0,0.0,0.0,870,0,0.01171165107356803,0.0
2875,17019,Champaign,Illinois,2004,41524,39896,1014,82434,0.5037241914743916,0.48397505883494674,0.01230074969066162,6009,-3111,5251,8149,0.02563305598270421,-0.04322863039953156,0.017595574416827353,1628,758,0.01974913263944489,0.008037481565876858
2876,17019,Champaign,Illinois,2008,48597,33871,1940,84408,0.5757392664202445,0.4012771301298455,0.022983603449909962,7073,926,-6025,1974,0.07201507494585291,0.010682853759248342,-0.08269792870510123,14726,13098,0.17446213629039903,0.15471300365095414
2877,17019,Champaign,Illinois,2012,40831,35312,2440,78583,0.5195907511802808,0.4493592761793263,0.03104997264039296,-7766,500,1441,-5825,-0.05614851523996378,0.008066369190482998,0.0480821460494808,5519,-9207,0.07023147500095445,-0.10423066128944458
2878,17019,Champaign,Illinois,2016,50137,33368,8123,91628,0.5471799013402017,0.36416815820491555,0.08865194045488278,9306,5683,-1944,13045,0.027589150159920917,0.05760196781448983,-0.08519111797441076,16769,11250,0.18301174313528612,0.11278026813433167
2879,17021,Christian,Illinois,2000,6799,7537,435,14771,0.4602938189696026,0.5102565838467267,0.029449597183670705,0,0,0,0,0.0,0.0,0.0,-738,0,-0.04996276487712409,0.0
2880,17021,Christian,Illinois,2004,6112,9044,111,15267,0.40034060391694504,0.5923888124713435,0.0072705836117115345,-687,-324,1507,496,-0.05995321505265755,-0.022179013571959172,0.08213222862461678,-2932,-2194,-0.19204820855439841,-0.14208544367727433
2881,17021,Christian,Illinois,2008,6918,7872,365,15155,0.4564830089079512,0.5194325305179809,0.024084460574067965,806,254,-1172,-112,0.056142404991006145,0.01681387696235643,-0.07295628195336257,-954,1978,-0.0629495216100297,0.1290986869443687
2882,17021,Christian,Illinois,2012,5494,8885,348,14727,0.3730562911658858,0.6033136416106472,0.0236300672234671,-1424,-17,1013,-428,-0.08342671774206539,-0.00045439335060086516,0.08388111109266627,-3391,-2437,-0.23025735044476137,-0.16730782883473166
2883,17021,Christian,Illinois,2016,3992,10543,942,15477,0.2579311236027654,0.6812043677715319,0.060864508625702654,-1502,594,1658,750,-0.11512516756312041,0.03723444140223556,0.07789072616088477,-6551,-3160,-0.42327324416876655,-0.19301589372400518
2884,17023,Clark,Illinois,2000,2932,4398,182,7512,0.3903088391906283,0.5854632587859425,0.02422790202342918,0,0,0,0,0.0,0.0,0.0,-1466,0,-0.1951544195953142,0.0
2885,17023,Clark,Illinois,2004,2877,5082,48,8007,0.3593106032221806,0.6346946421880855,0.005994754589733983,-55,-134,684,495,-0.030998235968447696,-0.0182331474336952,0.04923138340214295,-2205,-739,-0.27538403896590485,-0.08022961937059064
2886,17023,Clark,Illinois,2008,3742,4409,161,8312,0.4501924927815207,0.5304379210779596,0.01936958614051973,865,113,-673,305,0.09088188955934007,0.013374831550785747,-0.10425672111012585,-667,1538,-0.08024542829643894,0.19513861066946592
2887,17023,Clark,Illinois,2012,2591,5144,146,7881,0.3287653851034133,0.6527090470752442,0.01852556782134247,-1151,-15,735,-431,-0.12142710767810738,-0.0008440183191772595,0.12227112599728462,-2553,-1886,-0.32394366197183094,-0.243698233675392
2888,17023,Clark,Illinois,2016,1877,5622,429,7928,0.23675580221997983,0.7091321897073662,0.054112008072653886,-714,283,478,47,-0.09200958288343347,0.03558644025131141,0.056423142632122,-3745,-1192,-0.4723763874873864,-0.14843272551555547
2889,17025,Clay,Illinois,2000,2212,3789,134,6135,0.36055419722901383,0.6176039119804401,0.021841890790546048,0,0,0,0,0.0,0.0,0.0,-1577,0,-0.25704971475142624,0.0
2890,17025,Clay,Illinois,2004,2101,4416,37,6554,0.3205675923100397,0.6737870003051571,0.0056454073848031736,-111,-97,627,419,-0.039986604918974156,-0.016196483405742874,0.05618308832471708,-2315,-738,-0.3532194079951175,-0.09616969324369123
2891,17025,Clay,Illinois,2008,2425,3926,115,6466,0.37503866377977113,0.6071759975255181,0.017785338694710794,324,78,-490,-88,0.05447107146973146,0.01213993130990762,-0.06661100277963905,-1501,814,-0.23213733374574697,0.12108207424937051
2892,17025,Clay,Illinois,2012,1584,4190,134,5908,0.26811103588354773,0.7092078537576167,0.022681110358835476,-841,19,264,-558,-0.1069276278962234,0.0048957716641246825,0.10203185623209865,-2606,-1105,-0.441096817874069,-0.20895948412832205
2893,17025,Clay,Illinois,2016,1020,5021,309,6350,0.16062992125984252,0.7907086614173229,0.048661417322834646,-564,175,831,442,-0.10748111462370522,0.02598030696399917,0.08150080765970613,-4001,-1395,-0.6300787401574803,-0.18898192228341132
2894,17027,Clinton,Illinois,2000,6436,8588,403,15427,0.41719063978738574,0.5566863291631555,0.02612303104945874,0,0,0,0,0.0,0.0,0.0,-2152,0,-0.13949568937576978,0.0
2895,17027,Clinton,Illinois,2004,6797,10219,115,17131,0.39676609655011386,0.5965209269744907,0.0067129764753954815,361,-288,1631,1704,-0.020424543237271886,-0.019410054574063258,0.03983459781133514,-3422,-1270,-0.1997548304243768,-0.06025914104860702
2896,17027,Clinton,Illinois,2008,7657,9357,300,17314,0.44224327134111124,0.5404297100612221,0.017327018597666628,860,185,-862,183,0.04547717479099739,0.010614042122271145,-0.05609121691326857,-1700,1722,-0.09818643872011085,0.10156839170426596
2897,17027,Clinton,Illinois,2012,5596,10524,356,16476,0.3396455450352027,0.6387472687545521,0.021607186210245204,-2061,56,1167,-838,-0.10259772630590852,0.004280167612578576,0.09831755869333003,-4928,-3228,-0.2991017237193494,-0.20091528499923855
2898,17027,Clinton,Illinois,2016,3945,12412,1062,17419,0.2264768356392445,0.7125552557552098,0.06096790860554567,-1651,706,1888,943,-0.11316870939595822,0.03936072239530047,0.07380798700065772,-8467,-3539,-0.48607842011596536,-0.18697669639661596
2899,17029,Coles,Illinois,2000,8904,10495,694,20093,0.443139401781715,0.5223212063902851,0.0345393918279998,0,0,0,0,0.0,0.0,0.0,-1591,0,-0.0791818046085701,0.0
2900,17029,Coles,Illinois,2004,9566,13015,199,22780,0.4199297629499561,0.5713345039508341,0.008735733099209834,662,-495,2520,2687,-0.023209638831758916,-0.02580365872878997,0.04901329756054895,-3449,-1858,-0.15140474100087797,-0.07222293639230787
2901,17029,Coles,Illinois,2008,11716,10978,459,23153,0.5060251371312573,0.47415021811428326,0.019824644754459466,2150,260,-2037,373,0.0860953741813012,0.011088911655249632,-0.09718428583655081,738,4187,0.031874919016974035,0.183279660017852
2902,17029,Coles,Illinois,2012,9262,11631,544,21437,0.432056724355087,0.5425665904744134,0.025376685170499604,-2454,85,653,-1716,-0.07396841277617028,0.0055520404160401375,0.0684163723601301,-2369,-3107,-0.11050986611932634,-0.14238478513630037
2903,17029,Coles,Illinois,2016,7309,13003,1606,21918,0.33347020713568754,0.593256684004015,0.07327310886029748,-1953,1062,1372,481,-0.09858651721939948,0.04789642368979787,0.05069009352960163,-5694,-3325,-0.25978647686832745,-0.14927661074900112
2904,17031,Cook,Illinois,2000,1280547,534542,50818,1865907,0.6862866155708724,0.2864783721803927,0.027235012248734796,0,0,0,0,0.0,0.0,0.0,746005,0,0.39980824339047977,0.0
2905,17031,Cook,Illinois,2004,1439724,597405,12305,2049434,0.7024983483244642,0.29149755493467955,0.006004096740856256,159177,-38513,62863,183527,0.01621173275359178,-0.02123091550787854,0.005019182754286866,842319,96314,0.4110007933897847,0.011192549999304913
2906,17031,Cook,Illinois,2008,1629024,487736,20706,2137466,0.7621286139756142,0.22818421439218214,0.00968717163220374,189300,8401,-109669,88032,0.05963026565114993,0.0036830748913474843,-0.0633133405424974,1141288,298969,0.533944399583432,0.1229436061936473
2907,17031,Cook,Illinois,2012,1488537,495542,30442,2014521,0.7389036897604939,0.24598502572075445,0.015111284518751603,-140487,9736,7806,-122945,-0.023224924215120235,0.005424112886547863,0.017800811328572308,992995,-148293,0.4929186640397395,-0.04102573554369249
2908,17031,Cook,Illinois,2016,1611946,453287,115111,2180344,0.7393081091791021,0.207897010746928,0.05279488007396998,123409,84669,-42255,165823,0.00040441941860813735,0.03768359555521837,-0.03808801497382644,1158659,165664,0.531411098432174,0.03849243439243455
2909,17033,Crawford,Illinois,2000,3333,4974,193,8500,0.3921176470588235,0.5851764705882353,0.022705882352941176,0,0,0,0,0.0,0.0,0.0,-1641,0,-0.19305882352941178,0.0
2910,17033,Crawford,Illinois,2004,3194,6083,55,9332,0.3422631804543506,0.651843120445778,0.00589369909987141,-139,-138,1109,832,-0.0498544666044729,-0.016812183253069768,0.06666664985754267,-2889,-1248,-0.30957993999142736,-0.11652111646201557
2911,17033,Crawford,Illinois,2008,3883,5070,200,9153,0.42423249207909974,0.5539167486070141,0.021850759313886157,689,145,-1013,-179,0.08196931162474913,0.015957060214014746,-0.09792637183876385,-1187,1702,-0.12968425652791438,0.17989568346351298
2912,17033,Crawford,Illinois,2012,2858,5585,190,8633,0.33105525309857525,0.6469361751418974,0.022008571759527393,-1025,-10,515,-520,-0.09317723898052449,0.00015781244564123595,0.09301942653488326,-2727,-1540,-0.31588092204332213,-0.18619666551540776
2913,17033,Crawford,Illinois,2016,1992,6277,470,8739,0.22794370065224853,0.7182744021055041,0.0537818972422474,-866,280,692,106,-0.10311155244632672,0.03177332548272001,0.0713382269636067,-4285,-1558,-0.4903307014532555,-0.1744497794099334
2914,17035,Cumberland,Illinois,2000,1870,2964,141,4975,0.3758793969849246,0.5957788944723618,0.02834170854271357,0,0,0,0,0.0,0.0,0.0,-1094,0,-0.21989949748743715,0.0
2915,17035,Cumberland,Illinois,2004,1862,3497,57,5416,0.34379615952732645,0.6456794682422452,0.010524372230428361,-8,-84,533,441,-0.03208323745759817,-0.017817336312285208,0.04990057376988344,-1635,-541,-0.30188330871491875,-0.0819838112274816
2916,17035,Cumberland,Illinois,2008,2055,3156,128,5339,0.3849035399887619,0.5911219329462446,0.023974527064993444,193,71,-341,-77,0.04110738046143547,0.013450154834565083,-0.0545575352960006,-1101,534,-0.20621839295748268,0.09566491575743608
2917,17035,Cumberland,Illinois,2012,1641,3509,144,5294,0.3099735549678882,0.662825840574235,0.02720060445787684,-414,16,353,-45,-0.07492998502087372,0.0032260773928833968,0.0717039076279904,-1868,-767,-0.3528522856063468,-0.14663389264886412
2918,17035,Cumberland,Illinois,2016,1031,4206,334,5571,0.18506551786034822,0.7549811523963382,0.05995332974331359,-610,190,697,277,-0.12490803710753998,0.032752725285436754,0.09215531182210324,-3175,-1307,-0.56991563453599,-0.21706334892964324
2919,17037,DeKalb,Illinois,2000,14798,17139,1296,33233,0.4452802936839888,0.5157223241958294,0.038997382120181744,0,0,0,0,0.0,0.0,0.0,-2341,0,-0.07044203051184061,0.0
2920,17037,DeKalb,Illinois,2004,19263,21095,410,40768,0.47250294348508637,0.5174401491365777,0.01005690737833595,4465,-886,3956,7535,0.027222649801097565,-0.028940474741845794,0.001717824940748236,-1832,509,-0.044937205651491285,0.02550482486034933
2921,17037,DeKalb,Illinois,2008,25784,18266,924,44974,0.5733090229910615,0.40614577311335437,0.020545203895584115,6521,514,-2829,4206,0.10080607950597509,0.010488296517248166,-0.11129437602322328,7518,9350,0.1671632498777071,0.21210045552919837
2922,17037,DeKalb,Illinois,2012,21207,18934,1095,41236,0.5142836356581628,0.45916189737122903,0.026554466970608207,-4577,171,668,-3738,-0.05902538733289864,0.006009263075024092,0.053016124257874664,2273,-5245,0.055121738286933786,-0.1120415115907733
2923,17037,DeKalb,Illinois,2016,20466,19091,4043,43600,0.46940366972477066,0.43786697247706424,0.09272935779816514,-741,2948,157,2364,-0.04487996593339216,0.06617489082755694,-0.02129492489416479,1375,-898,0.03153669724770641,-0.023585041039227372
2924,17039,De Witt,Illinois,2000,2870,3968,213,7051,0.40703446319670966,0.5627570557367749,0.03020848106651539,0,0,0,0,0.0,0.0,0.0,-1098,0,-0.15572259254006526,0.0
2925,17039,De Witt,Illinois,2004,2836,4920,42,7798,0.3636829956399077,0.6309310079507566,0.005385996409335727,-34,-171,952,747,-0.04335146755680197,-0.024822484657179664,0.0681739522139817,-2084,-986,-0.26724801231084894,-0.11152541977078367
2926,17039,De Witt,Illinois,2008,3308,4348,175,7831,0.42242370067679735,0.5552292172136382,0.022347082109564553,472,133,-572,33,0.05874070503688966,0.016961085700228827,-0.07570179073711847,-1040,1044,-0.1328055165368408,0.13444249577400813
2927,17039,De Witt,Illinois,2012,2601,4579,187,7367,0.35306094746844036,0.6215555857201032,0.025383466811456496,-707,12,231,-464,-0.069362753208357,0.0030363847018919435,0.066326368506465,-1978,-938,-0.2684946382516628,-0.135689121714822
2928,17039,De Witt,Illinois,2016,1910,5077,569,7556,0.252779248279513,0.6719163578613023,0.07530439385918475,-691,382,498,189,-0.10028169918892738,0.049920927047728256,0.05036077214119916,-3167,-1189,-0.41913710958178935,-0.15064247133012654
2929,17041,Douglas,Illinois,2000,3215,4734,203,8152,0.3943817468105986,0.5807163886162905,0.02490186457311089,0,0,0,0,0.0,0.0,0.0,-1519,0,-0.18633464180569187,0.0
2930,17041,Douglas,Illinois,2004,2767,5702,71,8540,0.32400468384074943,0.6676814988290398,0.008313817330210773,-448,-132,968,388,-0.07037706296984919,-0.01658804724290012,0.08696511021274933,-2935,-1416,-0.3436768149882904,-0.15734217318259852
2931,17041,Douglas,Illinois,2008,3228,5005,146,8379,0.3852488363766559,0.5973266499582289,0.01742451366511517,461,75,-697,-161,0.06124415253590648,0.009110696334904397,-0.0703548488708109,-1777,1158,-0.21207781358157302,0.13159900140671738
2932,17041,Douglas,Illinois,2012,2430,5334,156,7920,0.3068181818181818,0.6734848484848485,0.019696969696969695,-798,10,329,-459,-0.07843065455847409,0.002272456031854525,0.07615819852661954,-2904,-1127,-0.36666666666666664,-0.15458885308509362
2933,17041,Douglas,Illinois,2016,1949,5698,548,8195,0.23782794386821232,0.6953020134228188,0.06687004270896889,-481,392,364,275,-0.0689902379499695,0.04717307301199919,0.021817164937970368,-3749,-845,-0.4574740695546065,-0.09080740288793987
2934,17043,DuPage,Illinois,2000,152550,201037,10775,364362,0.4186770299866616,0.5517507314154605,0.029572238597877935,0,0,0,0,0.0,0.0,0.0,-48487,0,-0.13307370142879887,0.0
2935,17043,DuPage,Illinois,2004,180097,218902,3447,402446,0.44750600080507696,0.5439288749298042,0.008565124265118799,27547,-7328,17865,38084,0.028828970818415345,-0.021007114332759137,-0.007821856485656253,-38805,9682,-0.09642287412472728,0.0366508273040716
2936,17043,DuPage,Illinois,2008,228698,183626,5649,417973,0.5471597447682027,0.4393250281716762,0.013515227060121109,48601,2202,-35276,15527,0.09965374396312576,0.00495010279500231,-0.10460384675812806,45072,83877,0.10783471659652655,0.20425759072125382
2937,17043,DuPage,Illinois,2012,199460,195046,6526,401032,0.4973667936723254,0.4863601907079734,0.01627301561970117,-29238,877,11420,-16941,-0.049792951095877336,0.0027577885595800617,0.04703516253629725,4414,-40658,0.011006602964351964,-0.09682811363217458
2938,17043,DuPage,Illinois,2016,228622,166415,35637,430674,0.530846997961335,0.38640595903165736,0.08274704300700762,29162,29111,-28631,29642,0.03348020428900966,0.06647402738730646,-0.09995423167631606,62207,57793,0.1444410389296777,0.13343443596532573
2939,17045,Edgar,Illinois,2000,3216,4833,183,8232,0.39067055393586003,0.5870991253644315,0.022230320699708456,0,0,0,0,0.0,0.0,0.0,-1617,0,-0.1964285714285715,0.0
2940,17045,Edgar,Illinois,2004,3093,5258,78,8429,0.36694744335033813,0.6237987898920394,0.009253766757622494,-123,-105,425,197,-0.0237231105855219,-0.012976553942085961,0.03669966452760787,-2165,-548,-0.2568513465417013,-0.06042277511312977
2941,17045,Edgar,Illinois,2008,3743,4398,143,8284,0.4518348623853211,0.530902945436987,0.017262192177691937,650,65,-860,-145,0.08488741903498298,0.008008425420069442,-0.09289584445505239,-655,1510,-0.0790680830516659,0.17778326349003537
2942,17045,Edgar,Illinois,2012,2565,5132,138,7835,0.32737715379706445,0.6550095724313976,0.01761327377153797,-1178,-5,734,-449,-0.12445770858825667,0.00035108159384603446,0.12410662699441055,-2567,-1912,-0.3276324186343331,-0.24856433558266722
2943,17045,Edgar,Illinois,2016,1793,5645,461,7899,0.22699075832383847,0.7146474237245221,0.05836181795163945,-772,323,513,64,-0.10038639547322598,0.04074854418010148,0.05963785129312449,-3852,-1285,-0.4876566654006836,-0.16002424676635046
2944,17047,Edwards,Illinois,2000,978,2212,70,3260,0.3,0.6785276073619632,0.02147239263803681,0,0,0,0,0.0,0.0,0.0,-1234,0,-0.37852760736196317,0.0
2945,17047,Edwards,Illinois,2004,930,2412,22,3364,0.27645659928656363,0.7170035671819263,0.006539833531510107,-48,-48,200,104,-0.023543400713436358,-0.014932559106526704,0.0384759598199631,-1482,-248,-0.44054696789536263,-0.06201936053339946
2946,17047,Edwards,Illinois,2008,1140,2137,85,3362,0.33908387864366446,0.6356335514574658,0.02528256989886972,210,63,-275,-2,0.06262727935710083,0.01874273636735961,-0.08137001572446045,-997,485,-0.29654967281380135,0.14399729508156128
2947,17047,Edwards,Illinois,2012,754,2405,69,3228,0.23358116480793062,0.7450433705080545,0.02137546468401487,-386,-16,268,-134,-0.10550271383573384,-0.00390710521485485,0.10940981905058866,-1651,-654,-0.5114622057001239,-0.21491253288632256
2948,17047,Edwards,Illinois,2016,434,2778,112,3324,0.1305655836341757,0.8357400722021661,0.03369434416365824,-320,43,373,96,-0.10301558117375492,0.012318879479643371,0.09069670169411159,-2344,-693,-0.7051744885679904,-0.19371228286786646
2949,17049,Effingham,Illinois,2000,4225,9855,405,14485,0.2916810493614084,0.6803589920607525,0.027959958577839145,0,0,0,0,0.0,0.0,0.0,-5630,0,-0.3886779426993441,0.0
2950,17049,Effingham,Illinois,2004,4388,11774,116,16278,0.26956628578449443,0.7233075316377934,0.00712618257771225,163,-289,1919,1793,-0.022114763576913943,-0.020833776000126897,0.04294853957704092,-7386,-1756,-0.45374124585329895,-0.06506330315395487
2951,17049,Effingham,Illinois,2008,5262,11323,295,16880,0.3117298578199052,0.6707938388625593,0.017476303317535545,874,179,-451,602,0.04216357203541077,0.010350120739823295,-0.0525136927752341,-6061,1325,-0.3590639810426541,0.09467726481064487
2952,17049,Effingham,Illinois,2012,3861,12501,249,16611,0.23243633736680513,0.7525735958100054,0.014990066823189452,-1401,-46,1178,-269,-0.07929352045310006,-0.002486236494346093,0.0817797569474461,-8640,-2579,-0.5201372584432002,-0.16107327740054617
2953,17049,Effingham,Illinois,2016,3083,13635,796,17514,0.17603060408815804,0.7785200411099692,0.04544935480187279,-778,547,1134,903,-0.05640573327864709,0.030459287978683337,0.025946445299963816,-10552,-1912,-0.6024894370218111,-0.08235217857861088
2954,17051,Fayette,Illinois,2000,3886,5200,252,9338,0.4161490683229814,0.5568644249303919,0.026986506746626688,0,0,0,0,0.0,0.0,0.0,-1314,0,-0.14071535660741052,0.0
2955,17051,Fayette,Illinois,2004,3571,5880,98,9549,0.3739658602995078,0.6157712849513038,0.010262854749188397,-315,-154,680,211,-0.042183208023473584,-0.01672365199743829,0.058906860020911944,-2309,-995,-0.24180542465179605,-0.10109006804438553
2956,17051,Fayette,Illinois,2008,3967,5499,242,9708,0.40863205603625874,0.5664400494437577,0.024927894519983517,396,144,-381,159,0.03466619573675095,0.01466503977079512,-0.049331235507546145,-1532,777,-0.15780799340749896,0.0839974312442971
2957,17051,Fayette,Illinois,2012,2853,5951,207,9011,0.31661302852069695,0.6604150482743314,0.0229719232049717,-1114,-35,452,-697,-0.09201902751556179,-0.001955971315011816,0.0939749988305737,-3098,-1566,-0.34380201975363445,-0.1859940263461355
2958,17051,Fayette,Illinois,2016,1819,7372,400,9591,0.189656970076113,0.768637264101762,0.04170576582212491,-1034,193,1421,580,-0.12695605844458394,0.018733842617153208,0.10822221582743063,-5553,-2455,-0.578980294025649,-0.23517827427201454
2959,17053,Ford,Illinois,2000,2090,3889,174,6153,0.33967170485941817,0.6320494067934341,0.028278888347147733,0,0,0,0,0.0,0.0,0.0,-1799,0,-0.29237770193401597,0.0
2960,17053,Ford,Illinois,2004,1912,4511,56,6479,0.2951072696403766,0.6962494212069764,0.008643309152647013,-178,-118,622,326,-0.044564435219041576,-0.01963557919450072,0.06420001441354228,-2599,-800,-0.4011421515665998,-0.10876444963258386
2961,17053,Ford,Illinois,2008,2227,4079,94,6400,0.34796875,0.63734375,0.0146875,315,38,-432,-79,0.0528614803596234,0.006044190847352986,-0.05890567120697643,-1852,747,-0.289375,0.11176715156659983
2962,17053,Ford,Illinois,2012,1656,4229,139,6024,0.2749003984063745,0.7020252324037185,0.02307436918990704,-571,45,150,-376,-0.07306835159362551,0.00838686918990704,0.06468148240371852,-2573,-721,-0.427124833997344,-0.13774983399734403
2963,17053,Ford,Illinois,2016,1414,4480,502,6396,0.2210756722951845,0.7004377736085053,0.0784865540963102,-242,363,251,372,-0.05382472611118999,0.05541218490640316,-0.0015874587952131591,-3066,-493,-0.47936210131332085,-0.05223726731597683
2964,17055,Franklin,Illinois,2000,10201,8490,521,19212,0.5309702269414949,0.4419113054341037,0.027118467624401416,0,0,0,0,0.0,0.0,0.0,1711,0,0.0890589215073912,0.0
2965,17055,Franklin,Illinois,2004,8816,10388,148,19352,0.4555601488218272,0.5367920628358825,0.007647788342290202,-1385,-373,1898,140,-0.07541007811966766,-0.019470679282111214,0.09488075740177887,-1572,-3283,-0.08123191401405533,-0.17029083552144653
2966,17055,Franklin,Illinois,2008,8880,9404,430,18714,0.47451106123757614,0.5025114887250187,0.022977450037405152,64,282,-984,-638,0.01895091241574892,0.01532966169511495,-0.034280574110863826,-524,1048,-0.02800042748744258,0.05323148652661275
2967,17055,Franklin,Illinois,2012,7254,10267,393,17914,0.40493468795355586,0.5731271631126493,0.021938148933794796,-1626,-37,863,-800,-0.06957637328402028,-0.0010393011036103558,0.07061567438763061,-3013,-2489,-0.16819247515909347,-0.1401920476716509
2968,17055,Franklin,Illinois,2016,4727,13116,868,18711,0.2526321415210304,0.7009780343113676,0.04638982416760194,-2527,475,2849,797,-0.15230254643252544,0.024451675233807146,0.1278508711987183,-8389,-5376,-0.4483458927903372,-0.28015341763124374
2969,17057,Fulton,Illinois,2000,8940,6936,401,16277,0.5492412606745715,0.42612274989248633,0.02463598943294219,0,0,0,0,0.0,0.0,0.0,2004,0,0.12311851078208513,0.0
2970,17057,Fulton,Illinois,2004,9080,7818,137,17035,0.5330202524214852,0.4589374816554153,0.008042265923099501,140,-264,882,758,-0.016221008253086255,-0.016593723509842687,0.032814731762928984,1262,-742,0.0740827707660699,-0.04903574001601524
2971,17057,Fulton,Illinois,2008,9732,6251,386,16369,0.5945384568391472,0.38188038365202515,0.02358115950882766,652,249,-1567,-666,0.06151820441766198,0.01553889358572816,-0.07705709800339017,3481,2219,0.21265807318712204,0.13857530242105215
2972,17057,Fulton,Illinois,2012,8328,6632,448,15408,0.5404984423676013,0.43042575285565937,0.029075804776739357,-1404,62,381,-961,-0.05404001447154594,0.005494645267911696,0.048545369203634225,1696,-1785,0.11007268951194188,-0.10258538367518016
2973,17057,Fulton,Illinois,2016,6133,8492,1172,15797,0.38823827308982717,0.5375704247641957,0.07419130214597708,-2195,724,1860,389,-0.15226016927777408,0.04511549736923772,0.10714467190853633,-2359,-4055,-0.14933215167436853,-0.2594048411863104
2974,17059,Gallatin,Illinois,2000,1878,1591,89,3558,0.5278246205733558,0.44716132658797075,0.02501405283867341,0,0,0,0,0.0,0.0,0.0,287,0,0.08066329398538502,0.0
2975,17059,Gallatin,Illinois,2004,1573,1619,33,3225,0.4877519379844961,0.5020155038759689,0.010232558139534883,-305,-56,28,-333,-0.040072682588859654,-0.014781494699138528,0.054854177287998185,-46,-333,-0.014263565891472818,-0.09492685987685784
2976,17059,Gallatin,Illinois,2008,1587,1212,73,2872,0.5525766016713092,0.4220055710306407,0.02541782729805014,14,40,-407,-353,0.06482466368681306,0.015185269158515258,-0.08000993284532826,375,421,0.1305710306406685,0.1448345965321413
2977,17059,Gallatin,Illinois,2012,1029,1492,49,2570,0.4003891050583658,0.5805447470817121,0.01906614785992218,-558,-24,280,-302,-0.1521874966129434,-0.00635167943812796,0.15853917605107143,-463,-838,-0.18015564202334633,-0.3107266726640148
2978,17059,Gallatin,Illinois,2016,657,1942,108,2707,0.2427041004802364,0.717399335057259,0.03989656446250462,-372,59,450,137,-0.15768500457812937,0.02083041660258244,0.13685458797554684,-1285,-822,-0.47469523457702256,-0.29453959255367623
2979,17061,Greene,Illinois,2000,2490,3129,148,5767,0.43176694988728975,0.5425697936535461,0.02566325645916421,0,0,0,0,0.0,0.0,0.0,-639,0,-0.11080284376625632,0.0
2980,17061,Greene,Illinois,2004,2457,3559,52,6068,0.40491100856954515,0.5865194462755439,0.008569545154911009,-33,-96,430,301,-0.026855941317744603,-0.0170937113042532,0.04394965262199779,-1102,-463,-0.18160843770599872,-0.0708055939397424
2981,17061,Greene,Illinois,2008,2619,3053,154,5826,0.44953656024716787,0.5240302094061106,0.026433230346721594,162,102,-506,-242,0.04462555167762272,0.017863685191810585,-0.06248923686943331,-434,668,-0.07449364915894269,0.10711478854705603
2982,17061,Greene,Illinois,2012,2023,3451,162,5636,0.3589425124201561,0.6123136976579134,0.028743789921930447,-596,8,398,-190,-0.09059404782701175,0.002310559575208853,0.08828348825180288,-1428,-994,-0.2533711852377573,-0.17887753607881463
2983,17061,Greene,Illinois,2016,1205,4145,235,5585,0.21575649059982094,0.7421665174574754,0.04207699194270367,-818,73,694,-51,-0.14318602182033519,0.013333202020773226,0.12985281979956198,-2940,-1512,-0.5264100268576545,-0.27303884161989717
2984,17063,Grundy,Illinois,2000,7516,8709,359,16584,0.45320791123974913,0.5251447178002895,0.021647370959961408,0,0,0,0,0.0,0.0,0.0,-1193,0,-0.07193680656054036,0.0
2985,17063,Grundy,Illinois,2004,8463,11198,170,19831,0.42675608895164135,0.564671473954919,0.008572437093439564,947,-189,2489,3247,-0.026451822288107774,-0.013074933866521844,0.03952675615462953,-2735,-1542,-0.13791538500327766,-0.0659785784427373
2986,17063,Grundy,Illinois,2008,11063,10687,482,22232,0.49761604893846706,0.48070349046419575,0.02168046059733717,2600,312,-511,2401,0.0708599599868257,0.013108023503897608,-0.08396798349072326,376,3111,0.01691255847427131,0.15482794347754897
2987,17063,Grundy,Illinois,2012,9451,11343,519,21313,0.44343827710786843,0.5322103880260873,0.024351334866044197,-1612,37,656,-919,-0.05417777183059863,0.0026708742687070255,0.051506897561891585,-1892,-2268,-0.0887721109182189,-0.10568466939249022
2988,17063,Grundy,Illinois,2016,8065,13454,1718,23237,0.34707578430950636,0.5789904032362181,0.07393381245427551,-1386,1199,2111,1924,-0.09636249279836206,0.04958247758823131,0.046780015210130754,-5389,-3497,-0.23191461892671172,-0.14314250800849282
2989,17065,Hamilton,Illinois,2000,1943,2519,125,4587,0.4235884020056682,0.5491606714628298,0.02725092653150207,0,0,0,0,0.0,0.0,0.0,-576,0,-0.12557226945716154,0.0
2990,17065,Hamilton,Illinois,2004,1814,2653,47,4514,0.40186087727071335,0.5877270713336287,0.010412051395657953,-129,-78,134,-73,-0.021727524734954873,-0.016838875135844117,0.038566399870798906,-839,-263,-0.18586619406291532,-0.06029392460575378
2991,17065,Hamilton,Illinois,2008,1796,2353,135,4284,0.419234360410831,0.5492530345471522,0.031512605042016806,-18,88,-300,-230,0.017373483140117663,0.021100553646358853,-0.03847403678647643,-557,282,-0.13001867413632123,0.05584751992659409
2992,17065,Hamilton,Illinois,2012,1269,2566,103,3938,0.3222447943118334,0.6515997968511935,0.026155408836973083,-527,-32,213,-346,-0.09698956609899761,-0.005357196205043723,0.10234676230404127,-1297,-740,-0.3293550025393601,-0.1993363284030389
2993,17065,Hamilton,Illinois,2016,802,3206,148,4156,0.1929740134744947,0.7714148219441771,0.0356111645813282,-467,45,640,218,-0.1292707808373387,0.009455755744355119,0.11981502509298358,-2404,-1107,-0.5784408084696824,-0.24908580593032226
2994,17067,Hancock,Illinois,2000,4256,5134,301,9691,0.43917036425549477,0.5297698895882778,0.031059746156227426,0,0,0,0,0.0,0.0,0.0,-878,0,-0.09059952533278298,0.0
2995,17067,Hancock,Illinois,2004,3975,5837,87,9899,0.40155571269825235,0.5896555207596726,0.008788766542074958,-281,-214,703,208,-0.03761465155724242,-0.022270979614152468,0.05988563117139489,-1862,-984,-0.1880998080614203,-0.09750028272863731
2996,17067,Hancock,Illinois,2008,4141,5161,167,9469,0.43732178688351464,0.5450417150702291,0.017636498046256204,166,80,-676,-430,0.03576607418526229,0.008847731504181246,-0.04461380568944351,-1020,842,-0.1077199281867145,0.0803798798747058
2997,17067,Hancock,Illinois,2012,3650,5271,189,9110,0.40065861690450055,0.5785949506037321,0.02074643249176729,-491,22,110,-359,-0.03666316997901409,0.0031099344455110846,0.03355323553350298,-1621,-601,-0.17793633369923156,-0.07021640551251707
2998,17067,Hancock,Illinois,2016,2139,6430,552,9121,0.23451375945619998,0.7049665606841355,0.06051967985966451,-1511,363,1159,11,-0.16614485744830057,0.039773247367897224,0.12637161008040343,-4291,-2670,-0.47045280122793554,-0.29251646752870397
2999,17069,Hardin,Illinois,2000,1184,1366,87,2637,0.44899507015547974,0.5180128934395146,0.03299203640500569,0,0,0,0,0.0,0.0,0.0,-182,0,-0.06901782328403488,0.0
3000,17069,Hardin,Illinois,2004,923,1501,13,2437,0.3787443578169881,0.6159212146081248,0.005334427574887156,-261,-74,135,-200,-0.07025071233849162,-0.027657608830118537,0.09790832116861015,-578,-396,-0.23717685679113665,-0.16815903350710176
3001,17069,Hardin,Illinois,2008,892,1330,40,2262,0.394341290893015,0.5879752431476569,0.01768346595932803,-31,27,-171,-175,0.015596933076026886,0.012349038384440873,-0.027945971460467844,-438,140,-0.19363395225464192,0.04354290453649473
3002,17069,Hardin,Illinois,2012,742,1535,53,2330,0.3184549356223176,0.6587982832618026,0.022746781115879827,-150,13,205,68,-0.07588635527069743,0.005063315156551798,0.07082304011414564,-793,-355,-0.340343347639485,-0.14670939538484307
3003,17069,Hardin,Illinois,2016,420,1653,75,2148,0.19553072625698323,0.7695530726256983,0.034916201117318434,-322,22,118,-182,-0.12292420936533435,0.012169420001438606,0.11075478936389571,-1233,-440,-0.5740223463687151,-0.2336789987292301
3004,17071,Henderson,Illinois,2000,2030,1708,128,3866,0.5250905328504915,0.44180031039834455,0.03310915675116399,0,0,0,0,0.0,0.0,0.0,322,0,0.0832902224521469,0.0
3005,17071,Henderson,Illinois,2004,2269,1857,27,4153,0.5463520346737298,0.44714664098242235,0.006501324343847821,239,-101,149,287,0.021261501823238382,-0.026607832407316172,0.005346330584077796,412,90,0.09920539369130749,0.015915171239160586
3006,17071,Henderson,Illinois,2008,2215,1541,73,3829,0.5784800208931836,0.402454949072865,0.01906503003395142,-54,46,-316,-324,0.032127986219453786,0.0125637056901036,-0.04469169190955735,674,262,0.17602507182031862,0.07681967812901114
3007,17071,Henderson,Illinois,2012,1978,1541,48,3567,0.5545276142416596,0.4320156994673395,0.01345668629100084,-237,-25,0,-262,-0.023952406651523983,-0.005608343742950581,0.029560750394474478,437,-237,0.12251191477432016,-0.05351315704599846
3008,17071,Henderson,Illinois,2016,1155,2155,208,3518,0.32831154064809553,0.6125639567936327,0.059124502558271744,-823,160,614,-49,-0.2262160735935641,0.0456678162672709,0.18054825732629326,-1000,-1437,-0.2842524161455372,-0.40676433091985736
3009,17073,Henry,Illinois,2000,11921,10896,653,23470,0.507925010651896,0.46425223689816786,0.027822752449936088,0,0,0,0,0.0,0.0,0.0,1025,0,0.043672773753728134,0.0
3010,17073,Henry,Illinois,2004,11877,13212,152,25241,0.4705439562616378,0.5234340953211045,0.0060219484172576365,-44,-501,2316,1771,-0.037381054390258184,-0.02180080403267845,0.05918185842293666,-1335,-2360,-0.05289013905946671,-0.09656291281319485
3011,17073,Henry,Illinois,2008,13181,11263,405,24849,0.5304438810414907,0.4532576763652461,0.01629844259326331,1304,253,-1949,-392,0.05989992477985284,0.010276494176005672,-0.07017641895585841,1918,3253,0.07718620467624454,0.13007634373571125
3012,17073,Henry,Illinois,2012,12332,11583,490,24405,0.5053062896947347,0.4746158574062692,0.020077852898996107,-849,85,320,-444,-0.025137591346755972,0.003779410305732797,0.021358181041023105,749,-1169,0.030690432288465463,-0.04649577238777908
3013,17073,Henry,Illinois,2016,8871,13985,1509,24365,0.36408783090498664,0.5739790683357274,0.06193310075928586,-3461,1019,2402,-40,-0.14121845878974804,0.041855247860289754,0.09936321092945821,-5114,-5863,-0.20989123743074078,-0.24058166971920625
3014,17075,Iroquois,Illinois,2000,4397,8685,342,13424,0.3275476758045292,0.6469755661501788,0.025476758045292015,0,0,0,0,0.0,0.0,0.0,-4288,0,-0.3194278903456496,0.0
3015,17075,Iroquois,Illinois,2004,3832,9914,89,13835,0.27697867726779907,0.7165883628478497,0.0064329598843512826,-565,-253,1229,411,-0.050568998536730136,-0.019043798160940734,0.06961279669767084,-6082,-1794,-0.4396096855800506,-0.12018179523440098
3016,17075,Iroquois,Illinois,2008,4643,8695,286,13624,0.34079565472695245,0.6382119788608338,0.02099236641221374,811,197,-1219,-211,0.06381697745915338,0.014559406527862459,-0.07837638398701585,-4052,2030,-0.29741632413388136,0.14219336144616923
3017,17075,Iroquois,Illinois,2012,3413,9120,276,12809,0.2664532750409868,0.7119993754391444,0.021547349519868843,-1230,-10,425,-815,-0.07434237968596563,0.0005549831076551021,0.07378739657831057,-5707,-1655,-0.44554610039815756,-0.1481297762642762
3018,17075,Iroquois,Illinois,2016,2504,9750,848,13102,0.19111586017401924,0.7441611967638528,0.06472294306212792,-909,572,630,293,-0.07533741486696757,0.043175593542259076,0.03216182132470846,-7246,-1539,-0.5530453365898336,-0.107499236191676
3019,17077,Jackson,Illinois,2000,11773,9823,1494,23090,0.5098744045041144,0.4254222607189259,0.06470333477695972,0,0,0,0,0.0,0.0,0.0,1950,0,0.08445214378518845,0.0
3020,17077,Jackson,Illinois,2004,14300,11190,336,25826,0.5537055680322156,0.433284287152482,0.013010144815302408,2527,-1158,1367,2736,0.043831163528101236,-0.05169318996165731,0.007862026433556102,3110,1160,0.12042128087973358,0.035969137094545134
3021,17077,Jackson,Illinois,2008,15248,9687,682,25617,0.595229730257251,0.37814732404262796,0.026622945700121012,948,346,-1503,-209,0.04152416222503541,0.013612800884818603,-0.055136963109854054,5561,2451,0.21708240621462305,0.09666112533488946
3022,17077,Jackson,Illinois,2012,13319,9864,905,24088,0.5529309199601461,0.409498505479907,0.03757057455994686,-1929,223,177,-1529,-0.042298810297104916,0.01094762885982585,0.03135118143727905,3455,-2106,0.14343241448023908,-0.07364999173438397
3023,17077,Jackson,Illinois,2016,11634,10843,2140,24617,0.4726002356095381,0.44046796928951537,0.08693179510094651,-1685,1235,979,529,-0.08033068435060797,0.049361220540999645,0.030969463809608355,791,-2664,0.03213226632002275,-0.11130014816021633
3024,17079,Jasper,Illinois,2000,1815,3119,87,5021,0.36148177653853814,0.6211909978092014,0.017327225652260504,0,0,0,0,0.0,0.0,0.0,-1304,0,-0.25970922127066326,0.0
3025,17079,Jasper,Illinois,2004,1781,3529,26,5336,0.3337706146926537,0.6613568215892054,0.004872563718140929,-34,-61,410,315,-0.027711161845884458,-0.012454661934119576,0.040165823780003995,-1748,-444,-0.3275862068965517,-0.06787698562588845
3026,17079,Jasper,Illinois,2008,2063,2964,115,5142,0.4012057565149747,0.5764294049008168,0.022364838584208478,282,89,-565,-194,0.06743514182232102,0.01749227486606755,-0.08492741668838855,-901,847,-0.17522364838584215,0.15236255851070957
3027,17079,Jasper,Illinois,2012,1436,3514,93,5043,0.2847511401943288,0.6968074558794368,0.018441403926234383,-627,-22,550,-99,-0.11645461632064591,-0.003923434657974095,0.12037805097861998,-2078,-1177,-0.41205631568510803,-0.2368326672992659
3028,17079,Jasper,Illinois,2016,924,3975,213,5112,0.1807511737089202,0.7775821596244131,0.041666666666666664,-512,120,461,69,-0.1039999664854086,0.02322526274043228,0.0807747037449763,-3051,-973,-0.596830985915493,-0.18477467023038496
3029,17081,Jefferson,Illinois,2000,6685,8362,313,15360,0.4352213541666667,0.5444010416666667,0.020377604166666667,0,0,0,0,0.0,0.0,0.0,-1677,0,-0.10917968750000001,0.0
3030,17081,Jefferson,Illinois,2004,6713,10160,75,16948,0.39609393438753837,0.5994807646919991,0.004425300920462592,28,-238,1798,1588,-0.039127419779128314,-0.015952303246204075,0.05507972302533237,-3447,-1770,-0.2033868303044607,-0.09420714280446069
3031,17081,Jefferson,Illinois,2008,7462,9302,457,17221,0.43330817025724405,0.5401544625747634,0.026537367167992567,749,382,-858,273,0.03721423586970568,0.022112066247529975,-0.05932630211723566,-1840,1607,-0.10684629231751935,0.09654053798694134
3032,17081,Jefferson,Illinois,2012,6089,9811,420,16320,0.37310049019607844,0.6011642156862745,0.025735294117647058,-1373,-37,509,-901,-0.060207680061165614,-0.0008020730503455094,0.061009753111511134,-3722,-1882,-0.2280637254901961,-0.12121743317267675
3033,17081,Jefferson,Illinois,2016,4425,11695,879,16999,0.2603094299664686,0.6879816459791752,0.05170892405435614,-1664,459,1884,679,-0.11279106022960983,0.025973629936709083,0.08681743029290068,-7270,-3548,-0.4276722160127066,-0.1996084905225105
3034,17083,Jersey,Illinois,2000,4355,4699,359,9413,0.4626580261340699,0.4992032295761181,0.03813874428981196,0,0,0,0,0.0,0.0,0.0,-344,0,-0.0365452034420482,0.0
3035,17083,Jersey,Illinois,2004,4597,5435,105,10137,0.4534872250172635,0.5361546808720529,0.010358094110683634,242,-254,736,724,-0.009170801116806404,-0.027780650179128327,0.036951451295934745,-838,-494,-0.08266745585478935,-0.04612225241274115
3036,17083,Jersey,Illinois,2008,5042,5329,244,10615,0.47498822421102216,0.5020254357041922,0.02298634008478568,445,139,-106,478,0.02150099919375864,0.012628245974102045,-0.034129245167860645,-287,551,-0.027037211493170066,0.055630244361619285
3037,17083,Jersey,Illinois,2012,3667,6039,295,10001,0.36666333366663334,0.6038396160383962,0.029497050294970503,-1375,51,710,-614,-0.10832489054438882,0.006510710210184824,0.10181418033420397,-2372,-2085,-0.23717628237176286,-0.2101390708785928
3038,17083,Jersey,Illinois,2016,2679,7748,564,10991,0.2437448821763261,0.7049404057865526,0.051314712037121284,-988,269,1709,990,-0.12291845149030725,0.02181766174215078,0.1011007897481564,-5069,-2697,-0.46119552361022653,-0.22401924123846367
3039,17085,Jo Daviess,Illinois,2000,4585,5304,433,10322,0.44419686107343537,0.5138539042821159,0.04194923464444875,0,0,0,0,0.0,0.0,0.0,-719,0,-0.06965704320868049,0.0
3040,17085,Jo Daviess,Illinois,2004,5311,6174,99,11584,0.4584772099447514,0.5329765193370166,0.008546270718232045,726,-334,870,1262,0.014280348871316018,-0.03340296392621671,0.01912261505490076,-863,-144,-0.07449930939226523,-0.0048422661835847425
3041,17085,Jo Daviess,Illinois,2008,6403,5170,177,11750,0.544936170212766,0.44,0.015063829787234043,1092,78,-1004,166,0.08645896026801458,0.006517559069001998,-0.09297651933701662,1233,2096,0.10493617021276597,0.1794354796050312
3042,17085,Jo Daviess,Illinois,2012,5667,5534,223,11424,0.4960609243697479,0.4844187675070028,0.0195203081232493,-736,46,364,-326,-0.048875245843018056,0.004456478336015257,0.0444187675070028,133,-1100,0.011642156862745112,-0.09329401335002085
3043,17085,Jo Daviess,Illinois,2016,4462,6121,751,11334,0.393682724545615,0.5400564672666314,0.06626080818775366,-1205,528,587,-90,-0.10237819982413293,0.046740500064504364,0.05563769975962857,-1659,-1792,-0.1463737427210164,-0.1580158995837615
3044,17087,Johnson,Illinois,2000,1928,3285,149,5362,0.3595673256247669,0.6126445356210369,0.027788138754196196,0,0,0,0,0.0,0.0,0.0,-1357,0,-0.25307720999627004,0.0
3045,17087,Johnson,Illinois,2004,1813,3997,55,5865,0.30912190963341857,0.6815004262574595,0.00937766410912191,-115,-94,712,503,-0.05044541599134833,-0.018410474645074285,0.06885589063642261,-2184,-827,-0.372378516624041,-0.11930130662777094
3046,17087,Johnson,Illinois,2008,1871,3912,131,5914,0.31636794048021644,0.6614812309773419,0.022150828542441665,58,76,-85,49,0.0072460308467978685,0.012773164433319755,-0.02001919528011764,-2041,143,-0.34511329049712547,0.02726522612691551
3047,17087,Johnson,Illinois,2012,1572,3963,158,5693,0.27612857895661336,0.6961180396978746,0.027753381345512033,-299,27,51,-221,-0.04023936152360308,0.005602552803070367,0.03463680872053265,-2391,-350,-0.4199894607412612,-0.07487617024413573
3048,17087,Johnson,Illinois,2016,1142,4649,298,6089,0.18755132205616687,0.7635079651831171,0.04894071276071604,-430,140,686,396,-0.08857725690044649,0.02118733141520401,0.06738992548524259,-3507,-1116,-0.5759566431269503,-0.15596718238568907
3049,17089,Kane,Illinois,2000,60127,76996,4282,141405,0.425211272585835,0.5445069127682897,0.030281814645875323,0,0,0,0,0.0,0.0,0.0,-16869,0,-0.11929564018245464,0.0
3050,17089,Kane,Illinois,2004,73813,92065,1419,167297,0.44120934625247316,0.5503087323741609,0.00848192137336593,13686,-2863,15069,25892,0.015998073666638135,-0.02179989327250939,0.005801819605871228,-18252,-1383,-0.10909938612168774,0.010196254060766907
3051,17089,Kane,Illinois,2008,106756,83963,2644,193363,0.5521014878751364,0.43422474827138596,0.013673763853477657,32943,1225,-8102,26066,0.1108921416226632,0.005191842480111727,-0.11608398410277493,22793,41045,0.11787673960375039,0.22697612572543813
3052,17089,Kane,Illinois,2012,90332,88335,3050,181717,0.4971026376178343,0.4861130218966855,0.016784340485480168,-16424,406,4372,-11646,-0.05499885025730206,0.0031105766320025114,0.05188827362529952,1997,-20796,0.010989615721148815,-0.10688712388260158
3053,17089,Kane,Illinois,2016,103665,82734,12915,199314,0.5201089737800656,0.4150937716367139,0.06479725458322044,13333,9865,-5601,17597,0.0230063361622313,0.04801291409774028,-0.07101925025997158,20931,18934,0.1050152021433517,0.09402558642220288
3054,17091,Kankakee,Illinois,2000,19180,20049,954,40183,0.4773162780280218,0.49894233879999006,0.023741383171988154,0,0,0,0,0.0,0.0,0.0,-869,0,-0.02162606077196827,0.0
3055,17091,Kankakee,Illinois,2004,20003,24739,294,45036,0.44415578648192555,0.5493161026734168,0.006528110844657607,823,-660,4690,4853,-0.03316049154609624,-0.017213272327330546,0.050373763873426736,-4736,-3867,-0.10516031619149124,-0.08353425541952297
3056,17091,Kankakee,Illinois,2008,24750,22527,861,48138,0.5141468278698741,0.46796709460301633,0.01788607752710956,4747,567,-2212,3102,0.06999104138794854,0.011357966682451953,-0.08134900807040046,2223,6959,0.04617973326685776,0.151340049458349
3057,17091,Kankakee,Illinois,2012,21595,23136,914,45645,0.47310767882572025,0.5068682221491949,0.020024099025084893,-3155,53,609,-2493,-0.041039149044153844,0.0021380214979753315,0.03890112754617858,-1541,-3764,-0.03376054332347467,-0.07994027659033243
3058,17091,Kankakee,Illinois,2016,18971,25129,3205,47305,0.4010358313074728,0.531212345418032,0.06775182327449529,-2624,2291,1993,1660,-0.07207184751824747,0.047727724249410394,0.02434412326883706,-6158,-4617,-0.1301765141105592,-0.09641597078708453
3059,17093,Kendall,Illinois,2000,8444,13688,637,22769,0.3708551100180069,0.6011682550836663,0.027976634898326674,0,0,0,0,0.0,0.0,0.0,-5244,0,-0.23031314506565942,0.0
3060,17093,Kendall,Illinois,2004,12497,19776,254,32527,0.384203892151136,0.6079872106250193,0.007808897223844806,4053,-383,6088,9758,0.013348782133129067,-0.020167737674481868,0.006818955541352922,-7279,-2035,-0.22378331847388327,0.0065298265917761444
3061,17093,Kendall,Illinois,2008,24742,21380,609,46731,0.5294558216173418,0.4575121439729516,0.013032034409706619,12245,355,1604,14204,0.14525192946620585,0.005223137185861813,-0.15047506665206767,3362,10641,0.07194367764439025,0.2957269961182735
3062,17093,Kendall,Illinois,2012,22471,24047,890,47408,0.4739917313533581,0.5072350658116773,0.018773202834964562,-2271,281,2667,677,-0.055464090263983745,0.005741168425257943,0.04972292183872573,-1576,-4938,-0.03324333445831923,-0.10518701210270948
3063,17093,Kendall,Illinois,2016,24884,24961,4210,54055,0.46034594394598094,0.4617704190176672,0.07788363703635186,2413,3320,914,6647,-0.013645787407377152,0.0591104342013873,-0.04546464679401013,-77,1499,-0.0014244750716862487,0.03181885938663298
3064,17095,Knox,Illinois,2000,12572,9912,690,23174,0.5425045309398464,0.42772072149823076,0.029774747561922846,0,0,0,0,0.0,0.0,0.0,2660,0,0.11478380944161565,0.0
3065,17095,Knox,Illinois,2004,13403,11111,194,24708,0.5424558847336894,0.449692407317468,0.00785170794884248,831,-496,1199,1534,-4.864620615696591e-05,-0.021923039613080366,0.021971685819237252,2292,-368,0.09276347741622143,-0.022020332025394218
3066,17095,Knox,Illinois,2008,14191,9419,488,24098,0.588887044568014,0.39086231222508094,0.020250643206905138,788,294,-1692,-610,0.046431159834324554,0.012398935258062658,-0.05883009509238707,4772,2480,0.19802473234293305,0.10526125492671162
3067,17095,Knox,Illinois,2012,13451,9408,497,23356,0.57591197122795,0.40280870011988357,0.021279328652166467,-740,9,-11,-742,-0.01297507334006398,0.0010286854452613292,0.011946387894802624,4043,-729,0.17310327110806645,-0.024921461234866604
3068,17095,Knox,Illinois,2016,10083,10737,1683,22503,0.44807359018797493,0.4771363818157579,0.07479002799626716,-3368,1186,1329,-853,-0.12783838103997508,0.053510699344100694,0.07432768169587434,-654,-4697,-0.02906279162778297,-0.20216606273584942
3069,17097,Lake,Illinois,2000,115058,120988,6118,242164,0.47512429593168265,0.4996118333030508,0.025263870765266514,0,0,0,0,0.0,0.0,0.0,-5930,0,-0.024487537371368162,0.0
3070,17097,Lake,Illinois,2004,134352,139081,1862,275295,0.48802920503459923,0.5052071414301023,0.006763653535298498,19294,-4256,18093,33131,0.012904909102916584,-0.018500217229968016,0.005595308127051446,-4729,1201,-0.017177936395503024,0.007309600975865138
3071,17097,Lake,Illinois,2008,177242,118545,4113,299900,0.5910036678892965,0.39528176058686226,0.013714571523841281,42890,2251,-20536,24605,0.10297446285469725,0.006950917988542783,-0.10992538084324,58697,63426,0.19572190730243422,0.21289984369793724
3072,17097,Lake,Illinois,2012,153757,129764,3953,287474,0.5348553260468772,0.4513938651843297,0.013750808768793005,-23485,-160,11219,-12426,-0.056148341842419236,3.623724495172356e-05,0.05611210459746746,23993,-34704,0.08346146086254752,-0.1122604464398867
3073,17097,Lake,Illinois,2016,171095,109767,22658,303520,0.5637025566684238,0.36164667896678965,0.0746507643647865,17338,18705,-19997,16046,0.028847230621546593,0.060899955595993496,-0.08974718621754008,61328,37335,0.2020558777016342,0.11859441683908667
3074,17099,LaSalle,Illinois,2000,23355,21276,1376,46007,0.5076401417175647,0.4624513660964636,0.0299084921859717,0,0,0,0,0.0,0.0,0.0,2079,0,0.045188775621101074,0.0
3075,17099,LaSalle,Illinois,2004,24263,26101,365,50729,0.4782865816396933,0.5145183228528061,0.007195095507500641,908,-1011,4825,4722,-0.029353560077871377,-0.02271339667847106,0.052066956756342486,-1838,-3917,-0.03623174121311279,-0.08142051683421386
3076,17099,LaSalle,Illinois,2008,27443,21872,995,50310,0.5454780361757106,0.4347445835817929,0.01977738024249652,3180,630,-4229,-419,0.06719145453601727,0.01258228473499588,-0.07977373927101317,5571,7409,0.11073345259391765,0.14696519380703044
3077,17099,LaSalle,Illinois,2012,23073,23256,1066,47395,0.4868235045890917,0.4906846713788374,0.022491824032070895,-4370,71,1384,-2915,-0.058654531586618874,0.002714443789574375,0.05594008779704451,-183,-5754,-0.0038611667897457402,-0.11459461938366339
3078,17099,LaSalle,Illinois,2016,19543,26689,3511,49743,0.39287940011659933,0.5365378043141749,0.07058279556922582,-3530,2445,3433,2348,-0.09394410447249235,0.04809097153715493,0.04585313293533744,-7146,-6963,-0.14365840419757553,-0.1397972374078298
3079,17101,Lawrence,Illinois,2000,2822,3594,162,6578,0.4290057768318638,0.5463666768014594,0.0246275463666768,0,0,0,0,0.0,0.0,0.0,-772,0,-0.11736089996959564,0.0
3080,17101,Lawrence,Illinois,2004,2518,4162,49,6729,0.37420121860603356,0.6185168672908308,0.007281914103135681,-304,-113,568,151,-0.05480455822583025,-0.01734563226354112,0.07215019048937132,-1644,-872,-0.24431564868479722,-0.12695474871520157
3081,17101,Lawrence,Illinois,2008,3016,3403,139,6558,0.4598963098505642,0.5189082037206465,0.021195486428789264,498,90,-759,-171,0.08569509124453062,0.013913572325653583,-0.09960866357018427,-387,1257,-0.05901189387008232,0.1853037548147149
3082,17101,Lawrence,Illinois,2012,2011,3857,121,5989,0.3357822674903991,0.6440140257138086,0.020203706795792285,-1005,-18,454,-569,-0.1241140423601651,-0.0009917796329969794,0.12510582199316211,-1846,-1459,-0.30823175822340954,-0.24921986435332721
3083,17101,Lawrence,Illinois,2016,1290,4521,247,6058,0.21294156487289534,0.7462859029382635,0.0407725321888412,-721,126,664,69,-0.12284070261750374,0.020568825393048915,0.10227187722445485,-3231,-1385,-0.5333443380653682,-0.22511257984195865
3084,17103,Lee,Illinois,2000,6111,8069,440,14620,0.4179890560875513,0.5519151846785225,0.030095759233926128,0,0,0,0,0.0,0.0,0.0,-1958,0,-0.1339261285909712,0.0
3085,17103,Lee,Illinois,2004,6416,9307,153,15876,0.40413202317964225,0.5862307886117409,0.00963718820861678,305,-287,1238,1256,-0.013857032907909073,-0.020458571025309347,0.03431560393321842,-2891,-933,-0.18209876543209869,-0.04817263684112749
3086,17103,Lee,Illinois,2008,7765,8258,334,16357,0.47472030323408937,0.5048603044568075,0.020419392309103137,1349,181,-1049,481,0.07058828005444712,0.010782204100486357,-0.08137048415493342,-493,2398,-0.03014000122271815,0.15195876420938054
3087,17103,Lee,Illinois,2012,6937,8059,346,15342,0.4521574762090992,0.5252900534480511,0.022552470342849695,-828,12,-199,-1015,-0.022562827024990184,0.0021330780337465577,0.020429748991243613,-1122,-629,-0.07313257723895195,-0.0429925760162338
3088,17103,Lee,Illinois,2016,5528,8612,1349,15489,0.3568984440570728,0.5560074891858738,0.08709406675705339,-1409,1003,553,147,-0.09525903215202641,0.06454159641420369,0.030717435737822707,-3084,-1962,-0.19910904512880107,-0.12597646788984912
3089,17105,Livingston,Illinois,2000,5829,9187,405,15421,0.37799105116399717,0.5957460605667596,0.02626288826924324,0,0,0,0,0.0,0.0,0.0,-3358,0,-0.21775500940276243,0.0
3090,17105,Livingston,Illinois,2004,5632,10316,91,16039,0.3511440862896689,0.6431822432820001,0.005673670428330943,-197,-314,1129,618,-0.02684696487432825,-0.020589217840912298,0.04743618271524053,-4684,-1326,-0.2920381569923312,-0.07428314758956878
3091,17105,Livingston,Illinois,2008,6189,9191,289,15669,0.3949837258280682,0.5865722126491799,0.01844406152275193,557,198,-1125,-370,0.043839639538399255,0.012770391094420987,-0.05661003063282022,-3002,1682,-0.19158848682111174,0.10044967017121947
3092,17105,Livingston,Illinois,2012,5020,9753,298,15071,0.3330900404750846,0.6471368854090638,0.019773074115851635,-1169,9,562,-598,-0.06189368535298356,0.0013290125930997057,0.060564672759883864,-4733,-1731,-0.31404684493397916,-0.12245835811286743
3093,17105,Livingston,Illinois,2016,4023,10208,1111,15342,0.2622213531482206,0.6653630556641899,0.07241559118758963,-997,813,455,271,-0.07086868732686402,0.05264251707173799,0.018226170255126073,-6185,-1452,-0.40314170251596926,-0.0890948575819901
3094,17107,Logan,Illinois,2000,4600,8141,324,13065,0.3520857252200536,0.623115193264447,0.024799081515499425,0,0,0,0,0.0,0.0,0.0,-3541,0,-0.2710294680443934,0.0
3095,17107,Logan,Illinois,2004,4273,9112,82,13467,0.3172941263830103,0.6766169154228856,0.006088958194104106,-327,-242,971,402,-0.0347915988370433,-0.01871012332139532,0.053501722158438625,-4839,-1298,-0.3593227890398753,-0.08829332099548193
3096,17107,Logan,Illinois,2008,5250,7429,262,12941,0.4056873502820493,0.5740669190943513,0.02024573062359941,977,180,-1683,-526,0.08839322389903898,0.014156772429495305,-0.10254999632853434,-2179,2660,-0.16837956881230198,0.19094322022757332
3097,17107,Logan,Illinois,2012,3978,7844,263,12085,0.32916839056681835,0.6490690939180803,0.021762515515101364,-1272,1,415,-856,-0.07651895971523093,0.0015167848915019523,0.07500217482372906,-3866,-1687,-0.319900703351262,-0.15152113453896
3098,17107,Logan,Illinois,2016,3313,8181,907,12401,0.2671558745262479,0.6597048625110878,0.0731392629626643,-665,644,337,316,-0.06201251604057045,0.051376747447562945,0.010635768593007522,-4868,-1002,-0.39254898798483995,-0.07264828463357798
3099,17109,McDonough,Illinois,2000,6080,6465,467,13012,0.467260989855518,0.49684906240393484,0.035889947740547185,0,0,0,0,0.0,0.0,0.0,-385,0,-0.029588072548416833,0.0
3100,17109,McDonough,Illinois,2004,7119,7656,154,14929,0.4768571237189363,0.5128273829459441,0.010315493335119566,1039,-313,1191,1917,0.009596133863418288,-0.02557445440542762,0.01597832054200926,-537,-152,-0.035970259227007806,-0.006382186678590973
3101,17109,McDonough,Illinois,2008,6783,6055,234,13072,0.5188953488372093,0.46320379436964504,0.017900856793145657,-336,80,-1601,-1857,0.04203822511827304,0.0075853634580260905,-0.04962358857629906,728,1265,0.0556915544675643,0.0916618136945721
3102,17109,McDonough,Illinois,2012,5967,6147,340,12454,0.4791231732776618,0.4935763610085113,0.027300465713826882,-816,106,92,-618,-0.03977217555954754,0.009399608920681226,0.030372566638866283,-180,-908,-0.014453187730849526,-0.07014474219841382
3103,17109,McDonough,Illinois,2016,5288,6795,1061,13144,0.4023128423615338,0.5169659160073037,0.08072124163116251,-679,721,648,690,-0.07681033091612799,0.05342077591733563,0.02338955499879236,-1507,-1327,-0.11465307364576988,-0.10019988591492035
3104,17111,McHenry,Illinois,2000,40698,62112,3375,106185,0.38327447379573387,0.584941375900551,0.03178415030371522,0,0,0,0,0.0,0.0,0.0,-21414,0,-0.20166690210481708,0.0
3105,17111,McHenry,Illinois,2004,50330,76412,1206,127948,0.39336292868978023,0.5972113671178917,0.009425704192328133,9632,-2169,14300,21763,0.010088454894046361,-0.022358446111387084,0.012269991217340737,-26082,-4668,-0.20384843842811146,-0.002181536323294375
3106,17111,McHenry,Illinois,2008,72288,64845,2499,139632,0.517703678239945,0.4643992781024407,0.0178970436576143,21958,1293,-11567,11684,0.12434074955016478,0.008471339465286169,-0.132812089015451,7443,33525,0.053304400137504315,0.25715283856561577
3107,17111,McHenry,Illinois,2012,59797,71598,2810,134205,0.4455646212883276,0.5334972616519503,0.020938117059722067,-12491,311,6753,-5427,-0.07213905695161743,0.0030410734021077655,0.06909798354950963,-11801,-19244,-0.08793264036362275,-0.14123704050112706
3108,17111,McHenry,Illinois,2016,60803,71612,11515,143930,0.4224484124227055,0.4975474188841798,0.0800041686931147,1006,8705,14,9725,-0.0231162088656221,0.05906605163339264,-0.03594984276777052,-10809,992,-0.07509900646147433,0.012833633902148422
3109,17113,McLean,Illinois,2000,24936,34008,1954,60898,0.4094715754211961,0.5584419849584551,0.03208643962034878,0,0,0,0,0.0,0.0,0.0,-9072,0,-0.14897040953725899,0.0
3110,17113,McLean,Illinois,2004,29877,41276,467,71620,0.41716001117006424,0.576319463836917,0.0065205249930187096,4941,-1487,7268,10722,0.007688435748868128,-0.025565914627330072,0.017877478878461917,-11399,-2327,-0.15915945266685277,-0.010189043129593789
3111,17113,McLean,Illinois,2008,37689,36767,1422,75878,0.49670523735470096,0.4845541527188381,0.0187406099264609,7812,955,-4509,4258,0.07954522618463672,0.01222008493344219,-0.0917653111180789,922,12321,0.012151084635862841,0.17131053730271562
3112,17113,McLean,Illinois,2012,31883,39947,1632,73462,0.43400669734012143,0.5437777354278402,0.02221556723203833,-5806,210,3180,-2416,-0.06269854001457953,0.003474957305577432,0.05922358270900213,-8064,-8986,-0.10977103808771882,-0.12192212272358166
3113,17113,McLean,Illinois,2016,36196,37237,7891,81324,0.4450838620825341,0.4578845113373666,0.09703162658009935,4313,6259,-2710,7862,0.01107716474241266,0.07481605934806101,-0.08589322409047367,-1041,7023,-0.012800649254832486,0.09697038883288633
3114,17115,Macon,Illinois,2000,24262,23830,1407,49499,0.49015131618820584,0.4814238671488313,0.028424816662962888,0,0,0,0,0.0,0.0,0.0,432,0,0.008727449039374557,0.0
3115,17115,Macon,Illinois,2004,23341,28118,287,51746,0.451068681637228,0.5433849959417153,0.0055463224210567,-921,-1120,4288,2247,-0.039082634550977824,-0.02287849424190619,0.06196112879288401,-4777,-5209,-0.09231631430448728,-0.10104376334386184
3116,17115,Macon,Illinois,2008,25487,24948,954,51389,0.49596217089260347,0.485473544922065,0.01856428418533149,2146,667,-3170,-357,0.04489348925537545,0.01301796176427479,-0.057911451019650284,539,5316,0.010488625970538457,0.10280494027502574
3117,17115,Macon,Illinois,2012,22780,25309,938,49027,0.4646419319966549,0.516225753156424,0.019132314846921083,-2707,-16,361,-2362,-0.03132023889594859,0.0005680306615895928,0.030752208234359035,-2529,-3068,-0.05158382115976917,-0.06207244713030763
3118,17115,Macon,Illinois,2016,18343,26866,2851,48060,0.38166874739908446,0.5590095713691219,0.05932168123179359,-4437,1913,1557,-967,-0.08297318459757042,0.04018936638487251,0.04278381821269783,-8523,-5994,-0.17734082397003742,-0.12575700281026825
3119,17117,Macoupin,Illinois,2000,11015,9749,625,21389,0.5149843377437,0.4557950348309879,0.029220627425312076,0,0,0,0,0.0,0.0,0.0,1266,0,0.05918930291271213,0.0
3120,17117,Macoupin,Illinois,2004,11193,11413,179,22785,0.4912442396313364,0.5008997147245995,0.007856045644064077,178,-446,1664,1396,-0.023740098112363606,-0.021364581781247997,0.04510467989361161,-220,-1486,-0.009655475093263088,-0.06884477800597522
3121,17117,Macoupin,Illinois,2008,12090,9891,462,22443,0.5386980350220558,0.44071648175377626,0.02058548322416789,897,283,-1522,-342,0.04745379539071942,0.012729437580103814,-0.06018323297082323,2199,2419,0.09798155326827956,0.10763702836154265
3122,17117,Macoupin,Illinois,2012,9464,10946,673,21083,0.4488924726082626,0.5191860740881279,0.03192145330360954,-2626,211,1055,-1360,-0.08980556241379323,0.011335970079441652,0.07846959233435163,-1482,-3681,-0.0702936014798653,-0.16827515474814486
3123,17117,Macoupin,Illinois,2016,6689,14322,1380,22391,0.2987360993256219,0.6396319949979903,0.061631905676387835,-2775,707,3376,1308,-0.1501563732826407,0.029710452372778293,0.12044592090986239,-7633,-6151,-0.3408958956723684,-0.2706022941925031
3124,17119,Madison,Illinois,2000,59077,48821,3206,111104,0.531727030529954,0.43941712269585254,0.028855846774193547,0,0,0,0,0.0,0.0,0.0,10256,0,0.09230990783410142,0.0
3125,17119,Madison,Illinois,2004,63399,59384,895,123678,0.5126133993111144,0.4801500671097527,0.00723653357913291,4322,-2311,10563,12574,-0.019113631218839577,-0.021619313195060635,0.040732944413900185,4015,-6241,0.03246333220136166,-0.05984657563273976
3126,17119,Madison,Illinois,2008,68979,57177,2534,128690,0.5360090139093947,0.44430025643018106,0.019690729660424275,5580,1639,-2207,5012,0.023395614598280323,0.012454196081291365,-0.03584981067957166,11802,7787,0.09170875747921364,0.05924542527785198
3127,17119,Madison,Illinois,2012,58922,60608,3339,122869,0.47955139213308484,0.4932733236210924,0.027175284245822787,-10057,805,3431,-5821,-0.05645762177630986,0.007484554585398512,0.048973067190911324,-1686,-13488,-0.013721931488007544,-0.10543068896722119
3128,17119,Madison,Illinois,2016,50587,70490,9102,130179,0.3885957028399358,0.5414851857826531,0.06991911137741111,-8335,5763,9882,7310,-0.09095568929314907,0.04274382713158832,0.04821186216156076,-19903,-18217,-0.15288948294271737,-0.13916755145470983
3129,17121,Marion,Illinois,2000,8068,8240,355,16663,0.4841865210346276,0.49450879193422553,0.02130468703114685,0,0,0,0,0.0,0.0,0.0,-172,0,-0.010322270899597918,0.0
3130,17121,Marion,Illinois,2004,7694,9413,117,17224,0.4467022758941013,0.5465048769159313,0.006792847189967487,-374,-238,1173,561,-0.03748424514052634,-0.014511839841179364,0.05199608498170577,-1719,-1547,-0.09980260102183003,-0.08948033012223211
3131,17121,Marion,Illinois,2008,8345,8691,374,17410,0.47932222860425044,0.49919586444572084,0.021481906950028717,651,257,-722,186,0.03261995271014917,0.01468905976006123,-0.047309012470210465,-346,1373,-0.019873635841470394,0.07992896518035963
3132,17121,Marion,Illinois,2012,6225,9248,345,15818,0.3935390061954735,0.58465039828044,0.021810595524086485,-2120,-29,557,-1592,-0.08578322240877695,0.0003286885740577672,0.08545453383471913,-3023,-2677,-0.19111139208496647,-0.17123775624349608
3133,17121,Marion,Illinois,2016,4369,11859,870,17098,0.25552696221780324,0.6935898935548017,0.05088314422739502,-1856,525,2611,1280,-0.13801204397767025,0.029072548703308533,0.10893949527436175,-7490,-4467,-0.4380629313369985,-0.246951539252032
3134,17123,Marshall,Illinois,2000,2570,3145,192,5907,0.4350770272557982,0.5324191637040799,0.03250380904012189,0,0,0,0,0.0,0.0,0.0,-575,0,-0.09734213644828171,0.0
3135,17123,Marshall,Illinois,2004,2806,3734,44,6584,0.4261846901579587,0.5671324422843257,0.006682867557715674,236,-148,589,677,-0.008892337097839542,-0.025820941482406212,0.034713278580245754,-928,-353,-0.140947752126367,-0.0436056156780853
3136,17123,Marshall,Illinois,2008,3081,3145,122,6348,0.4853497164461248,0.4954316320100819,0.01921865154379332,275,78,-589,-236,0.05916502628816611,0.012535783986077645,-0.0717008102742438,-64,864,-0.0100819155639571,0.1308658365624099
3137,17123,Marshall,Illinois,2012,2455,3290,122,5867,0.4184421339696608,0.5607635929776718,0.020794273052667463,-626,0,145,-481,-0.066907582476464,0.0015756215088741435,0.06533196096758986,-835,-771,-0.14232145900801096,-0.13223954344405386
3138,17123,Marshall,Illinois,2016,1789,3785,410,5984,0.2989639037433155,0.6325200534759359,0.06851604278074866,-666,288,495,117,-0.1194782302263453,0.0477217697280812,0.07175646049826412,-1996,-1161,-0.3335561497326204,-0.1912346907246094
3139,17125,Mason,Illinois,2000,3192,3411,169,6772,0.4713526284701713,0.5036916715888955,0.024955699940933256,0,0,0,0,0.0,0.0,0.0,-219,0,-0.03233904311872421,0.0
3140,17125,Mason,Illinois,2004,3215,3907,61,7183,0.4475845746902408,0.5439231518863984,0.008492273423360713,23,-108,496,411,-0.023768053779930465,-0.016463426517572544,0.0402314802975029,-692,-473,-0.09633857719615757,-0.06399953407743336
3141,17125,Mason,Illinois,2008,3542,3141,148,6831,0.5185185185185185,0.4598155467720685,0.02166593470941297,327,87,-766,-352,0.07093394382827767,0.013173661286052258,-0.08410760511432991,401,1093,0.058702971746450006,0.15504154894260758
3142,17125,Mason,Illinois,2012,2867,3265,164,6296,0.4553684879288437,0.5185832274459975,0.026048284625158832,-675,16,124,-535,-0.06315003058967478,0.004382349915745862,0.05876768067392901,-398,-799,-0.06321473951715378,-0.12191771126360379
3143,17125,Mason,Illinois,2016,2014,4058,421,6493,0.3101801940551363,0.6249807484983829,0.06483905744648083,-853,257,793,197,-0.1451882938737074,0.038790772821322,0.10639752105238542,-2044,-1646,-0.3148005544432466,-0.25158581492609283
3144,17127,Massac,Illinois,2000,2912,3676,156,6744,0.431791221826809,0.5450771055753262,0.023131672597864767,0,0,0,0,0.0,0.0,0.0,-764,0,-0.11328588374851717,0.0
3145,17127,Massac,Illinois,2004,2805,4578,41,7424,0.3778286637931034,0.6166487068965517,0.005522629310344827,-107,-115,902,680,-0.05396255803370559,-0.01760904328751994,0.07157160132122553,-1773,-1009,-0.2388200431034483,-0.12553415935493112
3146,17127,Massac,Illinois,2008,2693,4371,145,7209,0.3735608267443473,0.6063254265501457,0.020113746705507005,-112,104,-207,-215,-0.004267837048756107,0.014591117395162178,-0.01032328034640606,-1678,95,-0.23276459980579833,0.006055443297649954
3147,17127,Massac,Illinois,2012,2092,4278,122,6492,0.32224276032039434,0.6589648798521257,0.018792359827479975,-601,-23,-93,-717,-0.05131806642395298,-0.0013213868780270303,0.052639453301980055,-2186,-508,-0.33672211953173137,-0.10395751972593303
3148,17127,Massac,Illinois,2016,1558,4846,293,6697,0.2326414812602658,0.7236075854860385,0.04375093325369568,-534,171,568,205,-0.08960127906012855,0.024958573426215706,0.06464270563391283,-3288,-1102,-0.49096610422577275,-0.15424398469404138
3149,17129,Menard,Illinois,2000,2164,3862,176,6202,0.3489197033215092,0.6227023540793293,0.02837794259916156,0,0,0,0,0.0,0.0,0.0,-1698,0,-0.2737826507578201,0.0
3150,17129,Menard,Illinois,2004,2137,4408,29,6574,0.32506845147550956,0.6705202312138728,0.004411317310617584,-27,-147,546,372,-0.02385125184599962,-0.023966625288543975,0.04781787713454355,-2271,-573,-0.3454517797383633,-0.07166912898054317
3151,17129,Menard,Illinois,2008,2706,3672,99,6477,0.41778601204261234,0.5669291338582677,0.015284854099119963,569,70,-736,-97,0.09271756056710279,0.010873536788502378,-0.10359109735560512,-966,1305,-0.14914312181565537,0.1963086579227079
3152,17129,Menard,Illinois,2012,2100,3948,103,6151,0.3414079011542839,0.6418468541700536,0.016745244675662494,-606,4,276,-326,-0.07637811088832847,0.0014603905765425314,0.0749177203117859,-1848,-882,-0.3004389530157697,-0.15129583120011436
3153,17129,Menard,Illinois,2016,1817,4231,467,6515,0.27889485801995395,0.649424405218726,0.07168073676132003,-283,364,283,364,-0.06251304313432993,0.05493549208565754,0.007577551048672415,-2414,-566,-0.37052954719877207,-0.07009059418300234
3154,17131,Mercer,Illinois,2000,4400,3688,230,8318,0.5289733108920414,0.44337581149314736,0.02765087761481125,0,0,0,0,0.0,0.0,0.0,712,0,0.085597499398894,0.0
3155,17131,Mercer,Illinois,2004,4512,4405,57,8974,0.5027858257187431,0.4908624916425228,0.006351682638734121,112,-173,717,656,-0.026187485173298275,-0.02129919497607713,0.04748668014937546,107,-605,0.01192333407622026,-0.07367416532267373
3156,17131,Mercer,Illinois,2008,4887,3833,150,8870,0.5509582863585119,0.432130777903044,0.016910935738444193,375,93,-572,-104,0.048172460639768766,0.010559253099710071,-0.05873171373947883,1054,947,0.11882750845546786,0.1069041743792476
3157,17131,Mercer,Illinois,2012,4507,3876,183,8566,0.5261498949334579,0.45248657483072613,0.021363530235816018,-380,33,43,-304,-0.024808391425053977,0.004452594497371825,0.020355796927682135,631,-423,0.07366332010273174,-0.04516418835273611
3158,17131,Mercer,Illinois,2016,3071,4807,647,8525,0.36023460410557184,0.5638709677419355,0.07589442815249267,-1436,464,931,-41,-0.16591529082788603,0.05453089791667665,0.11138439291120933,-1736,-2367,-0.20363636363636362,-0.27729968373909536
3159,17133,Monroe,Illinois,2000,5797,7632,367,13796,0.42019425920556686,0.5532038271962888,0.02660191359814439,0,0,0,0,0.0,0.0,0.0,-1835,0,-0.13300956799072194,0.0
3160,17133,Monroe,Illinois,2004,6788,9468,114,16370,0.4146609651802077,0.5783750763591936,0.006963958460598656,991,-253,1836,2574,-0.005533294025359181,-0.019637955137545734,0.025171249162904807,-2680,-845,-0.16371411117898593,-0.03070454318826399
3161,17133,Monroe,Illinois,2008,7953,9881,295,18129,0.43868939268575213,0.5450383363671466,0.01627227094710133,1165,181,413,1759,0.02402842750554446,0.009308312486502674,-0.033336739992047004,-1928,752,-0.10634894368139447,0.05736516749759146
3162,17133,Monroe,Illinois,2012,6215,10888,388,17491,0.3553255960208107,0.6224915670916471,0.022182836887542166,-1738,93,1007,-638,-0.08336379666494143,0.005910565940440836,0.0774532307245005,-4673,-2745,-0.2671659710708364,-0.16081702738944192
3163,17133,Monroe,Illinois,2016,5535,12629,1190,19354,0.2859873927870208,0.6525266094864111,0.06148599772656815,-680,802,1741,1863,-0.06933820323378992,0.03930316083902599,0.030035042394763956,-7094,-2421,-0.36653921669939027,-0.09937324562855387
3164,17135,Montgomery,Illinois,2000,6542,6226,325,13093,0.4996563048957458,0.47552127090811885,0.02482242419613534,0,0,0,0,0.0,0.0,0.0,316,0,0.024135033987626953,0.0
3165,17135,Montgomery,Illinois,2004,5979,6851,100,12930,0.46241299303944317,0.5298530549110596,0.007733952049497293,-563,-225,625,-163,-0.03724331185630264,-0.017088472146638046,0.05433178400294075,-872,-1188,-0.06744006187161644,-0.0915750958592434
3166,17135,Montgomery,Illinois,2008,6491,6150,268,12909,0.5028274847005965,0.4764118057169417,0.02076070958246185,512,168,-701,-21,0.040414491661153296,0.013026757532964554,-0.05344124919411791,341,1213,0.026415678983654767,0.09385574085527121
3167,17135,Montgomery,Illinois,2012,5058,6776,351,12185,0.4151005334427575,0.5560935576528518,0.028805908904390644,-1433,83,626,-724,-0.08772695125783897,0.008045199321928796,0.07968175193591015,-1718,-2059,-0.14099302421009435,-0.16740870319374912
3168,17135,Montgomery,Illinois,2016,3504,8630,844,12978,0.26999537679149327,0.6649714902142086,0.06503313299429804,-1554,493,1854,793,-0.14510515665126422,0.036227224089907396,0.1088779325613568,-5126,-3408,-0.3949761134227154,-0.253983089212621
3169,17137,Morgan,Illinois,2000,5899,8058,377,14334,0.4115389981861309,0.5621598995395563,0.026301102274312822,0,0,0,0,0.0,0.0,0.0,-2159,0,-0.15062090135342537,0.0
3170,17137,Morgan,Illinois,2004,5650,9392,138,15180,0.37220026350461133,0.6187088274044796,0.00909090909090909,-249,-239,1334,846,-0.03933873468151955,-0.017210193183403732,0.05654892786492338,-3742,-1583,-0.2465085638998683,-0.09588766254644293
3171,17137,Morgan,Illinois,2008,7467,7591,336,15394,0.4850591139404963,0.49311420033779396,0.021826685721709756,1817,198,-1801,214,0.11285885043588495,0.012735776630800666,-0.12559462706668567,-124,3618,-0.008055086397297684,0.23845347750257062
3172,17137,Morgan,Illinois,2012,5806,7972,364,14142,0.4105501343515769,0.5637109319756753,0.025738933672747842,-1661,28,381,-1252,-0.07450897958891939,0.003912247951038086,0.07059673163788138,-2166,-2042,-0.15316079762409845,-0.14510571122680077
3173,17137,Morgan,Illinois,2016,4696,9076,1028,14800,0.3172972972972973,0.6132432432432432,0.06945945945945946,-1110,664,1104,658,-0.09325283705427961,0.043720525786711616,0.04953231126756785,-4380,-2214,-0.2959459459459459,-0.14278514832184747
3174,17139,Moultrie,Illinois,2000,2529,3058,138,5725,0.44174672489082967,0.5341484716157205,0.024104803493449782,0,0,0,0,0.0,0.0,0.0,-529,0,-0.09240174672489088,0.0
3175,17139,Moultrie,Illinois,2004,2388,4028,50,6466,0.36931642437364676,0.6229508196721312,0.007732755954222085,-141,-88,970,741,-0.07243030051718291,-0.016372047539227698,0.08880234805641063,-1640,-1111,-0.2536343952984844,-0.16123264857359354
3176,17139,Moultrie,Illinois,2008,2668,3471,134,6273,0.42531484138370795,0.553323768531803,0.02136139008448908,280,84,-557,-193,0.0559984170100612,0.013628634130266996,-0.06962705114032819,-803,837,-0.12800892714809503,0.12562546815038939
3177,17139,Moultrie,Illinois,2012,2144,3784,147,6075,0.3529218106995885,0.622880658436214,0.02419753086419753,-524,13,313,-198,-0.07239303068411945,0.0028361407797084515,0.069556889904411,-1640,-837,-0.2699588477366255,-0.14194992058853045
3178,17139,Moultrie,Illinois,2016,1481,4455,347,6283,0.23571542256883654,0.7090561833519019,0.0552283940792615,-663,200,671,208,-0.11720638813075196,0.03103086321506397,0.08617552491568792,-2974,-1334,-0.47334076078306536,-0.20338191304643988
3179,17141,Ogle,Illinois,2000,7673,12325,603,20601,0.3724576476870055,0.5982719285471579,0.02927042376583661,0,0,0,0,0.0,0.0,0.0,-4652,0,-0.22581428086015243,0.0
3180,17141,Ogle,Illinois,2004,9018,14918,155,24091,0.37433066290315886,0.6192353991117014,0.006433937985139679,1345,-448,2593,3490,0.0018730152161533509,-0.02283648578069693,0.020963470564543507,-5900,-1248,-0.24490473620854258,-0.019090455348390156
3181,17141,Ogle,Illinois,2008,11253,13144,537,24934,0.4513114622603674,0.527151680436352,0.02153685730328066,2235,382,-1774,843,0.07698079935720853,0.015102919318140982,-0.09208371867534948,-1891,4009,-0.07584021817598458,0.169064518032558
3182,17141,Ogle,Illinois,2012,9514,13422,430,23366,0.40717281520157494,0.5744243773003509,0.018402807498074124,-1739,-107,278,-1568,-0.044138647058792446,-0.0031340498052065367,0.04727269686399893,-3908,-2017,-0.16725156209877595,-0.09141134392279138
3183,17141,Ogle,Illinois,2016,8050,14352,1791,24193,0.33274087545984377,0.5932294465341215,0.0740296780060348,-1464,1361,930,827,-0.07443193974173118,0.055626870507960675,0.018805069233770566,-6302,-2394,-0.2604885710742777,-0.09323700897550175
3184,17143,Peoria,Illinois,2000,38604,36398,1810,76812,0.5025777222309015,0.4738582513148987,0.023564026454199864,0,0,0,0,0.0,0.0,0.0,2206,0,0.028719470916002743,0.0
3185,17143,Peoria,Illinois,2004,41121,41051,599,82771,0.49680443633639804,0.49595872950671127,0.0072368341568906985,2517,-1211,4653,5959,-0.005773285894503433,-0.016327192297309164,0.022100478191812545,70,-2136,0.0008457068296867654,-0.027873764086315977
3186,17143,Peoria,Illinois,2008,45906,34579,1219,81704,0.5618574366004112,0.4232228532262802,0.014919710173308528,4785,620,-6472,-1067,0.06505300026401317,0.00768287601641783,-0.07273587628043104,11327,11257,0.13863458337413098,0.13778887654444422
3187,17143,Peoria,Illinois,2012,40209,36774,1398,78381,0.5129942205381406,0.4691698243196693,0.017835955142190073,-5697,179,2195,-3323,-0.04886321606227062,0.0029162449688815446,0.04594697109338908,3435,-7892,0.043824396218471284,-0.0948101871556597
3188,17143,Peoria,Illinois,2016,38060,35633,5409,79102,0.4811509190665217,0.4504690146898941,0.06838006624358424,-2149,4011,-1141,721,-0.0318433014716189,0.05054411110139417,-0.018700809629775217,2427,-1008,0.0306819043766276,-0.013142491841843684
3189,17145,Perry,Illinois,2000,4862,4802,278,9942,0.48903641118487223,0.48300140816737075,0.02796218064775699,0,0,0,0,0.0,0.0,0.0,60,0,0.0060350030175014835,0.0
3190,17145,Perry,Illinois,2004,4770,5589,66,10425,0.45755395683453237,0.5361151079136691,0.006330935251798561,-92,-212,787,483,-0.03148245435033986,-0.02163124539595843,0.05311369974629837,-819,-879,-0.07856115107913675,-0.08459615409663823
3191,17145,Perry,Illinois,2008,4701,5086,208,9995,0.4703351675837919,0.5088544272136069,0.0208104052026013,-69,142,-503,-430,0.01278121074925953,0.01447946995080274,-0.027260680700062268,-385,434,-0.03851925962981495,0.0400418914493218
3192,17145,Perry,Illinois,2012,3819,5507,223,9549,0.39993716619541314,0.576709603099801,0.02335323070478584,-882,15,421,-446,-0.07039800138837876,0.002542825502184539,0.06785517588619416,-1688,-1303,-0.17677243690438788,-0.13825317727457292
3193,17145,Perry,Illinois,2016,2462,6855,557,9874,0.24934170548916346,0.6942475187360745,0.056410775774762,-1357,334,1348,325,-0.15059546070624968,0.03305754506997616,0.11753791563627347,-4393,-2705,-0.44490581324691103,-0.26813337634252316
3194,17147,Piatt,Illinois,2000,3488,4619,278,8385,0.4159809183064997,0.5508646392367322,0.03315444245676804,0,0,0,0,0.0,0.0,0.0,-1131,0,-0.13488372093023254,0.0
3195,17147,Piatt,Illinois,2004,3124,5392,70,8586,0.36384812485441415,0.6279990682506406,0.00815280689494526,-364,-208,773,201,-0.052132793452085546,-0.025001635561822777,0.07713442901390832,-2268,-1137,-0.2641509433962264,-0.12926722246599387
3196,17147,Piatt,Illinois,2008,3859,4991,168,9018,0.42792193390995786,0.5534486582390774,0.018629407850964737,735,98,-401,432,0.06407380905554372,0.010476600956019476,-0.07455041001156315,-1132,1136,-0.12552672432911954,0.13862421906710687
3197,17147,Piatt,Illinois,2012,3090,5413,239,8742,0.3534660260809883,0.6191946922900938,0.02733928162891787,-769,71,422,-276,-0.07445590782896955,0.008709873777953132,0.06574603405101642,-2323,-1191,-0.2657286662091055,-0.14020194187998597
3198,17147,Piatt,Illinois,2016,2645,5634,781,9060,0.29194260485651213,0.6218543046357616,0.08620309050772627,-445,542,221,318,-0.06152342122447618,0.058863808878808405,0.0026596123456678056,-2989,-666,-0.3299116997792495,-0.06418303357014399
3199,17149,Pike,Illinois,2000,3198,4706,208,8112,0.3942307692307692,0.5801282051282052,0.02564102564102564,0,0,0,0,0.0,0.0,0.0,-1508,0,-0.18589743589743596,0.0
3200,17149,Pike,Illinois,2004,2849,5032,99,7980,0.3570175438596491,0.6305764411027569,0.012406015037593985,-349,-109,326,-132,-0.037213225371120096,-0.013235010603431656,0.050448235974551725,-2183,-675,-0.2735588972431078,-0.08766146134567182
3201,17149,Pike,Illinois,2008,3024,4457,162,7643,0.39565615595970166,0.5831479785424571,0.021195865497841162,175,63,-575,-337,0.03863861210005254,0.008789850460247177,-0.047428462560299756,-1433,750,-0.18749182258275549,0.0860670746603523
3202,17149,Pike,Illinois,2012,2278,4860,163,7301,0.312012053143405,0.6656622380495822,0.022325708807012738,-746,1,403,-342,-0.08364410281629664,0.0011298433091715757,0.0825142595071251,-2582,-1149,-0.3536501849061772,-0.16615836232342174
3203,17149,Pike,Illinois,2016,1413,5754,363,7530,0.18764940239043826,0.7641434262948207,0.04820717131474104,-865,200,894,229,-0.12436265075296676,0.0258814625077283,0.09848118824523844,-4341,-1759,-0.5764940239043824,-0.2228438389982052
3204,17151,Pope,Illinois,2000,927,1346,57,2330,0.39785407725321886,0.5776824034334764,0.024463519313304722,0,0,0,0,0.0,0.0,0.0,-419,0,-0.17982832618025757,0.0
3205,17151,Pope,Illinois,2004,918,1500,18,2436,0.3768472906403941,0.6157635467980296,0.007389162561576354,-9,-39,154,106,-0.02100678661282479,-0.017074356751728366,0.03808114336455315,-582,-163,-0.2389162561576355,-0.05908792997737794
3206,17151,Pope,Illinois,2008,845,1343,43,2231,0.3787539220080681,0.601972209771403,0.01927386822052891,-73,25,-157,-205,0.0019066313676740498,0.011884705658952556,-0.013791337026626604,-498,84,-0.22321828776333486,0.015697968394300654
3207,17151,Pope,Illinois,2012,650,1512,59,2221,0.2926609635299415,0.6807744259342638,0.02656461053579469,-195,16,169,-10,-0.08609295847812665,0.007290742315265778,0.07880221616286087,-862,-364,-0.3881134624043224,-0.16489517464098752
3208,17151,Pope,Illinois,2016,375,1678,89,2142,0.17507002801120447,0.7833800186741363,0.041549953314659195,-275,30,166,-79,-0.117590935518737,0.014985342778864506,0.10260559273987246,-1303,-441,-0.6083099906629319,-0.22019652825860953
3209,17153,Pulaski,Illinois,2000,1518,1430,68,3016,0.503315649867374,0.47413793103448276,0.022546419098143235,0,0,0,0,0.0,0.0,0.0,88,0,0.02917771883289122,0.0
3210,17153,Pulaski,Illinois,2004,1372,1720,16,3108,0.44144144144144143,0.5534105534105535,0.005148005148005148,-146,-52,290,92,-0.06187420842593255,-0.017398413950138088,0.07927262237607069,-348,-436,-0.11196911196911202,-0.14114683080200324
3211,17153,Pulaski,Illinois,2008,1638,1593,39,3270,0.5009174311926605,0.4871559633027523,0.011926605504587157,266,23,-127,162,0.059475989751219094,0.006778600356582009,-0.06625459010780116,45,393,0.01376146788990823,0.12573057985902025
3212,17153,Pulaski,Illinois,2012,1389,1564,59,3012,0.46115537848605576,0.5192563081009296,0.019588313413014608,-249,20,-29,-258,-0.03976205270660477,0.0076617079084274516,0.032100344798177305,-175,-220,-0.05810092961487384,-0.07186239750478207
3213,17153,Pulaski,Illinois,2016,962,1675,98,2735,0.3517367458866545,0.6124314442413162,0.035831809872029254,-427,39,111,-277,-0.10941863259940127,0.016243496459014645,0.09317513614038664,-713,-538,-0.26069469835466175,-0.2025937687397879
3214,17155,Putnam,Illinois,2000,1657,1437,85,3179,0.5212330921673483,0.4520289399182133,0.026737967914438502,0,0,0,0,0.0,0.0,0.0,220,0,0.06920415224913495,0.0
3215,17155,Putnam,Illinois,2004,1704,1623,25,3352,0.5083532219570406,0.48418854415274465,0.007458233890214797,47,-60,186,173,-0.012879870210307676,-0.019279734024223706,0.03215960423453135,81,-139,0.02416467780429593,-0.04503947444483902
3216,17155,Putnam,Illinois,2008,1900,1378,64,3342,0.5685218432076601,0.412327947336924,0.019150209455415918,196,39,-245,-10,0.0601686212506195,0.011691975565201122,-0.07186059681582063,522,441,0.15619389587073607,0.13202921806644013
3217,17155,Putnam,Illinois,2012,1559,1502,82,3143,0.4960229080496341,0.47788736875596566,0.026089723194400255,-341,18,124,-199,-0.07249893515802597,0.006939513738984337,0.06555942141904164,57,-465,0.018135539293668457,-0.1380583565770676
3218,17155,Putnam,Illinois,2016,1147,1767,198,3112,0.368573264781491,0.5678020565552699,0.06362467866323908,-412,116,265,-31,-0.12744964326814312,0.037534955468838824,0.08991468779930428,-620,-677,-0.19922879177377895,-0.2173643310674474
3219,17157,Randolph,Illinois,2000,6794,7127,366,14287,0.4755372016518513,0.49884510394064535,0.025617694407503326,0,0,0,0,0.0,0.0,0.0,-333,0,-0.023307902288794036,0.0
3220,17157,Randolph,Illinois,2004,6771,8076,109,14956,0.4527280021396095,0.5399839529285906,0.007288044931799947,-23,-257,949,669,-0.022809199512241807,-0.01832964947570338,0.04113884898794523,-1305,-972,-0.08725595078898107,-0.06394804850018704
3221,17157,Randolph,Illinois,2008,7395,7538,269,15202,0.48644915142744377,0.4958558084462571,0.01769504012629917,624,160,-538,246,0.03372114928783426,0.010406995194499224,-0.04412814448233349,-143,1162,-0.009406657018813325,0.07784929377016775
3222,17157,Randolph,Illinois,2012,5759,8290,389,14438,0.3988779609364178,0.5741792492034908,0.026942789860091427,-1636,120,752,-764,-0.08757119049102596,0.009247749733792256,0.07832344075723374,-2531,-2388,-0.17530128826707303,-0.1658946312482597
3223,17157,Randolph,Illinois,2016,3439,10023,732,14194,0.24228547273495843,0.7061434408905172,0.05157108637452445,-2320,343,1733,-244,-0.15659248820145938,0.02462829651443302,0.13196419168702633,-6584,-4053,-0.46385796815555874,-0.2885566798884857
3224,17159,Richland,Illinois,2000,2491,4718,219,7428,0.3353527194399569,0.6351642434033388,0.02948303715670436,0,0,0,0,0.0,0.0,0.0,-2227,0,-0.29981152396338184,0.0
3225,17159,Richland,Illinois,2004,2529,5153,67,7749,0.32636469221835074,0.6649890308426893,0.008646276938959866,38,-152,435,321,-0.008988027221606187,-0.020836760217744495,0.029824787439350575,-2624,-397,-0.3386243386243386,-0.03881281466095676
3226,17159,Richland,Illinois,2008,3181,4329,163,7673,0.4145705721360615,0.5641861071288935,0.021243320735044962,652,96,-824,-76,0.08820587991771078,0.012597043796085096,-0.10080292371379584,-1148,1476,-0.14961553499283198,0.18900880363150663
3227,17159,Richland,Illinois,2012,2362,4756,164,7282,0.32436143916506455,0.653117275473771,0.022521285361164517,-819,1,427,-391,-0.09020913297099697,0.001277964626119555,0.08893116834487746,-2394,-1246,-0.3287558363087064,-0.17914030131587444
3228,17159,Richland,Illinois,2016,1584,5739,326,7649,0.20708589358086024,0.7502941560988364,0.04261995032030331,-778,162,983,367,-0.1172755455842043,0.02009866495913879,0.09717688062506546,-4155,-1761,-0.5432082625179762,-0.21445242620926974
3229,17161,Rock Island,Illinois,2000,37957,25194,1944,65095,0.5831016207081957,0.38703433443428836,0.02986404485751594,0,0,0,0,0.0,0.0,0.0,12763,0,0.19606728627390735,0.0
3230,17161,Rock Island,Illinois,2004,39880,29663,429,69972,0.5699422626193335,0.4239267135425599,0.006131023838106671,1923,-1515,4469,4877,-0.01315935808886226,-0.02373302101940927,0.036892379108271534,10217,-2546,0.14601554907677355,-0.050051737197133794
3231,17161,Rock Island,Illinois,2008,42210,25364,1034,68608,0.615234375,0.3696944962686567,0.015071128731343284,2330,605,-4299,-1364,0.04529211238066655,0.008940104893236614,-0.054232217273903205,16846,6629,0.2455398787313433,0.09952432965456975
3232,17161,Rock Island,Illinois,2012,39157,24934,1118,65209,0.6004845956846447,0.3823705316750755,0.017144872640279717,-3053,84,-430,-3399,-0.01474977931535526,0.0020737439089364325,0.012676035406418817,14223,-2623,0.21811406400956923,-0.027425814721774078
3233,17161,Rock Island,Illinois,2016,32298,26998,4698,63994,0.5047035659593087,0.4218833015595212,0.07341313248117011,-6859,3580,2064,-1215,-0.09578102972533609,0.05626825984089039,0.039512769884445686,5300,-8923,0.08282026439978746,-0.13529379960978177
3234,17163,St. Clair,Illinois,2000,55961,42299,2133,100393,0.5574193419859951,0.4213341567639178,0.021246501250087157,0,0,0,0,0.0,0.0,0.0,13662,0,0.1360851852220773,0.0
3235,17163,St. Clair,Illinois,2004,62410,50203,576,113189,0.5513786675383651,0.4435324987410437,0.005088833720591224,6449,-1557,7904,12796,-0.006040674447630012,-0.016157667529495934,0.022198341977125946,12207,-1455,0.10784616879732134,-0.02823901642475596
3236,17163,St. Clair,Illinois,2008,76160,47958,1936,126054,0.6041855077982452,0.3804559950497406,0.015358497152014216,13750,1360,-2245,12865,0.05280684025988014,0.010269663431422993,-0.06307650369130313,28202,15995,0.2237295127485046,0.11588334395118327
3237,17163,St. Clair,Illinois,2012,67285,50125,2403,119813,0.5615834675702971,0.41836027810003923,0.020056254329663726,-8875,467,2167,-6241,-0.04260204022794811,0.00469775717764951,0.03790428305029864,17160,-11042,0.14322318947025786,-0.08050632327824675
3238,17163,St. Clair,Illinois,2016,60756,53857,6823,121436,0.500312922033005,0.44350110346190585,0.0561859745050891,-6529,4420,3732,1623,-0.061270545537292054,0.03612972017542537,0.025140825361866626,6899,-10261,0.05681181857109918,-0.08641137089915868
3239,17165,Saline,Illinois,2000,5427,5933,290,11650,0.46583690987124465,0.5092703862660944,0.024892703862660945,0,0,0,0,0.0,0.0,0.0,-506,0,-0.04343347639484979,0.0
3240,17165,Saline,Illinois,2004,4697,7057,60,11814,0.39757914338919925,0.5973421364482817,0.005078720162519045,-730,-230,1124,164,-0.0682577664820454,-0.0198139837001419,0.08807175018218727,-2360,-1854,-0.19976299305908246,-0.15632951666423267
3241,17165,Saline,Illinois,2008,5083,6099,294,11476,0.4429243638898571,0.5314569536423841,0.0256186824677588,386,234,-958,-338,0.04534522050065787,0.020539962305239755,-0.06588518280589761,-1016,1344,-0.08853258975252698,0.11123040330655548
3242,17165,Saline,Illinois,2012,3701,6806,213,10720,0.34524253731343285,0.6348880597014925,0.019869402985074627,-1382,-81,707,-756,-0.09768182657642427,-0.005749279482684173,0.10343110605910844,-3105,-2089,-0.2896455223880597,-0.2011129326355327
3243,17165,Saline,Illinois,2016,2572,8276,536,11384,0.22593113141250878,0.7269852424455376,0.04708362614195362,-1129,323,1470,664,-0.11931140590092407,0.02721422315687899,0.0920971827440451,-5704,-2599,-0.5010541110330289,-0.2114085886449692
3244,17167,Sangamon,Illinois,2000,38414,50374,2697,91485,0.419893971689348,0.5506257856479204,0.029480242662731596,0,0,0,0,0.0,0.0,0.0,-11960,0,-0.13073181395857242,0.0
3245,17167,Sangamon,Illinois,2004,38630,55904,841,95375,0.40503276539973787,0.5861494102228048,0.008817824377457406,216,-1856,5530,3890,-0.01486120628961013,-0.020662418285274188,0.03552362457488434,-17274,-5314,-0.18111664482306689,-0.05038483086449447
3246,17167,Sangamon,Illinois,2008,51300,46945,1861,100106,0.5124567957964558,0.4689529099154896,0.018590294288054664,12670,1020,-8959,4731,0.10742403039671788,0.009772469910597258,-0.11719650030731515,4355,21629,0.04350388588096615,0.22462053070403304
3247,17167,Sangamon,Illinois,2012,42107,50225,1949,94281,0.4466117245256202,0.532716029740881,0.020672245733498795,-9193,88,3280,-5825,-0.06584507127083555,0.0020819514454441315,0.06376311982539135,-8118,-12473,-0.08610430521526075,-0.1296081910962269
3248,17167,Sangamon,Illinois,2016,40907,49944,7522,98373,0.4158356459597654,0.5077002836144064,0.07646407042582823,-1200,5573,-281,4092,-0.030776078565854792,0.055791824692329434,-0.025015746126474503,-9037,-919,-0.09186463765464103,-0.005760332439380289
3249,17169,Schuyler,Illinois,2000,1587,2077,108,3772,0.42073170731707316,0.5506362672322376,0.02863202545068929,0,0,0,0,0.0,0.0,0.0,-490,0,-0.12990455991516442,0.0
3250,17169,Schuyler,Illinois,2004,1594,2403,34,4031,0.39543537583726124,0.596129992557678,0.008434631605060779,7,-74,326,259,-0.025296331479811918,-0.020197393845628513,0.04549372532544038,-809,-319,-0.20069461672041672,-0.0707900568052523
3251,17169,Schuyler,Illinois,2008,1900,1833,106,3839,0.4949205522271425,0.4774680906486064,0.027611357124251105,306,72,-570,-192,0.09948517638988125,0.019176725519190328,-0.11866190190907155,67,876,0.017452461578536083,0.2181470782989528
3252,17169,Schuyler,Illinois,2012,1727,2069,106,3902,0.4425935417734495,0.5302409021014864,0.02716555612506407,-173,0,236,63,-0.05232701045369298,-0.00044580099918703486,0.05277281145288004,-342,-409,-0.08764736032803694,-0.10509982190657302
3253,17169,Schuyler,Illinois,2016,1075,2524,235,3834,0.28038601982263955,0.658320292123109,0.061293688054251436,-652,129,455,-68,-0.16220752195080995,0.034128131929187365,0.1280793900216226,-1449,-1107,-0.3779342723004695,-0.29028691197243256
3254,17171,Scott,Illinois,2000,954,1458,57,2469,0.3863912515188335,0.5905224787363305,0.023086269744835967,0,0,0,0,0.0,0.0,0.0,-504,0,-0.20413122721749694,0.0
3255,17171,Scott,Illinois,2004,927,1696,13,2636,0.3516691957511381,0.6433990895295902,0.004931714719271623,-27,-44,238,167,-0.03472205576769544,-0.018154555025564345,0.05287661079325978,-769,-265,-0.29172989377845215,-0.08759866656095522
3256,17171,Scott,Illinois,2008,1090,1455,62,2607,0.41810510164940545,0.5581127733026467,0.023782125047947834,163,49,-241,-29,0.06643590589826737,0.01885041032867621,-0.08528631622694349,-365,404,-0.1400076716532413,0.15172222212521086
3257,17171,Scott,Illinois,2012,910,1587,71,2568,0.3543613707165109,0.6179906542056075,0.02764797507788162,-180,9,132,-39,-0.06374373093289454,0.003865850029933785,0.059877880902960756,-677,-312,-0.2636292834890966,-0.1236216118358553
3258,17171,Scott,Illinois,2016,535,1966,107,2608,0.20513803680981596,0.7538343558282209,0.04102760736196319,-375,36,379,40,-0.14922333390669495,0.01337963228408157,0.1358437016226134,-1431,-754,-0.5486963190184049,-0.2850670355293083
3259,17173,Shelby,Illinois,2000,4018,5851,294,10163,0.3953557020564794,0.575715831939388,0.02892846600413264,0,0,0,0,0.0,0.0,0.0,-1833,0,-0.18036012988290862,0.0
3260,17173,Shelby,Illinois,2004,3744,6753,80,10577,0.3539756074501276,0.6384608111941004,0.007563581355771958,-274,-214,902,414,-0.04138009460635178,-0.021364884648360682,0.06274497925471234,-3009,-1176,-0.28448520374397274,-0.10412507386106412
3261,17173,Shelby,Illinois,2008,4245,6396,261,10902,0.38937809576224547,0.5866813428728673,0.023940561364887175,501,181,-357,325,0.03540248831211784,0.01637698000911522,-0.051779468321233035,-2151,858,-0.19730324711062186,0.08718195663335088
3262,17173,Shelby,Illinois,2012,3342,6843,254,10439,0.3201456078168407,0.6555225596321487,0.024331832551010634,-903,-7,447,-463,-0.06923248794540476,0.000391271186123459,0.06884121675928134,-3501,-1350,-0.33537695181530797,-0.1380737047046861
3263,17173,Shelby,Illinois,2016,2288,8229,532,11049,0.20707756358041451,0.7447732826500135,0.048149153769571906,-1054,278,1386,610,-0.11306804423642619,0.023817321218561272,0.08925072301786485,-5941,-2440,-0.537695719069599,-0.20231876725429104
3264,17175,Stark,Illinois,2000,1211,1694,84,2989,0.405152224824356,0.5667447306791569,0.02810304449648712,0,0,0,0,0.0,0.0,0.0,-483,0,-0.1615925058548009,0.0
3265,17175,Stark,Illinois,2004,1189,1841,31,3061,0.38843515191114014,0.601437438745508,0.010127409343351846,-22,-53,147,72,-0.016717072913215836,-0.017975635153135272,0.03469270806635116,-652,-169,-0.2130022868343679,-0.051409780979567
3266,17175,Stark,Illinois,2008,1357,1513,49,2919,0.46488523466940734,0.5183281945871874,0.016786570743405275,168,18,-328,-142,0.0764500827582672,0.00665916140005343,-0.08310924415832066,-156,496,-0.05344295991778003,0.15955932691658786
3267,17175,Stark,Illinois,2012,1095,1528,39,2662,0.4113448534936138,0.5740045078888054,0.014650638617580767,-262,-10,15,-257,-0.05354038117579352,-0.002135932125824509,0.05567631330161804,-433,-277,-0.1626596543951916,-0.10921669447741156
3268,17175,Stark,Illinois,2016,751,1778,188,2717,0.2764078027235922,0.6543982333456018,0.06919396393080604,-344,149,250,55,-0.1349370507700216,0.054543325313225276,0.08039372545679635,-1027,-594,-0.37799043062200954,-0.21533077622681795
3269,17177,Stephenson,Illinois,2000,8062,10715,601,19378,0.41603880689441636,0.5529466405201775,0.03101455258540613,0,0,0,0,0.0,0.0,0.0,-2653,0,-0.13690783362576114,0.0
3270,17177,Stephenson,Illinois,2004,8913,12212,195,21320,0.4180581613508443,0.5727954971857411,0.009146341463414634,851,-406,1497,1942,0.002019354456427924,-0.0218682111219915,0.019848856665563575,-3299,-646,-0.1547373358348968,-0.01782950220913565
3271,17177,Stephenson,Illinois,2008,11349,9909,399,21657,0.5240337996952487,0.45754259592741375,0.01842360437733758,2436,204,-2303,337,0.10597563834440438,0.009277262913922947,-0.11525290125832732,1440,4739,0.0664912037678349,0.2212285396027317
3272,17177,Stephenson,Illinois,2012,10165,10512,451,21128,0.48111510791366907,0.497538811056418,0.021346081029912912,-1184,52,603,-529,-0.04291869178157959,0.002922476652575331,0.03999621512900425,-347,-1787,-0.016423703142748936,-0.08291490691058384
3273,17177,Stephenson,Illinois,2016,7768,11083,1492,20343,0.38185125104458534,0.5448065673696112,0.07334218158580347,-2397,1041,571,-785,-0.09926385686908373,0.05199610055589056,0.04726775631319319,-3315,-2968,-0.16295531632502586,-0.14653161318227692
3274,17179,Tazewell,Illinois,2000,25379,31537,1432,58348,0.43495921025570716,0.5404983889764859,0.024542400767806952,0,0,0,0,0.0,0.0,0.0,-6158,0,-0.10553917872077878,0.0
3275,17179,Tazewell,Illinois,2004,25814,36058,466,62338,0.41409734030607337,0.578427283518881,0.007475376175045718,435,-966,4521,3990,-0.020861869949633793,-0.017067024592761236,0.03792889454239501,-10244,-4086,-0.16432994321280758,-0.0587907644920288
3276,17179,Tazewell,Illinois,2008,29384,33247,1429,64060,0.45869497346237903,0.5189978145488604,0.022307211988760536,3570,963,-2811,1722,0.04459763315630566,0.014831835813714818,-0.05942946897002055,-3863,6381,-0.060302841086481374,0.10402710212632621
3277,17179,Tazewell,Illinois,2012,24438,35335,1489,61262,0.3989096013842186,0.576784956416702,0.024305442199079364,-4946,60,2088,-2798,-0.059785372078160426,0.0019982302103188285,0.05778714186784162,-10897,-7034,-0.17787535503248342,-0.11757251394600204
3278,17179,Tazewell,Illinois,2016,20685,38707,5359,64751,0.3194545257988294,0.5977822736328396,0.08276320056833099,-3753,3870,3372,3489,-0.07945507558538922,0.05845775836925163,0.020997317216137623,-18022,-7125,-0.27832774783401026,-0.10045239280152685
3279,17181,Union,Illinois,2000,3982,4397,281,8660,0.45981524249422634,0.5077367205542725,0.032448036951501155,0,0,0,0,0.0,0.0,0.0,-415,0,-0.04792147806004621,0.0
3280,17181,Union,Illinois,2004,3735,5333,51,9119,0.4095843842526593,0.5848228972475052,0.005592718499835508,-247,-230,936,459,-0.050230858241567033,-0.026855318451665645,0.0770861766932327,-1598,-1183,-0.17523851299484594,-0.12731703493479973
3281,17181,Union,Illinois,2008,3918,5003,233,9154,0.4280096132838104,0.5465370329910422,0.025453353725147475,183,182,-330,35,0.01842522903115107,0.019860635225311965,-0.038285864256463076,-1085,513,-0.1185274197072318,0.056711093287614145
3282,17181,Union,Illinois,2012,3137,4957,224,8318,0.3771339264246213,0.595936523202693,0.026929550372685743,-781,-9,-46,-836,-0.050875686859189084,0.0014761966475382686,0.0493994902116508,-1820,-735,-0.21880259677807168,-0.10027517707083988
3283,17181,Union,Illinois,2016,2402,5790,424,8616,0.2787836583101207,0.6720055710306406,0.04921077065923862,-735,200,833,298,-0.0983502681145006,0.02228122028655288,0.07606904782794766,-3388,-1568,-0.39322191272051993,-0.17441931594244825
3284,17183,Vermilion,Illinois,2000,15406,15783,911,32100,0.47993769470404984,0.4916822429906542,0.02838006230529595,0,0,0,0,0.0,0.0,0.0,-377,0,-0.011744548286604373,0.0
3285,17183,Vermilion,Illinois,2004,14726,18731,257,33714,0.4367918372189595,0.5555852168238714,0.007622945957169129,-680,-654,2948,1614,-0.043145857485090366,-0.02075711634812682,0.06390297383321719,-4005,-3628,-0.11879337960491193,-0.10704883131830756
3286,17183,Vermilion,Illinois,2008,16246,16054,716,33016,0.4920644535982554,0.48624909134964867,0.021686455052095953,1520,459,-2677,-698,0.055272616379295925,0.014063509094926825,-0.06933612547422274,192,4197,0.005815362248606737,0.12460874185351867
3287,17183,Vermilion,Illinois,2012,12878,16892,625,30395,0.4236881065964797,0.5557493008718539,0.020562592531666393,-3368,-91,838,-2621,-0.0683763470017757,-0.0011238625204295603,0.06950020952220526,-4014,-4206,-0.13206119427537422,-0.13787655652398095
3288,17183,Vermilion,Illinois,2016,10039,19087,1692,30818,0.3257511843727692,0.619345836848595,0.05490297877863586,-2839,1067,2195,423,-0.09793692222371053,0.03434038624696947,0.06359653597674109,-9048,-5034,-0.29359465247582583,-0.16153345820045162
3289,17185,Wabash,Illinois,2000,1987,3406,115,5508,0.36074800290486564,0.6183732752360204,0.020878721859114015,0,0,0,0,0.0,0.0,0.0,-1419,0,-0.25762527233115473,0.0
3290,17185,Wabash,Illinois,2004,1752,4212,42,6006,0.2917082917082917,0.7012987012987013,0.006993006993006993,-235,-73,806,498,-0.06903971119657393,-0.013885714866107023,0.08292542606268094,-2460,-1041,-0.4095904095904096,-0.15196513725925487
3291,17185,Wabash,Illinois,2008,2462,3254,78,5794,0.4249223334483949,0.5616154642733863,0.013462202278218847,710,36,-958,-212,0.1332140417401032,0.006469195285211854,-0.13968323702531504,-792,1668,-0.13669313082499135,0.27289727876541825
3292,17185,Wabash,Illinois,2012,1590,3478,66,5134,0.30970003895597975,0.6774444877288663,0.012855473315153876,-872,-12,224,-660,-0.11522229449241517,-0.0006067289630649706,0.11582902345548007,-1888,-1096,-0.3677444487728866,-0.23105131794789524
3293,17185,Wabash,Illinois,2016,1151,4047,266,5464,0.2106515373352855,0.7406661786237189,0.04868228404099561,-439,200,569,330,-0.09904850162069426,0.035826810725841735,0.06322169089485252,-2896,-1008,-0.5300146412884333,-0.16227019251554675
3294,17187,Warren,Illinois,2000,3524,3899,208,7631,0.4618005503865811,0.5109422094089896,0.027257240204429302,0,0,0,0,0.0,0.0,0.0,-375,0,-0.049141659022408524,0.0
3295,17187,Warren,Illinois,2004,3938,4474,45,8457,0.4656497575972567,0.5290292065744354,0.005321035828307911,414,-163,575,826,0.0038492072106756092,-0.021936204376121392,0.018086997165445817,-536,-161,-0.06337944897717873,-0.014237789954770208
3296,17187,Warren,Illinois,2008,4286,3637,138,8061,0.5316958193772485,0.4511847165364099,0.017119464086341647,348,93,-837,-396,0.06604606177999184,0.011798428258033736,-0.07784449003802552,649,1185,0.08051110284083862,0.14389055181801735
3297,17187,Warren,Illinois,2012,4044,3618,156,7818,0.5172678434382195,0.46277820414428245,0.019953952417498082,-242,18,-19,-243,-0.014427975939029003,0.002834488331156435,0.011593487607872544,426,-223,0.054489639293937076,-0.026021463546901547
3298,17187,Warren,Illinois,2016,2987,4275,545,7807,0.3826053541693352,0.5475855001921353,0.06980914563852952,-1057,389,657,-11,-0.1346624892688843,0.04985519322103144,0.08480729604785281,-1288,-1714,-0.16498014602280003,-0.2194697853167371
3299,17189,Washington,Illinois,2000,2638,4353,147,7138,0.36957130848977304,0.6098346875875595,0.020594003922667414,0,0,0,0,0.0,0.0,0.0,-1715,0,-0.2402633790977865,0.0
3300,17189,Washington,Illinois,2004,2986,5072,46,8104,0.36846001974333664,0.6258637709772952,0.005676209279368213,348,-101,719,966,-0.0011112887464364007,-0.0149177946432992,0.016029083389735632,-2086,-371,-0.25740375123395853,-0.017140372136172033
3301,17189,Washington,Illinois,2008,3342,4473,117,7932,0.42133131618759456,0.5639183055975794,0.014750378214826021,356,71,-599,-172,0.05287129644425792,0.009074168935457809,-0.06194546537971579,-1131,955,-0.14258698940998482,0.11481676182397371
3302,17189,Washington,Illinois,2012,2450,4792,193,7435,0.32952252858103565,0.6445191661062541,0.025958305312710154,-892,76,319,-497,-0.09180878760655892,0.011207927097884133,0.08060086050867477,-2342,-1211,-0.3149966375252185,-0.17240964811523368
3303,17189,Washington,Illinois,2016,1448,5571,419,7438,0.19467598816886258,0.7489916644259209,0.056332347405216456,-1002,226,779,3,-0.13484654041217306,0.0303740420925063,0.10447249831966676,-4123,-1781,-0.5543156762570584,-0.23931903873183985
3304,17191,Wayne,Illinois,2000,2209,5347,137,7693,0.28714415702586765,0.6950474457298843,0.017808397244248018,0,0,0,0,0.0,0.0,0.0,-3138,0,-0.40790328870401665,0.0
3305,17191,Wayne,Illinois,2004,2139,6102,46,8287,0.2581151200675757,0.7363340171352721,0.005550862797152166,-70,-91,755,594,-0.029029036958291954,-0.012257534447095852,0.04128657140538783,-3963,-825,-0.47821889706769644,-0.07031560836367978
3306,17191,Wayne,Illinois,2008,2547,5390,134,8071,0.3155742782802627,0.6678230702515178,0.016602651468219553,408,88,-712,-216,0.05745915821268699,0.011051788671067387,-0.06851094688375436,-2843,1120,-0.3522487919712551,0.12597010509644135
3307,17191,Wayne,Illinois,2012,1514,5988,195,7697,0.19670001299207485,0.7779654410809407,0.025334545926984538,-1033,61,598,-374,-0.11887426528818784,0.008731894458764985,0.11014237082942291,-4474,-1631,-0.5812654280888658,-0.22901663611761075
3308,17191,Wayne,Illinois,2016,1048,6967,286,8301,0.12624984941573306,0.8392964703047826,0.0344536802794844,-466,91,979,604,-0.07045016357634179,0.009119134352499864,0.061331029223841926,-5919,-1445,-0.7130466208890496,-0.13178119280018374
3309,17193,White,Illinois,2000,2958,4521,158,7637,0.3873248657849941,0.591986382087207,0.020688752127798873,0,0,0,0,0.0,0.0,0.0,-1563,0,-0.2046615163022129,0.0
3310,17193,White,Illinois,2004,3071,5180,50,8301,0.3699554270569811,0.6240212022647874,0.006023370678231539,113,-108,659,664,-0.017369438728012998,-0.014665381449567335,0.032034820177580414,-2109,-546,-0.2540657752078063,-0.04940425890559341
3311,17193,White,Illinois,2008,3315,3987,151,7453,0.4447873339594794,0.5349523681738897,0.02026029786663089,244,101,-1193,-848,0.0748319069024983,0.01423692718839935,-0.08906883409089772,-672,1437,-0.0901650342144103,0.16390074099339602
3312,17193,White,Illinois,2012,2188,4731,161,7080,0.30903954802259886,0.6682203389830509,0.022740112994350282,-1127,10,744,-373,-0.13574778593688053,0.002479815127719394,0.1332679708091612,-2543,-1871,-0.359180790960452,-0.2690157567460417
3313,17193,White,Illinois,2016,1412,5640,283,7335,0.19250170415814588,0.7689161554192229,0.03858214042263122,-776,122,909,255,-0.11653784386445298,0.01584202742828094,0.10069581643617198,-4228,-1685,-0.5764144512610769,-0.2172336603006249
3314,17195,Whiteside,Illinois,2000,12886,11252,699,24837,0.5188227241615332,0.4530337802472118,0.028143495591254983,0,0,0,0,0.0,0.0,0.0,1634,0,0.06578894391432138,0.0
3315,17195,Whiteside,Illinois,2004,13723,12959,191,26873,0.5106612585122614,0.48223123581289773,0.0071075056748409185,837,-508,1707,2036,-0.008161465649271782,-0.021035989916414064,0.029197455565685926,764,-870,0.028430022699363677,-0.03735892121495771
3316,17195,Whiteside,Illinois,2008,15607,10883,504,26994,0.5781655182633177,0.4031636659998518,0.018670815736830406,1884,313,-2076,121,0.06750425975105634,0.011563310061989487,-0.07906756981304591,4724,3960,0.17500185226346593,0.14657182956410225
3317,17195,Whiteside,Illinois,2012,14833,10448,547,25828,0.5742992101595168,0.4045222239430076,0.021178565897475608,-774,43,-435,-1166,-0.003866308103800953,0.0025077501606452016,0.0013585579431557582,4385,-339,0.16977698621650922,-0.005224866046956711
3318,17195,Whiteside,Illinois,2016,11035,12615,1932,25582,0.4313579860839653,0.4931201626143382,0.0755218513016965,-3798,1385,2167,-246,-0.1429412240755515,0.0543432854042209,0.08859793867133064,-1580,-5965,-0.061762176530372914,-0.23153916274688213
3319,17197,Will,Illinois,2000,90902,95828,4940,191670,0.47426305629467314,0.4999634788960192,0.025773464809307665,0,0,0,0,0.0,0.0,0.0,-4926,0,-0.025700422601346085,0.0
3320,17197,Will,Illinois,2004,117172,130728,1709,249609,0.4694221762837077,0.5237311154645866,0.0068467082517056676,26270,-3231,34900,57939,-0.004840880010965443,-0.018926756557602,0.023767636568567396,-13556,-8630,-0.054308939180878923,-0.02860851657953284
3321,17197,Will,Illinois,2008,160406,122597,4178,287181,0.5585536647619446,0.4268980190193641,0.014548316218691348,43234,2469,-8131,37572,0.08913148847823688,0.007701607966985681,-0.09683309644522253,37809,51365,0.13165564574258048,0.1859645849234594
3322,17197,Will,Illinois,2012,144229,128969,4923,278121,0.518583638056817,0.46371543321072484,0.017700928732458175,-16177,745,6372,-9060,-0.039970026705127615,0.0031526125137668268,0.03681741419136075,15260,-22549,0.05486820484609212,-0.07678744089648837
3323,17197,Will,Illinois,2016,151927,132720,19579,304226,0.49938861241314025,0.4362546264947769,0.06435676109208285,7698,14656,3751,26105,-0.0191950256436767,0.04665583235962468,-0.027460806715947916,19207,3947,0.06313398591836333,0.008265781072271217
3324,17199,Williamson,Illinois,2000,12192,14012,735,26939,0.4525780466980957,0.520138089758343,0.02728386354356138,0,0,0,0,0.0,0.0,0.0,-1820,0,-0.06756004306024727,0.0
3325,17199,Williamson,Illinois,2004,11685,18086,189,29960,0.3900200267022697,0.6036715620827771,0.006308411214953271,-507,-546,4074,3021,-0.062558019995826,-0.020975452328608108,0.08353347232443409,-6401,-4581,-0.21365153538050735,-0.14609149232026009
3326,17199,Williamson,Illinois,2008,12589,17039,638,30266,0.41594528513843915,0.5629749553954932,0.021079759466067535,904,449,-1047,306,0.02592525843616944,0.014771348251114265,-0.04069660668728381,-4450,1951,-0.1470296702570541,0.06662186512345325
3327,17199,Williamson,Illinois,2012,10647,17909,689,29245,0.364062232860318,0.6123781843050095,0.023559582834672594,-1942,51,870,-1021,-0.05188305227812112,0.0024798233686050587,0.049403228909516206,-7262,-2812,-0.24831595144469143,-0.10128628118763733
3328,17199,Williamson,Illinois,2016,8581,21570,1701,31852,0.26940223533844027,0.6771945246766294,0.0534032399849303,-2066,1012,3661,2607,-0.09465999752187776,0.029843657150257708,0.06481634037161998,-12989,-5727,-0.4077922893381892,-0.15947633789349774
3329,17201,Winnebago,Illinois,2000,51981,53816,3500,109297,0.47559402362370423,0.4923831395189255,0.032022836857370285,0,0,0,0,0.0,0.0,0.0,-1835,0,-0.01678911589522125,0.0
3330,17201,Winnebago,Illinois,2004,59740,60782,903,121425,0.49199094091002676,0.5005723697755816,0.007436689314391599,7759,-2597,6966,12128,0.016396917286322532,-0.024586147542978685,0.008189230256656133,-1042,793,-0.008581428865554852,0.0082076870296664
3331,17201,Winnebago,Illinois,2008,70034,53886,2784,126704,0.5527370880161636,0.4252904407122111,0.021972471271625205,10294,1881,-6896,5279,0.06074614710613685,0.014535781957233606,-0.0752819290633705,16148,17190,0.1274466473039525,0.13602807616950735
3332,17201,Winnebago,Illinois,2012,61732,55138,2510,119380,0.5171050427207238,0.4618696599095326,0.021025297369743675,-8302,-274,1252,-7324,-0.03563204529543984,-0.0009471739018815303,0.03657921919732149,6594,-9554,0.05523538281119117,-0.07221126449276133
3333,17201,Winnebago,Illinois,2016,55713,55624,8718,120055,0.46406230477697724,0.463320977885136,0.0726167173378868,-6019,6208,486,675,-0.05304273794374653,0.05159141996814312,0.0014513179756033834,89,-6505,0.0007413268918412541,-0.054494055919349915
3334,17203,Woodford,Illinois,2000,5529,10905,359,16793,0.32924432799380693,0.6493777169058537,0.02137795510033943,0,0,0,0,0.0,0.0,0.0,-5376,0,-0.32013338891204673,0.0
3335,17203,Woodford,Illinois,2004,6005,12698,99,18802,0.3193809169237315,0.6753536857781087,0.00526539729815977,476,-260,1793,2009,-0.009863411070075434,-0.01611255780217966,0.025975968872255062,-6693,-1317,-0.35597276885437723,-0.035839379942330496
3336,17203,Woodford,Illinois,2008,6999,12191,350,19540,0.3581883316274309,0.623899692937564,0.01791197543500512,994,251,-507,738,0.03880741470369942,0.01264657813684535,-0.05145399284054475,-5192,1501,-0.26571136131013307,0.09026140754424417
3337,17203,Woodford,Illinois,2012,5572,12961,402,18935,0.2942698706099815,0.6844996039081067,0.021230525481911802,-1427,52,770,-605,-0.06391846101744941,0.0033185500469066834,0.060599910970542736,-7389,-2197,-0.3902297332981252,-0.12451837198799215
3338,17203,Woodford,Illinois,2016,5092,13207,1565,19864,0.2563431333064841,0.6648711236407572,0.07878574305275876,-480,1163,246,929,-0.03792673730349738,0.05755521757084696,-0.019628480267349535,-8115,-726,-0.40852799033427306,-0.018298257036147847
3339,18001,Adams,Indiana,2000,3775,8555,260,12590,0.2998411437648928,0.6795075456711676,0.020651310563939634,0,0,0,0,0.0,0.0,0.0,-4780,0,-0.37966640190627476,0.0
3340,18001,Adams,Indiana,2004,3512,9734,94,13340,0.26326836581709145,0.7296851574212894,0.007046476761619191,-263,-166,1179,750,-0.03657277794780134,-0.013604833802320443,0.05017761175012181,-6222,-1442,-0.4664167916041979,-0.08675038969792315
3341,18001,Adams,Indiana,2008,4928,8404,207,13539,0.36398552330305045,0.6207253120614521,0.015289164635497452,1416,113,-1330,199,0.100717157485959,0.008242687873878262,-0.10895984535983727,-3476,2746,-0.25673978875840164,0.20967700284579627
3342,18001,Adams,Indiana,2012,3806,8937,289,13032,0.29205033763044813,0.6857734806629834,0.022176181706568446,-1122,82,533,-507,-0.07193518567260232,0.006887017071070993,0.06504816860153129,-5131,-1655,-0.39372314303253525,-0.1369833542741336
3343,18001,Adams,Indiana,2016,2805,9648,741,13194,0.21259663483401547,0.7312414733969986,0.0561618917689859,-1001,452,711,162,-0.07945370279643266,0.033985710062417455,0.04546799273401525,-6843,-1712,-0.5186448385629832,-0.12492169553044791
3344,18003,Allen,Indiana,2000,41636,70426,2258,114320,0.36420573827851643,0.6160426871938418,0.01975157452764171,0,0,0,0,0.0,0.0,0.0,-28790,0,-0.2518369489153254,0.0
3345,18003,Allen,Indiana,2004,46710,82013,886,129609,0.3603916394694813,0.6327724154958375,0.006835945034681234,5074,-1372,11587,15289,-0.00381409880903516,-0.012915629492960476,0.016729728301995705,-35303,-6513,-0.27238077602635624,-0.020543827111030866
3346,18003,Allen,Indiana,2008,71263,77793,1491,150547,0.47336047878735543,0.5167356373757033,0.009903883836941288,24553,605,-4220,20938,0.11296883931787416,0.0030679388022600536,-0.11603677812013424,-6530,28773,-0.04337515858834784,0.2290056174380084
3347,18003,Allen,Indiana,2012,60036,84613,2597,147246,0.4077258465425207,0.5746370020238241,0.017637151433655244,-11227,1106,6820,-3301,-0.06563463224483473,0.007733267596713956,0.05790136464812079,-24577,-18047,-0.16691115548130336,-0.12353599689295552
3348,18003,Allen,Indiana,2016,55382,83930,9320,148632,0.37261155067549384,0.5646832445233866,0.06270520480111955,-4654,6723,-683,1386,-0.03511429586702686,0.045068053367464306,-0.009953757500437477,-28548,-3971,-0.19207169384789274,-0.02516053836658938
3349,18005,Bartholomew,Indiana,2000,9015,16200,554,25769,0.3498389537816757,0.6286623462299662,0.021498699988358103,0,0,0,0,0.0,0.0,0.0,-7185,0,-0.2788233924482905,0.0
3350,18005,Bartholomew,Indiana,2004,9191,19093,231,28515,0.322321585130633,0.6695774153954059,0.008100999473961073,176,-323,2893,2746,-0.02751736865104265,-0.01339770051439703,0.040915069165439744,-9902,-2717,-0.3472558302647729,-0.0684324378164824
3351,18005,Bartholomew,Indiana,2008,13567,17067,455,31089,0.4363922930940204,0.5489723053169931,0.014635401588986458,4376,224,-2026,2574,0.11407070796338736,0.006534402115025385,-0.12060511007841279,-3500,6402,-0.11258001222297276,0.23467581804180015
3352,18005,Bartholomew,Indiana,2012,10625,18083,684,29392,0.36149292324442023,0.6152354382144801,0.023271638541099617,-2942,229,1016,-1697,-0.07489936984960016,0.00863623695211316,0.06626313289748698,-7458,-3958,-0.2537425149700599,-0.14116250274708714
3353,18005,Bartholomew,Indiana,2016,9841,20640,2236,32717,0.3007916373750649,0.6308646880826482,0.06834367454228689,-784,1552,2557,3325,-0.060701285869355304,0.04507203600118727,0.01562924986816805,-10799,-3341,-0.33007305070758325,-0.07633053573752335
3354,18007,Benton,Indiana,2000,1328,2441,105,3874,0.3427981414558596,0.6300980898296334,0.02710376871450697,0,0,0,0,0.0,0.0,0.0,-1113,0,-0.2872999483737739,0.0
3355,18007,Benton,Indiana,2004,1135,2797,60,3992,0.2843186372745491,0.7006513026052105,0.01503006012024048,-193,-45,356,118,-0.05847950418131048,-0.012073708594266491,0.07055321277557702,-1662,-549,-0.4163326653306614,-0.1290327169568875
3356,18007,Benton,Indiana,2008,1563,2183,71,3817,0.409483887870055,0.5719151165837045,0.018600995546240503,428,11,-614,-175,0.12516525059550593,0.0035709354260000225,-0.12873618602150594,-620,1042,-0.1624312287136495,0.25390143661701187
3357,18007,Benton,Indiana,2012,1159,2329,90,3578,0.32392397987702626,0.6509223029625489,0.02515371716042482,-404,19,146,-239,-0.08555990799302876,0.0065527216141843155,0.07900718637884441,-1170,-550,-0.3269983230855227,-0.16456709437187317
3358,18007,Benton,Indiana,2016,860,2579,249,3688,0.23318872017353579,0.699295010845987,0.06751626898047722,-299,159,250,110,-0.09073525970349047,0.0423625518200524,0.04837270788343806,-1719,-549,-0.46610629067245124,-0.13910796758692856
3359,18009,Blackford,Indiana,2000,2103,2699,91,4893,0.4297976701410178,0.5516043327202126,0.01859799713876967,0,0,0,0,0.0,0.0,0.0,-596,0,-0.12180666257919481,0.0
3360,18009,Blackford,Indiana,2004,1903,3447,30,5380,0.3537174721189591,0.6407063197026023,0.0055762081784386614,-200,-61,748,487,-0.07608019802205868,-0.013021788960331009,0.08910198698238969,-1544,-948,-0.2869888475836432,-0.16518218500444837
3361,18009,Blackford,Indiana,2008,2677,2690,83,5450,0.49119266055045874,0.4935779816513762,0.015229357798165137,774,53,-757,70,0.13747518843149964,0.009653149619726475,-0.1471283380512261,-13,1531,-0.002385321100917437,0.28460352648272574
3362,18009,Blackford,Indiana,2012,1927,2711,122,4760,0.40483193277310925,0.5695378151260504,0.025630252100840335,-750,39,21,-690,-0.08636072777734949,0.010400894302675198,0.07595983347467422,-784,-771,-0.16470588235294115,-0.1623205612520237
3363,18009,Blackford,Indiana,2016,1243,3350,246,4839,0.2568712543914032,0.6922917958255838,0.05083694978301302,-684,124,639,79,-0.14796067838170607,0.025206697682172687,0.12275398069953336,-2107,-1323,-0.4354205414341806,-0.27071465908123943
3364,18011,Boone,Indiana,2000,4763,13161,472,18396,0.25891498151772124,0.7154272667971298,0.025657751685148944,0,0,0,0,0.0,0.0,0.0,-8398,0,-0.4565122852794085,0.0
3365,18011,Boone,Indiana,2004,5636,17055,207,22898,0.24613503362739103,0.7448248755349812,0.00904009083762774,873,-265,3894,4502,-0.012779947890330212,-0.016617660847521205,0.029397608737851466,-11419,-3021,-0.4986898419075902,-0.04217755662818168
3366,18011,Boone,Indiana,2008,9752,16622,318,26692,0.36535291473100556,0.6227334032668964,0.011913682002098008,4116,111,-433,3794,0.11921788110361453,0.0028735911644702673,-0.12209147226808481,-6870,4549,-0.25738048853589085,0.24130935337169934
3367,18011,Boone,Indiana,2012,8328,18808,646,27782,0.2997624361097113,0.6769850982650637,0.023252465625224965,-1424,328,2186,1090,-0.06559047862129425,0.011338783623126958,0.05425169499816729,-10480,-3610,-0.3772226621553524,-0.11984217361946153
3368,18011,Boone,Indiana,2016,10181,19654,2702,32537,0.3129053078034238,0.6040507729661616,0.08304391923041461,1853,2056,846,4755,0.013142871693712477,0.05979145360518964,-0.07293432529890209,-9473,1007,-0.2911454651627378,0.08607719699261457
3369,18013,Brown,Indiana,2000,2608,3871,338,6817,0.3825729793164148,0.5678450931494793,0.04958192753410591,0,0,0,0,0.0,0.0,0.0,-1263,0,-0.18527211383306447,0.0
3370,18013,Brown,Indiana,2004,2730,4512,88,7330,0.37244201909959074,0.6155525238744884,0.012005457025920874,122,-250,641,513,-0.010130960216824081,-0.037576470508185036,0.04770743072500916,-1782,-519,-0.2431105047748977,-0.05783839094183324
3371,18013,Brown,Indiana,2008,3854,4060,141,8055,0.47846058348851644,0.5040347610180013,0.017504655493482308,1124,53,-452,725,0.1060185643889257,0.005499198467561434,-0.11151776285648718,-206,1576,-0.02557417752948482,0.21753632724541289
3372,18013,Brown,Indiana,2012,3060,4332,242,7634,0.40083835472884466,0.5674613570867173,0.03170028818443804,-794,101,272,-421,-0.07762222875967179,0.014195632690955733,0.06342659606871603,-1272,-1066,-0.16662300235787264,-0.14104882482838782
3373,18013,Brown,Indiana,2016,2518,5016,411,7945,0.3169288860918817,0.6313404657016992,0.05173064820641913,-542,169,684,311,-0.08390946863696297,0.020030360021981088,0.06387910861498192,-2498,-1226,-0.3144115796098175,-0.14778857725194489
3374,18015,Carroll,Indiana,2000,2965,5102,201,8268,0.35861151427189164,0.6170778906627963,0.024310595065312045,0,0,0,0,0.0,0.0,0.0,-2137,0,-0.25846637639090464,0.0
3375,18015,Carroll,Indiana,2004,2689,5868,81,8638,0.31129891178513547,0.6793239175735124,0.009377170641352165,-276,-120,766,370,-0.04731260248675617,-0.01493342442395988,0.062246026910716123,-3179,-1042,-0.36802500578837694,-0.1095586293974723
3376,18015,Carroll,Indiana,2008,3736,4858,142,8736,0.42765567765567764,0.5560897435897436,0.016254578754578756,1047,61,-1010,98,0.11635676587054217,0.006877408113226591,-0.12323417398376879,-1122,2057,-0.12843406593406598,0.23959093985431096
3377,18015,Carroll,Indiana,2012,2635,4999,176,7810,0.3373879641485275,0.6400768245838668,0.022535211267605635,-1101,34,141,-926,-0.09026771350715013,0.006280632513026879,0.08398708099412322,-2364,-1242,-0.3026888604353393,-0.17425479450127335
3378,18015,Carroll,Indiana,2016,1892,6273,478,8643,0.21890547263681592,0.7257896563693162,0.05530487099386787,-743,302,1274,833,-0.11848249151171159,0.03276965972626224,0.08571283178544942,-4381,-2017,-0.5068841837325003,-0.204195323297161
3379,18017,Cass,Indiana,2000,5412,9305,389,15106,0.35826823778631006,0.6159804051370317,0.025751357076658283,0,0,0,0,0.0,0.0,0.0,-3893,0,-0.2577121673507216,0.0
3380,18017,Cass,Indiana,2004,4315,9480,136,13931,0.30974086569521214,0.6804967339028067,0.009762400401981192,-1097,-253,175,-1175,-0.04852737209109792,-0.01598895667467709,0.06451632876577507,-5165,-1272,-0.3707558682075946,-0.11304370085687299
3381,18017,Cass,Indiana,2008,7011,8346,296,15653,0.4479013607615154,0.5331885261611192,0.01891011307736536,2696,160,-1134,1722,0.13816049506630323,0.009147712675384168,-0.1473082077416875,-1335,3830,-0.08528716539960385,0.28546870280799075
3382,18017,Cass,Indiana,2012,5371,8443,347,14161,0.37928112421439164,0.5962149565708637,0.02450391921474472,-1640,51,97,-1492,-0.06862023654712374,0.005593806137379361,0.06302643040974443,-3072,-1737,-0.216933832356472,-0.13164666695686816
3383,18017,Cass,Indiana,2016,3759,9701,749,14209,0.2645506369202618,0.6827362938982335,0.05271306918150468,-1612,402,1258,48,-0.11473048729412982,0.02820914996675996,0.08652133732736988,-5942,-2870,-0.4181856569779717,-0.2012518246214997
3384,18019,Clark,Indiana,2000,17360,19417,559,37336,0.4649667880865652,0.5200610670666381,0.014972144846796657,0,0,0,0,0.0,0.0,0.0,-2057,0,-0.05509427898007291,0.0
3385,18019,Clark,Indiana,2004,17648,24495,194,42337,0.4168457850107471,0.5785719347143161,0.004582280274936817,288,-365,5078,5001,-0.048121003075818125,-0.01038986457185984,0.05851086764767799,-6847,-4790,-0.16172614970356902,-0.10663187072349611
3386,18019,Clark,Indiana,2008,21953,25326,605,47884,0.4584621167822237,0.5289031826915045,0.012634700526271823,4305,411,831,5547,0.04161633177147661,0.008052420251335006,-0.049668752022811624,-3373,3474,-0.07044106590928079,0.09128508379428824
3387,18019,Clark,Indiana,2012,20807,25450,1021,47278,0.4400989889589238,0.5383053428656035,0.021595668175472735,-1146,416,124,-606,-0.018363127823299907,0.008960967649200912,0.009402160174099006,-4643,-1270,-0.0982063539066797,-0.027765287997398913
3388,18019,Clark,Indiana,2016,18808,30035,2946,51789,0.3631659232655583,0.5799494101063932,0.056884666628048426,-1999,1925,4585,4511,-0.0769330656933655,0.03528899845257569,0.04164406724078973,-11227,-6584,-0.21678348684083493,-0.11857713293415523
3389,18021,Clay,Indiana,2000,3605,6393,160,10158,0.35489269541248275,0.6293561724748966,0.015751132112620594,0,0,0,0,0.0,0.0,0.0,-2788,0,-0.27446347706241386,0.0
3390,18021,Clay,Indiana,2004,3333,7361,89,10783,0.30909765371417974,0.6826486135583789,0.008253732727441343,-272,-71,968,625,-0.04579504169830301,-0.007497399385179251,0.0532924410834823,-4028,-1240,-0.37355095984419917,-0.09908748278178531
3391,18021,Clay,Indiana,2008,4954,6267,174,11395,0.43475208424747697,0.549978060552874,0.015269855199648968,1621,85,-1094,612,0.12565443053329722,0.007016122472207625,-0.1326705530055049,-1313,2715,-0.11522597630539705,0.2583249835388021
3392,18021,Clay,Indiana,2012,3460,7096,249,10805,0.32022211938917167,0.6567329939842665,0.023044886626561775,-1494,75,829,-590,-0.1145299648583053,0.007775031426912807,0.10675493343139253,-3636,-2323,-0.3365108745950949,-0.22128489828969783
3393,18021,Clay,Indiana,2016,2306,8531,498,11335,0.20344067048963388,0.7526246140273489,0.0439347154830172,-1154,249,1435,530,-0.11678144889953779,0.020889828856455427,0.09589162004308238,-6225,-2589,-0.549183943537715,-0.21267306894262017
3394,18023,Clinton,Indiana,2000,3643,7141,207,10991,0.33145300700573194,0.6497134018742607,0.01883359112000728,0,0,0,0,0.0,0.0,0.0,-3498,0,-0.3182603948685288,0.0
3395,18023,Clinton,Indiana,2004,3335,8471,71,11877,0.2807948135050939,0.7132272459375263,0.00597794055737981,-308,-136,1330,886,-0.05065819350063805,-0.012855650562627469,0.06351384406326555,-5136,-1638,-0.4324324324324324,-0.1141720375639036
3396,18023,Clinton,Indiana,2008,5307,6919,175,12401,0.4279493589226675,0.5579388758971051,0.0141117651802274,1972,104,-1552,524,0.1471545454175736,0.00813382462284759,-0.15528837004042118,-1612,3524,-0.1299895169744376,0.3024429154579948
3397,18023,Clinton,Indiana,2012,3308,6338,237,9883,0.3347161792977841,0.641303248001619,0.023980572700596985,-1999,62,-581,-2518,-0.09323317962488342,0.009868807520369585,0.08336437210451386,-3030,-1418,-0.3065870687038349,-0.17659755172939728
3398,18023,Clinton,Indiana,2016,2819,8531,586,11936,0.23617627345844505,0.7147285522788204,0.04909517426273458,-489,349,2193,2053,-0.09853990583933903,0.025114601562137597,0.0734253042772014,-5712,-2682,-0.4785522788203753,-0.17196521011654042
3399,18025,Crawford,Indiana,2000,1817,2327,65,4209,0.43169398907103823,0.5528629128058922,0.015443098123069612,0,0,0,0,0.0,0.0,0.0,-510,0,-0.12116892373485394,0.0
3400,18025,Crawford,Indiana,2004,1932,2609,33,4574,0.4223874070835155,0.570397901180586,0.007214691735898557,115,-32,282,365,-0.00930658198752271,-0.008228406387171056,0.017534988374693805,-677,-167,-0.14801049409707046,-0.026841570362216516
3401,18025,Crawford,Indiana,2008,2286,2393,65,4744,0.48187183811129847,0.5044266441821248,0.01370151770657673,354,32,-216,170,0.05948443102778295,0.006486825970678172,-0.06597125699846118,-107,570,-0.022554806070826328,0.12545568802624413
3402,18025,Crawford,Indiana,2012,2041,2421,128,4590,0.44466230936819173,0.5274509803921569,0.027886710239651415,-245,63,28,-154,-0.037209528743106735,0.014185192533074686,0.02302433621003208,-380,-273,-0.08278867102396514,-0.060233864953138816
3403,18025,Crawford,Indiana,2016,1323,3015,255,4593,0.2880470280862182,0.6564337034617896,0.05551926845199216,-718,127,594,3,-0.15661528128197355,0.027632558212340747,0.12898272306963277,-1692,-1312,-0.36838667537557146,-0.2855980043516063
3404,18027,Daviess,Indiana,2000,2697,6872,192,9761,0.2763036574121504,0.7040262268210224,0.01967011576682717,0,0,0,0,0.0,0.0,0.0,-4175,0,-0.42772256940887204,0.0
3405,18027,Daviess,Indiana,2004,2573,7936,90,10599,0.24275875082554957,0.7487498820643457,0.008491367110104727,-124,-102,1064,838,-0.03354490658660084,-0.011178748656722443,0.044723655243323224,-5363,-1188,-0.5059911312387961,-0.07826856182992409
3406,18027,Daviess,Indiana,2008,3370,7098,118,10586,0.3183449839410542,0.6705082184016625,0.011146797657283204,797,28,-838,-13,0.07558623311550464,0.0026554305471784764,-0.07824166366268315,-3728,1635,-0.3521632344606083,0.1538278967781878
3407,18027,Daviess,Indiana,2012,2437,7638,189,10264,0.23743180046765394,0.7441543257989088,0.018413873733437256,-933,71,540,-322,-0.08091318347340026,0.007267076076154053,0.07364610739724631,-5201,-1473,-0.5067225253312548,-0.15455929087064652
3408,18027,Daviess,Indiana,2016,1800,8545,474,10819,0.16637397171642482,0.7898142157315833,0.04381181255199187,-637,285,907,555,-0.07105782875122912,0.02539793881855461,0.04565988993267445,-6745,-1544,-0.6234402440151585,-0.11671771868390368
3409,18029,Dearborn,Indiana,2000,6020,11452,178,17650,0.34107648725212464,0.6488385269121814,0.010084985835694052,0,0,0,0,0.0,0.0,0.0,-5432,0,-0.3077620396600567,0.0
3410,18029,Dearborn,Indiana,2004,6596,14231,142,20969,0.31455958796318373,0.6786685106585912,0.0067719013782249985,576,-36,2779,3319,-0.02651689928894091,-0.003313084457469053,0.029829983746409883,-7635,-2203,-0.3641089226954075,-0.05634688303535079
3411,18029,Dearborn,Indiana,2008,7123,14886,208,22217,0.3206103434307062,0.6700274564522662,0.009362200117027502,527,66,655,1248,0.006050755467522484,0.002590298738802503,-0.008641054206324994,-7763,-128,-0.34941711302156003,0.014691809673847478
3412,18029,Dearborn,Indiana,2012,6528,15394,434,22356,0.29200214707461086,0.6885847199856862,0.01941313293970299,-595,226,508,139,-0.02860819635609535,0.010050932822675487,0.01855726353341991,-8866,-1103,-0.3965825729110753,-0.04716545988951526
3413,18029,Dearborn,Indiana,2016,4883,18113,991,23987,0.20356859965814816,0.7551173552340851,0.041314045107766706,-1645,557,2719,1631,-0.0884335474164627,0.021900912168063717,0.06653263524839892,-13230,-4364,-0.5515487555759369,-0.15496618266486156
3414,18031,Decatur,Indiana,2000,2889,6115,167,9171,0.3150147203140334,0.6667757060298768,0.01820957365608985,0,0,0,0,0.0,0.0,0.0,-3226,0,-0.3517609857158434,0.0
3415,18031,Decatur,Indiana,2004,2621,7499,79,10199,0.2569859790175507,0.7352681635454457,0.007745857437003628,-268,-88,1384,1028,-0.05802874129648267,-0.010463716219086221,0.06849245751556887,-4878,-1652,-0.47828218452789495,-0.12652119881205154
3416,18031,Decatur,Indiana,2008,3892,6449,162,10503,0.3705607921546225,0.6140150433209559,0.015424164524421594,1271,83,-1050,304,0.1135748131370718,0.007678307087417966,-0.12125312022448975,-2557,2321,-0.2434542511663334,0.23482793336156155
3417,18031,Decatur,Indiana,2012,2941,7119,267,10327,0.2847874503728091,0.6893579936089862,0.025854556018204706,-951,105,670,-176,-0.0857733417818134,0.010430391493783112,0.07534295028803029,-4178,-1621,-0.4045705432361771,-0.16111629206984368
3418,18031,Decatur,Indiana,2016,2121,8490,567,11178,0.189747718733226,0.7595276435856146,0.050724637681159424,-820,300,1371,851,-0.09503973163958312,0.024870081662954718,0.07016964997662845,-6369,-2191,-0.5697799248523887,-0.16520938161621163
3419,18033,DeKalb,Indiana,2000,4776,8701,308,13785,0.34646354733405876,0.6311933260790714,0.022343126586869787,0,0,0,0,0.0,0.0,0.0,-3925,0,-0.28472977874501265,0.0
3420,18033,DeKalb,Indiana,2004,4810,10468,125,15403,0.312276829189119,0.6796078685970266,0.008115302213854444,34,-183,1767,1618,-0.03418671814493979,-0.014227824373015343,0.048414542517955184,-5658,-1733,-0.3673310394079076,-0.08260126066289497
3421,18033,DeKalb,Indiana,2008,7175,9780,219,17174,0.4177826947711657,0.5694654710609061,0.012751834167928263,2365,94,-688,1771,0.10550586558204672,0.004636531954073819,-0.11014239753612054,-2605,3053,-0.15168277628974036,0.21564826311816726
3422,18033,DeKalb,Indiana,2012,5419,10587,354,16360,0.33123471882640587,0.6471271393643032,0.021638141809290953,-1756,135,807,-814,-0.08654797594475983,0.00888630764136269,0.07766166830339716,-5168,-2563,-0.31589242053789734,-0.16420964424815698
3423,18033,DeKalb,Indiana,2016,3942,12054,906,16902,0.23322683706070288,0.7131700390486333,0.05360312389066383,-1477,552,1467,542,-0.09800788176570299,0.03196498208137288,0.06604289968433008,-8112,-2944,-0.4799432019879304,-0.16405078145003305
3424,18035,Delaware,Indiana,2000,20876,22105,1166,44147,0.472874714023603,0.5007135252678552,0.026411760708541916,0,0,0,0,0.0,0.0,0.0,-1229,0,-0.027838811244252193,0.0
3425,18035,Delaware,Indiana,2004,20436,27064,439,47939,0.426291745760237,0.564550783287094,0.009157470952669017,-440,-727,4959,3792,-0.046582968263366,-0.017254289755872898,0.06383725801923879,-6628,-5399,-0.13825903752685698,-0.11042022628260478
3426,18035,Delaware,Indiana,2008,28384,20916,676,49976,0.567952617256283,0.41852089002721304,0.013526492716503922,7948,237,-6148,2037,0.141660871496046,0.004369021763834904,-0.14602989325988092,7468,14096,0.14943172722906994,0.2876907647559269
3427,18035,Delaware,Indiana,2012,22654,21251,1169,45074,0.5025957314638151,0.4714691396370413,0.02593512889914363,-5730,493,335,-4902,-0.0653568857924679,0.012408636182639708,0.052948249609828246,1403,-6065,0.031126591826773797,-0.11830513540229615
3428,18035,Delaware,Indiana,2016,18153,24263,3089,45505,0.39892319525326886,0.5331941544885177,0.06788265025821338,-4501,1920,3012,431,-0.10367253621054623,0.041947521359069755,0.06172501485147641,-6110,-7513,-0.13427095923524884,-0.16539755106202264
3429,18037,Dubois,Indiana,2000,5090,10134,280,15504,0.32830237358101133,0.6536377708978328,0.01805985552115583,0,0,0,0,0.0,0.0,0.0,-5044,0,-0.3253353973168215,0.0
3430,18037,Dubois,Indiana,2004,5210,11726,130,17066,0.3052853627094808,0.6870971522325091,0.007617485058010079,120,-150,1592,1562,-0.02301701087153052,-0.01044237046314575,0.0334593813346763,-6516,-1472,-0.3818117895230283,-0.056476392206206816
3431,18037,Dubois,Indiana,2008,8748,9526,319,18593,0.4704996504060668,0.5123433550260851,0.017156994567848114,3538,189,-2200,1527,0.16521428769658597,0.009539509509838034,-0.17475379720642403,-778,5738,-0.041843704620018296,0.33996808490301
3432,18037,Dubois,Indiana,2012,6522,11654,395,18571,0.3511927198319961,0.6275375585590437,0.021269721608960207,-2226,76,2128,-22,-0.11930693057407066,0.004112727041112093,0.11519420353295862,-5132,-4354,-0.27634483872704757,-0.23450113410702927
3433,18037,Dubois,Indiana,2016,5389,13365,1341,20095,0.26817616322468274,0.6650908186115949,0.06673301816372232,-1133,946,1711,1524,-0.08301655660731339,0.04546329655476211,0.03755326005255122,-7976,-2844,-0.3969146553869122,-0.1205698166598646
3434,18039,Elkhart,Indiana,2000,16402,36756,1324,54482,0.301053558973606,0.6746448368268418,0.024301604199552147,0,0,0,0,0.0,0.0,0.0,-20354,0,-0.37359127785323587,0.0
3435,18039,Elkhart,Indiana,2004,17966,42967,447,61380,0.2927012056044314,0.7000162919517758,0.007282502443792766,1564,-877,6211,6898,-0.008352353369174559,-0.01701910175575938,0.025371455124933995,-25001,-4647,-0.4073150863473444,-0.033723808494108554
3436,18039,Elkhart,Indiana,2008,31398,39396,840,71634,0.43831141636652987,0.5499623084010387,0.011726275232431527,13432,393,-3571,10254,0.14561021076209846,0.0044437727886387605,-0.15005398355073718,-7998,17003,-0.11165089203450879,0.29566419431283564
3437,18039,Elkhart,Indiana,2012,24399,42378,1252,68029,0.35865586735068866,0.6229402166723015,0.018403915977009806,-6999,412,2982,-3605,-0.07965554901584121,0.0066776407445782796,0.07297790827126283,-17979,-9981,-0.2642843493216128,-0.15263345728710404
3438,18039,Elkhart,Indiana,2016,20740,41867,3629,66236,0.3131227731143185,0.6320882903556978,0.05478893652998369,-3659,2377,-511,-1793,-0.04553309423637014,0.036385020552973886,0.009148073683396318,-21127,-3148,-0.3189655172413793,-0.05468116791976646
3439,18041,Fayette,Indiana,2000,3415,5060,172,8647,0.39493465941945183,0.5851740488030531,0.019891291777495084,0,0,0,0,0.0,0.0,0.0,-1645,0,-0.1902393893836013,0.0
3440,18041,Fayette,Indiana,2004,3626,5761,81,9468,0.38297422898183353,0.6084706379383186,0.008555133079847909,211,-91,701,821,-0.011960430437618297,-0.011336158697647175,0.023296589135265444,-2135,-490,-0.22549640895648504,-0.03525701957288374
3441,18041,Fayette,Indiana,2008,4389,4917,173,9479,0.46302352568836375,0.5187256039666631,0.018250870344973098,763,92,-844,11,0.08004929670653022,0.009695737265125189,-0.08974503397165545,-528,1607,-0.05570207827829937,0.16979433067818567
3442,18041,Fayette,Indiana,2012,3555,5045,237,8837,0.4022858436120855,0.5708951001471088,0.026819056240805703,-834,64,128,-642,-0.06073768207627822,0.008568185895832605,0.05216949618044564,-1490,-962,-0.16860925653502323,-0.11290717825672386
3443,18041,Fayette,Indiana,2016,2252,6839,439,9530,0.23630640083945437,0.7176285414480588,0.04606505771248688,-1303,202,1794,693,-0.16597944277263116,0.01924600147168118,0.14673344130095,-4587,-3097,-0.4813221406086044,-0.31271288407358117
3444,18043,Floyd,Indiana,2000,13209,16486,335,30030,0.4398601398601399,0.548984348984349,0.011155511155511156,0,0,0,0,0.0,0.0,0.0,-3277,0,-0.10912420912420912,0.0
3445,18043,Floyd,Indiana,2004,13857,19877,156,33890,0.4088816760106226,0.5865151962230747,0.004603127766302744,648,-179,3391,3860,-0.0309784638495173,-0.006552383389208412,0.037530847238725684,-6020,-2743,-0.1776335202124521,-0.06850931108824299
3446,18043,Floyd,Indiana,2008,16263,19957,447,36667,0.44353233152425886,0.5442768702102708,0.012190798265470313,2406,291,80,2777,0.034650655513636275,0.00758767049916757,-0.04223832601280386,-3694,2326,-0.10074453868601196,0.07688898152644014
3447,18043,Floyd,Indiana,2012,14812,19878,702,35392,0.4185126582278481,0.5616523508137432,0.01983499095840868,-1451,255,-79,-1275,-0.02501967329641075,0.007644192692938366,0.017375480603472382,-5066,-1372,-0.1431396925858951,-0.04239515389988313
3448,18043,Floyd,Indiana,2016,13945,21432,2465,37842,0.368505892923207,0.5663548438243222,0.0651392632524708,-867,1763,1554,2450,-0.0500067653046411,0.045304272294062115,0.004702493010579012,-7487,-2421,-0.1978489509011152,-0.05470925831522011
3449,18045,Fountain,Indiana,2000,2717,4408,156,7281,0.373163027056723,0.6054113445955226,0.021425628347754428,0,0,0,0,0.0,0.0,0.0,-1691,0,-0.2322483175387996,0.0
3450,18045,Fountain,Indiana,2004,2477,5260,67,7804,0.3174013326499231,0.6740133264992312,0.00858534085084572,-240,-89,852,523,-0.0557616944067999,-0.012840287496908707,0.06860198190370859,-2783,-1092,-0.3566119938493081,-0.12436367631050849
3451,18045,Fountain,Indiana,2008,3094,4158,174,7426,0.4166442230002693,0.5599245892809049,0.023431187718825748,617,107,-1102,-378,0.09924289035034622,0.014845846867980027,-0.11408873721832624,-1064,1719,-0.14328036628063562,0.21333162756867247
3452,18045,Fountain,Indiana,2012,2237,4664,210,7111,0.3145830403600056,0.6558852482070032,0.02953171143299114,-857,36,506,-315,-0.1020611826402637,0.0061005237141653935,0.09596065892609829,-2427,-1363,-0.3413022078469976,-0.198021841566362
3453,18045,Fountain,Indiana,2016,1476,5662,397,7535,0.19588586595885865,0.7514266755142668,0.052687458526874585,-761,187,998,424,-0.11869717440114697,0.023155747093883444,0.09554142730726356,-4186,-1759,-0.5555408095554082,-0.21423860170841058
3454,18047,Franklin,Indiana,2000,2591,5587,161,8339,0.31070871807171124,0.6699844106007915,0.019306871327497303,0,0,0,0,0.0,0.0,0.0,-2996,0,-0.35927569252908026,0.0
3455,18047,Franklin,Indiana,2004,2925,6977,90,9992,0.2927341873498799,0.6982586068855084,0.009007205764611689,334,-71,1390,1653,-0.01797453072183136,-0.010299665562885614,0.028274196284716946,-4052,-1056,-0.40552441953562857,-0.04624872700654831
3456,18047,Franklin,Indiana,2008,3404,7018,220,10642,0.31986468708889304,0.6594625070475475,0.02067280586355948,479,130,41,650,0.02713049973901316,0.01166560009894779,-0.03879609983796095,-3614,438,-0.33959781995865446,0.06592659957697411
3457,18047,Franklin,Indiana,2012,2909,7424,247,10580,0.274952741020794,0.7017013232514178,0.02334593572778828,-495,27,406,-62,-0.04491194606809906,0.0026731298642287994,0.042238816203870266,-4515,-901,-0.4267485822306238,-0.08715076227196933
3458,18047,Franklin,Indiana,2016,1969,8669,375,11013,0.17878870425860346,0.7871606283483156,0.03405066739308091,-940,128,1245,433,-0.09616403676219051,0.010704731665292629,0.08545930509689781,-6700,-2185,-0.6083719240897121,-0.1816233418590883
3459,18049,Fulton,Indiana,2000,2960,5218,149,8327,0.3554701573195629,0.6266362435450943,0.01789359913534286,0,0,0,0,0.0,0.0,0.0,-2258,0,-0.2711660862255314,0.0
3460,18049,Fulton,Indiana,2004,2607,6027,69,8703,0.29955187866253014,0.692519820751465,0.007928300586004825,-353,-80,809,376,-0.05591827865703275,-0.009965298549338036,0.06588357720637072,-3420,-1162,-0.3929679420889349,-0.12180185586340347
3461,18049,Fulton,Indiana,2008,3702,5147,157,9006,0.4110592938041306,0.5715078836331334,0.017432822562735952,1095,88,-880,303,0.11150741514160045,0.009504521976731127,-0.12101193711833158,-1445,1975,-0.16044858982900284,0.23251935225993203
3462,18049,Fulton,Indiana,2012,2621,5317,188,8126,0.3225449175486094,0.6543194683731233,0.02313561407826729,-1081,31,170,-880,-0.08851437625552117,0.0057027915155313386,0.08281158473998984,-2696,-1251,-0.33177455082451385,-0.171325960995511
3463,18049,Fulton,Indiana,2016,1960,6010,467,8437,0.2323100628185374,0.7123385089486785,0.05535142823278417,-661,279,693,311,-0.09023485473007203,0.03221581415451688,0.05801904057555518,-4050,-1354,-0.48002844613014106,-0.14825389530562721
3464,18051,Gibson,Indiana,2000,5802,7734,236,13772,0.42128957304676157,0.5615742085390648,0.017136218414173687,0,0,0,0,0.0,0.0,0.0,-1932,0,-0.14028463549230324,0.0
3465,18051,Gibson,Indiana,2004,5378,9133,103,14614,0.3680032845216915,0.6249486793485699,0.007048036129738607,-424,-133,1399,842,-0.05328628852507006,-0.01008818228443508,0.06337447080950509,-3755,-1823,-0.2569453948268784,-0.11666075933457515
3466,18051,Gibson,Indiana,2008,6455,8449,260,15164,0.42567924030598786,0.5571748878923767,0.017145871801635452,1077,157,-684,550,0.05767595578429635,0.010097835671896847,-0.06777379145619322,-1994,1761,-0.13149564758638882,0.12544974724048957
3467,18051,Gibson,Indiana,2012,4928,9487,306,14721,0.33475986685687115,0.6444535018001495,0.020786631342979416,-1527,46,1038,-443,-0.09091937344911671,0.003640759541343963,0.0872786139077728,-4559,-2565,-0.30969363494327834,-0.17819798735688952
3468,18051,Gibson,Indiana,2016,3721,11081,682,15484,0.24031258072849393,0.7156419529837251,0.044045466287780936,-1207,376,1594,763,-0.09444728612837722,0.02325883494480152,0.07118845118357564,-7360,-2801,-0.4753293722552312,-0.16563573731195286
3469,18053,Grant,Indiana,2000,9712,16153,521,26386,0.36807397862502844,0.6121807018873645,0.019745319487607063,0,0,0,0,0.0,0.0,0.0,-6441,0,-0.24410672326233607,0.0
3470,18053,Grant,Indiana,2004,8509,18769,182,27460,0.3098689002184996,0.6835032774945375,0.006627822286962855,-1203,-339,2616,1074,-0.05820507840652883,-0.013117497200644208,0.07132257560717303,-10260,-3819,-0.37363437727603793,-0.12952765401370187
3471,18053,Grant,Indiana,2008,11293,14734,317,26344,0.42867446097783174,0.5592924385059217,0.012033100516246583,2784,135,-4035,-1116,0.11880556075933213,0.005405278229283729,-0.12421083898861585,-3441,6819,-0.13061797752808996,0.24301639974794798
3472,18053,Grant,Indiana,2012,9589,15151,589,25329,0.37857791464329427,0.5981681077026334,0.023253977654072406,-1704,272,417,-1015,-0.05009654633453747,0.011220877137825823,0.038875669196711704,-5562,-2121,-0.21959019305933913,-0.08897221553124918
3473,18053,Grant,Indiana,2016,7010,17008,1554,25572,0.27412795244799,0.6651024558110433,0.06076959174096668,-2579,965,1857,243,-0.10444996219530428,0.03751561408689427,0.06693434810840992,-9998,-4436,-0.39097450336305334,-0.1713843103037142
3474,18055,Greene,Indiana,2000,4898,7452,269,12619,0.38814486092400347,0.5905380775021792,0.02131706157381726,0,0,0,0,0.0,0.0,0.0,-2554,0,-0.20239321657817577,0.0
3475,18055,Greene,Indiana,2004,4606,8609,137,13352,0.3449670461354104,0.6447723187537447,0.010260635110844817,-292,-132,1157,733,-0.04317781478859306,-0.011056426462972443,0.05423424125156551,-4003,-1449,-0.29980527261833434,-0.09741205604015857
3476,18055,Greene,Indiana,2008,5709,7691,250,13650,0.41824175824175824,0.5634432234432234,0.018315018315018316,1103,113,-918,298,0.07327471210634784,0.0080543832041735,-0.08132909531052135,-1982,2021,-0.14520146520146515,0.1546038074168692
3477,18055,Greene,Indiana,2012,4350,8457,334,13141,0.331025036146412,0.6435583288943003,0.025416634959287726,-1359,84,766,-509,-0.08721672209534626,0.00710161664426941,0.08011510545107692,-4107,-2125,-0.3125332927478883,-0.16733182754642317
3478,18055,Greene,Indiana,2016,2929,10277,655,13861,0.2113123151287786,0.7414327970564895,0.04725488781473198,-1421,321,1820,720,-0.11971272101763339,0.021838252855444253,0.09787446816218914,-7348,-3241,-0.5301204819277109,-0.21758718917982256
3479,18057,Hamilton,Indiana,2000,18002,56372,1552,75926,0.23709928087875037,0.7424597634538893,0.020440955667360323,0,0,0,0,0.0,0.0,0.0,-38370,0,-0.505360482575139,0.0
3480,18057,Hamilton,Indiana,2004,26388,77887,631,104906,0.25153947343335936,0.7424456179818123,0.006014908584828322,8386,-921,21515,28980,0.014440192554608988,-0.014426047082532001,-1.4145472077009558e-05,-51499,-13129,-0.49090614454845294,0.014454338026686053
3481,18057,Hamilton,Indiana,2008,49704,78401,1174,129279,0.3844707957208827,0.6064480696787568,0.00908113460036046,23316,543,514,24373,0.13293132228752336,0.003066226015532138,-0.13599754830305555,-28697,22802,-0.22197727395787403,0.2689288705905789
3482,18057,Hamilton,Indiana,2012,43796,90747,2546,137089,0.31947129237210864,0.6619568309638264,0.01857187666406495,-5908,1372,12346,7810,-0.06499950334877408,0.00949074206370449,0.05550876128506965,-46951,-18254,-0.34248553859171776,-0.12050826463384373
3483,18057,Hamilton,Indiana,2016,57263,87404,11291,155958,0.36716936611138895,0.5604329370728016,0.07239769681580939,13467,8745,-3343,18869,0.04769807373928031,0.05382582015174444,-0.10152389389102479,-30141,16810,-0.19326357096141267,0.1492219676303051
3484,18059,Hancock,Indiana,2000,6503,15943,504,22950,0.28335511982570805,0.6946840958605665,0.02196078431372549,0,0,0,0,0.0,0.0,0.0,-9440,0,-0.4113289760348584,0.0
3485,18059,Hancock,Indiana,2004,6912,20771,184,27867,0.2480353105824093,0.7453618975849571,0.006602791832633581,409,-320,4828,4917,-0.03531980924329875,-0.01535799248109191,0.050677801724390625,-13859,-4419,-0.4973265870025478,-0.08599761096768938
3486,18059,Hancock,Indiana,2008,11874,22008,371,34253,0.3466557673780399,0.6425130645490906,0.01083116807286953,4962,187,1237,6386,0.09862045679563058,0.004228376240235949,-0.10284883303586645,-10134,3725,-0.29585729717105075,0.20146928983149703
3487,18059,Hancock,Indiana,2012,9319,22796,728,32843,0.2837438723624517,0.6940900648540024,0.02216606278354596,-2555,357,788,-1410,-0.06291189501558819,0.01133489471067643,0.051577000304911746,-13477,-3343,-0.4103461924915507,-0.11448889532049994
3488,18059,Hancock,Indiana,2016,8904,25074,2518,36496,0.24397194213064446,0.687034195528277,0.06899386234107847,-415,1790,2278,3653,-0.03977193023180722,0.04682779955753251,-0.007055869325725328,-16170,-2693,-0.4430622533976326,-0.03271606090608192
3489,18061,Harrison,Indiana,2000,5870,8711,315,14896,0.3940655209452202,0.5847878625134264,0.021146616541353382,0,0,0,0,0.0,0.0,0.0,-2841,0,-0.19072234156820622,0.0
3490,18061,Harrison,Indiana,2004,6171,11015,124,17310,0.35649913344887346,0.6363373772385904,0.007163489312536107,301,-191,2304,2414,-0.03756638749634672,-0.013983127228817276,0.051549514725164,-4844,-2003,-0.27983824378971695,-0.08911590222151072
3491,18061,Harrison,Indiana,2008,7288,10551,335,18174,0.40101243534719927,0.5805546384945527,0.018432926158248045,1117,211,-464,864,0.04451330189832581,0.011269436845711939,-0.05578273874403772,-3263,1581,-0.17954220314735342,0.10029604064236353
3492,18061,Harrison,Indiana,2012,6607,10640,424,17671,0.3738894233489899,0.6021164619998868,0.02399411465112331,-681,89,89,-503,-0.02712301199820938,0.005561188492875263,0.021561823505334088,-4033,-770,-0.22822703865089689,-0.04868483550354347
3493,18061,Harrison,Indiana,2016,4783,12943,832,18558,0.257732514279556,0.6974350684340985,0.04483241728634551,-1824,408,2303,887,-0.11615690906943388,0.0208383026352222,0.09531860643421175,-8160,-4127,-0.4397025541545425,-0.21147551550364563
3494,18063,Hendricks,Indiana,2000,10786,28651,784,40221,0.2681683697570921,0.7123393252281147,0.01949230501479327,0,0,0,0,0.0,0.0,0.0,-17865,0,-0.44417095547102264,0.0
3495,18063,Hendricks,Indiana,2004,13548,38430,324,52302,0.2590340713548239,0.7347711368590111,0.006194791786164965,2762,-460,9779,12081,-0.009134298402268148,-0.013297513228628304,0.02243181163089636,-24882,-7017,-0.47573706550418715,-0.03156611003316451
3496,18063,Hendricks,Indiana,2008,24548,39728,778,65054,0.3773480493128785,0.610692655332493,0.011959295354628462,11000,454,1298,12752,0.1183139779580546,0.005764503568463497,-0.12407848152651813,-15180,9702,-0.23334460601961443,0.24239245948457272
3497,18063,Hendricks,Indiana,2012,21112,44312,1337,66761,0.3162325309686793,0.6637408067584368,0.02002666227288387,-3436,559,4584,1707,-0.061115518344199204,0.008067366918255407,0.05304815142594388,-23200,-8020,-0.3475082757897575,-0.11416366977014308
3498,18063,Hendricks,Indiana,2016,22600,48337,5247,76184,0.2966502152682978,0.6344770555497218,0.06887272918198047,1488,3910,4025,9423,-0.019582315700381492,0.0488460669090966,-0.02926375120871505,-25737,-2537,-0.33782684028142396,0.009681435508333558
3499,18065,Henry,Indiana,2000,7647,10321,347,18315,0.4175266175266175,0.5635271635271635,0.018946218946218948,0,0,0,0,0.0,0.0,0.0,-2674,0,-0.14600054600054596,0.0
3500,18065,Henry,Indiana,2004,7176,13137,191,20504,0.3499804916113929,0.6407042528287163,0.009315255559890753,-471,-156,2816,2189,-0.06754612591522463,-0.009630963386328194,0.07717708930155287,-5961,-3287,-0.29072376121732346,-0.1447232152167775
3501,18065,Henry,Indiana,2008,10059,10896,364,21319,0.47183263755335614,0.5110933908719921,0.01707397157465172,2883,173,-2241,815,0.12185214594196325,0.007758716014760966,-0.12961086195672422,-837,5124,-0.03926075331863599,0.2514630078986875
3502,18065,Henry,Indiana,2012,7613,10838,556,19007,0.4005366443941706,0.5702109749039828,0.029252380701846686,-2446,192,-58,-2312,-0.07129599315918556,0.012178409127194968,0.05911758403199063,-3225,-2388,-0.16967433050981218,-0.1304135771911762
3503,18065,Henry,Indiana,2016,5124,13895,1136,20155,0.2542297196725378,0.6894070950136443,0.05636318531381791,-2489,580,3057,1148,-0.14630692472163276,0.027110804611971226,0.11919612010966152,-8771,-5546,-0.43517737534110645,-0.2655030448312943
3504,18067,Howard,Indiana,2000,12899,20331,865,34095,0.37832526763455054,0.596304443466784,0.025370288898665494,0,0,0,0,0.0,0.0,0.0,-7432,0,-0.21797917583223347,0.0
3505,18067,Howard,Indiana,2004,12998,23714,309,37021,0.35109802544501767,0.640555360471084,0.008346614083898328,99,-556,3383,2926,-0.027227242189532874,-0.017023674814767166,0.04425091700429995,-10716,-3284,-0.2894573350260663,-0.07147815919383282
3506,18067,Howard,Indiana,2008,17871,20248,714,38833,0.46020137511909975,0.5214122009630984,0.018386423917801868,4873,405,-3466,1812,0.10910334967408208,0.01003980983390354,-0.1191431595079856,-2377,8339,-0.06121082584399862,0.22824650918206768
3507,18067,Howard,Indiana,2012,15135,20327,829,36291,0.417045548483095,0.5601113223664269,0.02284312915047808,-2736,115,79,-2542,-0.04315582663600476,0.004456705232676213,0.03869912140332854,-5192,-2815,-0.14306577388333191,-0.0818549480393333
3508,18067,Howard,Indiana,2016,11215,23675,2452,37342,0.30033206577044613,0.6340046060735901,0.06566332815596379,-3920,1623,3348,1051,-0.11671348271264886,0.04282019900548571,0.0738932837071632,-12460,-7268,-0.33367254030314397,-0.19060676641981206
3509,18069,Huntington,Indiana,2000,4119,10113,388,14620,0.2817373461012312,0.6917236662106703,0.026538987688098495,0,0,0,0,0.0,0.0,0.0,-5994,0,-0.4099863201094391,0.0
3510,18069,Huntington,Indiana,2004,3877,11617,133,15627,0.24809624368080885,0.7433928457157484,0.00851091060344276,-242,-255,1504,1007,-0.03364110242042234,-0.018028077084655737,0.0516691795050781,-7740,-1746,-0.4952966020349395,-0.08531028192550044
3511,18069,Huntington,Indiana,2008,5843,10291,223,16357,0.3572170935990707,0.6291495995598215,0.013633306841107782,1966,90,-1326,730,0.10912084991826188,0.005122396237665023,-0.11424324615592685,-4448,3292,-0.2719325059607508,0.22336409607418872
3512,18069,Huntington,Indiana,2012,4596,10862,339,15797,0.2909413179717668,0.6875989111856682,0.021459770842565045,-1247,116,571,-560,-0.06627577562730391,0.007826464001457263,0.058449311625846656,-6266,-1818,-0.39665759321390137,-0.12472508725315057
3513,18069,Huntington,Indiana,2016,3506,11649,1026,16181,0.21667387676905012,0.7199184228416043,0.06340770038934553,-1090,687,787,384,-0.0742674412027167,0.04194792954678048,0.03231951165593616,-8143,-1877,-0.5032445460725542,-0.10658695285865283
3514,18071,Jackson,Indiana,2000,5330,9054,218,14602,0.3650184906177236,0.6200520476647035,0.014929461717572935,0,0,0,0,0.0,0.0,0.0,-3724,0,-0.25503355704697983,0.0
3515,18071,Jackson,Indiana,2004,5092,11083,134,16309,0.3122202464896683,0.6795634312342879,0.008216322276043903,-238,-84,2029,1707,-0.05279824412805534,-0.006713139441529032,0.05951138356958441,-5991,-2267,-0.3673431847446196,-0.11230962769763975
3516,18071,Jackson,Indiana,2008,7354,9726,360,17440,0.4216743119266055,0.5576834862385321,0.020642201834862386,2262,226,-1357,1131,0.1094540654369372,0.012425879558818484,-0.12187994499575572,-2372,3619,-0.13600917431192666,0.23133401043269292
3517,18071,Jackson,Indiana,2012,5838,10419,455,16712,0.3493298228817616,0.6234442316898038,0.027225945428434657,-1516,95,693,-728,-0.07234448904484386,0.006583743593572271,0.06576074545127164,-4581,-2209,-0.27411440880804216,-0.1381052344961155
3518,18071,Jackson,Indiana,2016,3843,12859,965,17667,0.217524197656648,0.7278541914303504,0.05462161091300164,-1995,510,2440,955,-0.13180562522511363,0.027395665484566983,0.10440995974054657,-9016,-4435,-0.5103299937737024,-0.2362155849656602
3519,18073,Jasper,Indiana,2000,3744,7212,211,11167,0.3352735739231665,0.6458314677173815,0.018894958359451958,0,0,0,0,0.0,0.0,0.0,-3468,0,-0.31055789379421506,0.0
3520,18073,Jasper,Indiana,2004,3678,8056,110,11844,0.3105369807497467,0.6801756163458291,0.009287402904424182,-66,-101,844,677,-0.024736593173419752,-0.009607555455027776,0.03434414862844759,-4378,-910,-0.3696386355960824,-0.05908074180186734
3521,18073,Jasper,Indiana,2008,5044,7669,200,12913,0.39061410981181754,0.5938976225509177,0.015488267637264772,1366,90,-387,1069,0.08007712906207082,0.006200864732840591,-0.08627799379491141,-2625,1753,-0.20328351273910017,0.16635512285698223
3522,18073,Jasper,Indiana,2012,4672,7955,293,12920,0.36160990712074303,0.6157120743034056,0.022678018575851392,-372,93,286,7,-0.02900420269107451,0.00718975093858662,0.021814451752487862,-3283,-658,-0.25410216718266254,-0.05081865444356237
3523,18073,Jasper,Indiana,2016,3329,9382,667,13378,0.24884138137240244,0.7013006428464643,0.049857975781133206,-1343,374,1427,458,-0.11276852574834059,0.027179957205281813,0.08558856854305874,-6053,-2770,-0.4524592614740619,-0.19835709429139936
3524,18075,Jay,Indiana,2000,3167,4687,176,8030,0.39439601494396015,0.5836861768368617,0.021917808219178082,0,0,0,0,0.0,0.0,0.0,-1520,0,-0.1892901618929016,0.0
3525,18075,Jay,Indiana,2004,2740,5427,65,8232,0.3328474246841594,0.6592565597667639,0.007896015549076773,-427,-111,740,202,-0.06154859025980075,-0.01402179267010131,0.07557038292990215,-2687,-1167,-0.3264091350826045,-0.1371189731897029
3526,18075,Jay,Indiana,2008,3748,4401,174,8323,0.45031839480956387,0.5287756818454884,0.020905923344947737,1008,109,-1026,91,0.11747097012540447,0.013009907795870964,-0.1304808779212755,-653,2034,-0.07845728703592453,0.24795184804667997
3527,18075,Jay,Indiana,2012,3063,4645,193,7901,0.3876724465257562,0.5879002657891406,0.02442728768510315,-685,19,244,-422,-0.06264594828380765,0.0035213643401554133,0.059124583943652165,-1582,-929,-0.20022781926338434,-0.12177053222745982
3528,18075,Jay,Indiana,2016,1889,5697,400,7986,0.2365389431505134,0.713373403456048,0.05008765339343852,-1174,207,1052,85,-0.1511335033752428,0.02566036570833537,0.12547313766690749,-3808,-2226,-0.47683446030553467,-0.2766066410421503
3529,18077,Jefferson,Indiana,2000,5117,6582,232,11931,0.42888274243567176,0.5516721146592909,0.019445142905037297,0,0,0,0,0.0,0.0,0.0,-1465,0,-0.12278937222361913,0.0
3530,18077,Jefferson,Indiana,2004,5117,7763,91,12971,0.3944954128440367,0.5984889368591473,0.007015650296815974,0,-141,1181,1040,-0.03438732959163504,-0.012429492608221324,0.04681682219985639,-2646,-1181,-0.20399352401511056,-0.08120415179149143
3531,18077,Jefferson,Indiana,2008,6255,7053,202,13510,0.46299037749814953,0.5220577350111029,0.014951887490747594,1138,111,-710,539,0.06849496465411281,0.00793623719393162,-0.07643120184804442,-798,1848,-0.059067357512953333,0.14492616650215723
3532,18077,Jefferson,Indiana,2012,5728,7096,332,13156,0.4353906962602615,0.5393736698084525,0.025235633931286104,-527,130,43,-354,-0.02759968123788803,0.01028374644053851,0.017315934797349608,-1368,-570,-0.10398297354819097,-0.04491561603523764
3533,18077,Jefferson,Indiana,2016,4326,8546,781,13653,0.3168534388046583,0.6259430161869186,0.057203545008423055,-1402,449,1450,497,-0.11853725745560317,0.03196791107713695,0.08656934637846614,-4220,-2852,-0.3090895773822603,-0.2051066038340693
3534,18079,Jennings,Indiana,2000,3549,5732,213,9494,0.37381504107857594,0.6037497366757952,0.022435222245628817,0,0,0,0,0.0,0.0,0.0,-2183,0,-0.2299346955972193,0.0
3535,18079,Jennings,Indiana,2004,3538,6864,115,10517,0.33640772083293713,0.6526576019777504,0.010934677189312542,-11,-98,1132,1023,-0.03740732024563881,-0.011500545056316275,0.04890786530195512,-3326,-1143,-0.3162498811448132,-0.08631518554759393
3536,18079,Jennings,Indiana,2008,5312,6261,266,11839,0.44868654447166145,0.5288453416673705,0.022468113860967986,1774,151,-603,1322,0.11227882363872432,0.011533436671655444,-0.12381226031037984,-949,2377,-0.08015879719570906,0.23609108394910416
3537,18079,Jennings,Indiana,2012,3821,6120,309,10250,0.37278048780487805,0.5970731707317073,0.030146341463414633,-1491,43,-141,-1589,-0.0759060566667834,0.007678227602446647,0.06822782906433678,-2299,-1350,-0.22429268292682925,-0.14413388573112018
3538,18079,Jennings,Indiana,2016,2364,8224,562,11150,0.21201793721973095,0.7375784753363229,0.050403587443946185,-1457,253,2104,900,-0.1607625505851471,0.020257245980531552,0.14050530460461563,-5860,-3561,-0.525560538116592,-0.30126785518976273
3539,18081,Johnson,Indiana,2000,11952,29404,928,42284,0.2826601078422098,0.6953930564752625,0.02194683568252767,0,0,0,0,0.0,0.0,0.0,-17452,0,-0.4127329486330527,0.0
3540,18081,Johnson,Indiana,2004,13109,37765,381,51255,0.2557604136181836,0.7368061652521706,0.007433421129645889,1157,-547,8361,8971,-0.026899694224026216,-0.014513414552881783,0.04141310877690807,-24656,-7204,-0.481045751633987,-0.06831280300093429
3541,18081,Johnson,Indiana,2008,21553,36487,746,58786,0.36663491307454155,0.6206749906440309,0.012690096281427551,8444,365,-1278,7531,0.11087449945635797,0.0052566751517816625,-0.11613117460813971,-14934,9722,-0.2540400775694893,0.22700567406449768
3542,18081,Johnson,Indiana,2012,17260,39513,1319,58092,0.29711492115954,0.6801797149349308,0.02270536390552916,-4293,573,3026,-694,-0.06951999191500152,0.01001526762410161,0.059504724290899924,-22253,-7319,-0.38306479377539077,-0.12902471620590145
3543,18081,Johnson,Indiana,2016,17318,45456,4373,67147,0.25791174587099946,0.6769624852934606,0.06512576883553993,58,3054,5943,9055,-0.03920317528854056,0.04242040493001077,-0.0032172296414701984,-28138,-5885,-0.4190507394224611,-0.03598594564707036
3544,18083,Knox,Indiana,2000,6300,8485,269,15054,0.4184934236747708,0.5636375714095921,0.01786900491563704,0,0,0,0,0.0,0.0,0.0,-2185,0,-0.14514414773482132,0.0
3545,18083,Knox,Indiana,2004,5649,9990,107,15746,0.3587577797535882,0.6344468436428299,0.006795376603581862,-651,-162,1505,692,-0.059735643921182635,-0.011073628312055177,0.07080927223323774,-4341,-2156,-0.2756890638892417,-0.13054491615442038
3546,18083,Knox,Indiana,2008,7569,8639,216,16424,0.460849975645397,0.5259985387238189,0.013151485630784217,1920,109,-1351,678,0.10209219589180879,0.006356109027202355,-0.10844830491901103,-1070,3271,-0.06514856307842187,0.21054050081081982
3547,18083,Knox,Indiana,2012,5228,9612,305,15145,0.34519643446682075,0.634664905909541,0.020138659623638165,-2341,89,973,-1279,-0.11565354117857624,0.006987173992853948,0.1086663671857222,-4384,-3314,-0.2894684714427203,-0.22431990836429844
3548,18083,Knox,Indiana,2016,3772,11077,667,15516,0.24310389275586491,0.7139082237690126,0.04298788347512245,-1456,362,1465,371,-0.10209254171095583,0.022849223851484288,0.07924331785947158,-7305,-2921,-0.4708043310131477,-0.18133585957042742
3549,18085,Kosciusko,Indiana,2000,5785,19040,459,25284,0.22880082265464324,0.7530454042081949,0.018153773137161842,0,0,0,0,0.0,0.0,0.0,-13255,0,-0.5242445815535517,0.0
3550,18085,Kosciusko,Indiana,2004,5977,22136,247,28360,0.2107545839210155,0.7805359661495064,0.008709449929478138,192,-212,3096,3076,-0.018046238733627734,-0.009444323207683705,0.027490561941311498,-16159,-2904,-0.5697813822284908,-0.04553680067493915
3551,18085,Kosciusko,Indiana,2008,9236,20488,461,30185,0.3059797912870631,0.6787477223786649,0.015272486334271989,3259,214,-1648,1825,0.09522520736604759,0.006563036404793851,-0.1017882437708415,-11252,4907,-0.3727679310916018,0.19701345113688906
3552,18085,Kosciusko,Indiana,2012,6862,22558,720,30140,0.22767086927670868,0.7484406104844061,0.023888520238885203,-2374,259,2070,-45,-0.07830892201035441,0.008616033904613215,0.06969288810574126,-15696,-4444,-0.5207697412076975,-0.1480018101160957
3553,18085,Kosciusko,Indiana,2016,6313,23935,2193,32441,0.19459942665145957,0.7378009309207484,0.067599642427792,-549,1473,1377,2301,-0.03307144262524911,0.0437111221889068,-0.010639679563657745,-17622,-1926,-0.5432015042692888,-0.022431763061591337
3554,18087,LaGrange,Indiana,2000,2733,5437,163,8333,0.327973118924757,0.6524660986439458,0.01956078243129725,0,0,0,0,0.0,0.0,0.0,-2704,0,-0.3244929797191888,0.0
3555,18087,LaGrange,Indiana,2004,2523,6430,50,9003,0.28023992002665776,0.7142063756525603,0.005553704320781961,-210,-113,993,670,-0.04773319889809924,-0.014007078110515289,0.06174027700861451,-3907,-1203,-0.4339664556259025,-0.10947347590671375
3556,18087,LaGrange,Indiana,2008,3663,5702,170,9535,0.384163607760881,0.5980073413738857,0.01782905086523335,1140,120,-728,532,0.10392368773422322,0.012275346544451388,-0.11619903427867462,-2039,1868,-0.21384373361300468,0.22012272201289784
3557,18087,LaGrange,Indiana,2012,2898,6231,187,9316,0.311077715757836,0.6688492915414341,0.020072992700729927,-765,17,529,-219,-0.073085892003045,0.0022439418354965775,0.07084195016754846,-3333,-1294,-0.35777157578359814,-0.14392784217059346
3558,18087,LaGrange,Indiana,2016,2080,7025,461,9566,0.2174367551745766,0.7343717332218272,0.04819151160359607,-818,274,794,250,-0.09364096058325938,0.02811851890286614,0.06552244168039312,-4945,-1612,-0.5169349780472506,-0.1591634022636525
3559,18089,Lake,Indiana,2000,109078,63389,3527,175994,0.6197824925849745,0.3601770514903917,0.020040455924633795,0,0,0,0,0.0,0.0,0.0,45689,0,0.25960544109458283,0.0
3560,18089,Lake,Indiana,2004,114743,71903,1376,188022,0.6102636925466168,0.3824180149131485,0.0073182925402346536,5665,-2151,8514,12028,-0.0095188000383577,-0.012722163384399143,0.022240963422756777,42840,-2849,0.22784567763346836,-0.031759763461114476
3561,18089,Lake,Indiana,2008,139301,67742,1996,209039,0.6663876118810366,0.32406393065408845,0.009548457464874975,24558,620,-4161,21017,0.056123919334419736,0.0022301649246403215,-0.058354084259060024,71559,28719,0.3423236812269481,0.11447800359347976
3562,18089,Lake,Indiana,2012,130897,68431,2819,202147,0.6475337254572168,0.33852097730859226,0.01394529723419096,-8404,823,689,-6892,-0.0188538864238198,0.0043968397693159855,0.014457046654503813,62466,-9093,0.3090127481486245,-0.03331093307832361
3563,18089,Lake,Indiana,2016,116935,75625,10241,202801,0.5765997209086741,0.37290250048076684,0.05049777861055912,-13962,7422,7194,654,-0.0709340045485427,0.03655248137636816,0.03438152317217458,41310,-21156,0.20369722042790722,-0.10531552772071728
3564,18091,LaPorte,Indiana,2000,19736,18994,1017,39747,0.4965406194178177,0.47787254383978667,0.025586836742395654,0,0,0,0,0.0,0.0,0.0,742,0,0.018668075578031018,0.0
3565,18091,LaPorte,Indiana,2004,21114,20916,576,42606,0.4955640050697085,0.4909167722855936,0.01351922264469793,1378,-441,1922,2859,-0.000976614348109195,-0.012067614097697724,0.013044228445806938,198,-544,0.004647232784114885,-0.014020842793916133
3566,18091,LaPorte,Indiana,2008,28258,17918,842,47018,0.6010038708579692,0.38108809392147686,0.01790803522055383,7144,266,-2998,4412,0.10543986578826076,0.004388812575855902,-0.10982867836411675,10340,10142,0.2199157769364924,0.2152685441523775
3567,18091,LaPorte,Indiana,2012,24107,18615,959,43681,0.5518875483619881,0.4261578260570958,0.02195462558091619,-4151,117,697,-3337,-0.04911632249598119,0.004046590360362357,0.045069732135618934,5492,-4848,0.12572972230489227,-0.09418605463160012
3568,18091,LaPorte,Indiana,2016,19798,22687,3124,45609,0.4340809927865114,0.4974237540836238,0.06849525312986472,-4309,2165,4072,1928,-0.11780655557547665,0.046540627548948534,0.07126592802652804,-2889,-8381,-0.06334276129711242,-0.18907248360200468
3569,18093,Lawrence,Indiana,2000,5071,10677,394,16142,0.314149423863214,0.6614422004708215,0.024408375665964564,0,0,0,0,0.0,0.0,0.0,-5606,0,-0.3472927766076075,0.0
3570,18093,Lawrence,Indiana,2004,5346,12207,145,17698,0.302068030285908,0.6897389535540739,0.008193016160018081,275,-249,1530,1556,-0.012081393577305977,-0.016215359505946485,0.028296753083252413,-6861,-1255,-0.3876709232681659,-0.04037814666055839
3571,18093,Lawrence,Indiana,2008,7208,11018,308,18534,0.3889068738534585,0.5944750188842128,0.016618107262328694,1862,163,-1189,836,0.0868388435675505,0.008425091102310612,-0.09526393466986105,-3810,3051,-0.20556814503075432,0.18210277823741156
3572,18093,Lawrence,Indiana,2012,5779,11622,469,17870,0.3233911583659765,0.6503637381085619,0.026245103525461666,-1429,161,604,-664,-0.06551571548748203,0.009626996263132973,0.055888719224349015,-5843,-2033,-0.32697257974258537,-0.12140443471183104
3573,18093,Lawrence,Indiana,2016,4210,14035,907,19152,0.2198203842940685,0.7328216374269005,0.04735797827903091,-1569,438,2413,1282,-0.10357077407190798,0.021112874753569245,0.08245789931833869,-9825,-3982,-0.5130012531328321,-0.1860286733902467
3574,18095,Madison,Indiana,2000,23403,27956,857,52216,0.4481959552627547,0.535391450896277,0.016412593840968284,0,0,0,0,0.0,0.0,0.0,-4553,0,-0.08719549563352236,0.0
3575,18095,Madison,Indiana,2004,21882,32526,447,54855,0.3989062072737216,0.5929450369155045,0.008148755810773858,-1521,-410,4570,2639,-0.04928974798903307,-0.008263838030194426,0.05755358601922744,-10644,-6091,-0.19403882964178287,-0.10684333400826052
3576,18095,Madison,Indiana,2008,30152,26403,889,57444,0.5248938096232852,0.45963024858993107,0.01547594178678365,8270,442,-6123,2589,0.12598760234956363,0.007327185976009792,-0.13331478832557342,3749,14393,0.06526356103335418,0.25930239067513705
3577,18095,Madison,Indiana,2012,24407,26769,1334,52510,0.4648067034850505,0.5097886116930108,0.025404684821938677,-5745,445,366,-4934,-0.06008710613823476,0.009928743035155027,0.05015836310307975,-2362,-6111,-0.04498190820796033,-0.11024546924131451
3578,18095,Madison,Indiana,2016,18595,32376,3406,54377,0.3419644334921014,0.5953987899295659,0.06263677657833275,-5812,2072,5607,1867,-0.12284226999294906,0.03723209175639407,0.08561017823655503,-13781,-11419,-0.2534343564374644,-0.2084524482295041
3579,18097,Marion,Indiana,2000,134189,137810,7904,279903,0.47941251076265706,0.4923491352361354,0.028238354001207562,0,0,0,0,0.0,0.0,0.0,-3621,0,-0.01293662447347832,0.0
3580,18097,Marion,Indiana,2004,162249,156072,2517,320838,0.5057038131393413,0.4864511061657285,0.007845080694930152,28060,-5387,18262,40935,0.026291302376684256,-0.02039327330627741,-0.005898029070406874,6177,9798,0.01925270697361281,0.03218933144709113
3581,18097,Marion,Indiana,2008,241987,134313,3790,380090,0.6366571075271646,0.3533715698913415,0.009971322581493856,79738,1273,-21759,59252,0.13095329438782333,0.0021262418865637036,-0.133079536274387,107674,101497,0.28328553763582315,0.26403283066221034
3582,18097,Marion,Indiana,2012,216336,136509,7127,359972,0.6009800762281511,0.3792211616459058,0.01979876212594313,-25651,3337,2196,-20118,-0.03567703129901356,0.009827439544449272,0.025849591754564305,79827,-27847,0.22175891458224528,-0.06152662305357787
3583,18097,Marion,Indiana,2016,212899,130360,23620,366879,0.5802975913039449,0.3553215092714492,0.06438089942460594,-3437,16493,-6149,6907,-0.020682484924206213,0.04458213729866281,-0.023899652374456626,82539,2712,0.2249760820324957,0.0032171674502504133
3584,18099,Marshall,Indiana,2000,5541,10266,343,16150,0.34309597523219815,0.6356656346749227,0.021238390092879256,0,0,0,0,0.0,0.0,0.0,-4725,0,-0.2925696594427245,0.0
3585,18099,Marshall,Indiana,2004,5593,12074,147,17814,0.3139665431682946,0.6777815201526889,0.008251936679016504,52,-196,1808,1664,-0.02912943206390356,-0.012986453413862752,0.042115885477766235,-6481,-1756,-0.3638149769843943,-0.0712453175416698
3586,18099,Marshall,Indiana,2008,7889,10406,276,18571,0.42480211081794195,0.5603360077540251,0.014861881428032955,2296,129,-1668,757,0.11083556764964736,0.006609944749016451,-0.11744551239866374,-2517,3964,-0.1355338969360832,0.2282810800483111
3587,18099,Marshall,Indiana,2012,6137,11260,404,17801,0.34475591258918037,0.632548733217235,0.02269535419358463,-1752,128,854,-770,-0.08004619822876158,0.007833472765551673,0.07221272546320989,-5123,-2606,-0.28779282062805467,-0.15225892369197147
3588,18099,Marshall,Indiana,2016,4798,12288,1155,18241,0.26303382489995064,0.6736472781097528,0.06331889699029658,-1339,751,1028,440,-0.08172208768922973,0.04062354279671195,0.04109854489251774,-7490,-2367,-0.41061345320980214,-0.12282063258174747
3589,18101,Martin,Indiana,2000,1518,3008,83,4609,0.32935560859188545,0.6526361466695596,0.018008244738555,0,0,0,0,0.0,0.0,0.0,-1490,0,-0.32328053807767415,0.0
3590,18101,Martin,Indiana,2004,1522,3414,60,4996,0.30464371497197756,0.6833466773418735,0.01200960768614892,4,-23,406,387,-0.024711893619907888,-0.005998637052406082,0.030710530672313885,-1892,-402,-0.3787029623698959,-0.05542242429222177
3591,18101,Martin,Indiana,2008,1706,3122,75,4903,0.34795023455027535,0.6367530083622273,0.015296757087497451,184,15,-292,-93,0.043306519578297786,0.003287149401348532,-0.04659366897964623,-1416,476,-0.2888027738119519,0.08990018855794402
3592,18101,Martin,Indiana,2012,1351,3262,130,4743,0.28484081804764916,0.6877503689647902,0.027408812987560614,-355,55,140,-160,-0.06310941650262619,0.012112055900063163,0.05099736060256299,-1911,-495,-0.4029095509171411,-0.11410677710518918
3593,18101,Martin,Indiana,2016,881,3697,231,4809,0.18319817009773343,0.76876689540445,0.048034934497816595,-470,101,435,66,-0.10164264794991573,0.02062612151025598,0.08101652643965973,-2816,-905,-0.5855687253067166,-0.18265917438957546
3594,18103,Miami,Indiana,2000,4155,8401,372,12928,0.3213954207920792,0.6498298267326733,0.028774752475247526,0,0,0,0,0.0,0.0,0.0,-4246,0,-0.3284344059405941,0.0
3595,18103,Miami,Indiana,2004,3886,9600,142,13628,0.2851482242442031,0.7044320516583504,0.010419724097446435,-269,-230,1199,700,-0.036247196547876115,-0.01835502837780109,0.05460222492567712,-5714,-1468,-0.4192838274141473,-0.09084942147355324
3596,18103,Miami,Indiana,2008,5564,8312,280,14156,0.39304888386549874,0.5871715173777904,0.019779598756710936,1678,138,-1288,528,0.10790065962129564,0.009359874659264501,-0.11726053428056005,-2748,2966,-0.19412263351229164,0.22516119390185568
3597,18103,Miami,Indiana,2012,4222,8174,417,12813,0.32950909232810427,0.6379458362600484,0.03254507141184734,-1342,137,-138,-1343,-0.06353979153739447,0.012765472655136407,0.05077431888225803,-3952,-1204,-0.30843674393194415,-0.1143141104196525
3598,18103,Miami,Indiana,2016,2766,9975,741,13482,0.20516243880729862,0.7398753894080997,0.05496217178460169,-1456,324,1801,669,-0.12434665352080565,0.02241710037275435,0.1019295531480513,-7209,-3257,-0.534712950600801,-0.2262762066688569
3599,18105,Monroe,Indiana,2000,17523,19147,3550,40220,0.4356787667826952,0.4760566882148185,0.08826454500248633,0,0,0,0,0.0,0.0,0.0,-1624,0,-0.04037792143212332,0.0
3600,18105,Monroe,Indiana,2004,26965,22834,668,50467,0.5343095488140766,0.45245407890304556,0.01323637228287792,9442,-2882,3687,10247,0.09863078203138137,-0.0750281727196084,-0.023602609311772937,4131,5755,0.08185546991103099,0.12223339134315431
3601,18105,Monroe,Indiana,2008,41450,21118,819,63387,0.653919573414107,0.3331597961727168,0.012920630413176204,14485,151,-1716,12920,0.11961002460003045,-0.0003157418697017165,-0.11929428273032877,20332,16201,0.3207597772413902,0.23890430733035922
3602,18105,Monroe,Indiana,2012,33436,22481,1306,57223,0.5843105045174143,0.3928665047271202,0.02282299075546546,-8014,487,1363,-6164,-0.06960906889669272,0.009902360342289255,0.05970670855440341,10955,-9377,0.19144399979029408,-0.12931577745109613
3603,18105,Monroe,Indiana,2016,34216,20592,3646,58454,0.58534916344476,0.3522770041400075,0.06237383241523249,780,2340,-1889,1231,0.0010386589273456703,0.039550841659767036,-0.04058950058711269,13624,2669,0.23307215930475245,0.04162815951445836
3604,18107,Montgomery,Indiana,2000,3899,8891,311,13101,0.2976108693992825,0.6786504846958248,0.023738645904892757,0,0,0,0,0.0,0.0,0.0,-4992,0,-0.3810396152965423,0.0
3605,18107,Montgomery,Indiana,2004,3536,10901,111,14548,0.24305746494363487,0.749312620291449,0.00762991476491614,-363,-200,2010,1447,-0.05455340445564763,-0.016108731139976618,0.07066213559562418,-7365,-2373,-0.5062551553478141,-0.12521554005127178
3606,18107,Montgomery,Indiana,2008,6013,9060,212,15285,0.39339221458946677,0.592737978410206,0.013869807000327118,2477,101,-1841,737,0.1503347496458319,0.006239892235410978,-0.15657464188124293,-3047,4318,-0.19934576382073926,0.3069093915270748
3607,18107,Montgomery,Indiana,2012,4271,9824,345,14440,0.29577562326869805,0.6803324099722992,0.02389196675900277,-1742,133,764,-845,-0.09761659132076872,0.010022159758675653,0.08759443156209312,-5553,-2506,-0.3845567867036011,-0.18521102288286184
3608,18107,Montgomery,Indiana,2016,3362,11059,735,15156,0.22182633940353655,0.729678015307469,0.04849564528899446,-909,390,1235,716,-0.0739492838651615,0.024603678529991686,0.04934560533516985,-7697,-2144,-0.5078516759039324,-0.12329488920033133
3609,18109,Morgan,Indiana,2000,6228,15286,522,22036,0.2826284262116537,0.693683064076965,0.023688509711381377,0,0,0,0,0.0,0.0,0.0,-9058,0,-0.4110546378653113,0.0
3610,18109,Morgan,Indiana,2004,6650,19197,182,26029,0.25548426754773523,0.7375235314456952,0.0069922010065695955,422,-340,3911,3993,-0.02714415866391845,-0.016696308704811782,0.04384046736873015,-12547,-3489,-0.4820392638979599,-0.0709846260326486
3611,18109,Morgan,Indiana,2008,10330,18129,352,28811,0.3585436118149318,0.6292388323904065,0.012217555794661761,3680,170,-1068,2782,0.10305934426719654,0.005225354788092166,-0.1082846990552887,-7799,4748,-0.2706952205754747,0.21134404332248524
3612,18109,Morgan,Indiana,2012,7969,19591,765,28325,0.28134157105030894,0.6916504854368932,0.02700794351279788,-2361,413,1462,-486,-0.07720204076462284,0.014790387718136119,0.06241165304648677,-11622,-3823,-0.4103089143865843,-0.1396136938111096
3613,18109,Morgan,Indiana,2016,6040,23674,1732,31446,0.19207530369522355,0.752846148953762,0.05507854735101444,-1929,967,4083,3121,-0.08926626735508539,0.028070603838216558,0.06119566351686878,-17634,-6012,-0.5607708452585385,-0.1504619308719542
3614,18111,Newton,Indiana,2000,2101,3250,159,5510,0.3813067150635209,0.5898366606170599,0.02885662431941924,0,0,0,0,0.0,0.0,0.0,-1149,0,-0.208529945553539,0.0
3615,18111,Newton,Indiana,2004,2032,3757,59,5848,0.34746922024623805,0.6424418604651163,0.01008891928864569,-69,-100,507,338,-0.03383749481728282,-0.018767705030773546,0.05260519984805645,-1725,-576,-0.29497264021887826,-0.08644269466533927
3616,18111,Newton,Indiana,2008,2625,3301,128,6054,0.433597621407334,0.5452593326726132,0.021143045920052856,593,69,-456,206,0.08612840116109594,0.011054126631407165,-0.09718252779250314,-676,1049,-0.11166171126527918,0.18331092895359907
3617,18111,Newton,Indiana,2012,2212,3291,169,5672,0.3899858956276446,0.5802186177715092,0.02979548660084626,-413,41,-10,-382,-0.043611725779689414,0.008652440680793405,0.03495928509889601,-1079,-403,-0.1902327221438646,-0.07857101087858542
3618,18111,Newton,Indiana,2016,1404,4077,314,5795,0.24227782571182052,0.7035375323554789,0.0541846419327006,-808,145,786,123,-0.14770806991582405,0.024389155331854342,0.12331891458396971,-2673,-1594,-0.46125970664365834,-0.27102698449979373
3619,18113,Noble,Indiana,2000,4822,9103,291,14216,0.3391952729319077,0.6403348339898706,0.020469893078221724,0,0,0,0,0.0,0.0,0.0,-4281,0,-0.30113956105796286,0.0
3620,18113,Noble,Indiana,2004,4703,10859,117,15679,0.2999553542955546,0.6925824351042796,0.007462210600165827,-119,-174,1756,1463,-0.03923991863635312,-0.013007682478055897,0.05224760111440907,-6156,-1875,-0.39262708080872505,-0.09148751975076219
3621,18113,Noble,Indiana,2008,7064,9673,270,17007,0.41535838184277063,0.5687658023166932,0.01587581584053625,2361,153,-1186,1328,0.11540302754721604,0.008413605240370423,-0.12381663278758648,-2609,3547,-0.15340742047392253,0.23921966033480252
3622,18113,Noble,Indiana,2012,5229,10680,364,16273,0.3213298101149143,0.65630184968967,0.02236834019541572,-1835,94,1007,-734,-0.09402857172785634,0.006492524354879469,0.08753604737297682,-5451,-2842,-0.3349720395747557,-0.18156461910083316
3623,18113,Noble,Indiana,2016,3904,12198,1002,17104,0.22825070159027128,0.7131665107577175,0.05858278765201123,-1325,638,1518,831,-0.09307910852464302,0.03621444745659551,0.05686466106804755,-8294,-2843,-0.48491580916744625,-0.14994376959269057
3624,18115,Ohio,Indiana,2000,951,1515,26,2492,0.3816211878009631,0.6079454253611557,0.01043338683788122,0,0,0,0,0.0,0.0,0.0,-564,0,-0.2263242375601926,0.0
3625,18115,Ohio,Indiana,2004,1139,1796,23,2958,0.3850574712643678,0.6071670047329276,0.00777552400270453,188,-3,281,466,0.003436283463404688,-0.0026578628351766904,-0.0007784206282280826,-657,-93,-0.22210953346855983,0.0042147040916327705
3626,18115,Ohio,Indiana,2008,1158,1713,47,2918,0.3968471555860178,0.5870459218642906,0.01610692254969157,19,24,-83,-40,0.011789684321650007,0.00833139854698704,-0.020121082868637008,-555,102,-0.1901987662782728,0.031910767190287015
3627,18115,Ohio,Indiana,2012,994,1759,66,2819,0.3526073075558709,0.6239801347995744,0.023412557644554806,-164,19,46,-99,-0.04423984803014691,0.007305635094863237,0.03693421293528376,-765,-210,-0.2713728272437035,-0.08117406096543067
3628,18115,Ohio,Indiana,2016,686,2118,117,2921,0.23485107839780897,0.7250941458404656,0.040054775761725434,-308,51,359,102,-0.11775622915806191,0.016642218117170628,0.10111401104089124,-1432,-667,-0.49024306744265667,-0.21887024019895318
3629,18117,Orange,Indiana,2000,2601,4687,170,7458,0.3487530168946098,0.6284526682756771,0.022794314829713058,0,0,0,0,0.0,0.0,0.0,-2086,0,-0.27969965138106734,0.0
3630,18117,Orange,Indiana,2004,2885,5683,84,8652,0.3334489135460009,0.6568423485899214,0.009708737864077669,284,-86,996,1194,-0.015304103348608877,-0.01308557696563539,0.02838968031424427,-2798,-712,-0.3233934350439205,-0.04369378366285315
3631,18117,Orange,Indiana,2008,3390,4536,182,8108,0.4181055747409965,0.5594474592994573,0.022446965959546126,505,98,-1147,-544,0.0846566611949956,0.012738228095468457,-0.09739488929046414,-1146,1652,-0.14134188455846075,0.18205155048545973
3632,18117,Orange,Indiana,2012,2939,4617,220,7776,0.37795781893004116,0.59375,0.028292181069958847,-451,38,81,-332,-0.040147755810955366,0.0058452151104127215,0.03430254070054273,-1678,-532,-0.21579218106995884,-0.07445029651149809
3633,18117,Orange,Indiana,2016,2048,5803,341,8192,0.25,0.7083740234375,0.0416259765625,-891,121,1186,416,-0.12795781893004116,0.013333795492541153,0.1146240234375,-3755,-2077,-0.4583740234375,-0.24258184236754116
3634,18119,Owen,Indiana,2000,2253,4019,231,6503,0.34645548208519145,0.6180224511763801,0.03552206673842842,0,0,0,0,0.0,0.0,0.0,-1766,0,-0.27156696909118866,0.0
3635,18119,Owen,Indiana,2004,2536,5000,68,7604,0.3335086796422935,0.6575486586007364,0.008942661756970016,283,-163,981,1101,-0.01294680244289792,-0.026579404981458405,0.03952620742435631,-2464,-698,-0.3240399789584429,-0.05247300986725423
3636,18119,Owen,Indiana,2008,3570,4415,185,8170,0.4369645042839657,0.5403916768665851,0.022643818849449205,1034,117,-585,566,0.10345582464167219,0.01370115709247919,-0.11715698173415134,-845,1619,-0.10342717258261935,0.22061280637582353
3637,18119,Owen,Indiana,2012,2823,5062,228,8113,0.3479600640946629,0.62393689140885,0.02810304449648712,-747,43,647,-57,-0.08900444018930281,0.005459225647037914,0.08354521454226493,-2239,-1394,-0.2759768273141871,-0.17254965473156775
3638,18119,Owen,Indiana,2016,1946,6153,458,8557,0.22741615052004208,0.7190604183709244,0.05352343110903354,-877,230,1091,444,-0.12054391357462083,0.025420386612546423,0.09512352696207438,-4207,-1968,-0.49164426785088233,-0.21566744053669523
3639,18121,Parke,Indiana,2000,2481,3841,125,6447,0.3848301535597953,0.5957809834031332,0.019388863037071505,0,0,0,0,0.0,0.0,0.0,-1360,0,-0.21095082984333796,0.0
3640,18121,Parke,Indiana,2004,2362,4550,59,6971,0.3388323052646679,0.6527040596757997,0.008463635059532348,-119,-66,709,524,-0.045997848295127375,-0.010925227977539156,0.05692307627266646,-2188,-828,-0.3138717544111318,-0.10292092456779384
3641,18121,Parke,Indiana,2008,2924,3909,157,6990,0.4183118741058655,0.5592274678111588,0.02246065808297568,562,98,-641,19,0.07947956884119761,0.013997023023443331,-0.09347659186464086,-985,1203,-0.14091559370529333,0.17295616070583847
3642,18121,Parke,Indiana,2012,2110,4234,185,6529,0.3231735334660744,0.648491346301118,0.028335120232807473,-814,28,325,-461,-0.0951383406397911,0.005874462149831793,0.0892638784899592,-2124,-1139,-0.32531781283504363,-0.1844022191297503
3643,18121,Parke,Indiana,2016,1441,4863,332,6636,0.21714888487040385,0.7328209764918626,0.050030138637733576,-669,147,629,107,-0.10602464859567057,0.021695018404926103,0.08432963019074458,-3422,-1298,-0.5156720916214588,-0.19035427878641514
3644,18123,Perry,Indiana,2000,3823,3461,103,7387,0.5175307973466902,0.4685257885474482,0.013943414105861649,0,0,0,0,0.0,0.0,0.0,362,0,0.04900500879924197,0.0
3645,18123,Perry,Indiana,2004,4131,4137,47,8315,0.4968129885748647,0.4975345760673482,0.0056524353577871314,308,-56,676,928,-0.02071780877182544,-0.008290978748074516,0.029008787519899992,-6,-368,-0.0007215874924834664,-0.04972659629172543
3646,18123,Perry,Indiana,2008,5141,3202,147,8490,0.6055359246171967,0.37714958775029445,0.017314487632508833,1010,100,-935,175,0.10872293604233202,0.011662052274721703,-0.12038498831705374,1939,1945,0.2283863368669023,0.22910792435938576
3647,18123,Perry,Indiana,2012,4316,3403,156,7875,0.548063492063492,0.43212698412698414,0.019809523809523808,-825,9,201,-615,-0.05747243255370471,0.0024950361770149747,0.05497739637668969,913,-1026,0.1159365079365079,-0.1124498289303944
3648,18123,Perry,Indiana,2016,3062,4556,437,8055,0.3801365611421477,0.5656114214773432,0.054252017380509,-1254,281,1153,180,-0.1679269309213443,0.034442493570985194,0.1334844373503591,-1494,-2407,-0.1854748603351955,-0.3014113682717034
3649,18125,Pike,Indiana,2000,2605,3566,131,6302,0.41336083782926053,0.5658521104411298,0.020787051729609648,0,0,0,0,0.0,0.0,0.0,-961,0,-0.1524912726118693,0.0
3650,18125,Pike,Indiana,2004,2418,3745,49,6212,0.3892466194462331,0.6028654217643271,0.007887958789439794,-187,-82,179,-90,-0.024114218383027408,-0.012899092940169854,0.037013311323197295,-1327,-366,-0.213618802318094,-0.061127529706224704
3651,18125,Pike,Indiana,2008,2700,3221,107,6028,0.44790975447909753,0.5343397478433974,0.017750497677504976,282,58,-524,-184,0.05866313503286441,0.009862538888065183,-0.06852567392092968,-521,806,-0.0864299933642999,0.12718880895379409
3652,18125,Pike,Indiana,2012,2125,3627,174,5926,0.35858926763415455,0.6120485993925076,0.029362132973337833,-575,67,406,-102,-0.08932048684494298,0.011611635295832857,0.07770885154911011,-1502,-981,-0.253459331758353,-0.1670293383940531
3653,18125,Pike,Indiana,2016,1297,4398,282,5977,0.2169984942278735,0.7358206458089342,0.04718085996319224,-828,108,771,51,-0.14159077340628104,0.017818726989854407,0.1237720464164267,-3101,-1599,-0.5188221515810607,-0.2653628198227077
3654,18127,Porter,Indiana,2000,26790,31157,1431,59378,0.45117720367812997,0.5247229613661626,0.0240998349557075,0,0,0,0,0.0,0.0,0.0,-4367,0,-0.07354575768803262,0.0
3655,18127,Porter,Indiana,2004,29388,34794,691,64873,0.45300818522343655,0.536340233995653,0.010651580780910394,2598,-740,3637,5495,0.001830981545306587,-0.013448254174797105,0.011617272629490416,-5406,-1039,-0.08333204877221645,-0.009786291084183829
3656,18127,Porter,Indiana,2008,39178,33857,1211,74246,0.5276782587614147,0.4560110982409827,0.016310642997602563,9790,520,-937,9373,0.07467007353797817,0.005659062216692169,-0.08032913575467032,5321,10727,0.07166716052043204,0.1549992092926485
3657,18127,Porter,Indiana,2012,37252,34406,1645,73303,0.5081920248830198,0.4693668744798985,0.022441100637081702,-1926,434,549,-943,-0.019486233878394876,0.006130457639479139,0.013355776238915817,2846,-2475,0.038825150403121345,-0.032842010117310694
3658,18127,Porter,Indiana,2016,33676,38832,5745,78253,0.43034771829834,0.4962365660102488,0.0734157156914112,-3576,4100,4426,4950,-0.07784430658467983,0.0509746150543295,0.026869691530350293,-5156,-8002,-0.06588884771190878,-0.10471399811503013
3659,18129,Posey,Indiana,2000,4430,6498,182,11110,0.39873987398739874,0.5848784878487849,0.01638163816381638,0,0,0,0,0.0,0.0,0.0,-2068,0,-0.1861386138613862,0.0
3660,18129,Posey,Indiana,2004,4085,7833,68,11986,0.3408142833305523,0.6535124311696979,0.005673285499749708,-345,-114,1335,876,-0.05792559065684644,-0.010708352664066674,0.068633943320913,-3748,-1680,-0.3126981478391456,-0.12655953397775943
3661,18129,Posey,Indiana,2008,5828,6804,139,12771,0.4563464098347819,0.53276955602537,0.010884034139848094,1743,71,-1029,785,0.11553212650422962,0.005210748640098386,-0.12074287514432791,-976,2772,-0.0764231461905881,0.23627500164855753
3662,18129,Posey,Indiana,2012,4533,7430,263,12226,0.3707672174055292,0.6077212497955178,0.02151153279895305,-1295,124,626,-545,-0.08557919242925272,0.010627498659104955,0.07495169377014776,-2897,-1921,-0.23695403238998858,-0.16053088619940048
3663,18129,Posey,Indiana,2016,3521,8404,542,12467,0.2824256035934868,0.6740996230047325,0.0434747734017807,-1012,279,974,241,-0.08834161381204242,0.02196324060282765,0.06637837320921469,-4883,-1986,-0.3916740194112457,-0.1547199870212571
3664,18131,Pulaski,Indiana,2000,1919,3497,102,5518,0.3477709314969192,0.6337441101848496,0.018484958318231243,0,0,0,0,0.0,0.0,0.0,-1578,0,-0.2859731786879304,0.0
3665,18131,Pulaski,Indiana,2004,1750,3797,67,5614,0.3117206982543641,0.676344852155326,0.01193444959030994,-169,-35,300,96,-0.036050233242555074,-0.006550508727921303,0.042600741970476474,-2047,-469,-0.3646241539009619,-0.07865097521303155
3666,18131,Pulaski,Indiana,2008,2466,3388,110,5964,0.4134808853118712,0.568075117370892,0.018443997317236754,716,43,-409,350,0.10176018705750711,0.006509547726926815,-0.10826973478443402,-922,1125,-0.1545942320590208,0.21002992184194114
3667,18131,Pulaski,Indiana,2012,1899,3366,134,5399,0.3517318021855899,0.6234487868123727,0.024819411002037415,-567,24,-22,-565,-0.0617490831262813,0.0063754136848006605,0.0553736694414807,-1467,-545,-0.2717169846267828,-0.117122752567762
3668,18131,Pulaski,Indiana,2016,1327,3854,278,5459,0.2430848140685107,0.7059901080784027,0.05092507785308665,-572,144,488,60,-0.10864698811707921,0.026105666851049234,0.08254132126602998,-2527,-1060,-0.462905294009892,-0.1911883093831092
3669,18133,Putnam,Indiana,2000,4123,7352,396,11871,0.34731699098643753,0.6193244040097717,0.03335860500379075,0,0,0,0,0.0,0.0,0.0,-3229,0,-0.2720074130233342,0.0
3670,18133,Putnam,Indiana,2004,4103,8908,125,13136,0.3123477466504263,0.678136419001218,0.009515834348355665,-20,-271,1556,1265,-0.03496924433601123,-0.023842770655435087,0.05881201499144628,-4805,-1576,-0.3657886723507917,-0.09378125932745751
3671,18133,Putnam,Indiana,2008,6334,8086,255,14675,0.43161839863713797,0.5510051107325383,0.01737649063032368,2231,130,-822,1539,0.11927065198671166,0.007860656281968015,-0.1271313082686797,-1752,3053,-0.11938671209540036,0.24640196025539135
3672,18133,Putnam,Indiana,2012,4507,9005,317,13829,0.325909320992118,0.6511678357075711,0.02292284330031094,-1827,62,919,-846,-0.10570907764501997,0.005546352669987261,0.10016272497503276,-4498,-2746,-0.3252585147154531,-0.20587180262005272
3673,18133,Putnam,Indiana,2016,3356,10637,722,14715,0.22806659870880056,0.7228678219503908,0.0490655793408087,-1151,405,1632,886,-0.09784272228331745,0.026142736040497758,0.0716999862428197,-7281,-2783,-0.49480122324159026,-0.16954270852613718
3674,18135,Randolph,Indiana,2000,3906,6020,206,10132,0.38551125148045795,0.5941571259376234,0.020331622581918674,0,0,0,0,0.0,0.0,0.0,-2114,0,-0.20864587445716543,0.0
3675,18135,Randolph,Indiana,2004,3812,7172,108,11092,0.3436711143166246,0.6465921384781824,0.009736747205192933,-94,-98,1152,960,-0.041840137163833335,-0.010594875376725741,0.052435012540559045,-3360,-1246,-0.3029210241615578,-0.09427514970439238
3676,18135,Randolph,Indiana,2008,4839,5788,195,10822,0.44714470523008687,0.5348364442801701,0.018018850489743117,1027,87,-1384,-270,0.10347359091346225,0.008282103284550184,-0.11175569419801235,-949,2411,-0.0876917390500832,0.2152292851114746
3677,18135,Randolph,Indiana,2012,3769,6218,215,10202,0.36943736522250537,0.6094883356204666,0.021074299157028034,-1070,20,430,-620,-0.0777073400075815,0.003055448667284917,0.07465189134029648,-2449,-1500,-0.2400509703979612,-0.152359231347878
3678,18135,Randolph,Indiana,2016,2446,7517,560,10523,0.23244321961417846,0.7143400171053882,0.05321676328043334,-1323,345,1299,321,-0.1369941456083269,0.0321424641234053,0.10485168148492163,-5071,-2622,-0.4818967974912097,-0.24184582709324853
3679,18137,Ripley,Indiana,2000,3498,6988,189,10675,0.3276814988290398,0.6546135831381733,0.017704918032786884,0,0,0,0,0.0,0.0,0.0,-3490,0,-0.3269320843091335,0.0
3680,18137,Ripley,Indiana,2004,3510,8224,100,11834,0.2966030082812236,0.6949467635626162,0.008450228156160216,12,-89,1236,1159,-0.031078490547816195,-0.009254689876626669,0.040333180424442894,-4714,-1224,-0.3983437552813926,-0.07141167097225909
3681,18137,Ripley,Indiana,2008,4187,7794,253,12234,0.34224292954062446,0.6370769985286905,0.020680071930684975,677,153,-430,400,0.04563992125940086,0.01222984377452476,-0.05786976503392571,-3607,1107,-0.294834068988066,0.10350968629332657
3682,18137,Ripley,Indiana,2012,3241,7484,290,11015,0.29423513390830686,0.679437131184748,0.026327734906945077,-946,37,-310,-1219,-0.04800779563231761,0.005647662976260102,0.042360132656057536,-4243,-636,-0.38520199727644117,-0.09036792828837514
3683,18137,Ripley,Indiana,2016,2471,9806,658,12935,0.19103208349439504,0.7580981832238114,0.05086973328179358,-770,368,2322,1920,-0.10320305041391181,0.024541998374848505,0.07866105203906337,-7335,-3092,-0.5670660997294164,-0.18186410245297518
3684,18139,Rush,Indiana,2000,2370,4749,165,7284,0.32537067545304776,0.6519769357495881,0.022652388797364087,0,0,0,0,0.0,0.0,0.0,-2379,0,-0.3266062602965404,0.0
3685,18139,Rush,Indiana,2004,2000,5363,58,7421,0.2695054574855141,0.722678884247406,0.007815658267079908,-370,-107,614,137,-0.05586521796753369,-0.014836730530284179,0.07070194849781786,-3363,-984,-0.45317342676189193,-0.12656716646535154
3686,18139,Rush,Indiana,2008,3229,4271,129,7629,0.4232533752785424,0.5598374623148512,0.016909162406606372,1229,71,-1092,208,0.15374791779302832,0.009093504139526464,-0.1628414219325548,-1042,2321,-0.1365840870363088,0.3165893397255831
3687,18139,Rush,Indiana,2012,2221,4633,172,7026,0.316111585539425,0.6594079134642755,0.02448050099629946,-1008,43,362,-603,-0.10714178973911742,0.007571338589693086,0.09957045114942431,-2412,-1370,-0.34329632792485054,-0.20671224088854173
3688,18139,Rush,Indiana,2016,1525,5292,397,7214,0.21139451067369006,0.7335736068755199,0.05503188245079013,-696,225,659,188,-0.10471707486573492,0.030551381454490673,0.07416569341124435,-3767,-1355,-0.5221790962018298,-0.17888276827697924
3689,18141,St. Joseph,Indiana,2000,47703,47581,2190,97474,0.48939204300634015,0.4881404271908406,0.022467529802819214,0,0,0,0,0.0,0.0,0.0,122,0,0.0012516158154995405,0.0
3690,18141,St. Joseph,Indiana,2004,52637,55254,728,108619,0.4846021414301365,0.5086955320892294,0.006702326480634143,4934,-1462,7673,11145,-0.004789901576203626,-0.01576520332218507,0.020555104898388743,-2617,-2739,-0.024093390659092828,-0.02534500647459237
3691,18141,St. Joseph,Indiana,2008,68710,48510,1519,118739,0.5786641288877286,0.4085431071509782,0.012792763961293257,16073,791,-6744,10120,0.09406198745759203,0.006090437480659114,-0.10015242493825116,20200,22817,0.17012102173675037,0.1942144123958432
3692,18141,St. Joseph,Indiana,2012,56460,52578,1971,111009,0.508607410209983,0.47363727265356864,0.017755317136448397,-12250,452,4068,-7730,-0.07005671867774554,0.00496255317515514,0.06509416550259045,3882,-16318,0.03497013755641437,-0.135150884180336
3693,18141,St. Joseph,Indiana,2016,52252,52021,7569,111842,0.4671947926539225,0.4651293789452978,0.06767582840077967,-4208,5598,-557,833,-0.041412617556060516,0.049920511264331266,-0.00850789370827082,231,-3651,0.002065413708624675,-0.032904723847789696
3694,18143,Scott,Indiana,2000,3915,3761,170,7846,0.4989803721641601,0.47935253632424163,0.021667091511598267,0,0,0,0,0.0,0.0,0.0,154,0,0.01962783583991845,0.0
3695,18143,Scott,Indiana,2004,3822,4793,62,8677,0.44047481848565173,0.5523798547885214,0.007145326725826899,-93,-108,1032,831,-0.05850555367850835,-0.014521764785771368,0.07302731846427973,-971,-1125,-0.11190503630286963,-0.13153287214278808
3696,18143,Scott,Indiana,2008,4271,4445,219,8935,0.4780078343592613,0.4974818130945719,0.02451035254616676,449,157,-348,258,0.037533015873609576,0.01736502582033986,-0.05489804169394946,-174,797,-0.019473978735310593,0.09243105756755904
3697,18143,Scott,Indiana,2012,3998,4539,183,8720,0.45848623853211007,0.5205275229357799,0.020986238532110093,-273,-36,94,-215,-0.01952159582715124,-0.0035241140140566674,0.023045709841207962,-541,-367,-0.062041284403669794,-0.0425673056683592
3698,18143,Scott,Indiana,2016,2642,6074,385,9101,0.29029776947588176,0.6673991869025382,0.04230304362158004,-1356,202,1535,381,-0.1681884690562283,0.02131680508946995,0.14687166396675833,-3432,-2891,-0.3771014174266564,-0.31506013302298663
3699,18145,Shelby,Indiana,2000,5374,9590,346,15310,0.3510124101894187,0.6263879817112998,0.022599608099281514,0,0,0,0,0.0,0.0,0.0,-4216,0,-0.27537557152188114,0.0
3700,18145,Shelby,Indiana,2004,4519,11397,111,16027,0.28196168964871776,0.7111124976601985,0.006925812691083796,-855,-235,1807,717,-0.06905072054070094,-0.015673795408197716,0.08472451594889863,-6878,-2662,-0.4291508080114807,-0.15377523648959956
3701,18145,Shelby,Indiana,2008,6987,10333,282,17602,0.3969435291444154,0.5870355641404386,0.016020906715146006,2468,171,-1064,1575,0.11498183949569762,0.00909509402406221,-0.1240769335197599,-3346,3532,-0.19009203499602317,0.23905877301545753
3702,18145,Shelby,Indiana,2012,5359,10978,423,16760,0.31974940334128876,0.6550119331742243,0.025238663484486872,-1628,141,645,-842,-0.07719412580312662,0.009217756769340866,0.06797636903378579,-5619,-2273,-0.3352625298329356,-0.1451704948369124
3703,18145,Shelby,Indiana,2016,4247,12718,1029,17994,0.23602311881738358,0.7067911526064243,0.057185728576192064,-1112,606,1740,1234,-0.08372628452390518,0.031947065091705196,0.051779219432199985,-8471,-2852,-0.47076803378904075,-0.13550550395610517
3704,18147,Spencer,Indiana,2000,3752,5096,139,8987,0.4174919327918104,0.5670412818515633,0.015466785356626237,0,0,0,0,0.0,0.0,0.0,-1344,0,-0.14954934905975292,0.0
3705,18147,Spencer,Indiana,2004,3920,5934,70,9924,0.39500201531640466,0.5979443772672309,0.007053607416364369,168,-69,838,937,-0.02248991747540574,-0.00841317794026187,0.030903095415667603,-2014,-670,-0.20294236195082627,-0.053393012891073344
3706,18147,Spencer,Indiana,2008,5039,5001,156,10196,0.4942134170262848,0.49048646528050216,0.015300117693213025,1119,86,-933,272,0.09921140170988013,0.008246510276848657,-0.10745791198672877,38,2052,0.003726951745782636,0.2066693136966089
3707,18147,Spencer,Indiana,2012,4026,5515,203,9744,0.4131773399014778,0.5659893267651889,0.020833333333333332,-1013,47,514,-452,-0.08103607712480698,0.005533215640120307,0.07550286148468671,-1489,-1527,-0.15281198686371106,-0.1565389386094937
3708,18147,Spencer,Indiana,2016,2861,6572,546,9979,0.2867020743561479,0.6585830243511374,0.0547149012927147,-1165,343,1057,235,-0.1264752655453299,0.03388156795938137,0.09259369758594849,-3711,-2222,-0.37188094999498944,-0.21906896313127838
3709,18149,Starke,Indiana,2000,4136,4349,216,8701,0.47534766118836913,0.4998276060222963,0.024824732789334558,0,0,0,0,0.0,0.0,0.0,-213,0,-0.02447994483392718,0.0
3710,18149,Starke,Indiana,2004,3987,4846,104,8937,0.446122860020141,0.5422401253216963,0.011637014658162694,-149,-112,497,236,-0.02922480116822812,-0.013187718131171864,0.04241251929939999,-859,-646,-0.09611726530155529,-0.07163732046762811
3711,18149,Starke,Indiana,2008,4778,4473,228,9479,0.5040616098744594,0.4718852199599114,0.024053170165629287,791,124,-373,542,0.05793874985431835,0.012416155507466593,-0.0703549053617849,305,1164,0.032176389914547965,0.12829365521610325
3712,18149,Starke,Indiana,2012,3809,4738,222,8769,0.4343710799407002,0.5403124643630973,0.02531645569620253,-969,-6,265,-710,-0.06969052993375918,0.0012632855305732445,0.06842724440318593,-929,-1234,-0.10594138442239714,-0.1381177743369451
3713,18149,Starke,Indiana,2016,2489,6367,460,9316,0.267174753112924,0.6834478316874195,0.04937741519965651,-1320,238,1629,547,-0.1671963268277762,0.024060959503453976,0.1431353673243222,-3878,-2949,-0.4162730785744955,-0.3103316941520984
3714,18151,Steuben,Indiana,2000,4103,6953,221,11277,0.3638379001507493,0.6165646891903875,0.01959741065886317,0,0,0,0,0.0,0.0,0.0,-2850,0,-0.25272678903963824,0.0
3715,18151,Steuben,Indiana,2004,4345,8433,127,12905,0.3366912049593181,0.6534676481983728,0.009841146842309183,242,-94,1480,1628,-0.027146695191431203,-0.009756263816553989,0.03690295900798524,-4088,-1238,-0.3167764432390547,-0.06404965419941644
3716,18151,Steuben,Indiana,2008,6284,7674,230,14188,0.44290950098674936,0.5408796165773894,0.01621088243586129,1939,103,-759,1283,0.10621829602743127,0.006369735593552108,-0.11258803162098341,-1390,2698,-0.09797011559064,0.21880632764841468
3717,18151,Steuben,Indiana,2012,4853,8547,295,13695,0.3543629061701351,0.6240963855421687,0.02154070828769624,-1431,65,873,-493,-0.08854659481661425,0.00532982585183495,0.08321676896477936,-3694,-2304,-0.2697334793720336,-0.17176336378139362
3718,18151,Steuben,Indiana,2016,3744,10133,689,14566,0.257036935328848,0.6956611286557737,0.04730193601537828,-1109,394,1586,871,-0.09732597084128708,0.025761227727682037,0.07156474311360495,-6389,-2695,-0.43862419332692565,-0.16889071395489202
3719,18153,Sullivan,Indiana,2000,3833,4319,110,8262,0.46393125151295084,0.5227547809247156,0.013313967562333575,0,0,0,0,0.0,0.0,0.0,-486,0,-0.058823529411764774,0.0
3720,18153,Sullivan,Indiana,2004,3341,4999,54,8394,0.39802239695020253,0.5955444365022635,0.006433166547533953,-492,-56,680,132,-0.06590885456274831,-0.006880801014799622,0.07278965557754791,-1658,-1172,-0.197522039552061,-0.13869851014029622
3721,18153,Sullivan,Indiana,2008,4284,4343,155,8782,0.4878159872466409,0.4945342746526987,0.017649738100660443,943,101,-656,388,0.08979359029643835,0.01121657155312649,-0.1010101618495648,-59,1599,-0.0067182874060578435,0.19080375214600315
3722,18153,Sullivan,Indiana,2012,3191,4902,197,8290,0.38492159227985523,0.5913148371531967,0.02376357056694813,-1093,42,559,-492,-0.10289439496678565,0.006113832466287685,0.09678056250049794,-1711,-1652,-0.20639324487334143,-0.1996749574672836
3723,18153,Sullivan,Indiana,2016,2113,6138,308,8559,0.2468746348872532,0.7171398527865405,0.03598551232620633,-1078,111,1236,269,-0.13804695739260203,0.012221941759258202,0.1258250156333438,-4025,-2314,-0.47026521789928727,-0.26387197302594584
3724,18155,Switzerland,Indiana,2000,1336,1831,72,3239,0.4124729854893486,0.5652979314603273,0.022229083050324176,0,0,0,0,0.0,0.0,0.0,-495,0,-0.15282494597097868,0.0
3725,18155,Switzerland,Indiana,2004,1479,2161,31,3671,0.4028874965949333,0.5886679378915827,0.008444565513484064,143,-41,330,432,-0.009585488894415295,-0.013784517536840112,0.02337000643125542,-682,-187,-0.1857804412966494,-0.032955495325670714
3726,18155,Switzerland,Indiana,2008,1638,1940,62,3640,0.45,0.532967032967033,0.01703296703296703,159,31,-221,-31,0.04711250340506673,0.008588401519482968,-0.05570090492454971,-302,380,-0.08296703296703295,0.10281340832961644
3727,18155,Switzerland,Indiana,2012,1437,1872,88,3397,0.4230203120400353,0.5510744774801295,0.02590521047983515,-201,26,-68,-243,-0.026979687959964693,0.008872243446868117,0.018107444513096538,-435,-133,-0.12805416544009418,-0.04508713247306123
3728,18155,Switzerland,Indiana,2016,930,2558,211,3699,0.25141930251419303,0.6915382535820492,0.057042443903757775,-507,123,686,302,-0.17160100952584229,0.031137233423922626,0.14046377610191974,-1628,-1193,-0.4401189510678562,-0.312064785627762
3729,18157,Tippecanoe,Indiana,2000,18220,26106,1969,46295,0.39356301976455343,0.5639053893509018,0.042531590884544765,0,0,0,0,0.0,0.0,0.0,-7886,0,-0.1703423695863484,0.0
3730,18157,Tippecanoe,Indiana,2004,20818,30897,645,52360,0.3975935828877005,0.5900878533231474,0.012318563789152024,2598,-1324,4791,6065,0.004030563123147091,-0.03021302709539274,0.02618246397224555,-10079,-2193,-0.19249427043544687,-0.02215190084909846
3731,18157,Tippecanoe,Indiana,2008,37781,29822,1033,68636,0.550454571944752,0.43449501719214406,0.01505041086310391,16963,388,-1075,16276,0.15286098905705148,0.0027318470739518853,-0.15559283613100333,7959,18038,0.11595955475260794,0.3084538251880548
3732,18157,Tippecanoe,Indiana,2012,26711,28757,1595,57063,0.4680966650894625,0.5039517726022116,0.027951562308325885,-11070,562,-1065,-11573,-0.08235790685528949,0.012901151445221975,0.06945675541006752,-2046,-10005,-0.03585510751274906,-0.151814662265357
3733,18157,Tippecanoe,Indiana,2016,27282,30768,5289,63339,0.4307298820631838,0.4857670629469995,0.0835030549898167,571,3694,2011,6276,-0.037366783026278716,0.05555149268149081,-0.018184709655212072,-3486,-1440,-0.055037180883815706,-0.019182073371066644
3734,18159,Tipton,Indiana,2000,2392,4784,140,7316,0.32695462001093495,0.6539092400218699,0.01913613996719519,0,0,0,0,0.0,0.0,0.0,-2392,0,-0.32695462001093495,0.0
3735,18159,Tipton,Indiana,2004,2203,5628,61,7892,0.2791434363912823,0.7131272174353775,0.007729346173340091,-189,-79,844,576,-0.04781118361965264,-0.011406793793855098,0.05921797741350765,-3425,-1033,-0.43398378104409524,-0.10702916103316029
3736,18159,Tipton,Indiana,2008,3250,4452,136,7838,0.41464659351875477,0.5680020413370758,0.01735136514416943,1047,75,-1176,-54,0.13550315712747246,0.00962201897082934,-0.14512517609830178,-1202,2223,-0.153355447818321,0.28062833322577424
3737,18159,Tipton,Indiana,2012,2432,4773,168,7373,0.32985216329852163,0.6473619964736199,0.022785840227858404,-818,32,321,-465,-0.08479443022023314,0.0054344750836889735,0.07935995513654415,-2341,-1139,-0.3175098331750983,-0.1641543853567773
3738,18159,Tipton,Indiana,2016,1587,5589,334,7510,0.21131824234354193,0.7442077230359521,0.04447403462050599,-845,166,816,137,-0.1185339209549797,0.021688194392647586,0.09684572656233215,-4002,-1661,-0.5328894806924102,-0.21537964751731187
3739,18161,Union,Indiana,2000,927,1838,63,2828,0.3277934936350778,0.6499292786421499,0.022277227722772276,0,0,0,0,0.0,0.0,0.0,-911,0,-0.3221357850070721,0.0
3740,18161,Union,Indiana,2004,1045,2266,33,3344,0.3125,0.6776315789473685,0.009868421052631578,118,-30,428,516,-0.015293493635077815,-0.012408806670140698,0.027702300305218586,-1221,-310,-0.3651315789473685,-0.0429957939402964
3741,18161,Union,Indiana,2008,1224,2061,70,3355,0.3648286140089419,0.6143070044709389,0.020864381520119227,179,37,-205,11,0.0523286140089419,0.010995960467487648,-0.06332457447642958,-837,384,-0.249478390461997,0.11565318848537148
3742,18161,Union,Indiana,2012,1018,2022,64,3104,0.3279639175257732,0.6514175257731959,0.020618556701030927,-206,-6,-39,-251,-0.0368646964831687,-0.0002458248190882993,0.037110521302257005,-1004,-167,-0.3234536082474227,-0.0739752177854257
3743,18161,Union,Indiana,2016,715,2445,131,3291,0.21725919173503494,0.7429352780309936,0.03980553023397144,-303,67,423,187,-0.11070472579073826,0.01918697353294051,0.09151775225779768,-1730,-726,-0.5256760862959586,-0.20222247804853594
3744,18163,Vanderburgh,Indiana,2000,29222,35846,1153,66221,0.44127995650926444,0.541308648313979,0.01741139517675662,0,0,0,0,0.0,0.0,0.0,-6624,0,-0.10002869180471452,0.0
3745,18163,Vanderburgh,Indiana,2004,28767,41463,424,70654,0.4071531689642483,0.5868457553712458,0.006001075664505902,-455,-729,5617,4433,-0.034126787545016135,-0.011410319512250716,0.04553710705726688,-12696,-6072,-0.17969258640699753,-0.07966389460228301
3746,18163,Vanderburgh,Indiana,2008,39423,37512,978,77913,0.5059874475376381,0.48146009010049673,0.012552462361865158,10656,554,-3951,7259,0.09883427857338983,0.006551386697359256,-0.10538566527074911,1911,14607,0.024527357437141406,0.20421994384413894
3747,18163,Vanderburgh,Indiana,2012,31725,39389,1474,72588,0.4370557116878823,0.5426379015815286,0.020306386730589078,-7698,496,1877,-5325,-0.06893173584975582,0.00775392436872392,0.06117781148103185,-7664,-9575,-0.10558218989364626,-0.13010954733078767
3748,18163,Vanderburgh,Indiana,2016,28530,40496,4343,73369,0.388856328967275,0.551949733538688,0.059193937494036994,-3195,2869,1107,781,-0.04819938272060731,0.038887550763447916,0.009311831957159455,-11966,-4302,-0.16309340457141303,-0.057511214677766764
3749,18165,Vermillion,Indiana,2000,3370,3130,133,6633,0.508065731946329,0.47188300919644205,0.020051258857229005,0,0,0,0,0.0,0.0,0.0,240,0,0.03618272274988693,0.0
3750,18165,Vermillion,Indiana,2004,3424,3536,57,7017,0.48795781673079663,0.5039190537266638,0.008123129542539546,54,-76,406,384,-0.020107915215532346,-0.01192812931468946,0.03203604453022174,-112,-352,-0.015961236995867156,-0.05214395974575409
3751,18165,Vermillion,Indiana,2008,4003,3010,122,7135,0.5610371408549404,0.42186405045550107,0.017098808689558515,579,65,-526,118,0.07307932412414375,0.008975679147018968,-0.08205500327116272,993,1105,0.13917309039943931,0.15513432739530647
3752,18165,Vermillion,Indiana,2012,2979,3426,198,6603,0.45115856428895956,0.5188550658791459,0.029986369831894594,-1024,76,416,-532,-0.10987857656598082,0.01288756114233608,0.0969910154236448,-447,-1440,-0.06769650159018631,-0.20686959198962562
3753,18165,Vermillion,Indiana,2016,2081,4513,379,6973,0.29843682776423347,0.6472106697260863,0.0543525025096802,-898,181,1087,370,-0.1527217365247261,0.024366132677785604,0.12835560384694045,-2432,-1985,-0.34877384196185285,-0.28107734037166654
3754,18167,Vigo,Indiana,2000,17570,18021,637,36228,0.48498399028375844,0.4974329248095396,0.017583084906701997,0,0,0,0,0.0,0.0,0.0,-451,0,-0.012448934525781163,0.0
3755,18167,Vigo,Indiana,2004,18426,20988,330,39744,0.4636171497584541,0.5280797101449275,0.008303140096618358,856,-307,2967,3516,-0.021366840525304354,-0.009279944810083639,0.030646785335387894,-2562,-2111,-0.06446256038647341,-0.05201362586069225
3756,18167,Vigo,Indiana,2008,25040,18121,723,43884,0.5705952055418831,0.4129295415185489,0.01647525293956795,6614,393,-2867,4140,0.10697805578342906,0.008172112842949593,-0.11515016862637861,6919,9481,0.15766566402333426,0.22212822440980767
3757,18167,Vigo,Indiana,2012,19712,19369,924,40005,0.4927384076990376,0.48416447944007,0.023097112860892388,-5328,201,1248,-3879,-0.07785679784284555,0.006621859921324438,0.07123493792152114,343,-6576,0.008573928258967578,-0.14909173576436668
3758,18167,Vigo,Indiana,2016,15931,21937,2259,40127,0.39701447902908266,0.5466892615944376,0.056296259376479675,-3781,1335,2568,122,-0.09572392866995494,0.03319914651558729,0.06252478215436763,-6006,-6349,-0.149674782565355,-0.15824871082432257
3759,18169,Wabash,Indiana,2000,4277,8321,285,12883,0.33198789101917253,0.6458899324691454,0.02212217651168206,0,0,0,0,0.0,0.0,0.0,-4044,0,-0.31390204144997286,0.0
3760,18169,Wabash,Indiana,2004,3920,9607,75,13602,0.28819291280694015,0.706293192177621,0.005513895015438906,-357,-210,1286,719,-0.04379497821223238,-0.016608281496243157,0.0604032597084756,-5687,-1643,-0.41810027937068084,-0.10419823792070798
3761,18169,Wabash,Indiana,2008,5456,8238,198,13892,0.3927440253383242,0.5930031672905269,0.014252807371148863,1536,123,-1369,290,0.10455111253138405,0.008738912355709956,-0.11329002488709405,-2782,2905,-0.20025914195220273,0.2178411374184781
3762,18169,Wabash,Indiana,2012,3973,8644,278,12895,0.3081039162466072,0.6703373400542846,0.021558743699108183,-1483,80,406,-997,-0.08464010909171699,0.00730593632795932,0.07733417276375765,-4671,-1889,-0.36223342380767737,-0.16197428185547463
3763,18169,Wabash,Indiana,2016,3018,9821,713,13552,0.22269775678866588,0.7246900826446281,0.05261216056670602,-955,435,1177,657,-0.08540615945794133,0.031053416867597838,0.054352742590343506,-6803,-2132,-0.5019923258559622,-0.13975890204828484
3764,18171,Warren,Indiana,2000,1471,2218,79,3768,0.3903927813163482,0.5886411889596603,0.020966029723991506,0,0,0,0,0.0,0.0,0.0,-747,0,-0.19824840764331214,0.0
3765,18171,Warren,Indiana,2004,1356,2565,39,3960,0.3424242424242424,0.6477272727272727,0.009848484848484848,-115,-40,347,192,-0.04796853889210578,-0.011117544875506659,0.059086083767612374,-1209,-462,-0.3053030303030303,-0.10705462265971816
3766,18171,Warren,Indiana,2008,1755,2166,77,3998,0.4389694847423712,0.5417708854427213,0.019259629814907454,399,38,-399,38,0.09654524231812878,0.009411144966422607,-0.10595638728455137,-411,798,-0.10280140070035015,0.20250162960268014
3767,18171,Warren,Indiana,2012,1324,2377,99,3800,0.34842105263157896,0.6255263157894737,0.02605263157894737,-431,22,211,-198,-0.09054843211079222,0.006793001764039915,0.08375543034675237,-1053,-642,-0.27710526315789474,-0.1743038624575446
3768,18171,Warren,Indiana,2016,839,2898,193,3930,0.21348600508905852,0.7374045801526717,0.04910941475826972,-485,94,521,130,-0.13493504754252045,0.023056783179322353,0.11187826436319803,-2059,-1006,-0.5239185750636133,-0.24681331190571854
3769,18173,Warrick,Indiana,2000,8749,13205,355,22309,0.39217356223945493,0.5919135774799408,0.015912860280604242,0,0,0,0,0.0,0.0,0.0,-4456,0,-0.19974001524048585,0.0
3770,18173,Warrick,Indiana,2004,8980,16930,115,26025,0.3450528338136407,0.6505283381364073,0.004418828049951969,231,-240,3725,3716,-0.04712072842581422,-0.011494032230652273,0.058614760656466536,-7950,-3494,-0.3054755043227666,-0.10573548908228075
3771,18173,Warrick,Indiana,2008,12329,16013,379,28721,0.4292677831551826,0.5575362974826782,0.013195919362139201,3349,264,-917,2696,0.08421494934154189,0.008777091312187232,-0.09299204065372912,-3684,4266,-0.1282685143274956,0.177206989995271
3772,18173,Warrick,Indiana,2012,10181,17680,566,28427,0.3581454251240018,0.6219439265487037,0.019910648327294472,-2148,187,1667,-294,-0.07112235803118078,0.006714728965155271,0.06440762906602548,-7499,-3815,-0.26379850142470185,-0.13552998709720626
3773,18173,Warrick,Indiana,2016,9086,19113,1740,29939,0.30348375029226093,0.6383980760880457,0.058118173619693375,-1095,1174,1433,1512,-0.05466167483174089,0.0382075252923989,0.01645414953934199,-10027,-2528,-0.33491432579578473,-0.07111582437108288
3774,18175,Washington,Indiana,2000,3675,5868,258,9801,0.3749617385981022,0.5987144168962351,0.026323844505662688,0,0,0,0,0.0,0.0,0.0,-2193,0,-0.22375267829813283,0.0
3775,18175,Washington,Indiana,2004,3879,6915,86,10880,0.35652573529411763,0.6355698529411765,0.007904411764705882,204,-172,1047,1079,-0.018436003303984594,-0.018419432740956806,0.03685543604494146,-3036,-843,-0.2790441176470589,-0.05529143934892605
3776,18175,Washington,Indiana,2008,4562,6519,271,11352,0.40186751233262863,0.5742600422832981,0.02387244538407329,683,185,-396,472,0.045341777038511,0.015968033619367408,-0.06130981065787844,-1957,1079,-0.17239252995066945,0.10665158769638944
3777,18175,Washington,Indiana,2012,3909,6533,295,10737,0.36406817546800785,0.6084567383812983,0.027475086150693863,-653,24,14,-615,-0.03779933686462078,0.0036026407666205733,0.034196696098000245,-2624,-667,-0.24438856291329047,-0.07199603296262103
3778,18175,Washington,Indiana,2016,2636,8209,537,11382,0.23159374450887366,0.7212264979792655,0.047179757511860834,-1273,242,1676,645,-0.1324744309591342,0.01970467136116697,0.1127697595979672,-5573,-2949,-0.48963275347039187,-0.2452441905571014
3779,18177,Wayne,Indiana,2000,10273,14273,605,25151,0.40845294421692974,0.5674923462287782,0.024054709554292075,0,0,0,0,0.0,0.0,0.0,-4000,0,-0.15903940201184846,0.0
3780,18177,Wayne,Indiana,2004,10775,16586,296,27657,0.38959395451422785,0.5997035108652421,0.010702534620530064,502,-309,2313,2506,-0.01885898970270189,-0.01335217493376201,0.032211164636463896,-5811,-1811,-0.21010955635101425,-0.051070154339165785
3781,18177,Wayne,Indiana,2008,13459,14558,624,28641,0.4699207429908174,0.5082923082294613,0.021786948779721378,2684,328,-2028,984,0.08032678847658953,0.011084414159191314,-0.09141120263578084,-1099,4712,-0.03837156523864388,0.17173799111237037
3782,18177,Wayne,Indiana,2012,10591,14321,565,25477,0.41570828590493386,0.5621148486870511,0.022176865408015074,-2868,-59,-237,-3164,-0.054212457085883514,0.0003899166282936954,0.05382254045758983,-3730,-2631,-0.14640656278211722,-0.10803499754347334
3783,18177,Wayne,Indiana,2016,8322,16028,1229,25579,0.3253450095781696,0.6266077641815552,0.04804722624027523,-2269,664,1707,102,-0.09036327632676427,0.025870360832260155,0.06449291549450409,-7706,-3976,-0.3012627546033856,-0.15485619182126836
3784,18179,Wells,Indiana,2000,3319,7755,207,11281,0.29421150607215674,0.6874390568212038,0.01834943710663948,0,0,0,0,0.0,0.0,0.0,-4436,0,-0.39322755074904703,0.0
3785,18179,Wells,Indiana,2004,3112,9168,74,12354,0.25190221790513195,0.7421078193297718,0.005989962765096325,-207,-133,1413,1073,-0.04230928816702478,-0.012359474341543157,0.054668762508568,-6056,-1620,-0.4902056014246398,-0.09697805067559279
3786,18179,Wells,Indiana,2008,4403,8504,181,13088,0.33641503667481665,0.6497555012224939,0.013829462102689486,1291,107,-664,734,0.0845128187696847,0.007839499337593162,-0.09235231810727784,-4101,1955,-0.3133404645476773,0.17686513687696254
3787,18179,Wells,Indiana,2012,3436,9256,260,12952,0.2652872143298332,0.7146386658431131,0.020074119827053736,-967,79,752,-136,-0.07112782234498344,0.00624465772436425,0.06488316462061916,-5820,-1719,-0.4493514515132799,-0.1360109869656026
3788,18179,Wells,Indiana,2016,2586,10005,695,13286,0.19464097546289327,0.7530483215414723,0.0523107029956345,-850,435,749,334,-0.07064623886693994,0.03223658316858076,0.03840965569835919,-7419,-1599,-0.558407346078579,-0.10905589456529913
3789,18181,White,Indiana,2000,3655,6037,212,9904,0.36904281098546043,0.6095516962843296,0.021405492730210016,0,0,0,0,0.0,0.0,0.0,-2382,0,-0.24050888529886916,0.0
3790,18181,White,Indiana,2004,3277,6974,115,10366,0.3161296546401698,0.6727763843333976,0.011093961026432567,-378,-97,937,462,-0.052913156345290646,-0.010311531703777448,0.063224688049068,-3697,-1315,-0.3566467296932278,-0.11613784439435865
3791,18181,White,Indiana,2008,4839,5731,235,10805,0.44784821841739936,0.5304025913928737,0.02174919018972698,1562,120,-1243,439,0.13171856377722957,0.010655229163294411,-0.14237379294052388,-892,2805,-0.08255437297547435,0.27409235671775345
3792,18181,White,Indiana,2012,3637,5970,328,9935,0.36607951685958734,0.6009058882737796,0.033014594866633114,-1202,93,239,-870,-0.08176870155781202,0.011265404676906135,0.07050329688090584,-2333,-1441,-0.23482637141419221,-0.15227199843871786
3793,18181,White,Indiana,2016,2590,6893,613,10096,0.2565372424722662,0.6827456418383518,0.060717115689381936,-1047,285,923,161,-0.10954227438732111,0.027702520822748822,0.08183975356457229,-4303,-1970,-0.4262083993660856,-0.1913820279518934
3794,18183,Whitley,Indiana,2000,4107,8080,245,12432,0.33035714285714285,0.6499356499356499,0.019707207207207207,0,0,0,0,0.0,0.0,0.0,-3973,0,-0.31957850707850705,0.0
3795,18183,Whitley,Indiana,2004,3880,9512,89,13481,0.28781247681922706,0.7055856390475485,0.006601884133224538,-227,-156,1432,1049,-0.04254466603791579,-0.01310532307398267,0.05564998911189856,-5632,-1659,-0.4177731622283214,-0.09819465514981435
3796,18183,Whitley,Indiana,2008,5862,9124,222,15208,0.3854550236717517,0.599947396107312,0.01459758022093635,1982,133,-388,1727,0.09764254685252466,0.007995696087711812,-0.1056382429402365,-3262,2370,-0.21449237243556024,0.20328078979276115
3797,18183,Whitley,Indiana,2012,4420,10258,354,15032,0.2940393826503459,0.682410856838744,0.02354976051091006,-1442,132,1134,-176,-0.09141564102140581,0.00895218028997371,0.08246346073143207,-5838,-2576,-0.3883714741883981,-0.17387910175283788
3798,18183,Whitley,Indiana,2016,3379,11358,1022,15759,0.21441715844914017,0.7207310108509423,0.06485183069991751,-1041,668,1100,727,-0.07962222420120574,0.04130207018900745,0.03832015401219824,-7979,-2141,-0.506313852401802,-0.11794237821340392
3799,19001,Adair,Iowa,2000,1753,2275,95,4123,0.4251758428328887,0.5517826825127334,0.02304147465437788,0,0,0,0,0.0,0.0,0.0,-522,0,-0.12660683967984476,0.0
3800,19001,Adair,Iowa,2004,1844,2402,32,4278,0.4310425432445068,0.5614773258532024,0.0074801309022907905,91,-63,127,155,0.005866700411618131,-0.01556134375208709,0.009694643340468989,-558,-36,-0.13043478260869562,-0.003827942928850858
3801,19001,Adair,Iowa,2008,1924,2060,69,4053,0.47471009129040215,0.5082654823587466,0.017024426350851222,80,37,-342,-225,0.043667548045895344,0.009544295448560431,-0.053211843494455846,-136,422,-0.03355539106834443,0.09687939154035119
3802,19001,Adair,Iowa,2012,1790,2114,92,3996,0.44794794794794796,0.529029029029029,0.023023023023023025,-134,23,54,-57,-0.026762143342454192,0.005998596672171803,0.020763546670282462,-324,-188,-0.08108108108108109,-0.047525690012736654
3803,19001,Adair,Iowa,2016,1133,2461,217,3811,0.2972972972972973,0.6457622671214904,0.05694043558121228,-657,125,347,-185,-0.15065065065065064,0.03391741255818925,0.11673323809246139,-1328,-1004,-0.3484649698241931,-0.26738388874311203
3804,19003,Adams,Iowa,2000,897,1170,78,2145,0.41818181818181815,0.5454545454545454,0.03636363636363636,0,0,0,0,0.0,0.0,0.0,-273,0,-0.12727272727272726,0.0
3805,19003,Adams,Iowa,2004,977,1317,31,2325,0.42021505376344087,0.5664516129032258,0.013333333333333334,80,-47,147,180,0.0020332355816227166,-0.023030303030303026,0.02099706744868035,-340,-67,-0.1462365591397849,-0.018963831867057634
3806,19003,Adams,Iowa,2008,1118,1046,42,2206,0.5067996373526745,0.4741613780598368,0.019038984587488667,141,11,-271,-119,0.08658458358923365,0.005705651254155333,-0.09229023484338894,72,412,0.0326382592928377,0.1788748184326226
3807,19003,Adams,Iowa,2012,1028,1108,49,2185,0.47048054919908466,0.5070938215102975,0.022425629290617848,-90,7,62,-21,-0.03631908815358986,0.003386644703129181,0.03293244345046065,-80,-152,-0.03661327231121281,-0.06925153160405051
3808,19003,Adams,Iowa,2016,565,1395,146,2106,0.26828110161443497,0.6623931623931624,0.06932573599240266,-463,97,287,-79,-0.2021994475846497,0.04690010670178481,0.1552993408828649,-830,-750,-0.3941120607787274,-0.3574987884675146
3809,19005,Allamakee,Iowa,2000,2883,3277,302,6462,0.44614670380687094,0.5071185391519654,0.04673475704116373,0,0,0,0,0.0,0.0,0.0,-394,0,-0.06097183534509443,0.0
3810,19005,Allamakee,Iowa,2004,3449,3530,83,7062,0.4883885584820164,0.49985839705465873,0.011753044463324838,566,-219,253,600,0.04224185467514546,-0.034981712577838886,-0.007260142097306632,-81,313,-0.011469838572642332,0.049501996772452095
3811,19005,Allamakee,Iowa,2008,3971,2965,126,7062,0.5623052959501558,0.4198527329368451,0.01784197111299915,522,43,-565,0,0.07391673746813937,0.006088926649674312,-0.08000566411781362,1006,1087,0.14245256301331066,0.153922401585953
3812,19005,Allamakee,Iowa,2012,3553,3264,117,6934,0.5124026535910009,0.47072396884914913,0.016873377559850015,-418,-9,299,-128,-0.04990264235915487,-0.0009685935531491344,0.050871235912304025,289,-717,0.04167868474185177,-0.1007738782714589
3813,19005,Allamakee,Iowa,2016,2421,4093,409,6923,0.3497038855987289,0.5912176801964466,0.0590784342048245,-1132,292,829,-11,-0.162698767992272,0.04220505664497448,0.12049371134729747,-1672,-1961,-0.2415137945977177,-0.2831924793395695
3814,19007,Appanoose,Iowa,2000,2560,2992,152,5704,0.4488078541374474,0.5245441795231417,0.02664796633941094,0,0,0,0,0.0,0.0,0.0,-432,0,-0.0757363253856943,0.0
3815,19007,Appanoose,Iowa,2004,3063,3340,47,6450,0.47488372093023257,0.517829457364341,0.007286821705426357,503,-105,348,746,0.026075866792785174,-0.019361144633984584,-0.006714722158800646,-277,155,-0.042945736434108484,0.03279058895158582
3816,19007,Appanoose,Iowa,2008,2970,3086,123,6179,0.48066030101958246,0.49943356530182875,0.019906133678588768,-93,76,-254,-271,0.005776580089349892,0.012619311973162411,-0.018395892062512298,-116,161,-0.018773264282246294,0.02417247215186219
3817,19007,Appanoose,Iowa,2012,2951,3161,133,6245,0.47253803042433945,0.5061649319455565,0.021297037630104085,-19,10,75,66,-0.008122270595243009,0.0013909039515153168,0.006731366643727699,-210,-94,-0.033626901521217,-0.014853637238970707
3818,19007,Appanoose,Iowa,2016,1814,4033,289,6136,0.29563233376792697,0.6572685788787483,0.04709908735332464,-1137,156,872,-109,-0.17690569665641248,0.025802049723220553,0.1511036469331919,-2219,-2009,-0.3616362451108214,-0.3280093435896044
3819,19009,Audubon,Iowa,2000,1780,1909,95,3784,0.4704016913319239,0.504492600422833,0.02510570824524313,0,0,0,0,0.0,0.0,0.0,-129,0,-0.03409090909090906,0.0
3820,19009,Audubon,Iowa,2004,1608,1958,26,3592,0.44766146993318484,0.5451002227171492,0.007238307349665924,-172,-69,49,-192,-0.022740221398739047,-0.017867400895577205,0.04060762229431625,-350,-221,-0.09743875278396436,-0.0633478436930553
3821,19009,Audubon,Iowa,2008,1739,1634,63,3436,0.5061117578579744,0.4755529685681024,0.018335273573923165,131,37,-324,-156,0.05845028792478951,0.011096966224257241,-0.06954725414904678,105,455,0.030558789289871935,0.1279975420738363
3822,19009,Audubon,Iowa,2012,1611,1802,44,3457,0.4660109921897599,0.5212612091408736,0.012727798669366503,-128,-19,168,21,-0.040100765668214466,-0.005607474904556662,0.045708240572771175,-191,-296,-0.055250216951113706,-0.08580900624098564
3823,19009,Audubon,Iowa,2016,1080,2136,196,3412,0.31652989449003516,0.6260257913247362,0.05744431418522861,-531,152,334,-45,-0.14948109769972473,0.0447165155158621,0.10476458218386264,-1056,-865,-0.3094958968347011,-0.25424567988358737
3824,19011,Benton,Iowa,2000,5915,5468,383,11766,0.5027197008329084,0.4647288798232194,0.03255141934387217,0,0,0,0,0.0,0.0,0.0,447,0,0.03799082100968898,0.0
3825,19011,Benton,Iowa,2004,6747,6658,96,13501,0.49974075994370787,0.49314865565513666,0.00711058440115547,832,-287,1190,1735,-0.002978940889200532,-0.025440834942716702,0.028419775831917238,89,-358,0.00659210428857121,-0.03139871672111777
3826,19011,Benton,Iowa,2008,7058,6447,212,13717,0.5145439965006926,0.470000729022381,0.01545527447692644,311,116,-211,216,0.014803236556984734,0.008344690075770971,-0.023147926632755667,611,522,0.04454326747831161,0.0379511631897404
3827,19011,Benton,Iowa,2012,6862,6940,221,14023,0.4893389431648007,0.4949012336875134,0.015759823147685946,-196,9,493,306,-0.025205053335891903,0.0003045486707595052,0.024900504665132384,-78,-689,-0.005562290522712676,-0.050105558001024286
3828,19011,Benton,Iowa,2016,4678,8232,934,13844,0.3379081190407397,0.5946258306847731,0.06746605027448714,-2184,713,1292,-179,-0.151430824124061,0.051706227126801195,0.09972459699725977,-3554,-3476,-0.25671771164403345,-0.2511554211213208
3829,19013,Black Hawk,Iowa,2000,30112,23468,1505,55085,0.5466460924026505,0.4260324952346374,0.027321412362712173,0,0,0,0,0.0,0.0,0.0,6644,0,0.12061359716801312,0.0
3830,19013,Black Hawk,Iowa,2004,35392,28046,469,63907,0.5538047475237454,0.43885646329823025,0.007338789178024317,5280,-1036,4578,8822,0.007158655121094926,-0.019982623184687857,0.012823968063592872,7346,702,0.11494828422551517,-0.0056653129424979465
3831,19013,Black Hawk,Iowa,2008,39184,24662,941,64787,0.6048126939046413,0.38066278728757313,0.014524518807785512,3792,472,-3384,880,0.0510079463808959,0.0071857296297611955,-0.058193676010657114,14522,7176,0.22414990661706818,0.10920162239155301
3832,19013,Black Hawk,Iowa,2012,39821,26235,1085,67141,0.5930951281631194,0.39074485038947887,0.016160021447401737,637,144,1573,2354,-0.01171756574152194,0.001635502639616225,0.010082063101905736,13586,-936,0.2023502777736405,-0.021799628843427676
3833,19013,Black Hawk,Iowa,2016,32233,27476,4696,64405,0.5004735657169475,0.42661284061796445,0.07291359366508811,-7588,3611,1241,-2736,-0.09262156244617192,0.05675357221768637,0.03586799022848558,4757,-8829,0.073860725098983,-0.1284895526746575
3834,19015,Boone,Iowa,2000,6270,5625,354,12249,0.5118785206955669,0.4592211609110948,0.02890031839333823,0,0,0,0,0.0,0.0,0.0,645,0,0.05265735978447217,0.0
3835,19015,Boone,Iowa,2004,7027,6870,112,14009,0.5016061103576273,0.49039902919551714,0.007994860446855594,757,-242,1245,1760,-0.010272410337939686,-0.020905457946482638,0.031177868284422372,157,-488,0.01120708116211011,-0.04145027862236206
3836,19015,Boone,Iowa,2008,7356,6293,282,13931,0.5280310099777474,0.45172636565932095,0.020242624362931592,329,170,-577,-78,0.02642489962012018,0.012247763916075998,-0.038672663536196195,1063,906,0.07630464431842648,0.06509756315631637
3837,19015,Boone,Iowa,2012,7512,6556,320,14388,0.5221017514595496,0.45565749235474007,0.022240756185710316,156,38,263,457,-0.005929258518197811,0.001998131822778724,0.003931126695419118,956,-107,0.06644425910480956,-0.009860385213616929
3838,19015,Boone,Iowa,2016,5541,7484,1171,14196,0.3903212172442942,0.5271907579599887,0.08248802479571711,-1971,851,928,-192,-0.13178053421525543,0.060247268610006795,0.07153326560524864,-1943,-2899,-0.13686954071569452,-0.20331379982050407
3839,19017,Bremer,Iowa,2000,5169,5675,331,11175,0.4625503355704698,0.5078299776286354,0.029619686800894853,0,0,0,0,0.0,0.0,0.0,-506,0,-0.04527964205816554,0.0
3840,19017,Bremer,Iowa,2004,6025,6665,89,12779,0.47147664136473905,0.5215588074184209,0.006964551216840129,856,-242,990,1604,0.00892630579426923,-0.022655135584054725,0.013728829789785513,-640,-134,-0.05008216605368182,-0.0048025239955162835
3841,19017,Bremer,Iowa,2008,6940,5741,191,12872,0.5391547545059043,0.4460068365444375,0.014838408949658172,915,102,-924,93,0.06767811314116529,0.007873857732818044,-0.07555197087398335,1199,1839,0.09314791796146682,0.14323008401514864
3842,19017,Bremer,Iowa,2012,6763,6405,178,13346,0.5067435935860932,0.4799190768769669,0.013337329536939908,-177,-13,664,474,-0.03241116091981111,-0.0015010794127182647,0.033912240332529375,358,-841,0.026824516709126334,-0.06632340125234049
3843,19017,Bremer,Iowa,2016,5356,7208,974,13538,0.3956271236519427,0.5324272418377899,0.07194563451026739,-1407,796,803,192,-0.11111646993415053,0.05860830497332749,0.052508164960823,-1852,-2210,-0.1368001181858472,-0.16362463489497353
3844,19019,Buchanan,Iowa,2000,5045,4092,273,9410,0.5361317747077577,0.4348565356004251,0.029011689691817215,0,0,0,0,0.0,0.0,0.0,953,0,0.10127523910733266,0.0
3845,19019,Buchanan,Iowa,2004,5608,4797,70,10475,0.5353699284009547,0.4579474940334129,0.006682577565632458,563,-203,705,1065,-0.0007618463068030934,-0.022329112126184755,0.023090958432987807,811,-142,0.07742243436754176,-0.0238528047397909
3846,19019,Buchanan,Iowa,2008,6050,4139,153,10342,0.5849932314832721,0.4002127248114485,0.014794043705279442,442,83,-658,-133,0.04962330308231744,0.008111466139646984,-0.05773476922196441,1911,1100,0.1847805066718236,0.10735807230428185
3847,19019,Buchanan,Iowa,2012,5911,4450,174,10535,0.5610821072615092,0.4224015187470337,0.01651637399145705,-139,21,311,193,-0.02391112422176289,0.001722330286177607,0.022188793935585205,1461,-450,0.1386805885144755,-0.046099918157348097
3848,19019,Buchanan,Iowa,2016,3970,5510,772,10252,0.3872415138509559,0.537456106125634,0.07530238002341007,-1941,598,1060,-283,-0.1738405934105533,0.05878600603195302,0.1150545873786003,-1540,-3001,-0.1502145922746781,-0.2888951807891536
3849,19021,Buena Vista,Iowa,2000,3297,4354,326,7977,0.41331327566754417,0.5458192302870754,0.04086749404538047,0,0,0,0,0.0,0.0,0.0,-1057,0,-0.13250595461953119,0.0
3850,19021,Buena Vista,Iowa,2004,3520,4887,83,8490,0.41460541813898705,0.5756183745583039,0.00977620730270907,223,-243,533,513,0.0012921424714428809,-0.0310912867426714,0.02979914427122854,-1367,-310,-0.16101295641931684,-0.02850700179978566
3851,19021,Buena Vista,Iowa,2008,4075,4223,122,8420,0.4839667458432304,0.5015439429928741,0.014489311163895487,555,39,-664,-70,0.06936132770424336,0.004713103861186417,-0.07407443156542981,-148,1219,-0.017577197149643675,0.14343575926967317
3852,19021,Buena Vista,Iowa,2012,3700,4554,129,8383,0.44136943814863416,0.5432422760348324,0.01538828581653346,-375,7,331,-37,-0.04259730769459624,0.0008989746526379735,0.04169833304195836,-854,-706,-0.10187283788619828,-0.0842956407365546
3853,19021,Buena Vista,Iowa,2016,2856,4903,519,8278,0.34501087219135057,0.5922928243537087,0.0626963034549408,-844,390,349,-105,-0.09635856595728359,0.04730801763840734,0.04905054831887623,-2047,-1193,-0.2472819521623581,-0.14540911427615982
3854,19023,Butler,Iowa,2000,2735,3837,152,6724,0.40675193337299226,0.5706424747174301,0.022605591909577633,0,0,0,0,0.0,0.0,0.0,-1102,0,-0.16389054134443787,0.0
3855,19023,Butler,Iowa,2004,3001,4417,57,7475,0.4014715719063545,0.5909030100334448,0.007625418060200669,266,-95,580,751,-0.00528036146663774,-0.014980173849376964,0.020260535316014683,-1416,-314,-0.1894314381270903,-0.025540896782652422
3856,19023,Butler,Iowa,2008,3364,3700,102,7166,0.46943901758303097,0.516327100195367,0.014233882221602009,363,45,-717,-309,0.06796744567667645,0.00660846416140134,-0.07457590983807783,-336,1080,-0.04688808261233601,0.14254335551475428
3857,19023,Butler,Iowa,2012,3329,4106,110,7545,0.4412193505632869,0.5442014579191518,0.0145791915175613,-35,8,406,379,-0.028219667019744044,0.0003453092959592903,0.02787435772378477,-777,-441,-0.10298210735586483,-0.056094024743528814
3858,19023,Butler,Iowa,2016,2157,4921,435,7513,0.28710235591641153,0.6549980034606682,0.05789964062292027,-1172,325,815,-32,-0.1541169946468754,0.043320449105358975,0.11079654554151641,-2764,-1987,-0.36789564754425663,-0.2649135401883918
3859,19025,Calhoun,Iowa,2000,2132,2776,133,5041,0.4229319579448522,0.5506843880182504,0.02638365403689744,0,0,0,0,0.0,0.0,0.0,-644,0,-0.12775243007339815,0.0
3860,19025,Calhoun,Iowa,2004,2243,3255,44,5542,0.40472753518585347,0.587333092746301,0.007939372067845544,111,-89,479,501,-0.01820442275899875,-0.018444281969051894,0.036648704728050596,-1012,-368,-0.1826055575604475,-0.05485312748704935
3861,19025,Calhoun,Iowa,2008,2341,2741,113,5195,0.45062560153994224,0.5276227141482195,0.021751684311838305,98,69,-514,-347,0.04589806635408877,0.013812312243992762,-0.05971037859808148,-400,612,-0.07699711260827724,0.10560844495217026
3862,19025,Calhoun,Iowa,2012,2238,2891,101,5230,0.42791586998087955,0.552772466539197,0.019311663479923517,-103,-12,150,35,-0.022709731559062696,-0.002440020831914788,0.025149752390977498,-653,-253,-0.12485659655831743,-0.047859483950040194
3863,19025,Calhoun,Iowa,2016,1398,3468,293,5159,0.2709827485946889,0.6722232990889707,0.05679395231634038,-840,192,577,-71,-0.15693312138619064,0.03748228883641686,0.11945083254977373,-2070,-1417,-0.4012405504942818,-0.2763839539359644
3864,19027,Carroll,Iowa,2000,4463,4879,226,9568,0.4664506688963211,0.5099289297658863,0.023620401337792644,0,0,0,0,0.0,0.0,0.0,-416,0,-0.043478260869565244,0.0
3865,19027,Carroll,Iowa,2004,4689,5762,73,10524,0.44555302166476624,0.5475104522995059,0.00693652603572786,226,-153,883,956,-0.02089764723155485,-0.016683875302064784,0.03758152253361957,-1073,-657,-0.10195743063473967,-0.05847916976517442
3866,19027,Carroll,Iowa,2008,5302,4922,171,10395,0.5100529100529101,0.47349687349687347,0.01645021645021645,613,98,-840,-129,0.06449988838814386,0.009513690414488591,-0.07401357880263243,380,1453,0.03655603655603662,0.13851346719077628
3867,19027,Carroll,Iowa,2012,4947,5601,126,10674,0.4634626194491287,0.5247329960652052,0.011804384485666104,-355,-45,679,279,-0.04659029060378139,-0.004645831964550347,0.05123612256833171,-654,-1034,-0.06127037661607648,-0.0978264131721131
3868,19027,Carroll,Iowa,2016,3309,6638,597,10544,0.31382776934749623,0.6295523520485584,0.05661987860394537,-1638,471,1037,-130,-0.14963485010163247,0.044815494118279266,0.10481935598335324,-3329,-2675,-0.3157245827010622,-0.2544542060849857
3869,19029,Cass,Iowa,2000,2481,4206,193,6880,0.3606104651162791,0.6113372093023256,0.028052325581395348,0,0,0,0,0.0,0.0,0.0,-1725,0,-0.2507267441860465,0.0
3870,19029,Cass,Iowa,2004,2679,4796,68,7543,0.35516372795969775,0.635821291263423,0.009014980776879226,198,-125,590,663,-0.005446737156581338,-0.01903734480451612,0.024484081961097415,-2117,-392,-0.28065756330372527,-0.029930819117678753
3871,19029,Cass,Iowa,2008,3211,4006,135,7352,0.4367519042437432,0.544885745375408,0.018362350380848748,532,67,-790,-191,0.08158817628404547,0.009347369603969521,-0.090935545888015,-795,1322,-0.1081338411316648,0.17252372217206047
3872,19029,Cass,Iowa,2012,2858,4217,130,7205,0.39666897987508676,0.5852879944482998,0.018043025676613464,-353,-5,211,-147,-0.04008292436865646,-0.000319324704235284,0.040402249072891805,-1359,-564,-0.18861901457321306,-0.08048517344154826
3873,19029,Cass,Iowa,2016,1951,4761,413,7125,0.27382456140350875,0.6682105263157895,0.057964912280701754,-907,283,544,-80,-0.12284441847157801,0.03992188660408829,0.08292253186748966,-2810,-1451,-0.39438596491228073,-0.20576695033906767
3874,19031,Cedar,Iowa,2000,4033,4031,280,8344,0.4833413231064238,0.4831016299137105,0.03355704697986577,0,0,0,0,0.0,0.0,0.0,2,0,0.00023969319271333056,0.0
3875,19031,Cedar,Iowa,2004,4747,4869,78,9694,0.489684340829379,0.5022694450175367,0.008046214153084381,714,-202,838,1350,0.006343017722955202,-0.02551083282678139,0.019167815103826202,-122,-124,-0.01258510418815767,-0.012824797380871
3876,19031,Cedar,Iowa,2008,5221,4289,155,9665,0.54019658561821,0.44376616658044493,0.01603724780134506,474,77,-580,-29,0.05051224478883104,0.00799103364826068,-0.058503278437091744,932,1054,0.09643041903776511,0.10901552322592278
3877,19031,Cedar,Iowa,2012,4972,4529,148,9649,0.5152865581925589,0.4693750647735517,0.015338377033889522,-249,-7,240,-16,-0.024910027425651182,-0.0006988707674555391,0.025608898193106744,443,-489,0.04591149341900719,-0.050518925618757926
3878,19031,Cedar,Iowa,2016,3599,5295,647,9541,0.377214128498061,0.5549732732417986,0.06781259826014045,-1373,499,766,-108,-0.13807242969449784,0.05247422122625093,0.0855982084682469,-1696,-2139,-0.17775914474373755,-0.22367063816274474
3879,19033,Cerro Gordo,Iowa,2000,12185,9397,580,22162,0.5498149986463315,0.4240140781517914,0.026170923201877087,0,0,0,0,0.0,0.0,0.0,2788,0,0.12580092049454017,0.0
3880,19033,Cerro Gordo,Iowa,2004,13372,10960,184,24516,0.5454397128405939,0.44705498449991843,0.007505302659487682,1187,-396,1563,2354,-0.00437528580573765,-0.018665620542389405,0.023040906348127055,2412,-376,0.09838472834067546,-0.027416192153864705
3881,19033,Cerro Gordo,Iowa,2008,14405,9375,363,24143,0.5966532742409808,0.388311311767386,0.015035413991633186,1033,179,-1585,-373,0.05121356140038691,0.007530111332145505,-0.05874367273253245,5030,2618,0.20834196247359482,0.10995723413291936
3882,19033,Cerro Gordo,Iowa,2012,13316,10128,380,23824,0.5589321692411015,0.42511752854264606,0.01595030221625252,-1089,17,753,-319,-0.03772110499987935,0.0009148882246193327,0.03680621677526008,3188,-1842,0.1338146406984554,-0.07452732177513943
3883,19033,Cerro Gordo,Iowa,2016,9862,11621,1482,22965,0.42943609841062486,0.506030916612236,0.06453298497713912,-3454,1102,1493,-859,-0.1294960708304766,0.048582682760886606,0.08091338806958992,-1759,-4947,-0.07659481820161113,-0.21040945890006651
3884,19035,Cherokee,Iowa,2000,2845,3463,284,6592,0.43158373786407767,0.5253337378640777,0.04308252427184466,0,0,0,0,0.0,0.0,0.0,-618,0,-0.09375,0.0
3885,19035,Cherokee,Iowa,2004,2988,3758,50,6796,0.4396703943496174,0.5529723366686286,0.0073572689817539725,143,-234,295,204,0.008086656485539745,-0.03572525529009069,0.027638598804550885,-770,-152,-0.11330194231901114,-0.01955194231901114
3886,19035,Cherokee,Iowa,2008,2890,3372,106,6368,0.4538316582914573,0.5295226130653267,0.01664572864321608,-98,56,-386,-428,0.014161263941839863,0.009288459661462106,-0.023449723603301886,-482,288,-0.07569095477386939,0.03761098754514175
3887,19035,Cherokee,Iowa,2012,2634,3662,119,6415,0.4106001558846454,0.5708495713172252,0.018550272798129385,-256,13,290,47,-0.043231502406811895,0.0019045441549133055,0.04132695825189858,-1028,-546,-0.16024941543257987,-0.08455846065871048
3888,19035,Cherokee,Iowa,2016,1679,4192,387,6258,0.2682965803771173,0.6698625759028444,0.06184084372003835,-955,268,530,-157,-0.1423035755075281,0.043290570921908966,0.09901300458561912,-2513,-1485,-0.4015659955257271,-0.24131658009314721
3889,19037,Chickasaw,Iowa,2000,3435,2936,213,6584,0.5217193195625759,0.4459295261239368,0.03235115431348724,0,0,0,0,0.0,0.0,0.0,499,0,0.07578979343863906,0.0
3890,19037,Chickasaw,Iowa,2004,3708,3040,58,6806,0.5448133999412283,0.4466647076109315,0.008521892447840141,273,-155,104,222,0.02309408037865246,-0.0238292618656471,0.000735181486994696,668,169,0.09814869233029683,0.022358898891657764
3891,19037,Chickasaw,Iowa,2008,3923,2557,106,6586,0.595657455208017,0.38824779836015794,0.016094746431825083,215,48,-483,-220,0.0508440552667887,0.007572853983984941,-0.058416909250773585,1366,698,0.20740965684785911,0.10926096451756229
3892,19037,Chickasaw,Iowa,2012,3554,2836,94,6484,0.5481184454040715,0.43738433066008636,0.014497223935842072,-369,-12,279,-102,-0.04753900980394554,-0.0015975224959830104,0.049136532299928426,718,-648,0.11073411474398515,-0.09667554210387397
3893,19037,Chickasaw,Iowa,2016,2266,3742,427,6435,0.35213675213675216,0.5815073815073815,0.06635586635586635,-1288,333,906,-49,-0.19598169326731935,0.051858642420024276,0.1441230508472951,-1476,-2194,-0.2293706293706293,-0.34010474411461444
3894,19039,Clarke,Iowa,2000,2081,1984,111,4176,0.49832375478927204,0.47509578544061304,0.02658045977011494,0,0,0,0,0.0,0.0,0.0,97,0,0.023227969348659006,0.0
3895,19039,Clarke,Iowa,2004,2323,2200,43,4566,0.508760402978537,0.4818221638195357,0.009417433201927288,242,-68,216,390,0.01043664818926493,-0.017163026568187655,0.006726378378922648,123,26,0.026938239159001287,0.0037102698103422815
3896,19039,Clarke,Iowa,2008,2218,2118,109,4445,0.49898762654668166,0.4764904386951631,0.024521934758155232,-105,66,-82,-121,-0.009772776431855312,0.015104501556227943,-0.005331725124372577,100,-23,0.022497187851518552,-0.004441051307482735
3897,19039,Clarke,Iowa,2012,2189,2124,117,4430,0.49413092550790066,0.47945823927765235,0.026410835214446954,-29,8,6,-15,-0.004856701038780997,0.001888900456291722,0.002967800582489244,65,-35,0.01467268623024831,-0.007824501621270241
3898,19039,Clarke,Iowa,2016,1465,2713,276,4454,0.3289178266726538,0.6091154018859453,0.06196677144140099,-724,159,589,24,-0.16521309883524687,0.035555936226954035,0.1296571626082929,-1248,-1313,-0.28019757521329147,-0.2948702614435398
3899,19041,Clay,Iowa,2000,3294,3992,292,7578,0.4346793349168646,0.5267880707310636,0.038532594352071785,0,0,0,0,0.0,0.0,0.0,-698,0,-0.09210873581419898,0.0
3900,19041,Clay,Iowa,2004,3547,4898,143,8588,0.4130181648812296,0.5703306939916162,0.016651141127154167,253,-149,906,1010,-0.021661170035635002,-0.021881453224917618,0.04354262326055258,-1351,-653,-0.15731252911038657,-0.06520379329618758
3901,19041,Clay,Iowa,2008,3925,4355,122,8402,0.46715067840990243,0.5183289692930255,0.014520352297072126,378,-21,-543,-186,0.05413251352867282,-0.002130788830082041,-0.05200172469859066,-430,921,-0.05117829088312309,0.10613423822726348
3902,19041,Clay,Iowa,2012,3385,4951,166,8502,0.398141613737944,0.5823335685721007,0.019524817689955305,-540,44,596,100,-0.06900906467195844,0.005004465392883179,0.0640045992790752,-1566,-1136,-0.18419195483415673,-0.13301366395103364
3903,19041,Clay,Iowa,2016,2249,5877,491,8617,0.26099570616223744,0.6820239062318673,0.05698038760589532,-1136,325,926,115,-0.13714590757570655,0.03745556991594001,0.09969033765976654,-3628,-2062,-0.4210282000696298,-0.2368362452354731
3904,19043,Clayton,Iowa,2000,4238,4034,299,8571,0.49445805623614514,0.47065686617664215,0.034885077587212696,0,0,0,0,0.0,0.0,0.0,204,0,0.023801190059502986,0.0
3905,19043,Clayton,Iowa,2004,4736,4312,120,9168,0.5165794066317626,0.47033158813263526,0.013089005235602094,498,-179,278,597,0.022121350395617467,-0.0217960723516106,-0.00032527804400689364,424,220,0.04624781849912735,0.02244662843962436
3906,19043,Clayton,Iowa,2008,5195,3651,144,8990,0.5778642936596218,0.4061179087875417,0.016017797552836485,459,24,-661,-178,0.06128488702785917,0.002928792317234391,-0.06421367934509353,1544,1120,0.17174638487208005,0.1254985663729527
3907,19043,Clayton,Iowa,2012,4806,4164,168,9138,0.525935653315824,0.4556795797767564,0.018384766907419567,-389,24,513,148,-0.05192864034379774,0.0023669693545830817,0.04956167098921466,642,-902,0.07025607353906765,-0.1014903113330124
3908,19043,Clayton,Iowa,2016,3237,5317,575,9129,0.35458429181728557,0.5824296198926499,0.06298608829006463,-1569,407,1153,-9,-0.17135136149853847,0.04460132138264507,0.12675004011589347,-2080,-2722,-0.22784532807536428,-0.29810140161443194
3909,19045,Clinton,Iowa,2000,12276,9229,675,22180,0.5534715960324617,0.4160955816050496,0.03043282236248873,0,0,0,0,0.0,0.0,0.0,3047,0,0.13737601442741204,0.0
3910,19045,Clinton,Iowa,2004,13813,10666,205,24684,0.5595932587911198,0.43210176632636527,0.00830497488251499,1537,-470,1437,2504,0.0061216627586581085,-0.02212784747997374,0.016006184721315653,3147,100,0.1274914924647545,-0.009884521962657544
3911,19045,Clinton,Iowa,2008,15018,9324,380,24722,0.6074751233718955,0.37715395194563545,0.015370924682469056,1205,175,-1342,38,0.0478818645807757,0.007065949799954067,-0.05494781438072982,5694,2547,0.23032117142626002,0.10282967896150552
3912,19045,Clinton,Iowa,2012,15141,9432,427,25000,0.60564,0.37728,0.01708,123,47,108,278,-0.0018351233718955084,0.0017090753175309451,0.00012604805436455813,5709,15,0.22835999999999995,-0.0019611714262600666
3913,19045,Clinton,Iowa,2016,10095,11276,1696,23067,0.4376381844193003,0.48883686651926994,0.07352494906142974,-5046,1269,1844,-1933,-0.16800181558069965,0.056444949061429744,0.11155686651926994,-1181,-6890,-0.05119868209996964,-0.2795586820999696
3914,19047,Crawford,Iowa,2000,2838,3482,235,6555,0.43295194508009155,0.5311975591151793,0.03585049580472922,0,0,0,0,0.0,0.0,0.0,-644,0,-0.09824561403508775,0.0
3915,19047,Crawford,Iowa,2004,3220,3955,67,7242,0.44462855564761117,0.5461198563932615,0.009251587959127313,382,-168,473,687,0.011676610567519619,-0.026598907845601906,0.014922297278082253,-735,-91,-0.10149130074565038,-0.003245686710562634
3916,19047,Crawford,Iowa,2008,3715,3345,131,7191,0.5166179947156168,0.4651647893199833,0.018217215964399944,495,64,-610,-51,0.07198943906800559,0.008965628005272631,-0.08095506707327826,370,1105,0.05145320539563347,0.15294450614128385
3917,19047,Crawford,Iowa,2012,3066,3595,91,6752,0.4540876777251185,0.5324348341232228,0.013477488151658768,-649,-40,250,-439,-0.06253031699049827,-0.004739727812741176,0.0672700448032395,-529,-899,-0.0783471563981043,-0.12980036179373777
3918,19047,Crawford,Iowa,2016,1991,4617,327,6935,0.28709444844989185,0.6657534246575343,0.0471521268925739,-1075,236,1022,183,-0.16699322927522664,0.03367463874091513,0.1333185905343115,-2626,-2097,-0.37865897620764244,-0.30031181980953814
3919,19049,Dallas,Iowa,2000,8561,10306,463,19330,0.4428867046042421,0.5331608898085877,0.0239524055871702,0,0,0,0,0.0,0.0,0.0,-1745,0,-0.09027418520434555,0.0
3920,19049,Dallas,Iowa,2004,10917,15183,193,26293,0.41520556802190695,0.5774540752291485,0.007340356748944586,2356,-270,4877,6963,-0.027681136582335175,-0.016612048838225615,0.04429318542056082,-4266,-2521,-0.16224850720724154,-0.071974322002896
3921,19049,Dallas,Iowa,2008,15149,16954,540,32643,0.4640811199950985,0.519376282817143,0.016542597187758478,4232,347,1771,6350,0.048875551973191544,0.009202240438813892,-0.0580777924120055,-1805,2461,-0.0552951628220445,0.10695334438519705
3922,19049,Dallas,Iowa,2012,16576,20988,552,38116,0.43488298877111975,0.5506349039773324,0.014482107251547907,1427,12,4034,5473,-0.02919813122397874,-0.0020604899362105713,0.031258621160189404,-4412,-2607,-0.11575191520621264,-0.060456752384168144
3923,19049,Dallas,Iowa,2016,15701,19339,3212,38252,0.41046219805500367,0.5055683362961414,0.08396946564885496,-875,2660,-1649,136,-0.02442079071611608,0.06948735839730706,-0.045066567681190994,-3638,774,-0.09510613824113773,0.020645776965074913
3924,19051,Davis,Iowa,2000,1691,1956,111,3758,0.44997339010111764,0.5204896221394358,0.029536987759446513,0,0,0,0,0.0,0.0,0.0,-265,0,-0.0705162320383182,0.0
3925,19051,Davis,Iowa,2004,1731,2148,39,3918,0.44180704441041346,0.5482388973966309,0.009954058192955589,40,-72,192,160,-0.00816634569070418,-0.019582929566490923,0.02774927525719506,-417,-152,-0.10643185298621743,-0.03591562094789924
3926,19051,Davis,Iowa,2008,1680,2029,109,3818,0.4400209533787323,0.5314300680984809,0.0285489785227868,-51,70,-119,-100,-0.0017860910316811474,0.018594920329831212,-0.016808829298149974,-349,68,-0.09140911471974861,0.015022738266468827
3927,19051,Davis,Iowa,2012,1520,2138,115,3773,0.4028624436787702,0.5666578319639544,0.03047972435727538,-160,6,109,-45,-0.037158509699962095,0.00193074583448858,0.03522776386547344,-618,-269,-0.16379538828518414,-0.07238627356543553
3928,19051,Davis,Iowa,2016,977,2723,182,3882,0.25167439464193714,0.7014425553838227,0.04688304997424008,-543,67,585,109,-0.15118804903683308,0.0164033256169647,0.13478472341986836,-1746,-1128,-0.4497681607418856,-0.28597277245670144
3929,19053,Decatur,Iowa,2000,1674,1903,132,3709,0.4513345915341062,0.5130763008897277,0.03558910757616608,0,0,0,0,0.0,0.0,0.0,-229,0,-0.061741709355621455,0.0
3930,19053,Decatur,Iowa,2004,1859,2088,64,4011,0.46347544253303413,0.5205684367988033,0.015956120668162554,185,-68,185,302,0.012140850998927921,-0.019632986908003528,0.0074921359090756035,-229,0,-0.05709299426576914,0.004648715089852318
3931,19053,Decatur,Iowa,2008,1986,2020,100,4106,0.4836824159766196,0.4919629810034096,0.024354603019970774,127,36,-68,95,0.020206973443585463,0.00839848235180822,-0.02860545579539364,-34,195,-0.008280565026790032,0.048812429238979105
3932,19053,Decatur,Iowa,2012,1791,1947,95,3833,0.46725802243673364,0.507957213670754,0.02478476389251239,-195,-5,-73,-273,-0.01642439353988595,0.0004301608725416177,0.015994232667344344,-156,-122,-0.04069919123402033,-0.032418626207230294
3933,19053,Decatur,Iowa,2016,1201,2296,237,3734,0.3216389930369577,0.6148901981788967,0.06347080878414568,-590,142,349,-99,-0.14561902939977595,0.03868604489163329,0.1069329845081427,-1095,-939,-0.293251205141939,-0.25255201390791865
3934,19055,Delaware,Iowa,2000,3808,4273,268,8349,0.4561025272487723,0.5117978200982154,0.03209965265301234,0,0,0,0,0.0,0.0,0.0,-465,0,-0.05569529284944308,0.0
3935,19055,Delaware,Iowa,2004,4227,4908,65,9200,0.45945652173913043,0.5334782608695652,0.007065217391304348,419,-203,635,851,0.0033539944903581143,-0.02503443526170799,0.021680440771349785,-681,-216,-0.07402173913043475,-0.01832644628099167
3936,19055,Delaware,Iowa,2008,4649,4113,141,8903,0.522183533640346,0.4619791081657868,0.015837358193867234,422,76,-795,-297,0.06272701190121555,0.008772140802562885,-0.07149915270377838,536,1217,0.060204425474559176,0.13422616460499392
3937,19055,Delaware,Iowa,2012,4616,4636,126,9378,0.49221582426956706,0.49434847515461716,0.013435700575815739,-33,-15,523,475,-0.029967709370778917,-0.002401657618051495,0.03236936698883036,-20,-556,-0.0021326508850501025,-0.06233707635960928
3938,19055,Delaware,Iowa,2016,2957,5694,590,9241,0.31998701439238175,0.6161670814846878,0.06384590412293042,-1659,464,1058,-137,-0.1722288098771853,0.05041020354711469,0.12181860633007063,-2737,-2717,-0.29618006709230604,-0.29404741620725594
3939,19057,Des Moines,Iowa,2000,11351,7385,629,19365,0.5861605990188484,0.38135812032016525,0.032481280660986316,0,0,0,0,0.0,0.0,0.0,3966,0,0.20480247869868318,0.0
3940,19057,Des Moines,Iowa,2004,12456,8221,197,20874,0.5967231963207819,0.39383922583117753,0.009437577848040625,1105,-432,836,1509,0.01056259730193343,-0.02304370281294569,0.01248110551101228,4235,269,0.20288397048960433,-0.0019185082090788508
3941,19057,Des Moines,Iowa,2008,12462,7721,391,20574,0.6057159521726451,0.37527947895401964,0.01900456887333528,6,194,-500,-300,0.00899275585186321,0.009566991025294654,-0.01855974687715789,4741,506,0.23043647321862543,0.0275525027290211
3942,19057,Des Moines,Iowa,2012,11888,8136,361,20385,0.5831739023792004,0.3991169977924945,0.017709099828305125,-574,-30,415,-189,-0.022542049793444652,-0.0012954690450301537,0.023837518838474847,3752,-989,0.18405690458670593,-0.0463795686319195
3943,19057,Des Moines,Iowa,2016,8212,9529,1362,19103,0.4298801235408051,0.4988221745275611,0.07129770193163378,-3676,1001,1393,-1282,-0.1532937788383953,0.05358860210332865,0.09970517673506663,-1317,-5069,-0.06894205098675599,-0.2529989555734619
3944,19059,Dickinson,Iowa,2000,3660,4225,236,8121,0.4506834133727374,0.5202561260928457,0.029060460534416944,0,0,0,0,0.0,0.0,0.0,-565,0,-0.06957271272010829,0.0
3945,19059,Dickinson,Iowa,2004,4140,5337,76,9553,0.43337171569140587,0.5586726682717471,0.007955616036847064,480,-160,1112,1432,-0.017311697681331506,-0.02110484449756988,0.03841654217890145,-1197,-632,-0.12530095258034124,-0.05572823986023295
3946,19059,Dickinson,Iowa,2008,4625,5162,120,9907,0.4668416271323307,0.5210457252447764,0.012112647622892905,485,44,-175,354,0.033469911440924816,0.004157031586045841,-0.03762694302697067,-537,660,-0.05420409811244575,0.07109685446789549
3947,19059,Dickinson,Iowa,2012,4095,5912,152,10159,0.40309085539915346,0.581947042031696,0.014962102569150508,-530,32,750,252,-0.06375077173317723,0.002849454946257603,0.06090131678691957,-1817,-1280,-0.17885618663254255,-0.1246520885200968
3948,19059,Dickinson,Iowa,2016,3056,6753,545,10354,0.2951516322194321,0.652211705621016,0.052636662159551866,-1039,393,841,195,-0.10793922317972138,0.037674559590401356,0.07026466358932004,-3697,-1880,-0.35706007340158397,-0.17820388676904142
3949,19061,Dubuque,Iowa,2000,22341,16462,1520,40323,0.5540510378692062,0.40825335416511666,0.037695607965677155,0,0,0,0,0.0,0.0,0.0,5879,0,0.14579768370408952,0.0
3950,19061,Dubuque,Iowa,2004,26561,20100,382,47043,0.5646111004825373,0.4272686690899815,0.00812023042748124,4220,-1138,3638,6720,0.01056006261333109,-0.029575377538195915,0.019015314924864857,6461,582,0.13734243139255575,-0.008455252311533767
3951,19061,Dubuque,Iowa,2008,28611,18651,701,47963,0.5965223192877843,0.3888622479828201,0.014615432729395576,2050,319,-1449,920,0.031911218805247055,0.006495202301914336,-0.038406421107161415,9960,3499,0.20766007130496422,0.07031763991240847
3952,19061,Dubuque,Iowa,2012,28768,21280,846,50894,0.565253271505482,0.41812394388336543,0.016622784611152592,157,145,2629,2931,-0.03126904778230233,0.0020073518817570156,0.029261695900545337,7488,-2472,0.14712932762211656,-0.060530743682847665
3953,19061,Dubuque,Iowa,2016,22850,23460,3411,49721,0.4595643691800245,0.47183282717564007,0.0686028036443354,-5918,2565,2180,-1173,-0.10568890232545747,0.051980019033182806,0.053708883292274634,-610,-8098,-0.012268457995615545,-0.1593977856177321
3954,19063,Emmet,Iowa,2000,2165,2331,134,4630,0.46760259179265656,0.5034557235421167,0.028941684665226782,0,0,0,0,0.0,0.0,0.0,-166,0,-0.03585313174946009,0.0
3955,19063,Emmet,Iowa,2004,2405,2697,54,5156,0.4664468580294802,0.5230799069045772,0.01047323506594259,240,-80,366,526,-0.0011557337631763476,-0.01846844959928419,0.019624183362460523,-292,-126,-0.05663304887509696,-0.02077991712563687
3956,19063,Emmet,Iowa,2008,2570,2373,72,5015,0.5124626121635095,0.4731804586241276,0.014356929212362911,165,18,-324,-141,0.04601575413402931,0.0038836941464203203,-0.049899448280449565,197,489,0.039282153539381914,0.09591520241447887
3957,19063,Emmet,Iowa,2012,2099,2507,81,4687,0.44783443567313846,0.5348837209302325,0.017281843396628974,-471,9,134,-328,-0.06462817649037106,0.002924914184266063,0.0617032623061049,-408,-605,-0.08704928525709404,-0.12633143879647596
3958,19063,Emmet,Iowa,2016,1357,3124,272,4753,0.28550389227856093,0.657269093204292,0.05722701451714707,-742,191,617,66,-0.16233054339457753,0.0399451711205181,0.12238537227405955,-1767,-1359,-0.3717652009257311,-0.2847159156686371
3959,19065,Fayette,Iowa,2000,4640,4747,234,9621,0.4822783494439247,0.49339985448498075,0.02432179607109448,0,0,0,0,0.0,0.0,0.0,-107,0,-0.011121505041056023,0.0
3960,19065,Fayette,Iowa,2004,5185,5128,79,10392,0.498941493456505,0.49345650500384913,0.0076020015396458815,545,-155,381,771,0.01666314401258029,-0.0167197945314486,5.6650518868384125e-05,57,164,0.005484988452655881,0.016606493493711905
3961,19065,Fayette,Iowa,2008,5908,4205,149,10262,0.5757162346521146,0.40976417852270514,0.014519586825180278,723,70,-923,-130,0.07677474119560962,0.006917585285534396,-0.083692326481144,1703,1646,0.1659520561294095,0.16046706767675362
3962,19065,Fayette,Iowa,2012,5732,4492,142,10366,0.5529616052479259,0.4333397646150878,0.0136986301369863,-176,-7,287,104,-0.02275462940418871,-0.0008209566881939769,0.02357558609238264,1240,-463,0.11962184063283815,-0.04633021549657135
3963,19065,Fayette,Iowa,2016,3689,5620,666,9975,0.3698245614035088,0.5634085213032581,0.06676691729323309,-2043,524,1128,-391,-0.18313704384441715,0.053068287156246785,0.13006875668817036,-1931,-3171,-0.19358395989974936,-0.3132058005325875
3964,19067,Floyd,Iowa,2000,3830,3191,217,7238,0.5291516993644653,0.44086764299530257,0.029980657640232108,0,0,0,0,0.0,0.0,0.0,639,0,0.0882840563691627,0.0
3965,19067,Floyd,Iowa,2004,4349,3745,73,8167,0.5325088771886862,0.4585527121341986,0.00893841067711522,519,-144,554,929,0.0033571778242209582,-0.021042246963116885,0.01768506913889606,604,-35,0.0739561650544876,-0.0143278913146751
3966,19067,Floyd,Iowa,2008,4822,3051,220,8093,0.5958235512171012,0.376992462622019,0.02718398616087977,473,147,-694,-74,0.06331467402841495,0.01824557548376455,-0.0815602495121796,1771,1167,0.21883108859508216,0.14487492354059456
3967,19067,Floyd,Iowa,2012,4680,3472,105,8257,0.5667918130071454,0.4204917040087199,0.012716482984134674,-142,-115,421,164,-0.02903173820995575,-0.014467503176745097,0.04349924138670086,1208,-563,0.14630010899842555,-0.07253097959665661
3968,19067,Floyd,Iowa,2016,3179,4375,506,8060,0.3944168734491315,0.542803970223325,0.06277915632754343,-1501,401,903,-197,-0.17237493955801392,0.05006267334340875,0.12231226621460517,-1196,-2404,-0.14838709677419354,-0.2946872057726191
3969,19069,Franklin,Iowa,2000,2122,2657,159,4938,0.42972863507492914,0.5380720939651681,0.03219927095990279,0,0,0,0,0.0,0.0,0.0,-535,0,-0.10834345889023894,0.0
3970,19069,Franklin,Iowa,2004,2340,3128,53,5521,0.42383626154682125,0.5665640282557508,0.009599710197428002,218,-106,471,583,-0.005892373528107897,-0.02259956076247479,0.02849193429058272,-788,-253,-0.14272776670892956,-0.03438430781869062
3971,19069,Franklin,Iowa,2008,2575,2501,73,5149,0.5000971062342202,0.4857253835696252,0.014177510196154593,235,20,-627,-372,0.07626084468739897,0.0045777999987265915,-0.08083864468612562,74,862,0.014371722664595021,0.15709948937352458
3972,19069,Franklin,Iowa,2012,2266,2823,97,5186,0.43694562283069804,0.5443501735441574,0.01870420362514462,-309,24,322,37,-0.06315148340352217,0.004526693428990026,0.05862478997453219,-557,-631,-0.10740455071345933,-0.12177627337805436
3973,19069,Franklin,Iowa,2016,1493,3163,312,4968,0.3005233494363929,0.6366747181964574,0.06280193236714976,-773,215,340,-218,-0.13642227339430513,0.04409772874200514,0.0923245446523,-1670,-1113,-0.33615136876006446,-0.22874681804660513
3974,19071,Fremont,Iowa,2000,1459,2069,88,3616,0.40348451327433627,0.572179203539823,0.024336283185840708,0,0,0,0,0.0,0.0,0.0,-610,0,-0.16869469026548672,0.0
3975,19071,Fremont,Iowa,2004,1510,2362,39,3911,0.38609051393505495,0.6039376118639734,0.009971874200971618,51,-49,293,295,-0.01739399933928132,-0.01436440898486909,0.031758408324150444,-852,-242,-0.2178470979289185,-0.04915240766343176
3976,19071,Fremont,Iowa,2008,1848,1989,59,3896,0.47433264887063653,0.510523613963039,0.015143737166324436,338,20,-373,-15,0.08824213493558158,0.005171862965352818,-0.09341399790093441,-141,711,-0.036190965092402494,0.181656132836516
3977,19071,Fremont,Iowa,2012,1637,1972,59,3668,0.4462922573609597,0.5376226826608506,0.01608505997818975,-211,0,-17,-228,-0.028040391509676854,0.0009413228118653142,0.027099068697811535,-335,-194,-0.09133042529989088,-0.05513946020748839
3978,19071,Fremont,Iowa,2016,963,2407,225,3595,0.2678720445062587,0.6695410292072322,0.06258692628650904,-674,166,435,-73,-0.178420212854701,0.04650186630831929,0.13191834654638168,-1444,-1109,-0.40166898470097356,-0.3103385594010827
3979,19073,Greene,Iowa,2000,2301,2282,136,4719,0.48760330578512395,0.4835770290315745,0.028819665183301545,0,0,0,0,0.0,0.0,0.0,19,0,0.00402627675354944,0.0
3980,19073,Greene,Iowa,2004,2459,2618,36,5113,0.48093096029728144,0.5120281635047917,0.0070408761979268535,158,-100,336,394,-0.006672345487842513,-0.021778788985374692,0.028451134473217232,-159,-178,-0.031097203207510304,-0.035123479961059745
3981,19073,Greene,Iowa,2008,2371,2349,84,4804,0.49354704412989175,0.48896752706078267,0.017485428809325562,-88,48,-269,-309,0.012616083832610314,0.010444552611398709,-0.023060636444009075,22,181,0.004579517069109085,0.03567672027661939
3982,19073,Greene,Iowa,2012,2375,2380,91,4846,0.49009492364836976,0.49112670243499795,0.018778373916632275,4,7,31,42,-0.003452120481521992,0.0012929451073067123,0.002159175374215283,-5,-27,-0.0010317787866281902,-0.005611295855737275
3983,19073,Greene,Iowa,2016,1691,2820,310,4821,0.3507571043352002,0.5849408836341008,0.06430201203069902,-684,219,440,-25,-0.13933781931316958,0.04552363811406675,0.09381418119910284,-1129,-1124,-0.2341837792989006,-0.23315200051227242
3984,19075,Grundy,Iowa,2000,2139,3851,121,6111,0.35002454590083454,0.6301750940926198,0.019800360006545573,0,0,0,0,0.0,0.0,0.0,-1712,0,-0.2801505481917853,0.0
3985,19075,Grundy,Iowa,2004,2386,4429,34,6849,0.3483720251131552,0.6466637465323405,0.004964228354504307,247,-87,578,738,-0.0016525207876793568,-0.014836131652041265,0.01648865243972064,-2043,-331,-0.2982917214191853,-0.018141173227399998
3986,19075,Grundy,Iowa,2008,2790,3945,94,6829,0.4085517645336067,0.5776834089910675,0.013764826475325816,404,60,-484,-20,0.06017973942045152,0.008800598120821509,-0.06898033754127297,-1155,888,-0.16913164445746082,0.1291600769617245
3987,19075,Grundy,Iowa,2012,2635,4215,112,6962,0.3784831944843436,0.6054294742889974,0.016087331226659007,-155,18,270,133,-0.03006857004926311,0.0023225047513331914,0.02774606529792989,-1580,-425,-0.22694627980465382,-0.057814635347193
3988,19075,Grundy,Iowa,2016,1856,4527,489,6872,0.270081490104773,0.6587601862630966,0.07115832363213039,-779,377,312,-90,-0.10840170437957058,0.05507099240547138,0.05333071197409922,-2671,-1091,-0.3886786961583236,-0.1617324163536698
3989,19077,Guthrie,Iowa,2000,2493,2840,136,5469,0.455842018650576,0.5192905467178643,0.0248674346315597,0,0,0,0,0.0,0.0,0.0,-347,0,-0.06344852806728835,0.0
3990,19077,Guthrie,Iowa,2004,2614,3325,55,5994,0.43610276943610277,0.5547213880547214,0.009175842509175842,121,-81,485,525,-0.01973924921447323,-0.015691592122383857,0.03543084133685703,-711,-364,-0.11861861861861861,-0.055170090551330264
3991,19077,Guthrie,Iowa,2008,2625,3074,150,5849,0.4487946657548299,0.5255599247734656,0.025645409471704565,11,95,-251,-145,0.012691896318727136,0.01646956696252872,-0.029161463281255795,-449,262,-0.07676525901863568,0.04185335959998293
3992,19077,Guthrie,Iowa,2012,2569,3171,148,5888,0.43631114130434784,0.5385529891304348,0.025135869565217392,-56,-2,97,39,-0.012483524450482064,-0.0005095399064871733,0.01299306435696923,-602,-153,-0.10224184782608697,-0.025476588807451295
3993,19077,Guthrie,Iowa,2016,1732,3628,390,5750,0.3012173913043478,0.6309565217391304,0.06782608695652174,-837,242,457,-138,-0.13509375,0.04269021739130435,0.0924035326086956,-1896,-1294,-0.3297391304347826,-0.22749728260869562
3994,19079,Hamilton,Iowa,2000,3407,3968,199,7574,0.4498283601795617,0.5238975442302615,0.026274095590176922,0,0,0,0,0.0,0.0,0.0,-561,0,-0.07406918405069979,0.0
3995,19079,Hamilton,Iowa,2004,3895,4367,73,8335,0.4673065386922616,0.5239352129574085,0.008758248350329933,488,-126,399,761,0.017478178512699893,-0.01751584723984699,3.766872714705549e-05,-472,89,-0.05662867426514695,0.017440509785552838
3996,19079,Hamilton,Iowa,2008,4018,3913,150,8081,0.4972156911273357,0.48422224972156913,0.018562059151095163,123,77,-454,-254,0.029909152435074138,0.00980381080076523,-0.039712963235839394,105,577,0.012993441405766581,0.06962211567091353
3997,19079,Hamilton,Iowa,2012,3782,3991,154,7927,0.4771035700769522,0.5034691560489466,0.019427273874101172,-236,4,78,-154,-0.020112121050383513,0.0008652147230060088,0.019246906327377467,-209,-314,-0.0263655859719944,-0.03935902737776098
3998,19079,Hamilton,Iowa,2016,2726,4463,505,7694,0.35430205354821936,0.5800623862750195,0.06563556017676112,-1056,351,472,-233,-0.12280151652873283,0.04620828630265994,0.0765932302260729,-1737,-1528,-0.22576033272680013,-0.19939474675480573
3999,19081,Hancock,Iowa,2000,2281,2988,169,5438,0.41945568223611623,0.549466715704303,0.03107760205958073,0,0,0,0,0.0,0.0,0.0,-707,0,-0.13001103346818682,0.0
4000,19081,Hancock,Iowa,2004,2484,3368,53,5905,0.4206604572396274,0.5703640982218459,0.008975444538526672,203,-116,380,467,0.0012047750035111826,-0.02210215752105406,0.020897382517542806,-884,-177,-0.14970364098221844,-0.019692607514031624
4001,19081,Hancock,Iowa,2008,2805,3016,109,5930,0.4730185497470489,0.5086003372681281,0.018381112984822933,321,56,-352,25,0.05235809250742146,0.009405668446296261,-0.06176376095371772,-211,673,-0.03558178752107927,0.11412185346113918
4002,19081,Hancock,Iowa,2012,2521,3317,87,5925,0.42548523206751054,0.559831223628692,0.014683544303797468,-284,-22,301,-5,-0.047533317679538334,-0.0036975686810254652,0.05123088636056383,-796,-585,-0.13434599156118143,-0.09876420404010217
4003,19081,Hancock,Iowa,2016,1587,3977,307,5871,0.2703117015840572,0.6773973769374894,0.05229092147845341,-934,220,660,-54,-0.15517353048345334,0.03760737717465595,0.11756615330879738,-2390,-1594,-0.40708567535343215,-0.2727396837922507
4004,19083,Hardin,Iowa,2000,3734,4486,215,8435,0.44267931238885594,0.5318316538233551,0.025489033787788974,0,0,0,0,0.0,0.0,0.0,-752,0,-0.08915234143449913,0.0
4005,19083,Hardin,Iowa,2004,4015,4875,59,8949,0.4486534808358476,0.5447536037546095,0.006592915409542966,281,-156,389,514,0.005974168446991668,-0.018896118378246007,0.012921949931254395,-860,-108,-0.09610012291876185,-0.006947781484262727
4006,19083,Hardin,Iowa,2008,4393,4315,153,8861,0.49576797201218825,0.4869653537975398,0.017266674190271978,378,94,-560,-88,0.047114491176340645,0.010673758780729011,-0.05778824995706966,78,938,0.00880261821464845,0.1049027411334103
4007,19083,Hardin,Iowa,2012,4075,4670,153,8898,0.4579680827152169,0.5248370420319173,0.017194875252865813,-318,0,355,37,-0.03779988929697137,-7.17989374061645e-05,0.037871688234377476,-595,-673,-0.0668689593167004,-0.07567157753134884
4008,19083,Hardin,Iowa,2016,2787,5254,492,8533,0.32661432087190906,0.6157271768428454,0.057658502285245515,-1288,339,584,-365,-0.13135376184330783,0.0404636270323797,0.09089013481092811,-2467,-1872,-0.28911285597093633,-0.22224389665423594
4009,19085,Harrison,Iowa,2000,2551,3802,190,6543,0.3898823169799786,0.5810790157420144,0.02903866727800703,0,0,0,0,0.0,0.0,0.0,-1251,0,-0.19119669876203577,0.0
4010,19085,Harrison,Iowa,2004,2906,4680,94,7680,0.37838541666666664,0.609375,0.012239583333333333,355,-96,878,1137,-0.011496900313311964,-0.0167990839446737,0.02829598425798563,-1774,-523,-0.23098958333333336,-0.03979288457129759
4011,19085,Harrison,Iowa,2008,3555,3909,119,7583,0.4688118159039958,0.5154951866016089,0.015692997494395358,649,25,-771,-97,0.09042639923732915,0.003453414161062025,-0.09387981339839113,-354,1420,-0.04668337069761308,0.18430621263572028
4012,19085,Harrison,Iowa,2012,3136,4065,121,7322,0.42829827915869984,0.55517618137121,0.01652553947009014,-419,2,156,-261,-0.04051353674529595,0.0008325419756947811,0.039680994769601186,-929,-575,-0.12687790221251022,-0.08019453151489714
4013,19085,Harrison,Iowa,2016,2131,4902,432,7465,0.2854655056932351,0.6566644340254522,0.05787006028131279,-1005,311,837,143,-0.14283277346546475,0.041344520811222654,0.1014882526542421,-2771,-1842,-0.37119892833221707,-0.24432102611970685
4014,19087,Henry,Iowa,2000,3907,4476,288,8671,0.45058240110713876,0.5162034367431669,0.03321416214969438,0,0,0,0,0.0,0.0,0.0,-569,0,-0.06562103563602817,0.0
4015,19087,Henry,Iowa,2004,4127,5220,110,9457,0.4363963201861055,0.5519720841704557,0.011631595643438722,220,-178,744,786,-0.01418608092103324,-0.02158256650625566,0.0357686474272888,-1093,-524,-0.11557576398435021,-0.04995472834832204
4016,19087,Henry,Iowa,2008,4349,4822,209,9380,0.4636460554371002,0.5140724946695095,0.022281449893390193,222,99,-398,-77,0.027249735250994667,0.010649854249951471,-0.037899589500946185,-473,620,-0.05042643923240936,0.06514932475194085
4017,19087,Henry,Iowa,2012,4460,5035,202,9697,0.4599360626998041,0.5192327523976488,0.02083118490254718,111,-7,213,317,-0.0037099927372961083,-0.001450264990843015,0.005160257728139217,-575,-102,-0.059296689697844684,-0.008870250465435325
4018,19087,Henry,Iowa,2016,2904,5779,721,9404,0.3088047639302425,0.6145257337303275,0.07666950233943003,-1556,519,744,-293,-0.1511312987695616,0.05583831743688285,0.09529298133267872,-2875,-2300,-0.305720969800085,-0.24642428010224032
4019,19089,Howard,Iowa,2000,2426,1922,143,4491,0.5401914940993098,0.42796704520151413,0.03184146069917613,0,0,0,0,0.0,0.0,0.0,504,0,0.11222444889779565,0.0
4020,19089,Howard,Iowa,2004,2614,2028,55,4697,0.5565254417713434,0.4317649563551203,0.0117096018735363,188,-88,106,206,0.016333947672033666,-0.02013185882563983,0.0037979111536061705,586,82,0.12476048541622314,0.012536036518427496
4021,19089,Howard,Iowa,2008,2941,1722,66,4729,0.6219073799957707,0.36413618101078454,0.013956438993444703,327,11,-306,32,0.06538193822442728,0.0022468371199084024,-0.06762877534433576,1219,633,0.2577711989849862,0.13301071356876304
4022,19089,Howard,Iowa,2012,2768,1795,82,4645,0.5959095801937567,0.38643702906350913,0.017653390742734122,-173,16,73,-84,-0.025997799802014,0.003696951749289419,0.022300848052724587,973,-246,0.2094725511302476,-0.048298647854738586
4023,19089,Howard,Iowa,2016,1677,2611,271,4559,0.3678438254003071,0.5727133143233165,0.0594428602763764,-1091,189,816,-86,-0.22806575479344965,0.04178946953364228,0.18627628525980738,-934,-1907,-0.20486948892300944,-0.41434204005325703
4024,19091,Humboldt,Iowa,2000,1949,2846,145,4940,0.3945344129554656,0.5761133603238866,0.029352226720647773,0,0,0,0,0.0,0.0,0.0,-897,0,-0.181578947368421,0.0
4025,19091,Humboldt,Iowa,2004,2146,3162,42,5350,0.4011214953271028,0.5910280373831776,0.007850467289719627,197,-103,316,410,0.006587082371637187,-0.021501759430928146,0.014914677059290948,-1016,-119,-0.18990654205607477,-0.008327594687653761
4026,19091,Humboldt,Iowa,2008,2160,2895,68,5123,0.42162795237165723,0.5650985750536794,0.013273472574663284,14,26,-267,-227,0.02050645704455445,0.005423005284943657,-0.02592946232949811,-735,281,-0.1434706226820222,0.04643591937405256
4027,19091,Humboldt,Iowa,2012,1972,3099,87,5158,0.38231872818922064,0.600814269096549,0.016867002714230323,-188,19,204,35,-0.0393092241824366,0.0035935301395670395,0.03571569404286956,-1127,-392,-0.21849554090732837,-0.07502491822530616
4028,19091,Humboldt,Iowa,2016,1252,3568,267,5087,0.2461175545508158,0.7013957145665421,0.05248673088264203,-720,180,469,-71,-0.13620117363840484,0.035619728168411705,0.10058144546999315,-2316,-1189,-0.45527816001572635,-0.23678261910839798
4029,19093,Ida,Iowa,2000,1411,1968,112,3491,0.4041821827556574,0.5637353193927241,0.03208249785161845,0,0,0,0,0.0,0.0,0.0,-557,0,-0.15955313663706672,0.0
4030,19093,Ida,Iowa,2004,1415,2342,17,3774,0.3749337572866985,0.620561738208797,0.0045045045045045045,4,-95,374,283,-0.02924842546895895,-0.027577993347113947,0.056826418816072866,-927,-370,-0.24562798092209853,-0.08607484428503182
4031,19093,Ida,Iowa,2008,1454,2036,57,3547,0.409923879334649,0.5740062024245841,0.016069918240766846,39,40,-306,-227,0.034990122047950545,0.011565413736262343,-0.0465555357842129,-582,345,-0.1640823230899351,0.08154565783216344
4032,19093,Ida,Iowa,2012,1321,2286,56,3663,0.36063336063336066,0.6240786240786241,0.015288015288015287,-133,-1,250,116,-0.049290518701288366,-0.0007819029527515592,0.05007242165404002,-965,-383,-0.2634452634452635,-0.09936294035532839
4033,19093,Ida,Iowa,2016,792,2655,165,3612,0.21926910299003322,0.7350498338870431,0.04568106312292359,-529,109,369,-51,-0.14136425764332744,0.0303930478349083,0.11097120980841901,-1863,-898,-0.5157807308970099,-0.25233546745174645
4034,19095,Iowa,Iowa,2000,3230,3894,289,7413,0.4357210306218805,0.5252934034803723,0.0389855658977472,0,0,0,0,0.0,0.0,0.0,-664,0,-0.08957237285849184,0.0
4035,19095,Iowa,Iowa,2004,3841,4544,69,8454,0.45434114028862077,0.5374970428199669,0.008161816891412349,611,-220,650,1041,0.01862010966674027,-0.030823749006334854,0.012203639339594563,-703,-39,-0.08315590253134614,0.006416470327145707
4036,19095,Iowa,Iowa,2008,4202,4188,158,8548,0.4915769770706598,0.48993916705662144,0.018483855872718766,361,89,-356,94,0.03723583678203901,0.010322038981306417,-0.04755787576334547,14,717,0.0016378100140383434,0.08479371254538448
4037,19095,Iowa,Iowa,2012,4144,4569,153,8866,0.46740356417775775,0.515339499210467,0.017256936611775322,-58,-5,381,318,-0.024173412892902035,-0.0012269192609434439,0.025400332153845517,-425,-439,-0.04793593503270921,-0.04957374504674755
4038,19095,Iowa,Iowa,2016,3084,5205,615,8904,0.3463611859838275,0.5845687331536388,0.06907008086253369,-1060,462,636,38,-0.12104237819393027,0.051813144250758364,0.06922923394317182,-2121,-1696,-0.2382075471698113,-0.1902716121371021
4039,19097,Jackson,Iowa,2000,4945,3769,318,9032,0.5474977856510186,0.41729406554472986,0.03520814880425155,0,0,0,0,0.0,0.0,0.0,1176,0,0.13020372010628872,0.0
4040,19097,Jackson,Iowa,2004,5656,4242,113,10011,0.5649785236240136,0.4237338927180102,0.011287583657976226,711,-205,473,979,0.017480737972994986,-0.023920565146275323,0.006439827173280344,1414,238,0.14124463090600337,0.011040910799714643
4041,19097,Jackson,Iowa,2008,6102,3673,182,9957,0.6128351913226876,0.36888621070603594,0.01827859797127649,446,69,-569,-54,0.04785666769867403,0.0069910143133002645,-0.054847682011974264,2429,1015,0.24394898061665166,0.10270434971064829
4042,19097,Jackson,Iowa,2012,5907,4177,158,10242,0.5767428236672525,0.40783050185510644,0.015426674477641086,-195,-24,504,285,-0.03609236765543511,-0.0028519234936354044,0.0389442911490705,1730,-699,0.16891232181214605,-0.07503665880450561
4043,19097,Jackson,Iowa,2016,3837,5824,649,10310,0.37216294859359844,0.5648884578079535,0.06294859359844811,-2070,491,1647,68,-0.20457987507365405,0.04752191912080702,0.15705795595284705,-1987,-3717,-0.19272550921435505,-0.3616378310265011
4044,19099,Jasper,Iowa,2000,8699,8729,407,17835,0.48774880852256797,0.4894308943089431,0.022820297168488927,0,0,0,0,0.0,0.0,0.0,-30,0,-0.0016820857863751315,0.0
4045,19099,Jasper,Iowa,2004,10430,9462,170,20062,0.5198883461270063,0.4716379224404347,0.008473731432559067,1731,-237,733,2227,0.03213953760443833,-0.01434656573592986,-0.017792971868508423,968,998,0.04825042368657162,0.04993250947294675
4046,19099,Jasper,Iowa,2008,10250,8794,378,19422,0.5277520337761301,0.4527855009782721,0.019462465245597776,-180,208,-668,-640,0.007863687649123818,0.01098873381303871,-0.018852421462162594,1456,488,0.07496653279785803,0.026716109111286412
4047,19099,Jasper,Iowa,2012,10257,8877,381,19515,0.5255956956187549,0.454880860876249,0.019523443504996157,7,3,83,93,-0.0021563381573752594,6.0978259398380974e-05,0.002095359897976934,1380,-76,0.07071483474250584,-0.004251698055352193
4048,19099,Jasper,Iowa,2016,7109,10560,1365,19034,0.37348954502469267,0.5547966796259325,0.0717137753493748,-3148,984,1683,-481,-0.15210615059406218,0.05219033184437864,0.09991581874968347,-3451,-4831,-0.18130713460123982,-0.25202196934374566
4049,19101,Jefferson,Iowa,2000,2863,3248,1437,7548,0.3793057763645999,0.4303126656067833,0.19038155802861687,0,0,0,0,0.0,0.0,0.0,-385,0,-0.051006889242183384,0.0
4050,19101,Jefferson,Iowa,2004,4490,3648,143,8281,0.5422050476995532,0.4405265064605724,0.01726844583987441,1627,-1294,400,733,0.16289927133495335,-0.17311311218874245,0.010213840853789125,842,1227,0.10167854123898085,0.15268543048116423
4051,19101,Jefferson,Iowa,2008,5070,3324,238,8632,0.5873493975903614,0.3850787766450417,0.02757182576459685,580,95,-324,351,0.04514434989080818,0.010303379924722439,-0.0554477298155307,1746,904,0.20227062094531972,0.10059207970633888
4052,19101,Jefferson,Iowa,2012,4798,3436,296,8530,0.5624853458382181,0.40281359906213365,0.0347010550996483,-272,58,112,-102,-0.024864051752143346,0.007129229335051449,0.017734822417091956,1362,-384,0.15967174677608442,-0.0425988741692353
4053,19101,Jefferson,Iowa,2016,3710,3748,698,8156,0.4548798430603237,0.45953898970083373,0.08558116723884257,-1088,402,312,-374,-0.10760550277789438,0.05088011213919427,0.05672539063870008,-38,-1400,-0.004659146640510037,-0.16433089341659446
4054,19103,Johnson,Iowa,2000,31174,17899,3696,52769,0.5907635164585268,0.33919536091265706,0.07004112262881616,0,0,0,0,0.0,0.0,0.0,13275,0,0.2515681555458697,0.0
4055,19103,Johnson,Iowa,2004,41847,22715,811,65373,0.6401266577945023,0.3474676089517079,0.012405733253789792,10673,-2885,4816,12604,0.049363141335975524,-0.05763538937502637,0.008272248039050856,19132,5857,0.29265904884279437,0.04109089329692467
4056,19103,Johnson,Iowa,2008,51027,20732,1230,72989,0.6991053446409733,0.28404280097000917,0.016851854389017523,9180,419,-1983,7616,0.05897868684647101,0.004446121135227731,-0.06342480798169875,30295,11163,0.4150625436709641,0.12240349482816976
4057,19103,Johnson,Iowa,2012,50666,23698,1613,75977,0.6668597075430722,0.3119101833449597,0.021230109111968095,-361,383,2966,2988,-0.03224563709790107,0.0043782547229505725,0.02786738237495051,26968,-3327,0.35494952419811254,-0.06011301947285158
4058,19103,Johnson,Iowa,2016,50200,21044,5696,76940,0.6524564595788926,0.2735118273979725,0.07403171302313491,-466,4083,-2654,963,-0.014403247964179577,0.05280160391116681,-0.038398355946987206,29156,2188,0.37894463218092017,0.02399510798280763
4059,19105,Jones,Iowa,2000,4690,4201,252,9143,0.5129607349885158,0.4594771956688177,0.02756206934266652,0,0,0,0,0.0,0.0,0.0,489,0,0.053483539319698126,0.0
4060,19105,Jones,Iowa,2004,5054,4834,90,9978,0.5065143315293646,0.4844658248145921,0.009019843656043296,364,-162,633,835,-0.006446403459151151,-0.018542225686623226,0.024988629145774433,220,-269,0.022048506714772542,-0.031435032604925583
4061,19105,Jones,Iowa,2008,5446,4405,157,10008,0.5441646682653877,0.4401478816946443,0.015687450039968024,392,67,-429,30,0.03765033673602303,0.006667606383924728,-0.0443179431199478,1041,821,0.10401678657074337,0.08196827985597083
4062,19105,Jones,Iowa,2012,5534,4721,194,10449,0.5296200593358216,0.45181357067661976,0.018566369987558617,88,37,316,441,-0.014544608929566105,0.0028789199475905934,0.011665688981975453,813,-228,0.07780648865920181,-0.026210297911541558
4063,19105,Jones,Iowa,2016,3787,5720,626,10133,0.3737293989933879,0.5644922530346393,0.061778347971972764,-1747,432,999,-316,-0.15589066034243365,0.043211977984414146,0.11267868235801959,-1933,-2746,-0.19076285404125143,-0.26856934270045324
4064,19107,Keokuk,Iowa,2000,2181,2571,195,4947,0.4408732565191025,0.5197089144936325,0.03941782898726501,0,0,0,0,0.0,0.0,0.0,-390,0,-0.07883565797453007,0.0
4065,19107,Keokuk,Iowa,2004,2294,3119,67,5480,0.41861313868613137,0.5691605839416058,0.012226277372262773,113,-128,548,533,-0.022260117832971105,-0.027191551615002234,0.0494516694479733,-825,-435,-0.15054744525547448,-0.0717117872809444
4066,19107,Keokuk,Iowa,2008,2518,2712,132,5362,0.46960089518836257,0.505781424841477,0.02461767997016039,224,65,-407,-118,0.050987756502231196,0.012391402597897616,-0.06337915910012881,-194,631,-0.03618052965311447,0.11436691560236001
4067,19107,Keokuk,Iowa,2012,2303,2843,120,5266,0.43733383972654766,0.5398784656285606,0.02278769464489176,-215,-12,131,-96,-0.03226705546181491,-0.0018299853252686307,0.03409704078708353,-540,-346,-0.10254462590201291,-0.06636409624889844
4068,19107,Keokuk,Iowa,2016,1342,3390,253,4985,0.26920762286860583,0.6800401203610833,0.050752256770310936,-961,133,547,-281,-0.16812621685794182,0.027964562125419177,0.14016165473252273,-2048,-1508,-0.41083249749247747,-0.30828787159046456
4069,19109,Kossuth,Iowa,2000,3960,4612,306,8878,0.44604640684838925,0.5194863708042352,0.03446722234737554,0,0,0,0,0.0,0.0,0.0,-652,0,-0.07343996395584595,0.0
4070,19109,Kossuth,Iowa,2004,4132,5042,84,9258,0.4463166990710737,0.5446100669691079,0.009073233959818535,172,-222,430,380,0.00027029222268443176,-0.025393988387557,0.025123696164872644,-910,-258,-0.09829336789803417,-0.024853403942188212
4071,19109,Kossuth,Iowa,2008,4625,4329,146,9100,0.5082417582417582,0.4757142857142857,0.016043956043956045,493,62,-713,-158,0.06192505917068453,0.00697072208413751,-0.06889578125482215,296,1206,0.03252747252747251,0.13082084042550668
4072,19109,Kossuth,Iowa,2012,3850,4937,136,8923,0.43146923680376553,0.553289252493556,0.01524151070267847,-775,-10,608,-177,-0.07677252143799268,-0.0008024453412775745,0.07757496677927028,-1087,-1383,-0.12182001568979045,-0.15434748821726296
4073,19109,Kossuth,Iowa,2016,2543,5653,411,8607,0.2954571860113861,0.6567909840827234,0.04775182990589055,-1307,275,716,-316,-0.13601205079237944,0.03251031920321208,0.10350173158916742,-3110,-2023,-0.3613337980713373,-0.23951378238154686
4074,19111,Lee,Iowa,2000,9632,6339,601,16572,0.5812213371952691,0.38251267197682837,0.03626599082790249,0,0,0,0,0.0,0.0,0.0,3293,0,0.19870866521844077,0.0
4075,19111,Lee,Iowa,2004,10152,7472,234,17858,0.5684847127337888,0.41841191622802104,0.013103371038190167,520,-367,1133,1286,-0.012736624461480384,-0.02316261978971232,0.035899244251192675,2680,-613,0.1500727965057677,-0.04863586871267306
4076,19111,Lee,Iowa,2008,9821,7062,347,17230,0.5699941961694719,0.40986651189785256,0.020139291932675565,-331,113,-410,-628,0.0015094834356831344,0.007035920894485398,-0.008545404330168482,2759,79,0.16012768427161933,0.010054887765851617
4077,19111,Lee,Iowa,2012,10714,7785,412,18911,0.5665485696155677,0.411665168420496,0.021786261963936335,893,65,723,1681,-0.0034456265539042352,0.0016469700312607694,0.0017986565226434381,2929,170,0.15488340119507166,-0.005244283076547673
4078,19111,Lee,Iowa,2016,6215,8803,1133,16151,0.3848058943718655,0.5450436505479537,0.07015045508018079,-4499,721,1018,-2760,-0.18174267524370213,0.04836419311624446,0.13337848212745768,-2588,-5517,-0.16023775617608815,-0.3151211573711598
4079,19113,Linn,Iowa,2000,48897,40417,2750,92064,0.5311196558915537,0.4390098192561696,0.02987052485227668,0,0,0,0,0.0,0.0,0.0,8480,0,0.09210983663538413,0.0
4080,19113,Linn,Iowa,2004,60442,49442,856,110740,0.5458009752573596,0.4464692071518873,0.007729817590753116,11545,-1894,9025,18676,0.014681319365805856,-0.022140707261523562,0.007459387895717706,11000,2520,0.09933176810547228,0.00722193147008815
4081,19113,Linn,Iowa,2008,68037,43626,1706,113369,0.6001376037541126,0.3848141908281805,0.015048205417706781,7595,850,-5816,2629,0.054336628496753026,0.007318387826953665,-0.06165501632370679,24411,13411,0.2153234129259321,0.11599164482045982
4082,19113,Linn,Iowa,2012,68581,47622,2250,118453,0.5789722505972833,0.4020328737980465,0.018994875604670208,544,544,3996,5084,-0.021165353156829325,0.003946670186963427,0.01721868296986595,20959,-3452,0.17693937679923682,-0.038384036126695276
4083,19113,Linn,Iowa,2016,58935,48390,9773,117098,0.5032963842251789,0.413243607918154,0.08346000785666706,-9646,7523,768,-1355,-0.07567586637210444,0.06446513225199685,0.011210734120107535,10545,-10414,0.09005277630702485,-0.08688660049221197
4084,19115,Louisa,Iowa,2000,2294,2207,136,4637,0.4947164114729351,0.4759542807849903,0.029329307742074616,0,0,0,0,0.0,0.0,0.0,87,0,0.0187621306879448,0.0
4085,19115,Louisa,Iowa,2004,2297,2572,47,4916,0.4672497965825875,0.5231895850284785,0.009560618388934093,3,-89,365,279,-0.02746661489034763,-0.019768689353140523,0.04723530424348815,-275,-362,-0.05593978844589098,-0.07470191913383578
4086,19115,Louisa,Iowa,2008,2523,2314,84,4921,0.5127006705954075,0.470229628124365,0.017069701280227598,226,37,-258,5,0.04545087401282,0.0075090828912935045,-0.05295995690411348,209,484,0.0424710424710425,0.09841083091693348
4087,19115,Louisa,Iowa,2012,2452,2420,96,4968,0.49355877616747185,0.48711755233494364,0.01932367149758454,-71,12,106,47,-0.019141894427935624,0.0022539702173569424,0.016887924210578664,32,-177,0.006441223832528209,-0.03602981863851429
4088,19115,Louisa,Iowa,2016,1648,3069,291,5008,0.329073482428115,0.6128194888178914,0.05810702875399361,-804,195,649,40,-0.16448529373935683,0.038783357256409065,0.12570193648294775,-1421,-1453,-0.2837460063897764,-0.2901872302223046
4089,19117,Lucas,Iowa,2000,1934,2262,107,4303,0.44945386939344645,0.525679758308157,0.02486637229839647,0,0,0,0,0.0,0.0,0.0,-328,0,-0.0762258889147106,0.0
4090,19117,Lucas,Iowa,2004,1987,2543,41,4571,0.43469700284401663,0.5563334062568366,0.008969590899146795,53,-66,281,268,-0.014756866549429815,-0.015896781399249674,0.03065364794867953,-556,-228,-0.12163640341281995,-0.045410514498109344
4091,19117,Lucas,Iowa,2008,2029,2330,117,4476,0.4533065236818588,0.5205540661304736,0.02613941018766756,42,76,-213,-95,0.018609520837842175,0.017169819288520766,-0.03577934012636297,-301,255,-0.0672475424486148,0.054388860964205143
4092,19117,Lucas,Iowa,2012,1987,2254,82,4323,0.45963451306962755,0.5213971778857275,0.018968309044644922,-42,-35,-76,-153,0.00632798938776874,-0.007171101143022638,0.0008431117552538669,-267,34,-0.06176266481609993,0.005484877632514873
4093,19117,Lucas,Iowa,2016,1239,2877,238,4354,0.2845659163987138,0.6607717041800643,0.05466237942122187,-748,156,623,31,-0.17506859667091373,0.035694070376576945,0.13937452629433678,-1638,-1371,-0.37620578778135044,-0.3144431229652505
4094,19119,Lyon,Iowa,2000,1313,3918,111,5342,0.24578809434668664,0.7334331710969674,0.020778734556345938,0,0,0,0,0.0,0.0,0.0,-2605,0,-0.48764507675028074,0.0
4095,19119,Lyon,Iowa,2004,1303,4751,47,6101,0.2135715456482544,0.7787247992132438,0.007703655138501885,-10,-64,833,759,-0.03221654869843224,-0.013075079417844054,0.045291628116276406,-3448,-843,-0.5651532535649894,-0.07750817681470862
4096,19119,Lyon,Iowa,2008,1675,4471,74,6220,0.2692926045016077,0.7188102893890675,0.011897106109324759,372,27,-280,119,0.055721058853353295,0.004193450970822874,-0.05991450982417623,-2796,652,-0.44951768488745986,0.1156355686775295
4097,19119,Lyon,Iowa,2012,1423,4978,108,6509,0.21862037179290214,0.7647872176985712,0.016592410508526657,-252,34,507,289,-0.05067223270870555,0.004695304399201898,0.04597692830950362,-3555,-759,-0.546166845905669,-0.09664916101820914
4098,19119,Lyon,Iowa,2016,920,5192,265,6377,0.14426846479535832,0.8141759448016309,0.04155559040301082,-503,157,214,-132,-0.07435190699754382,0.024963179894484166,0.04938872710305975,-4272,-717,-0.6699074800062725,-0.12374063410060354
4099,19121,Madison,Iowa,2000,3093,3662,214,6969,0.4438226431338786,0.5254699382981777,0.03070741856794375,0,0,0,0,0.0,0.0,0.0,-569,0,-0.08164729516429908,0.0
4100,19121,Madison,Iowa,2004,3380,4538,86,8004,0.4222888555722139,0.5669665167416292,0.01074462768615692,287,-128,876,1035,-0.021533787561664686,-0.019962790881786832,0.04149657844345156,-1158,-589,-0.14467766116941533,-0.06303036600511625
4101,19121,Madison,Iowa,2008,3733,4579,169,8481,0.4401603584482962,0.5399127461384271,0.019926895413276736,353,83,41,477,0.0178715028760823,0.009182267727119815,-0.027053770603202132,-846,312,-0.0997523876901309,0.04492527347928443
4102,19121,Madison,Iowa,2012,3630,4638,190,8458,0.4291794750532041,0.5483565854812013,0.022463939465594704,-103,21,59,-23,-0.010980883395092123,0.002537044052317968,0.008443839342774151,-1008,-162,-0.11917711042799717,-0.019424722737866273
4103,19121,Madison,Iowa,2016,2678,5360,598,8636,0.310097267253358,0.6206577119036591,0.06924502084298287,-952,408,722,178,-0.11908220779984607,0.046781081377388165,0.0723011264224579,-2682,-1674,-0.31056044465030114,-0.19138333422230397
4104,19123,Mahaska,Iowa,2000,3370,5971,202,9543,0.353138426071466,0.6256942261343393,0.0211673477941947,0,0,0,0,0.0,0.0,0.0,-2601,0,-0.27255580006287333,0.0
4105,19123,Mahaska,Iowa,2004,3790,6858,80,10728,0.35328113348247575,0.639261744966443,0.007457121551081283,420,-122,887,1185,0.00014270741100974593,-0.013710226243113417,0.013567518832103609,-3068,-467,-0.2859806114839672,-0.013424811421093863
4106,19123,Mahaska,Iowa,2008,4464,6271,199,10934,0.4082677885494787,0.5735321017011158,0.018200109749405523,674,119,-587,206,0.054986655067002954,0.010742988198324241,-0.06572964326532715,-1807,1261,-0.1652643131516371,0.12071629833233011
4107,19123,Mahaska,Iowa,2012,4213,6448,222,10883,0.38711752274189104,0.5924836901589635,0.020398787099145457,-251,23,177,-51,-0.021150265807587665,0.0021986773497399345,0.018951588457847723,-2235,-428,-0.20536616741707248,-0.04010185426543539
4108,19123,Mahaska,Iowa,2016,2619,7432,581,10632,0.24633182844243792,0.6990218209179835,0.05464635063957863,-1594,359,984,-251,-0.14078569429945312,0.03424756354043317,0.10653813075901997,-4813,-2578,-0.45268999247554553,-0.24732382505847306
4109,19125,Marion,Iowa,2000,5741,8358,309,14408,0.39845918933925595,0.580094392004442,0.021446418656302053,0,0,0,0,0.0,0.0,0.0,-2617,0,-0.18163520266518607,0.0
4110,19125,Marion,Iowa,2004,6574,9990,132,16696,0.39374700527072354,0.5983469094393867,0.007906085289889795,833,-177,1632,2288,-0.00471218406853241,-0.013540333366412258,0.018252517434944715,-3416,-799,-0.2045999041686632,-0.022964701503477125
4111,19125,Marion,Iowa,2008,7421,9256,355,17032,0.4357092531705026,0.5434476279943635,0.020843118835133866,847,223,-734,336,0.04196224789977904,0.012937033545244071,-0.05489928144502321,-1835,1581,-0.10773837482386095,0.09686152934480224
4112,19125,Marion,Iowa,2012,7507,9828,352,17687,0.42443602646011197,0.5556623508791768,0.019901622660711257,86,-3,572,655,-0.011273226710390605,-0.0009414961744226083,0.01221472288481329,-2321,-486,-0.13122632441906484,-0.023487949595203894
4113,19125,Marion,Iowa,2016,5482,10962,1372,17816,0.3077009429726089,0.6152896273013022,0.07700942972608892,-2025,1020,1134,129,-0.11673508348750306,0.05710780706537766,0.0596272764221254,-5480,-3159,-0.3075886843286933,-0.17636235990962845
4114,19127,Marshall,Iowa,2000,8322,8785,517,17624,0.47219700408533816,0.49846799818429416,0.02933499773036768,0,0,0,0,0.0,0.0,0.0,-463,0,-0.026270994098956002,0.0
4115,19127,Marshall,Iowa,2004,9443,9557,164,19164,0.492746816948445,0.49869547067418074,0.008557712377374243,1121,-353,772,1540,0.020549812863106864,-0.02077728535299344,0.00022747248988658209,-114,349,-0.00594865372573572,0.020322340373220282
4116,19127,Marshall,Iowa,2008,10023,8278,362,18663,0.5370519209130364,0.44355141188447733,0.019396667202486204,580,198,-1279,-501,0.04430510396459142,0.010838954825111961,-0.05514405878970341,1745,1859,0.09350050902855911,0.09944916275429483
4117,19127,Marshall,Iowa,2012,10257,8472,335,19064,0.538029794376836,0.4443978178766261,0.017572387746537976,234,-27,194,401,0.0009778734637995168,-0.0018242794559482287,0.0008464059921487466,1785,40,0.09363197650020988,0.00013146747165077022
4118,19127,Marshall,Iowa,2016,7652,9146,1182,17980,0.42558398220244714,0.5086763070077864,0.06573971078976641,-2605,847,674,-1084,-0.11244581217438882,0.04816732304322843,0.06427848913116035,-1494,-3279,-0.08309232480533929,-0.17672430130554917
4119,19129,Mills,Iowa,2000,2039,3684,192,5915,0.3447168216398986,0.6228233305156382,0.03245984784446323,0,0,0,0,0.0,0.0,0.0,-1645,0,-0.2781065088757396,0.0
4120,19129,Mills,Iowa,2004,2308,4556,76,6940,0.3325648414985591,0.6564841498559078,0.01095100864553314,269,-116,872,1025,-0.012151980141339502,-0.02150883919893009,0.03366081934026954,-2248,-603,-0.32391930835734867,-0.045812799481609046
4121,19129,Mills,Iowa,2008,2976,4183,124,7283,0.40862282026637375,0.574351228889194,0.01702595084443224,668,48,-373,343,0.07605797876781467,0.0060749421988991,-0.08213292096671376,-1207,1041,-0.16572840862282023,0.15819089973452843
4122,19129,Mills,Iowa,2012,2848,4216,148,7212,0.3948973932334997,0.5845812534664449,0.020521353300055462,-128,24,33,-71,-0.013725427032874049,0.0034954024556232213,0.010230024577250862,-1368,-161,-0.18968386023294515,-0.02395545161012491
4123,19129,Mills,Iowa,2016,2090,5067,541,7698,0.27149909067290207,0.6582229150428682,0.07027799428422966,-758,393,851,486,-0.12339830256059764,0.049756640984174205,0.07364166157642338,-2977,-1609,-0.38672382436996616,-0.19703996413702102
4124,19131,Mitchell,Iowa,2000,2650,2388,124,5162,0.5133669120495932,0.4626113909337466,0.02402169701666021,0,0,0,0,0.0,0.0,0.0,262,0,0.05075552111584658,0.0
4125,19131,Mitchell,Iowa,2004,2785,2646,49,5480,0.5082116788321168,0.4828467153284672,0.008941605839416058,135,-75,258,318,-0.0051552332174763515,-0.015080091177244152,0.02023532439472059,139,-123,0.02536496350364964,-0.02539055761219694
4126,19131,Mitchell,Iowa,2008,3179,2469,118,5766,0.551335414498786,0.42819979188345475,0.02046479361775928,394,69,-177,286,0.04312373566666916,0.011523187778343222,-0.05464692344501243,710,571,0.12313562261533123,0.09777065911168159
4127,19131,Mitchell,Iowa,2012,2831,2643,112,5586,0.5068027210884354,0.4731471535982814,0.020050125313283207,-348,-6,174,-180,-0.0445326934103506,-0.0004146683044760728,0.04494736171482666,188,-522,0.03365556749015397,-0.08948005512517726
4128,19131,Mitchell,Iowa,2016,1888,3190,339,5417,0.34853239800627656,0.5888868377330626,0.06258076426066088,-943,227,547,-169,-0.15827032308215883,0.04253063894737767,0.1157396841347812,-1302,-1490,-0.24035443972678605,-0.27401000721694
4129,19133,Monona,Iowa,2000,2086,2304,170,4560,0.45745614035087717,0.5052631578947369,0.03728070175438596,0,0,0,0,0.0,0.0,0.0,-218,0,-0.04780701754385969,0.0
4130,19133,Monona,Iowa,2004,2397,2575,46,5018,0.47768035073734555,0.5131526504583499,0.009166998804304504,311,-124,271,458,0.020224210386468378,-0.02811370295008146,0.007889492563613043,-178,40,-0.03547229972100435,0.012334717822855334
4131,19133,Monona,Iowa,2008,2295,2411,91,4797,0.47842401500938087,0.5026057952887221,0.018970189701897018,-102,45,-164,-221,0.0007436642720353159,0.009803190897592514,-0.010546855169627833,-116,62,-0.024181780279341203,0.01129051944166315
4132,19133,Monona,Iowa,2012,2101,2557,84,4742,0.44306199915647404,0.5392239561366512,0.017714044706874738,-194,-7,146,-55,-0.035362015852906825,-0.0012561449950222806,0.036618160847929127,-456,-340,-0.09616195698017715,-0.07198017670083595
4133,19133,Monona,Iowa,2016,1247,3120,205,4572,0.2727471566054243,0.6824146981627297,0.04483814523184602,-854,121,563,-170,-0.17031484255104973,0.02712410052497128,0.1431907420260785,-1873,-1417,-0.4096675415573054,-0.31350558457712824
4134,19135,Monroe,Iowa,2000,1699,1858,90,3647,0.4658623526185906,0.509459829997258,0.024677817384151358,0,0,0,0,0.0,0.0,0.0,-159,0,-0.043597477378667426,0.0
4135,19135,Monroe,Iowa,2004,1855,2067,41,3963,0.46807973757254606,0.5215745647236941,0.010345697703759779,156,-49,209,316,0.002217384953955459,-0.014332119680391579,0.012114734726436094,-212,-53,-0.05349482715114806,-0.009897349772480635
4136,19135,Monroe,Iowa,2008,1798,2000,76,3874,0.46411977284460504,0.5162622612287042,0.01961796592669076,-57,35,-67,-89,-0.003959964727941023,0.009272268222930981,-0.005312303494989901,-202,10,-0.052142488384099184,0.0013523387670488773
4137,19135,Monroe,Iowa,2012,1731,2026,73,3830,0.45195822454308093,0.528981723237598,0.01906005221932115,-67,-3,26,-44,-0.012161548301524105,-0.000557913707369611,0.012719462008893734,-295,-93,-0.07702349869451702,-0.02488101031041784
4138,19135,Monroe,Iowa,2016,1056,2638,171,3865,0.27322121604139715,0.682535575679172,0.04424320827943079,-675,98,612,35,-0.17873700850168378,0.02518315606010964,0.15355385244157405,-1582,-1287,-0.40931435963777485,-0.3322908609432578
4139,19137,Montgomery,Iowa,2000,1838,3417,139,5394,0.3407489803485354,0.6334816462736373,0.025769373377827216,0,0,0,0,0.0,0.0,0.0,-1579,0,-0.29273266592510194,0.0
4140,19137,Montgomery,Iowa,2004,1899,3601,56,5556,0.341792656587473,0.6481281497480201,0.010079193664506839,61,-83,184,162,0.0010436762389375853,-0.015690179713320377,0.014646503474382788,-1702,-123,-0.30633549316054715,-0.013602827235445203
4141,19137,Montgomery,Iowa,2008,2326,2887,76,5289,0.4397806768765362,0.5458498771034221,0.014369446020041596,427,20,-714,-267,0.09798802028906323,0.0042902523555347575,-0.10227827264459799,-561,1141,-0.10606920022688593,0.20026629293366122
4142,19137,Montgomery,Iowa,2012,1922,3001,102,5025,0.3824875621890547,0.5972139303482588,0.020298507462686566,-404,26,114,-264,-0.057293114687481494,0.00592906144264497,0.051364053244836616,-1079,-518,-0.21472636815920404,-0.10865716793231811
4143,19137,Montgomery,Iowa,2016,1314,3436,294,5044,0.26050753370341,0.6812053925455988,0.05828707375099128,-608,192,435,19,-0.12198002848564471,0.037988566288304715,0.08399146219734,-2122,-1043,-0.42069785884218874,-0.2059714906829847
4144,19139,Muscatine,Iowa,2000,8058,7483,535,16076,0.5012440905697935,0.4654764866882309,0.033279422741975616,0,0,0,0,0.0,0.0,0.0,575,0,0.03576760388156258,0.0
4145,19139,Muscatine,Iowa,2004,9542,9020,155,18717,0.5098039215686274,0.4819148367793984,0.008281241651974141,1484,-380,1537,2641,0.00855983099883395,-0.024998181090001473,0.01643835009116751,522,-53,0.027889084789229024,-0.007878519092333558
4146,19139,Muscatine,Iowa,2008,10920,7929,271,19120,0.5711297071129707,0.41469665271966527,0.014173640167364016,1378,116,-1091,403,0.061325785544343314,0.005892398515389875,-0.06721818405973312,2991,2469,0.15643305439330546,0.12854396960407644
4147,19139,Muscatine,Iowa,2012,11323,8168,374,19865,0.5699974830103196,0.41117543418071983,0.018827082808960484,403,103,239,745,-0.0011322241026511248,0.004653442641596468,-0.0035212185389454365,3155,164,0.15882204882959977,0.0023889944362943116
4148,19139,Muscatine,Iowa,2016,8368,9584,1482,19434,0.4305855716785016,0.493156323968303,0.07625810435319542,-2955,1108,1416,-431,-0.13941191133181802,0.05743102154423494,0.08198088978758317,-1216,-4371,-0.06257075228980141,-0.22139280111940118
4149,19141,O'Brien,Iowa,2000,2170,4674,200,7044,0.3080636002271437,0.6635434412265758,0.028392958546280524,0,0,0,0,0.0,0.0,0.0,-2504,0,-0.35547984099943214,0.0
4150,19141,O'Brien,Iowa,2004,2330,5328,73,7731,0.3013840382874143,0.689173457508731,0.009442504203854611,160,-127,654,687,-0.006679561939729406,-0.018950454342425913,0.02563001628215522,-2998,-494,-0.38778941922131677,-0.03230957822188463
4151,19141,O'Brien,Iowa,2008,2338,4894,101,7333,0.3188326742124642,0.6673939724532933,0.013773353334242466,8,28,-434,-398,0.017448635925049916,0.0043308491303878545,-0.021779485055437697,-2556,442,-0.34856129824082915,0.03922812098048761
4152,19141,O'Brien,Iowa,2012,1969,5266,106,7341,0.26821958861190576,0.7173409617218363,0.014439449666258004,-369,5,372,8,-0.05061308560055844,0.000666096332015538,0.04994698926854291,-3297,-741,-0.4491213731099305,-0.10056007486910135
4153,19141,O'Brien,Iowa,2016,1315,5752,339,7406,0.17755873615987036,0.7766675668376991,0.04577369700243046,-654,233,486,65,-0.0906608524520354,0.03133424733617246,0.05932660511586285,-4437,-1140,-0.5991088306778287,-0.14998745756789822
4154,19143,Osceola,Iowa,2000,913,2064,86,3063,0.2980737838720209,0.67384916748286,0.028077048645119163,0,0,0,0,0.0,0.0,0.0,-1151,0,-0.37577538361083906,0.0
4155,19143,Osceola,Iowa,2004,934,2295,37,3266,0.2859767299448867,0.7026944274341702,0.01132884262094305,21,-49,231,203,-0.012097053927134171,-0.016748206024176114,0.028845259951310265,-1361,-210,-0.4167176974892835,-0.040942313878444436
4156,19143,Osceola,Iowa,2008,1037,2027,65,3129,0.3314157877916267,0.6478108021732183,0.020773410035155003,103,28,-268,-137,0.045439057846740016,0.009444567414211954,-0.05488362526095192,-990,371,-0.31639501438159157,0.10032268310769193
4157,19143,Osceola,Iowa,2012,912,2230,52,3194,0.2855353788353162,0.6981840951784596,0.01628052598622417,-125,-13,203,65,-0.045880408956310514,-0.004492884048930834,0.05037329300524129,-1318,-328,-0.4126487163431434,-0.09625370196155181
4158,19143,Osceola,Iowa,2016,552,2531,130,3213,0.17180205415499533,0.7877373171490819,0.04046062869592281,-360,78,301,19,-0.11373332468032088,0.024180102709698642,0.08955322197062232,-1979,-661,-0.6159352629940866,-0.20328654665094326
4159,19145,Page,Iowa,2000,2293,4588,178,7059,0.324833545828021,0.649950417906219,0.025216036265760022,0,0,0,0,0.0,0.0,0.0,-2295,0,-0.325116872078198,0.0
4160,19145,Page,Iowa,2004,2211,5243,59,7513,0.29428989751098095,0.6978570477838414,0.007853054705177692,-82,-119,655,454,-0.03054364831704004,-0.01736298156058233,0.0479066298776224,-3032,-737,-0.40356715027286044,-0.07845027819466244
4161,19145,Page,Iowa,2008,2900,4351,108,7359,0.3940752819676587,0.5912488109797527,0.014675907052588666,689,49,-892,-154,0.09978538445667773,0.006822852347410974,-0.10660823680408871,-1451,1581,-0.197173529012094,0.20639362126076644
4162,19145,Page,Iowa,2012,2613,4348,118,7079,0.36911993219381267,0.6142110467580166,0.016669021048170647,-287,10,-3,-280,-0.024955349773846003,0.001993113995581981,0.02296223577826395,-1735,-284,-0.24509111456420396,-0.047917585552109954
4163,19145,Page,Iowa,2016,1807,4893,344,7044,0.2565303804656445,0.694633730834753,0.0488358886996025,-806,226,545,-35,-0.11258955172816815,0.032166867651431855,0.08042268407673636,-3086,-1351,-0.43810335036910847,-0.1930122358049045
4164,19147,Palo Alto,Iowa,2000,2326,2341,156,4823,0.48227244453659546,0.4853825419863156,0.03234501347708895,0,0,0,0,0.0,0.0,0.0,-15,0,-0.0031100974497201284,0.0
4165,19147,Palo Alto,Iowa,2004,2482,2674,35,5191,0.4781352340589482,0.5151223271046041,0.006742438836447698,156,-121,333,368,-0.004137210477647257,-0.02560257464064125,0.029739785118288564,-192,-177,-0.03698709304565595,-0.03387699559593582
4166,19147,Palo Alto,Iowa,2008,2428,2294,86,4808,0.5049916805324459,0.47712146422628954,0.01788685524126456,-54,51,-380,-383,0.02685644647349772,0.011144416404816861,-0.03800086287831461,134,326,0.02787021630615638,0.06485730935181233
4167,19147,Palo Alto,Iowa,2012,2139,2660,88,4887,0.4376918354818907,0.5443012072846327,0.018006957233476572,-289,2,366,79,-0.0672998450505552,0.0001201019922120114,0.06717974305834318,-521,-655,-0.10660937180274199,-0.13447958810889837
4168,19147,Palo Alto,Iowa,2016,1398,3081,224,4703,0.2972570699553477,0.6551137571762705,0.047629172868381885,-741,136,421,-184,-0.14043476552654305,0.029622215634905313,0.1108125498916378,-1683,-1162,-0.35785668722092284,-0.25124731541818085
4169,19149,Plymouth,Iowa,2000,3499,6189,430,10118,0.3458193318837715,0.6116821506226527,0.042498517493575805,0,0,0,0,0.0,0.0,0.0,-2690,0,-0.26586281873888123,0.0
4170,19149,Plymouth,Iowa,2004,4278,7810,134,12222,0.35002454590083454,0.6390116183930616,0.010963835706103747,779,-296,1621,2104,0.00420521401706303,-0.031534681787472055,0.0273294677704089,-3532,-842,-0.2889870724922271,-0.02312425375334587
4171,19149,Plymouth,Iowa,2008,4629,7765,121,12515,0.369876148621654,0.620455453455853,0.009668397922493008,351,-13,-45,293,0.019851602720819483,-0.0012954377836107388,-0.018556164937208686,-3136,396,-0.25057930483419893,0.03840776765802817
4172,19149,Plymouth,Iowa,2012,4164,8597,189,12950,0.32154440154440156,0.6638610038610039,0.014594594594594595,-465,68,832,435,-0.04833174707725246,0.004926196672101587,0.04340555040515093,-4433,-1297,-0.3423166023166023,-0.09173729748240339
4173,19149,Plymouth,Iowa,2016,2885,9680,625,13190,0.21872630780894617,0.7338893100833965,0.047384382107657316,-1279,436,1083,240,-0.10281809373545539,0.03278978751306272,0.07002830622239264,-6795,-2362,-0.5151630022744503,-0.172846399957848
4174,19151,Pocahontas,Iowa,2000,1736,2242,163,4141,0.4192224100458826,0.5414151171214683,0.03936247283264912,0,0,0,0,0.0,0.0,0.0,-506,0,-0.12219270707558566,0.0
4175,19151,Pocahontas,Iowa,2004,1822,2441,50,4313,0.42244377463482496,0.5659633665661952,0.011592858798979828,86,-113,199,172,0.0032213645889423437,-0.02776961403366929,0.02454824944472689,-619,-113,-0.1435195919313702,-0.021326884855784545
4176,19151,Pocahontas,Iowa,2008,1800,2138,74,4012,0.44865403788634095,0.532901296111665,0.018444666001994018,-22,24,-303,-301,0.026210263251515986,0.00685180720301419,-0.033062070454530135,-338,281,-0.08424725822532408,0.05927233370604612
4177,19151,Pocahontas,Iowa,2012,1523,2396,113,4032,0.3777281746031746,0.5942460317460317,0.028025793650793652,-277,39,258,20,-0.07092586328316636,0.009581127648799634,0.06134473563436671,-873,-535,-0.21651785714285715,-0.13227059891753307
4178,19151,Pocahontas,Iowa,2016,963,2702,200,3865,0.24915912031047865,0.6990944372574386,0.0517464424320828,-560,87,306,-167,-0.12856905429269594,0.023720648781289145,0.10484840551140684,-1739,-866,-0.44993531694695993,-0.23341745980410278
4179,19153,Polk,Iowa,2000,89715,79927,4525,174167,0.5151090619922258,0.4589101264877962,0.025980811519977953,0,0,0,0,0.0,0.0,0.0,9788,0,0.056198935504429615,0.0
4180,19153,Polk,Iowa,2004,105218,95828,1572,202618,0.5192924616766527,0.4729490963290527,0.007758441994294683,15503,-2953,15901,28451,0.004183399684426825,-0.01822236952568327,0.014038969841256466,9390,-398,0.046343365347599974,-0.00985557015682964
4181,19153,Polk,Iowa,2008,120984,89668,3757,214409,0.5642673581799271,0.41821005648083803,0.017522585339234828,15766,2185,-6160,11791,0.044974896503274464,0.009764143344940145,-0.054739039848214655,31316,21926,0.1460573016990891,0.09971393635148912
4182,19153,Polk,Iowa,2012,128465,96096,4321,228882,0.561271747013745,0.4198495294518573,0.018878723534397637,7481,564,6428,14473,-0.0029956111661820772,0.0013561381951628093,0.0016394729710192402,32369,1053,0.14142221756188778,-0.004635084137201317
4183,19153,Polk,Iowa,2016,119804,93492,18259,231555,0.5173889572671719,0.40375720671114856,0.07885383602167952,-8661,13938,-2604,2673,-0.043882789746573114,0.05997511248728188,-0.01609232274070871,26312,-6057,0.11363175055602337,-0.027790467005864405
4184,19155,Pottawattamie,Iowa,2000,14726,18783,958,34467,0.42724925290857924,0.544956044912525,0.027794702178895757,0,0,0,0,0.0,0.0,0.0,-4057,0,-0.11770679200394579,0.0
4185,19155,Pottawattamie,Iowa,2004,16906,24558,356,41820,0.40425633668101385,0.5872309899569584,0.008512673362027738,2180,-602,5775,7353,-0.022992916227565385,-0.019282028816868017,0.04227494504443341,-7652,-3595,-0.1829746532759446,-0.0652678612719988
4186,19155,Pottawattamie,Iowa,2008,20436,21237,651,42324,0.4828466118514318,0.501772044230224,0.015381343918344201,3530,295,-3321,504,0.07859027517041794,0.006868670556316464,-0.0854589457267344,-801,6851,-0.01892543237879224,0.16404922089715235
4187,19155,Pottawattamie,Iowa,2012,19644,21860,797,42301,0.4643861847237654,0.5167726531287676,0.018841162147466964,-792,146,623,-23,-0.01846042712766638,0.0034598182291227624,0.0150006088985436,-2216,-1415,-0.05238646840500222,-0.03346103602620998
4188,19155,Pottawattamie,Iowa,2016,15355,24447,2878,42680,0.35977038425492036,0.5727975632614808,0.06743205248359888,-4289,2081,2587,379,-0.10461580046884505,0.04859089033613191,0.05602491013271316,-9092,-6876,-0.21302717900656043,-0.1606407106015582
4189,19157,Poweshiek,Iowa,2000,4222,4396,362,8980,0.47015590200445434,0.48953229398663695,0.040311804008908686,0,0,0,0,0.0,0.0,0.0,-174,0,-0.019376391982182606,0.0
4190,19157,Poweshiek,Iowa,2004,5043,4965,83,10091,0.49975225448419386,0.4920225943910415,0.008225151124764641,821,-279,569,1111,0.02959635247973952,-0.03208665288414404,0.0024903004044045662,78,252,0.007729660093152346,0.027106052075334952
4191,19157,Poweshiek,Iowa,2008,5519,4340,174,10033,0.5500847204226054,0.4325725107146417,0.017342768862752916,476,91,-625,-58,0.05033246593841151,0.009117617737988274,-0.05945008367639981,1179,1101,0.11751220970796367,0.10978254961481132
4192,19157,Poweshiek,Iowa,2012,5357,4424,194,9975,0.5370426065162908,0.4435087719298246,0.01944862155388471,-162,20,84,-58,-0.0130421139063146,0.002105852691131796,0.010936261215182874,933,-246,0.09353383458646619,-0.023978375121497475
4193,19157,Poweshiek,Iowa,2016,4304,4946,583,9833,0.43770975287297875,0.5030001016983626,0.0592901454286586,-1053,389,522,-142,-0.09933285364331201,0.03984152387477388,0.05949132976853805,-642,-1575,-0.06529034882538387,-0.15882418341185006
4194,19159,Ringgold,Iowa,2000,1246,1369,77,2692,0.46285289747399705,0.5085438335809807,0.028603268945022287,0,0,0,0,0.0,0.0,0.0,-123,0,-0.045690936106983604,0.0
4195,19159,Ringgold,Iowa,2004,1286,1466,26,2778,0.462922966162707,0.5277177825773938,0.009359251259899209,40,-51,97,86,7.006868870995664e-05,-0.01924401768512308,0.019173948996413115,-180,-57,-0.06479481641468676,-0.019103880307703158
4196,19159,Ringgold,Iowa,2008,1236,1401,52,2689,0.4596504276682782,0.5210115284492376,0.019338043882484196,-50,26,-65,-89,-0.0032725384944288227,0.009978792622584987,-0.006706254128156175,-165,15,-0.06136110078095941,0.0034337156337273522
4197,19159,Ringgold,Iowa,2012,1186,1368,45,2599,0.4563293574451712,0.5263562908811081,0.01731435167372066,-50,-7,-33,-90,-0.003321070223106959,-0.002023692208763535,0.005344762431870542,-182,-17,-0.07002693343593691,-0.008665832654977501
4198,19159,Ringgold,Iowa,2016,753,1824,130,2707,0.2781677133357961,0.6738086442556336,0.04802364240857037,-433,85,456,108,-0.17816164410937513,0.03070929073484971,0.14745235337452545,-1071,-889,-0.3956409309198375,-0.3256139974839006
4199,19161,Sac,Iowa,2000,2099,2776,158,5033,0.4170474865885158,0.5515597059407907,0.031392807470693423,0,0,0,0,0.0,0.0,0.0,-677,0,-0.13451221935227492,0.0
4200,19161,Sac,Iowa,2004,2215,3128,31,5374,0.4121697059918124,0.582061778935616,0.0057685150725716415,116,-127,352,341,-0.004877780596703407,-0.025624292398121782,0.030502072994825213,-913,-236,-0.16989207294380354,-0.03537985359152862
4201,19161,Sac,Iowa,2008,2256,2705,92,5053,0.44646744508212943,0.5353255491787057,0.018207005739164853,41,61,-423,-321,0.034297739090317025,0.012438490666593211,-0.046736229756910275,-449,464,-0.08885810409657624,0.0810339688472273
4202,19161,Sac,Iowa,2012,2122,3094,75,5291,0.40105840105840107,0.5847665847665847,0.014175014175014175,-134,-17,389,238,-0.04540904402372836,-0.004031991564150678,0.049441035587879045,-972,-523,-0.18370818370818365,-0.09485007961160741
4203,19161,Sac,Iowa,2016,1270,3703,239,5212,0.2436684574059862,0.7104758250191865,0.04585571757482732,-852,164,609,-79,-0.15738994365241488,0.031680703399813145,0.12570924025260177,-2433,-1461,-0.4668073676132003,-0.28309918390501665
4204,19163,Scott,Iowa,2000,35857,32801,1910,70568,0.508119827683936,0.46481408003627706,0.02706609227978687,0,0,0,0,0.0,0.0,0.0,3056,0,0.04330574764765899,0.0
4205,19163,Scott,Iowa,2004,42122,39958,642,82722,0.5091994874398588,0.48303957834675176,0.007760934213389425,6265,-1268,7157,12154,0.001079659755922724,-0.019305158066397446,0.018225498310474708,2164,-892,0.026159909093107003,-0.017145838554551984
4206,19163,Scott,Iowa,2008,48927,36365,1086,86378,0.5664289518164347,0.4209984023709741,0.012572645812591168,6805,444,-3593,3656,0.057229464376575945,0.0048117115992017435,-0.062041175975777685,12562,10398,0.14543054944546063,0.11927064035235363
4207,19163,Scott,Iowa,2012,50652,38251,1360,90263,0.5611601652947498,0.42377275295525296,0.01506708174999723,1725,274,1886,3885,-0.005268786521684943,0.002494435937406062,0.002774350584278884,12401,-161,0.1373874123394968,-0.008043137105963827
4208,19163,Scott,Iowa,2016,40440,39149,6631,86220,0.46903270702853167,0.454059382973788,0.07690790999768035,-10212,5271,898,-4043,-0.0921274582662181,0.061840828247683124,0.030286630018535043,1291,-11110,0.014973324054743664,-0.12241408828475314
4209,19165,Shelby,Iowa,2000,2179,3655,175,6009,0.36262273256781496,0.6082542852388084,0.0291229821933766,0,0,0,0,0.0,0.0,0.0,-1476,0,-0.24563155267099346,0.0
4210,19165,Shelby,Iowa,2004,2355,4256,59,6670,0.3530734632683658,0.6380809595202399,0.008845577211394303,176,-116,601,661,-0.009549269299449159,-0.0202774049819823,0.029826674281431487,-1901,-425,-0.2850074962518741,-0.039375943580880646
4211,19165,Shelby,Iowa,2008,2863,3488,104,6455,0.44353214562354765,0.5403563129357087,0.01611154144074361,508,45,-768,-215,0.09045868235518184,0.007265964229349305,-0.09772464658453117,-625,1276,-0.09682416731216109,0.188183328939713
4212,19165,Shelby,Iowa,2012,2469,3911,103,6483,0.38084220268394264,0.6032700910072497,0.01588770630880765,-394,-1,423,28,-0.062689942939605,-0.0002238351319359573,0.06291377807154097,-1442,-817,-0.22242788832330707,-0.12560372101114597
4213,19165,Shelby,Iowa,2016,1662,4362,346,6370,0.2609105180533752,0.6847723704866562,0.054317111459968606,-807,243,451,-113,-0.11993168463056747,0.03842940515116096,0.08150227947940647,-2700,-1258,-0.423861852433281,-0.20143396410997394
4214,19167,Sioux,Iowa,2000,2148,12241,303,14692,0.14620201470187857,0.8331745167438062,0.020623468554315273,0,0,0,0,0.0,0.0,0.0,-10093,0,-0.6869725020419276,0.0
4215,19167,Sioux,Iowa,2004,2259,14229,82,16570,0.13633071816535908,0.8587205793602897,0.004948702474351237,111,-221,1988,1878,-0.009871296536519497,-0.015674766079964035,0.02554606261648351,-11970,-1877,-0.7223898611949306,-0.035417359153003036
4216,19167,Sioux,Iowa,2008,3030,13490,145,16665,0.18181818181818182,0.8094809480948095,0.0087008700870087,771,63,-739,95,0.045487463652822746,0.003752167612657463,-0.049239631265480144,-10460,1510,-0.6276627662766276,0.094727094918303
4217,19167,Sioux,Iowa,2012,2700,14407,201,17308,0.1559972267159695,0.8323896464062861,0.011613126877744396,-330,56,917,643,-0.02582095510221233,0.002912256790735696,0.022908698311476572,-11707,-1247,-0.6763924196903166,-0.048729653413688956
4218,19167,Sioux,Iowa,2016,2300,14785,1109,18194,0.12641530174782895,0.8126305375398483,0.06095416071232274,-400,908,378,886,-0.02958192496814055,0.04934103383457834,-0.019759108866437836,-12485,-778,-0.6862152357920193,-0.009822816101702658
4219,19169,Story,Iowa,2000,17478,16228,1658,35364,0.49423142178486595,0.4588847415450741,0.04688383667005995,0,0,0,0,0.0,0.0,0.0,1250,0,0.03534668023979187,0.0
4220,19169,Story,Iowa,2004,23296,20819,537,44652,0.5217235510167517,0.4662501119770671,0.012026337006181134,5818,-1121,4591,9288,0.027492129231885765,-0.03485749966387881,0.007365370431993035,2477,1227,0.0554734390396846,0.02012675879989273
4221,19169,Story,Iowa,2008,26548,18995,1038,46581,0.5699319465017926,0.4077842897318649,0.0222837637663425,3252,501,-1824,1929,0.048208395485040856,0.010257426760161368,-0.05846582224520219,7553,5076,0.16214765676992765,0.10667421773024305
4222,19169,Story,Iowa,2012,26192,19668,1290,47150,0.5555037115588547,0.4171367974549311,0.02735949098621421,-356,252,673,569,-0.014428234942937879,0.00507572721987171,0.009352507723066172,6524,-1029,0.1383669141039236,-0.02378074266600405
4223,19169,Story,Iowa,2016,25709,19458,5500,50667,0.5074111354530563,0.38403694712534786,0.10855191742159591,-483,4210,-210,3517,-0.048092576105798424,0.0811924264353817,-0.033099850329583236,6251,-273,0.12337418832770841,-0.014992725776215188
4224,19171,Tama,Iowa,2000,4045,4034,236,8315,0.4864702345159351,0.48514732411304873,0.028382441371016236,0,0,0,0,0.0,0.0,0.0,11,0,0.0013229104028863459,0.0
4225,19171,Tama,Iowa,2004,4487,4456,58,9001,0.4985001666481502,0.49505610487723584,0.006443728474613932,442,-178,422,686,0.012029932132215149,-0.021938712896402306,0.009908780764187108,31,20,0.003444061770914386,0.0021211513680280403
4226,19171,Tama,Iowa,2008,4899,3820,133,8852,0.5534342521464076,0.4315408947130592,0.015024853140533213,412,75,-636,-149,0.0549340854982574,0.00858112466591928,-0.06351521016417666,1079,1048,0.12189335743334845,0.11844929566243406
4227,19171,Tama,Iowa,2012,4768,4098,151,9017,0.5287789730509038,0.4544748807807475,0.016746146168348675,-131,18,278,165,-0.0246552790955038,0.0017212930278154622,0.022933986067688317,670,-409,0.07430409227015633,-0.04758926516319212
4228,19171,Tama,Iowa,2016,3196,4971,585,8752,0.36517367458866545,0.5679844606946983,0.0668418647166362,-1572,434,873,-265,-0.16360529846223837,0.050095718548287524,0.11350957991395083,-1775,-2445,-0.20281078610603287,-0.2771148783761892
4229,19173,Taylor,Iowa,2000,1247,1770,79,3096,0.4027777777777778,0.5717054263565892,0.025516795865633074,0,0,0,0,0.0,0.0,0.0,-523,0,-0.16892764857881137,0.0
4230,19173,Taylor,Iowa,2004,1252,1908,30,3190,0.3924764890282132,0.5981191222570533,0.009404388714733543,5,-49,138,94,-0.010301288749564597,-0.01611240715089953,0.026413695900464162,-656,-133,-0.20564263322884013,-0.03671498465002876
4231,19173,Taylor,Iowa,2008,1347,1607,72,3026,0.44514210178453406,0.5310641110376735,0.023793787177792465,95,42,-301,-164,0.05266561275632087,0.014389398463058922,-0.06705501121937985,-260,396,-0.08592200925313942,0.11972062397570071
4232,19173,Taylor,Iowa,2012,1262,1683,50,2995,0.4213689482470785,0.5619365609348915,0.01669449081803005,-85,-22,76,-31,-0.02377315353745557,-0.007099296359762416,0.030872449897218046,-421,-161,-0.14056761268781304,-0.05464560343467362
4233,19173,Taylor,Iowa,2016,758,2111,160,3029,0.2502476064707824,0.6969296797622978,0.05282271376691978,-504,110,428,34,-0.17112134177629607,0.03612822294888973,0.13499311882740628,-1353,-932,-0.4466820732915154,-0.30611446060370234
4234,19175,Union,Iowa,2000,2540,3003,197,5740,0.4425087108013937,0.5231707317073171,0.0343205574912892,0,0,0,0,0.0,0.0,0.0,-463,0,-0.08066202090592339,0.0
4235,19175,Union,Iowa,2004,2747,3165,66,5978,0.4595182335229174,0.5294412847106056,0.011040481766477083,207,-131,162,238,0.017009522721523673,-0.023280075724812117,0.006270553003288493,-418,45,-0.06992305118768821,0.01073896971823518
4236,19175,Union,Iowa,2008,3000,2781,133,5914,0.5072708826513358,0.4702401082177883,0.022489009130875887,253,67,-384,-64,0.04775264912841842,0.011448527364398805,-0.05920117649281731,219,637,0.03703077443354752,0.10695382562123573
4237,19175,Union,Iowa,2012,3043,2813,101,5957,0.5108275977841196,0.4722175591740809,0.016954843041799565,43,-32,32,43,0.003556715132783772,-0.005534166089076323,0.001977450956292648,230,11,0.038610038610038644,0.0015792641764911242
4238,19175,Union,Iowa,2016,1922,3525,385,5832,0.3295610425240055,0.6044238683127572,0.06601508916323731,-1121,284,712,-125,-0.1812665552601141,0.04906024612143775,0.13220630913867626,-1603,-1833,-0.2748628257887517,-0.31347286439879035
4239,19177,Van Buren,Iowa,2000,1440,2016,105,3561,0.4043807919123842,0.5661331086773378,0.02948609941027801,0,0,0,0,0.0,0.0,0.0,-576,0,-0.1617523167649536,0.0
4240,19177,Van Buren,Iowa,2004,1568,2211,57,3836,0.40875912408759124,0.5763816475495308,0.014859228362877997,128,-48,195,275,0.004378332175207056,-0.014626871047400014,0.010248538872193014,-643,-67,-0.16762252346193957,-0.005870206696985958
4241,19177,Van Buren,Iowa,2008,1546,1986,80,3612,0.4280177187153931,0.5498338870431894,0.0221483942414175,-22,23,-225,-224,0.019258594627801884,0.007289165878539502,-0.026547760506341445,-440,203,-0.12181616832779624,0.04580635513414333
4242,19177,Van Buren,Iowa,2012,1402,2064,103,3569,0.3928271224432614,0.5783132530120482,0.02885962454469039,-144,23,78,-43,-0.035190596272131724,0.0067112303032728915,0.028479365968858805,-662,-222,-0.18548613056878677,-0.06366996224099053
4243,19177,Van Buren,Iowa,2016,845,2527,189,3561,0.2372928952541421,0.7096321258073575,0.05307497893850042,-557,86,463,-8,-0.1555342271891193,0.024215354393810028,0.1313188727953093,-1682,-1020,-0.47233923055321536,-0.2868530999844286
4244,19179,Wapello,Iowa,2000,8355,6313,471,15139,0.5518858577184754,0.4170024440187595,0.031111698262765042,0,0,0,0,0.0,0.0,0.0,2042,0,0.1348834136997159,0.0
4245,19179,Wapello,Iowa,2004,9125,7403,179,16707,0.5461782486382953,0.44310767941581375,0.010714071945890944,770,-292,1090,1568,-0.005707609080180087,-0.0203976263168741,0.026105235397054227,1722,-320,0.10307056922248159,-0.031812844477234314
4246,19179,Wapello,Iowa,2008,8820,6663,457,15940,0.5533249686323714,0.41800501882057717,0.028670012547051444,-305,278,-740,-767,0.007146719994076012,0.0179559406011605,-0.02510266059523658,2157,435,0.13531994981179418,0.03224938058931259
4247,19179,Wapello,Iowa,2012,8663,6789,318,15770,0.5493341788205454,0.4305009511731135,0.020164870006341155,-157,-139,126,-170,-0.00399078981182599,-0.00850514254071029,0.01249593235253632,1874,-283,0.11883322764743187,-0.01648672216436231
4248,19179,Wapello,Iowa,2016,5594,8715,840,15149,0.36926529803947455,0.5752854973925672,0.05544920456795828,-3069,522,1926,-621,-0.1800688807810708,0.03528433456161713,0.1447845462194537,-3121,-4995,-0.20602019935309263,-0.3248534270005245
4249,19181,Warren,Iowa,2000,9521,9621,511,19653,0.4844552994453773,0.4895435811326515,0.0260011194219712,0,0,0,0,0.0,0.0,0.0,-100,0,-0.00508828168727421,0.0
4250,19181,Warren,Iowa,2004,10730,12160,163,23053,0.465449182319004,0.5274801544267558,0.007070663254240229,1209,-348,2539,3400,-0.01900611712637329,-0.018930456167730973,0.03793657329410427,-1430,-1330,-0.06203097210775177,-0.05694269042047756
4251,19181,Warren,Iowa,2008,12299,12144,446,24889,0.49415404395516094,0.4879263931857447,0.01791956285909438,1569,283,-16,1836,0.02870486163615693,0.01084889960485415,-0.039553761241011065,155,1585,0.006227650769416226,0.068258622877168
4252,19181,Warren,Iowa,2012,12551,13052,469,26072,0.4813976679963179,0.5006136851795029,0.017988646824179198,252,23,908,1183,-0.012756375958843047,6.908396508481865e-05,0.012687291993758176,-501,-656,-0.019216017183184997,-0.025443667952601223
4253,19181,Warren,Iowa,2016,10411,14814,2075,27300,0.38135531135531137,0.5426373626373626,0.076007326007326,-2140,1606,1762,1228,-0.10004235664100652,0.05801867918314681,0.04202367745785973,-4403,-3902,-0.16128205128205125,-0.14206603409886626
4254,19183,Washington,Iowa,2000,3932,4827,335,9094,0.43237299318231803,0.5307895315592699,0.03683747525841214,0,0,0,0,0.0,0.0,0.0,-895,0,-0.09841653837695186,0.0
4255,19183,Washington,Iowa,2004,4595,5977,116,10688,0.42992140718562877,0.5592252994011976,0.010853293413173653,663,-219,1150,1594,-0.002451585996689265,-0.025984181845238485,0.028435767841927695,-1382,-487,-0.12930389221556882,-0.03088735383861696
4256,19183,Washington,Iowa,2008,5170,5247,212,10629,0.486405118073196,0.49364944961896695,0.01994543230783705,575,96,-730,-59,0.05648371088756721,0.009092138894663397,-0.06557584978223063,-77,1305,-0.007244331545770977,0.12205956066979784
4257,19183,Washington,Iowa,2012,5115,5562,327,11004,0.4648309705561614,0.5054525627044711,0.0297164667393675,-55,115,315,375,-0.02157414751703457,0.009771034431530452,0.011803113085504191,-447,-370,-0.04062159214830974,-0.03337726060253876
4258,19183,Washington,Iowa,2016,3943,6173,813,10929,0.3607832372586696,0.5648275231036691,0.07438923963766127,-1172,486,611,-75,-0.10404773329749178,0.044672772898293765,0.059374960399197985,-2230,-1783,-0.2040442858449995,-0.16342269369668977
4259,19185,Wayne,Iowa,2000,1300,1666,55,3021,0.43032108573320094,0.5514730221780867,0.018205892088712348,0,0,0,0,0.0,0.0,0.0,-366,0,-0.12115193644488575,0.0
4260,19185,Wayne,Iowa,2004,1379,1733,21,3133,0.44015320778806255,0.5531439514842005,0.006702840727736993,79,-34,67,112,0.009832122054861614,-0.011503051360975354,0.0016709293061137886,-354,12,-0.11299074369613793,0.008161192748747825
4261,19185,Wayne,Iowa,2008,1357,1565,59,2981,0.45521637034552165,0.5249916135524991,0.019792016101979202,-22,38,-168,-152,0.015063162557459098,0.013089175374242208,-0.028152337931701354,-208,146,-0.06977524320697748,0.04321550048916045
4262,19185,Wayne,Iowa,2012,1251,1583,66,2900,0.43137931034482757,0.5458620689655173,0.022758620689655173,-106,7,18,-81,-0.023837060000694077,0.0029666045876759715,0.02087045541301813,-332,-124,-0.11448275862068968,-0.04470751541371221
4263,19185,Wayne,Iowa,2016,719,2069,152,2940,0.2445578231292517,0.7037414965986395,0.05170068027210884,-532,86,486,40,-0.18682148721557587,0.028942059582453668,0.15787942763312224,-1350,-1018,-0.4591836734693878,-0.34470091484869814
4264,19187,Webster,Iowa,2000,8479,8172,397,17048,0.4973603941811356,0.47935241670577194,0.023287189113092445,0,0,0,0,0.0,0.0,0.0,307,0,0.018007977475363646,0.0
4265,19187,Webster,Iowa,2004,9561,8959,111,18631,0.5131769631259728,0.480865224625624,0.005957812248403199,1082,-286,787,1583,0.01581656894483724,-0.017329376864689244,0.0015128079198520328,602,295,0.03231173850034885,0.014303761024985207
4266,19187,Webster,Iowa,2008,9917,8337,302,18556,0.534436300926924,0.44928863979305883,0.016275059280017243,356,191,-622,-75,0.021259337800951128,0.010317247031614045,-0.03157658483256515,1580,978,0.08514766113386513,0.052835922633516275
4267,19187,Webster,Iowa,2012,9537,8469,286,18292,0.5213754646840149,0.46298928493330416,0.015635250382680953,-380,-16,132,-264,-0.013060836242909102,-0.0006398088973362907,0.013700645140245327,1068,-512,0.0583861797507107,-0.02676148138315443
4268,19187,Webster,Iowa,2016,6305,10056,1069,17430,0.361732644865175,0.5769363166953528,0.06133103843947217,-3232,783,1587,-862,-0.15964281981883988,0.04569578805679122,0.11394703176204868,-3751,-4819,-0.21520367183017786,-0.27358985158088855
4269,19189,Winnebago,Iowa,2000,2691,2662,174,5527,0.4868825764429166,0.48163560702008323,0.03148181653700018,0,0,0,0,0.0,0.0,0.0,29,0,0.00524696942283337,0.0
4270,19189,Winnebago,Iowa,2004,2707,3175,70,5952,0.45480510752688175,0.5334341397849462,0.011760752688172043,16,-104,513,425,-0.03207746891603486,-0.01972106384882814,0.051798532764863014,-468,-497,-0.0786290322580645,-0.08387600168089787
4271,19189,Winnebago,Iowa,2008,3254,2730,101,6085,0.5347576006573541,0.4486442070665571,0.016598192276088743,547,31,-445,133,0.07995249313047237,0.0048374395879167,-0.08478993271838914,524,992,0.086113393590797,0.1647424258488615
4272,19189,Winnebago,Iowa,2012,2903,2906,109,5918,0.490537343697195,0.4910442717134167,0.01841838458938831,-351,8,176,-167,-0.04422025696015913,0.001820192313299565,0.04240006464685958,-3,-527,-0.0005069280162217082,-0.08662032160701871
4273,19189,Winnebago,Iowa,2016,1931,3447,409,5787,0.3336789355451875,0.5956454121306376,0.07067565232417487,-972,300,541,-131,-0.15685840815200747,0.05225726773478656,0.1046011404172209,-1516,-1513,-0.2619664765854501,-0.2614595485692284
4274,19191,Winneshiek,Iowa,2000,4339,4647,431,9417,0.46076245088669426,0.49346925772539024,0.04576829138791547,0,0,0,0,0.0,0.0,0.0,-308,0,-0.03270680683869598,0.0
4275,19191,Winneshiek,Iowa,2004,5354,5324,106,10784,0.49647626112759646,0.49369436201780414,0.009829376854599406,1015,-325,677,1367,0.0357138102409022,-0.03593891453331607,0.0002251042924139024,30,338,0.0027818991097923185,0.0354887059484883
4276,19191,Winneshiek,Iowa,2008,6829,4273,182,11284,0.6051931939028713,0.37867777383906415,0.016129032258064516,1475,76,-1051,500,0.10871693277527483,0.00629965540346511,-0.11501658817874,2556,2526,0.22651542006380715,0.22373352095401483
4277,19191,Winneshiek,Iowa,2012,6256,4622,206,11084,0.5644171779141104,0.4169974738361602,0.01858534824972934,-573,24,349,-200,-0.040776015988760905,0.0024563159916648238,0.03831969999709606,1634,-922,0.1474197040779502,-0.07909571598585696
4278,19191,Winneshiek,Iowa,2016,5254,5344,764,11362,0.46241858827671184,0.4703397289209646,0.06724168280232354,-1002,558,722,278,-0.10199858963739855,0.0486563345525942,0.05334225508480439,-90,-1724,-0.007921140644252755,-0.15534084472220294
4279,19193,Woodbury,Iowa,2000,17691,18864,1341,37896,0.46683027232425583,0.49778340721975933,0.0353863204559848,0,0,0,0,0.0,0.0,0.0,-1173,0,-0.030953134895503498,0.0
4280,19193,Woodbury,Iowa,2004,21455,22451,289,44195,0.48546215635252854,0.5079986423803597,0.006539201267111664,3764,-1052,3587,6299,0.018631884028272705,-0.028847119188873133,0.010215235160600411,-996,177,-0.022536486027831204,0.008416648867672294
4281,19193,Woodbury,Iowa,2008,21983,22219,613,44815,0.49052772509204506,0.49579381903380565,0.01367845587414928,528,324,-232,620,0.005065568739516524,0.007139254607037616,-0.012204823346554095,-236,760,-0.005266093941760586,0.01727039208607062
4282,19193,Woodbury,Iowa,2012,22302,21841,876,45019,0.4953908349807859,0.48515071414291744,0.019458450876296676,319,263,-378,204,0.004863109888740835,0.005779995002147396,-0.010643104890888211,461,697,0.01024012083786846,0.015506214779629046
4283,19193,Woodbury,Iowa,2016,16210,24727,2781,43718,0.3707854888146759,0.5656022690882474,0.06361224209707672,-6092,1905,2886,-1301,-0.12460534616611002,0.044153791220780045,0.08045155494532996,-8517,-8978,-0.19481678027357152,-0.20505690111143998
4284,19195,Worth,Iowa,2000,2208,1659,137,4004,0.5514485514485514,0.4143356643356643,0.034215784215784216,0,0,0,0,0.0,0.0,0.0,549,0,0.1371128871128871,0.0
4285,19195,Worth,Iowa,2004,2286,1795,42,4123,0.554450642735872,0.43536260004850835,0.010186757215619695,78,-95,136,119,0.0030020912873205408,-0.024029027000164523,0.02102693571284403,491,-58,0.11908804268736362,-0.01802484442552349
4286,19195,Worth,Iowa,2008,2567,1612,80,4259,0.6027236440478986,0.37849260389762857,0.018783752054472882,281,38,-183,136,0.04827300131202661,0.008596994838853187,-0.05686999615087979,955,464,0.22423104015027,0.1051429974629064
4287,19195,Worth,Iowa,2012,2350,1744,78,4172,0.5632790028763183,0.41802492809204217,0.018696069031639503,-217,-2,132,-87,-0.03944464117158031,-8.768302283337914e-05,0.039532324194413604,606,-349,0.1452540747842761,-0.07897696536599391
4288,19195,Worth,Iowa,2016,1530,2453,274,4257,0.3594080338266385,0.5762273901808785,0.06436457599248296,-820,196,709,85,-0.20387096904967977,0.04566850696084346,0.15820246208883637,-923,-1529,-0.21681935635424004,-0.36207343113851614
4289,19197,Wright,Iowa,2000,2796,3384,156,6336,0.4412878787878788,0.5340909090909091,0.02462121212121212,0,0,0,0,0.0,0.0,0.0,-588,0,-0.09280303030303028,0.0
4290,19197,Wright,Iowa,2004,2930,3631,42,6603,0.44373769498712706,0.5499015598970165,0.006360745115856429,134,-114,247,267,0.002449816199248278,-0.01826046700535569,0.01581065080610744,-701,-113,-0.10616386490988944,-0.013360834606859162
4291,19197,Wright,Iowa,2008,3102,3198,95,6395,0.48506645817044564,0.5000781860828772,0.014855355746677092,172,53,-433,-208,0.04132876318331857,0.008494610630820663,-0.04982337381413926,-96,605,-0.015011727912431605,0.09115213699745783
4292,19197,Wright,Iowa,2012,2836,3349,93,6278,0.45173622172666456,0.5334501433577572,0.01481363491557821,-266,-2,151,-117,-0.03333023644378108,-4.172083109888272e-05,0.03337195727487996,-513,-417,-0.08171392163109265,-0.06670219371866104
4293,19197,Wright,Iowa,2016,1896,3800,330,6026,0.3146365748423498,0.6306007301692665,0.054762694988383674,-940,237,451,-252,-0.13709964688431475,0.039949060072805465,0.09715058681150934,-1904,-1391,-0.31596415532691674,-0.2342502336958241
4294,20001,Allen,Kansas,2000,2132,3379,255,5766,0.36975372875476936,0.5860215053763441,0.04422476586888657,0,0,0,0,0.0,0.0,0.0,-1247,0,-0.21626777662157476,0.0
4295,20001,Allen,Kansas,2004,1922,3867,84,5873,0.32726034394687553,0.658436914694364,0.014302741358760428,-210,-171,488,107,-0.04249338480789383,-0.029922024510126145,0.07241540931801993,-1945,-698,-0.3311765707474885,-0.11490879412591376
4296,20001,Allen,Kansas,2008,2189,3552,114,5855,0.373868488471392,0.6066609735269001,0.019470538001707942,267,30,-315,-18,0.04660814452451645,0.0051677966429475135,-0.05177594116746398,-1363,582,-0.2327924850555081,0.09838408569198043
4297,20001,Allen,Kansas,2012,1869,3316,125,5310,0.3519774011299435,0.624482109227872,0.023540489642184557,-320,11,-236,-545,-0.021891087341448456,0.004069951640476615,0.01782113570097188,-1447,-84,-0.2725047080979284,-0.039712223042420336
4298,20001,Allen,Kansas,2016,1433,3651,370,5454,0.2627429409607627,0.6694169416941694,0.06784011734506784,-436,245,335,144,-0.0892344601691808,0.04429962770288329,0.04493483246629748,-2218,-771,-0.4066740007334067,-0.13416929263547828
4299,20003,Anderson,Kansas,2000,1327,1984,167,3478,0.38154111558366877,0.5704427832087406,0.04801610120759057,0,0,0,0,0.0,0.0,0.0,-657,0,-0.18890166762507188,0.0
4300,20003,Anderson,Kansas,2004,1295,2500,68,3863,0.3352316852187419,0.6471654154801968,0.01760289930106135,-32,-99,516,385,-0.04630943036492685,-0.030413201906529217,0.07672263227145615,-1205,-548,-0.3119337302614549,-0.123032062636383
4301,20003,Anderson,Kansas,2008,1175,2362,89,3626,0.3240485383342526,0.6514065085493657,0.024544953116381687,-120,21,-138,-237,-0.011183146884489292,0.006942053815320336,0.004241093069168866,-1187,18,-0.32735797021511304,-0.015424239953658159
4302,20003,Anderson,Kansas,2012,944,2276,95,3315,0.28476621417797887,0.6865761689291101,0.02865761689291101,-231,6,-86,-311,-0.03928232415627375,0.0041126637765293225,0.03516966037974445,-1332,-145,-0.40180995475113124,-0.0744519845360182
4303,20003,Anderson,Kansas,2016,672,2435,243,3350,0.20059701492537313,0.7268656716417911,0.07253731343283581,-272,148,159,35,-0.08416919925260574,0.04387969653992481,0.04028950271268095,-1763,-431,-0.5262686567164179,-0.12445870196528663
4304,20005,Atchison,Kansas,2000,3171,3378,351,6900,0.45956521739130435,0.4895652173913044,0.050869565217391305,0,0,0,0,0.0,0.0,0.0,-207,0,-0.030000000000000027,0.0
4305,20005,Atchison,Kansas,2004,3120,3880,118,7118,0.43832537229558866,0.54509693734195,0.016577690362461366,-51,-233,502,218,-0.021239845095715693,-0.03429187485492994,0.0555317199506456,-760,-553,-0.10677156504636132,-0.07677156504636129
4306,20005,Atchison,Kansas,2008,3241,3791,159,7191,0.45070226672229174,0.5271867612293144,0.022110972048393827,121,41,-89,73,0.012376894426703089,0.005533281685932461,-0.017910176112635567,-550,210,-0.07648449450702266,0.030287070539338656
4307,20005,Atchison,Kansas,2012,2567,3917,190,6674,0.38462691039856156,0.5869044051543303,0.02846868444710818,-674,31,126,-517,-0.06607535632373018,0.006357712398714355,0.059717643925015884,-1350,-800,-0.20227749475576873,-0.12579300024874607
4308,20005,Atchison,Kansas,2016,1989,4049,537,6575,0.30250950570342205,0.6158174904942966,0.08167300380228137,-578,347,132,-99,-0.0821174046951395,0.053204319355173196,0.028913085339966282,-2060,-710,-0.3133079847908745,-0.11103049003510579
4309,20007,Barber,Kansas,2000,637,1755,106,2498,0.25500400320256206,0.7025620496397118,0.04243394715772618,0,0,0,0,0.0,0.0,0.0,-1118,0,-0.44755804643714975,0.0
4310,20007,Barber,Kansas,2004,588,1782,33,2403,0.24469413233458176,0.7415730337078652,0.01373283395755306,-49,-73,27,-95,-0.010309870867980298,-0.02870111320017312,0.0390109840681534,-1194,-76,-0.49687890137328344,-0.049320854936133696
4311,20007,Barber,Kansas,2008,598,1833,31,2462,0.24289195775792038,0.7445166531275386,0.012591389114541024,10,-2,51,59,-0.001802174576661375,-0.0011414448430120353,0.00294361941967336,-1235,-41,-0.5016246953696182,-0.004745793996334735
4312,20007,Barber,Kansas,2012,482,1772,60,2314,0.20829732065687123,0.7657735522904062,0.02592912705272256,-116,29,-61,-148,-0.03459463710104915,0.013337737938181535,0.02125689916286766,-1290,-55,-0.557476231633535,-0.05585153626391681
4313,20007,Barber,Kansas,2016,286,1850,116,2252,0.1269982238010657,0.8214920071047958,0.05150976909413854,-196,56,78,-62,-0.08129909685580552,0.025580642041415982,0.05571845481438953,-1564,-274,-0.69449378330373,-0.13701755167019503
4314,20009,Barton,Kansas,2000,3238,7302,415,10955,0.2955727978092195,0.6665449566408033,0.03788224554997718,0,0,0,0,0.0,0.0,0.0,-4064,0,-0.37097215883158374,0.0
4315,20009,Barton,Kansas,2004,2874,8666,166,11706,0.24551512045105076,0.7403041175465573,0.014180762002391935,-364,-249,1364,751,-0.05005767735816877,-0.023701483547585243,0.07375916090575407,-5792,-1728,-0.4947889970955066,-0.12381683826392287
4316,20009,Barton,Kansas,2008,3027,7802,228,11057,0.27376322691507643,0.7056163516324501,0.020620421452473545,153,62,-864,-649,0.028248106464025674,0.0064396594500816095,-0.03468776591410727,-4775,1017,-0.43185312471737364,0.06293587237813297
4317,20009,Barton,Kansas,2012,2297,7874,170,10341,0.22212551977565032,0.7614350643071269,0.016439415917222706,-730,-58,72,-716,-0.051637707139426114,-0.004181005535250838,0.05581871267467686,-5577,-802,-0.5393095445314766,-0.10745641981410298
4318,20009,Barton,Kansas,2016,1839,7888,610,10337,0.177904614491632,0.7630840669439877,0.05901131856438038,-458,440,14,-4,-0.044220905284018314,0.042571902647157676,0.0016490026368607413,-6049,-472,-0.5851794524523557,-0.04586990792087908
4319,20011,Bourbon,Kansas,2000,2211,3852,245,6308,0.35050729232720357,0.6106531388712746,0.038839568801521875,0,0,0,0,0.0,0.0,0.0,-1641,0,-0.260145846544071,0.0
4320,20011,Bourbon,Kansas,2004,2216,4372,98,6686,0.3314388274005384,0.6539036793299432,0.014657493269518396,5,-147,520,378,-0.01906846492666514,-0.02418207553200348,0.04325054045866861,-2156,-515,-0.32246485192940477,-0.06231900538533375
4321,20011,Bourbon,Kansas,2008,2394,4240,147,6781,0.3530452735584722,0.6252765078896918,0.021678218551836013,178,49,-132,95,0.02160644615793378,0.007020725282317617,-0.028627171440251398,-1846,310,-0.2722312343312196,0.050233617598185176
4322,20011,Bourbon,Kansas,2012,1996,4102,156,6254,0.31915574032619126,0.6559002238567317,0.02494403581707707,-398,9,-138,-527,-0.033889533232280944,0.0032658172652410555,0.030623715967039944,-2106,-260,-0.3367444835305405,-0.06451324919932089
4323,20011,Bourbon,Kansas,2016,1336,4424,333,6093,0.21926801247333005,0.7260791071721647,0.05465288035450517,-660,177,322,-161,-0.09988772785286121,0.0297088445374281,0.07017888331543298,-3088,-982,-0.5068110946988347,-0.1700666111682942
4324,20013,Brown,Kansas,2000,1512,2985,194,4691,0.3223193348966105,0.6363248774248561,0.04135578767853336,0,0,0,0,0.0,0.0,0.0,-1473,0,-0.3140055425282456,0.0
4325,20013,Brown,Kansas,2004,1268,3092,58,4418,0.2870076957899502,0.6998641919420552,0.013128112267994568,-244,-136,107,-273,-0.0353116391066603,-0.02822767541053879,0.06353931451719907,-1824,-351,-0.41285649615210496,-0.09885095362385937
4326,20013,Brown,Kansas,2008,1317,2985,74,4376,0.3009597806215722,0.6821297989031079,0.016910420475319928,49,16,-107,-42,0.01395208483162197,0.00378230820732536,-0.017734393038947305,-1668,156,-0.3811700182815357,0.031686477870569274
4327,20013,Brown,Kansas,2012,1076,2829,88,3993,0.26947157525669924,0.7084898572501879,0.02203856749311295,-241,14,-156,-383,-0.031488205364872957,0.00512814701779302,0.026360058347079995,-1753,-85,-0.43901828199348863,-0.05784826371195295
4328,20013,Brown,Kansas,2016,863,2906,267,4036,0.21382556987115955,0.72001982160555,0.06615460852329039,-213,179,77,43,-0.05564600538553968,0.04411604103017744,0.011529964355362132,-2043,-290,-0.5061942517343905,-0.06717596974090184
4329,20015,Butler,Kansas,2000,6755,13377,870,21002,0.3216360346633654,0.6369393391105609,0.04142462622607371,0,0,0,0,0.0,0.0,0.0,-6622,0,-0.3153033044471955,0.0
4330,20015,Butler,Kansas,2004,7495,18438,347,26280,0.2851978691019787,0.7015981735159817,0.013203957382039574,740,-523,5061,5278,-0.03643816556138668,-0.02822066884403413,0.06465883440542086,-10943,-4321,-0.41640030441400305,-0.10109699996680754
4331,20015,Butler,Kansas,2008,9159,18155,559,27873,0.3285975675384781,0.6513471818605819,0.02005525060093998,1664,212,-283,1593,0.04339969843649938,0.006851293218900404,-0.05025099165539981,-8996,1947,-0.32274961432210386,0.09365069009189919
4332,20015,Butler,Kansas,2012,7282,18157,646,26085,0.27916427065363236,0.6960705386237301,0.024765190722637533,-1877,87,2,-1788,-0.04943329688484571,0.004709940121697554,0.0447233567631482,-10875,-1879,-0.4169062679700978,-0.09415665364799392
4333,20015,Butler,Kansas,2016,6573,19073,2011,27657,0.23766135155656795,0.6896264960046281,0.07271215243880393,-709,1365,916,1572,-0.04150291909706441,0.04794696171616639,-0.006444042619102031,-12500,-1625,-0.45196514444806013,-0.03505887647796235
4334,20017,Chase,Kansas,2000,391,848,78,1317,0.2968868640850418,0.6438876233864844,0.05922551252847381,0,0,0,0,0.0,0.0,0.0,-457,0,-0.34700075930144264,0.0
4335,20017,Chase,Kansas,2004,418,1055,28,1501,0.27848101265822783,0.7028647568287808,0.018654230512991338,27,-50,207,184,-0.018405851426813946,-0.04057128201548247,0.05897713344229638,-637,-180,-0.42438374417055297,-0.07738298486911033
4336,20017,Chase,Kansas,2008,383,976,25,1384,0.27673410404624277,0.7052023121387283,0.018063583815028903,-35,-3,-79,-117,-0.0017469086119850652,-0.0005906466979624346,0.0023375553099475033,-593,44,-0.42846820809248554,-0.0040844639219325685
4337,20017,Chase,Kansas,2012,358,875,38,1271,0.2816679779701023,0.6884343036978757,0.02989771833202203,-25,13,-101,-113,0.004933873923859522,0.011834134516993128,-0.016768008440852578,-517,76,-0.40676632572777344,0.0217018823647121
4338,20017,Chase,Kansas,2016,316,969,84,1369,0.2308254200146092,0.7078159240321402,0.061358655953250546,-42,46,94,98,-0.050842557955493084,0.031460937621228514,0.019381620334264493,-653,-136,-0.476990504017531,-0.07022417828975758
4339,20019,Chautauqua,Kansas,2000,443,1347,90,1880,0.23563829787234042,0.7164893617021276,0.047872340425531915,0,0,0,0,0.0,0.0,0.0,-904,0,-0.4808510638297872,0.0
4340,20019,Chautauqua,Kansas,2004,404,1529,27,1960,0.20612244897959184,0.7801020408163265,0.013775510204081633,-39,-63,182,80,-0.02951584889274858,-0.03409683022145028,0.06361267911419888,-1125,-221,-0.5739795918367346,-0.09312852800694743
4341,20019,Chautauqua,Kansas,2008,401,1418,33,1852,0.21652267818574514,0.765658747300216,0.017818574514038878,-3,6,-111,-108,0.0104002292061533,0.004043064309957245,-0.014443293516110511,-1017,108,-0.5491360691144709,0.024843522722263756
4342,20019,Chautauqua,Kansas,2012,280,1304,46,1630,0.17177914110429449,0.8,0.02822085889570552,-121,13,-114,-222,-0.04474353708145065,0.010402284381666644,0.03434125269978405,-1024,-7,-0.6282208588957056,-0.07908478978123468
4343,20019,Chautauqua,Kansas,2016,197,1236,48,1481,0.13301823092505063,0.8345712356515868,0.03241053342336259,-83,2,-68,-149,-0.03876091017924385,0.004189674527657072,0.03457123565158671,-1039,-15,-0.7015530047265361,-0.07333214583083059
4344,20021,Cherokee,Kansas,2000,3783,5014,333,9130,0.41434830230010955,0.5491785323110624,0.03647316538882804,0,0,0,0,0.0,0.0,0.0,-1231,0,-0.13483023001095285,0.0
4345,20021,Cherokee,Kansas,2004,3726,6083,104,9913,0.37587006960556846,0.6136386563098961,0.010491274084535459,-57,-229,1069,783,-0.03847823269454109,-0.025981891304292584,0.06446012399883372,-2357,-1126,-0.23776858670432766,-0.10293835669337481
4346,20021,Cherokee,Kansas,2008,3594,5886,185,9665,0.3718572167615106,0.6090015519917227,0.019141231246766685,-132,81,-197,-248,-0.004012852844057835,0.008649957162231227,-0.004637104318173435,-2292,65,-0.23714433523021206,0.0006242514741156002
4347,20021,Cherokee,Kansas,2012,2930,5456,185,8571,0.34185042585462605,0.6365651615914129,0.02158441255396103,-664,0,-430,-1094,-0.030006790906884573,0.0024431813071943455,0.027563609599690175,-2526,-234,-0.2947147357367868,-0.05757040050657475
4348,20021,Cherokee,Kansas,2016,2005,6182,433,8620,0.2325986078886311,0.717169373549884,0.05023201856148492,-925,248,726,49,-0.10925181796599495,0.028647606007523887,0.08060421195847112,-4177,-1651,-0.4845707656612529,-0.1898560299244661
4349,20023,Cheyenne,Kansas,2000,350,1312,65,1727,0.2026635784597568,0.7596988998262884,0.03763752171395483,0,0,0,0,0.0,0.0,0.0,-962,0,-0.5570353213665316,0.0
4350,20023,Cheyenne,Kansas,2004,320,1353,19,1692,0.18912529550827423,0.799645390070922,0.011229314420803783,-30,-46,41,-35,-0.013538282951482572,-0.026408207293151048,0.03994649024463359,-1033,-71,-0.6105200945626477,-0.05348477319611611
4351,20023,Cheyenne,Kansas,2008,323,1148,27,1498,0.21562082777036048,0.7663551401869159,0.018024032042723633,3,8,-205,-194,0.026495532262086258,0.006794717621919849,-0.033290249884006085,-825,208,-0.5507343124165553,0.059785782146092314
4352,20023,Cheyenne,Kansas,2012,233,1159,34,1426,0.16339410939691446,0.8127629733520336,0.023842917251051893,-90,7,11,-72,-0.05222671837344603,0.00581888520832826,0.04640783316511776,-926,-101,-0.6493688639551192,-0.09863455153856382
4353,20023,Cheyenne,Kansas,2016,181,1173,53,1407,0.12864250177683015,0.8336886993603412,0.037668798862828715,-52,19,14,-19,-0.03475160762008431,0.013825881611776822,0.020925726008307555,-992,-66,-0.7050461975835111,-0.05567733362839189
4354,20025,Clark,Kansas,2000,292,926,43,1261,0.2315622521808089,0.7343378271213322,0.03409992069785884,0,0,0,0,0.0,0.0,0.0,-634,0,-0.5027755749405234,0.0
4355,20025,Clark,Kansas,2004,257,1014,20,1291,0.19907048799380325,0.7854376452362509,0.015491866769945779,-35,-23,88,30,-0.03249176418700564,-0.01860805392791306,0.051099818114918705,-757,-123,-0.5863671572424477,-0.08359158230192432
4356,20025,Clark,Kansas,2008,245,897,17,1159,0.21138912855910266,0.7739430543572045,0.014667817083692839,-12,-3,-117,-132,0.01231864056529941,-0.0008240496862529402,-0.011494590879046473,-652,105,-0.5625539257981018,0.023813231444345884
4357,20025,Clark,Kansas,2012,174,805,38,1017,0.1710914454277286,0.7915437561455261,0.03736479842674533,-71,21,-92,-142,-0.04029768313137405,0.022696981343052494,0.017600701788321627,-631,21,-0.6204523107177975,-0.05789838491969568
4358,20025,Clark,Kansas,2016,120,825,60,1005,0.11940298507462686,0.8208955223880597,0.05970149253731343,-54,22,20,-12,-0.05168846035310175,0.0223366941105681,0.02935176624253366,-705,-74,-0.7014925373134329,-0.08104022659563537
4359,20027,Clay,Kansas,2000,951,2998,139,4088,0.2326320939334638,0.7333659491193738,0.034001956947162425,0,0,0,0,0.0,0.0,0.0,-2047,0,-0.50073385518591,0.0
4360,20027,Clay,Kansas,2004,793,3174,43,4010,0.19775561097256858,0.7915211970074812,0.010723192019950124,-158,-96,176,-78,-0.03487648296089521,-0.0232787649272123,0.05815524788810744,-2381,-334,-0.5937655860349127,-0.09303173084900274
4361,20027,Clay,Kansas,2008,1009,2998,47,4054,0.24888998519980265,0.7395165268870252,0.011593487913172176,216,4,-176,44,0.051134374227234075,0.000870295893222052,-0.052004670120456065,-1989,392,-0.49062654168722253,0.10313904434769017
4362,20027,Clay,Kansas,2012,834,2788,64,3686,0.22626153011394465,0.7563754747693977,0.017362995116657624,-175,17,-210,-368,-0.022628455085858007,0.005769507203485447,0.01685894788237252,-1954,35,-0.530113944655453,-0.0394874029682305
4363,20027,Clay,Kansas,2016,677,2891,252,3820,0.17722513089005235,0.756806282722513,0.06596858638743455,-157,188,103,134,-0.0490363992238923,0.04860559127077693,0.0004308079531153419,-2214,-260,-0.5795811518324607,-0.0494672071770077
4364,20029,Cloud,Kansas,2000,1314,2918,271,4503,0.2918054630246502,0.6480124361536753,0.06018210082167444,0,0,0,0,0.0,0.0,0.0,-1604,0,-0.3562069731290251,0.0
4365,20029,Cloud,Kansas,2004,1210,3221,72,4503,0.2687097490561848,0.7153009105041084,0.015989340439706862,-104,-199,303,0,-0.023095713968465437,-0.04419276038196758,0.06728847435043306,-2011,-407,-0.4465911614479236,-0.0903841883188985
4366,20029,Cloud,Kansas,2008,1233,3121,97,4451,0.277016400808807,0.7011907436531116,0.02179285553808133,23,25,-100,-52,0.00830665175262224,0.005803515098374467,-0.014110166850996753,-1888,123,-0.4241743428443046,0.022416818603618993
4367,20029,Cloud,Kansas,2012,974,2954,130,4058,0.24001971414489898,0.7279448003942829,0.032035485460818136,-259,33,-167,-393,-0.03699668666390804,0.010242629922736807,0.02675405674117126,-1980,-92,-0.4879250862493839,-0.0637507434050793
4368,20029,Cloud,Kansas,2016,761,2919,250,3930,0.19363867684478372,0.7427480916030534,0.06361323155216285,-213,120,-35,-128,-0.04638103730011525,0.03157774609134471,0.014803291208770553,-2158,-178,-0.5491094147582697,-0.06118432850888578
4369,20031,Coffey,Kansas,2000,1196,2700,144,4040,0.296039603960396,0.6683168316831684,0.03564356435643564,0,0,0,0,0.0,0.0,0.0,-1504,0,-0.37227722772277233,0.0
4370,20031,Coffey,Kansas,2004,1093,3259,56,4408,0.24795825771324864,0.7393375680580763,0.012704174228675136,-103,-88,559,368,-0.04808134624714738,-0.022939390127760504,0.07102073637490791,-2166,-662,-0.4913793103448276,-0.1191020826220553
4371,20031,Coffey,Kansas,2008,1121,3054,57,4232,0.2648865784499055,0.7216446124763705,0.013468809073724008,28,1,-205,-176,0.016928320736656843,0.0007646348450488713,-0.017692955581705805,-1933,233,-0.456758034026465,0.03462127631836265
4372,20031,Coffey,Kansas,2012,898,2903,105,3906,0.22990271377368152,0.743215565796211,0.026881720430107527,-223,48,-151,-326,-0.03498386467622397,0.01341291135638352,0.02157095331984049,-2005,-72,-0.5133128520225294,-0.05655481799606443
4373,20031,Coffey,Kansas,2016,727,3050,291,4068,0.17871189773844642,0.7497541789577188,0.0715339233038348,-171,186,147,162,-0.05119081603523509,0.04465220287372727,0.0065386131615078336,-2323,-318,-0.5710422812192724,-0.057729429196742954
4374,20033,Comanche,Kansas,2000,211,760,35,1006,0.20974155069582506,0.7554671968190855,0.03479125248508946,0,0,0,0,0.0,0.0,0.0,-549,0,-0.5457256461232605,0.0
4375,20033,Comanche,Kansas,2004,200,770,11,981,0.2038735983690112,0.7849133537206932,0.011213047910295617,-11,-24,10,-25,-0.005867952326813863,-0.023578204574793846,0.02944615690160768,-570,-21,-0.581039755351682,-0.035314109228421486
4376,20033,Comanche,Kansas,2008,194,765,15,974,0.19917864476386038,0.7854209445585215,0.015400410677618069,-6,4,-5,-7,-0.00469495360515082,0.004187362767322452,0.0005075908378283644,-571,-1,-0.5862422997946611,-0.0052025444429791845
4377,20033,Comanche,Kansas,2012,143,767,18,928,0.1540948275862069,0.8265086206896551,0.01939655172413793,-51,3,2,-46,-0.045083817177653474,0.0039961410465198625,0.04108767613113362,-624,-53,-0.6724137931034482,-0.08617149330878704
4378,20033,Comanche,Kansas,2016,102,715,50,867,0.11764705882352941,0.8246828143021915,0.05767012687427912,-41,32,-52,-61,-0.036447768762677496,0.038273575150141195,-0.0018258063874636576,-613,11,-0.707035755478662,-0.034621962375213866
4379,20035,Cowley,Kansas,2000,5535,8080,595,14210,0.38951442646023926,0.5686136523574947,0.04187192118226601,0,0,0,0,0.0,0.0,0.0,-2545,0,-0.17909922589725547,0.0
4380,20035,Cowley,Kansas,2004,4818,9407,222,14447,0.3334948432200457,0.6511386447013221,0.015366512078632242,-717,-373,1327,237,-0.05601958324019357,-0.026505409103633765,0.08252499234382737,-4589,-2044,-0.3176438014812764,-0.13854457558402095
4381,20035,Cowley,Kansas,2008,5012,8492,283,13787,0.3635308624066149,0.6159425545804018,0.020526583012983244,194,61,-915,-660,0.03003601918656923,0.005160070934351002,-0.03519609012092029,-3480,1109,-0.2524116921737869,0.06523210930748952
4382,20035,Cowley,Kansas,2012,4319,8081,310,12710,0.3398111723052714,0.6357985837922895,0.024390243902439025,-693,27,-411,-1077,-0.023719690101343505,0.0038636608894557813,0.01985602921188767,-3762,-282,-0.29598741148701807,-0.043575719313231176
4383,20035,Cowley,Kansas,2016,3551,8270,800,12621,0.2813564693764361,0.6552571111639331,0.06338641945963078,-768,490,189,-89,-0.05845470292883531,0.03899617555719175,0.019458527371643664,-4719,-957,-0.37390064178749705,-0.07791323030047898
4384,20037,Crawford,Kansas,2000,7076,7160,798,15034,0.4706664892909405,0.4762538246640947,0.05307968604496475,0,0,0,0,0.0,0.0,0.0,-84,0,-0.005587335373154201,0.0
4385,20037,Crawford,Kansas,2004,7617,8626,284,16527,0.46088219277545833,0.5219338052883161,0.01718400193622557,541,-514,1466,1493,-0.009784296515482183,-0.03589568410873918,0.045679980624221406,-1009,-925,-0.06105161251285779,-0.05546427713970359
4386,20037,Crawford,Kansas,2008,7957,7735,383,16075,0.4949922239502333,0.48118195956454124,0.023825816485225505,340,99,-891,-452,0.03411003117477496,0.006641814548999935,-0.04075184572377488,222,1231,0.01381026438569205,0.07486187689854984
4387,20037,Crawford,Kansas,2012,6826,7708,506,15040,0.4538563829787234,0.5125,0.0336436170212766,-1131,123,-27,-1035,-0.04113584097150991,0.009817800536051094,0.031318040435458716,-882,-1104,-0.05864361702127657,-0.07245388140696862
4388,20037,Crawford,Kansas,2016,5199,8624,1068,14891,0.34913706265529515,0.5791417634812974,0.07172117386340743,-1627,562,916,-149,-0.10471932032342823,0.03807755684213083,0.06664176348129747,-3425,-2543,-0.23000470082600227,-0.1713610838047257
4389,20039,Decatur,Kansas,2000,424,1255,80,1759,0.24104604889141557,0.7134735645252984,0.04548038658328596,0,0,0,0,0.0,0.0,0.0,-831,0,-0.47242751563388286,0.0
4390,20039,Decatur,Kansas,2004,355,1355,30,1740,0.20402298850574713,0.7787356321839081,0.017241379310344827,-69,-50,100,-19,-0.03702306038566844,-0.02823900727294113,0.06526206765860965,-1000,-169,-0.5747126436781609,-0.10228512804427803
4391,20039,Decatur,Kansas,2008,343,1189,16,1548,0.22157622739018087,0.7680878552971576,0.0103359173126615,-12,-14,-166,-192,0.017553238884433747,-0.006905461997683328,-0.010647776886750449,-846,154,-0.5465116279069767,0.028201015771184168
4392,20039,Decatur,Kansas,2012,266,1218,48,1532,0.17362924281984335,0.7950391644908616,0.031331592689295036,-77,32,29,-16,-0.047946984570337525,0.020995675376633535,0.02695130919370403,-952,-106,-0.6214099216710183,-0.07489829376404156
4393,20039,Decatur,Kansas,2016,178,1210,64,1452,0.12258953168044077,0.8333333333333334,0.0440771349862259,-88,16,-8,-80,-0.051039711139402574,0.01274554229693086,0.03829416884247172,-1032,-80,-0.7107438016528926,-0.08933387998187436
4394,20041,Dickinson,Kansas,2000,2413,5243,436,8092,0.29819574888779043,0.6479238754325259,0.05388037567968364,0,0,0,0,0.0,0.0,0.0,-2830,0,-0.3497281265447355,0.0
4395,20041,Dickinson,Kansas,2004,2364,6295,132,8791,0.26891138664543285,0.7160732567398476,0.0150153566147196,-49,-304,1052,699,-0.029284362242357587,-0.038865019064964035,0.06814938130732162,-3931,-1101,-0.4471618700944147,-0.09743374354967921
4396,20041,Dickinson,Kansas,2008,2422,6081,164,8667,0.27945079035421716,0.7016268605053652,0.018922349140417676,58,32,-214,-124,0.010539403708784312,0.003906992525698075,-0.014446396234482406,-3659,272,-0.422176070151148,0.024985799943266718
4397,20041,Dickinson,Kansas,2012,2020,5832,190,8042,0.2511812981845312,0.7251927381248445,0.023625963690624224,-402,26,-249,-625,-0.02826949216968594,0.004703614550206549,0.02356587761947937,-3812,-153,-0.4740114399403133,-0.05183536978916531
4398,20041,Dickinson,Kansas,2016,1609,6029,572,8210,0.19598051157125457,0.7343483556638246,0.06967113276492083,-411,382,197,168,-0.05520078661327665,0.04604516907429661,0.009155617538980088,-4420,-608,-0.5383678440925701,-0.0643564041522568
4399,20043,Doniphan,Kansas,2000,1134,2350,165,3649,0.31077007399287476,0.644012058098109,0.04521786790901617,0,0,0,0,0.0,0.0,0.0,-1216,0,-0.33324198410523426,0.0
4400,20043,Doniphan,Kansas,2004,1065,2491,47,3603,0.29558701082431305,0.691368304190952,0.013044684984734944,-69,-118,141,-46,-0.015183063168561717,-0.03217318292428123,0.047356246092842946,-1426,-210,-0.3957812933666389,-0.06253930926140466
4401,20043,Doniphan,Kansas,2008,1115,2372,77,3564,0.3128507295173962,0.6655443322109988,0.021604938271604937,50,30,-119,-39,0.01726371869308313,0.008560253286869993,-0.02582397197995312,-1257,169,-0.35269360269360267,0.04308769067303625
4402,20043,Doniphan,Kansas,2012,902,2414,87,3403,0.26506024096385544,0.7093740816926242,0.025565677343520422,-213,10,42,-161,-0.04779048855354073,0.003960739071915485,0.043829749481625324,-1512,-255,-0.4443138407287687,-0.09162023803516606
4403,20043,Doniphan,Kansas,2016,587,2606,185,3378,0.1737714624037892,0.7714624037892244,0.05476613380698638,-315,98,192,-25,-0.09128877856006623,0.02920045646346596,0.0620883220966002,-2019,-507,-0.5976909413854352,-0.1533771006566665
4404,20045,Douglas,Kansas,2000,18249,17062,4527,39838,0.4580802249108891,0.42828455243737135,0.11363522265173955,0,0,0,0,0.0,0.0,0.0,1187,0,0.029795672473517776,0.0
4405,20045,Douglas,Kansas,2004,28634,20544,933,50111,0.5714114665442717,0.40996986689549203,0.018618666560236277,10385,-3594,3482,10273,0.11333124163338254,-0.09501655609150327,-0.018314685541879316,8090,6903,0.16144159964877963,0.13164592717526186
4406,20045,Douglas,Kansas,2008,34398,17929,1314,53641,0.6412632128409239,0.33424059954139557,0.024496187617680507,5764,381,-2615,3530,0.06985174629665225,0.00587752105744423,-0.07572926735409646,16469,8379,0.30702261329952835,0.14558101365074871
4407,20045,Douglas,Kansas,2012,29267,17401,1796,48464,0.6038915483657973,0.35905001650709806,0.037058435127104654,-5131,482,-528,-5177,-0.03737166447512663,0.012562247509424147,0.02480941696570249,11866,-4603,0.24484153185869922,-0.06218108144082912
4408,20045,Douglas,Kansas,2016,31195,14688,4204,50087,0.6228162996386288,0.2932497454429293,0.08393395491844191,1928,2408,-2713,1623,0.018924751272831553,0.04687551979133726,-0.06580027106416875,16507,4641,0.3295665541956995,0.0847250223370003
4409,20047,Edwards,Kansas,2000,447,1062,54,1563,0.28598848368522073,0.6794625719769674,0.0345489443378119,0,0,0,0,0.0,0.0,0.0,-615,0,-0.3934740882917466,0.0
4410,20047,Edwards,Kansas,2004,386,1084,26,1496,0.2580213903743315,0.7245989304812834,0.017379679144385027,-61,-28,22,-67,-0.0279670933108892,-0.017169265193426875,0.045136358504316076,-698,-83,-0.4665775401069519,-0.07310345181520528
4411,20047,Edwards,Kansas,2008,333,995,29,1357,0.24539425202652912,0.7332350773765659,0.021370670596904937,-53,3,-89,-139,-0.012627138347802408,0.00399099145251991,0.00863614689528247,-662,36,-0.4878408253500368,-0.021263285243084906
4412,20047,Edwards,Kansas,2012,298,1059,28,1385,0.21516245487364621,0.7646209386281588,0.020216606498194945,-35,-1,64,28,-0.030231797152882905,-0.0011540640987099914,0.03138586125159293,-761,-99,-0.5494584837545127,-0.06161765840447586
4413,20047,Edwards,Kansas,2016,212,1037,70,1319,0.1607278241091736,0.7862016679302501,0.05307050796057619,-86,42,-22,-66,-0.05443463076447261,0.03285390146238125,0.021580729302091317,-825,-64,-0.6254738438210765,-0.07601536006656384
4414,20049,Elk,Kansas,2000,402,1080,68,1550,0.2593548387096774,0.6967741935483871,0.04387096774193548,0,0,0,0,0.0,0.0,0.0,-678,0,-0.4374193548387097,0.0
4415,20049,Elk,Kansas,2004,369,1119,27,1515,0.24356435643564356,0.7386138613861386,0.01782178217821782,-33,-41,39,-35,-0.015790482274033846,-0.026049185563717662,0.041839667837751504,-750,-72,-0.49504950495049505,-0.05763015011178535
4416,20049,Elk,Kansas,2008,363,1042,29,1434,0.25313807531380755,0.7266387726638772,0.020223152022315203,-6,2,-77,-81,0.009573718878163995,0.0024013698440973827,-0.011975088722261384,-679,71,-0.47350069735006967,0.02154880760042538
4417,20049,Elk,Kansas,2012,281,1049,39,1369,0.20525931336742148,0.7662527392257122,0.028487947406866325,-82,10,7,-65,-0.04787876194638607,0.008264795384551122,0.03961396656183502,-768,-89,-0.5609934258582907,-0.08749272850822104
4418,20049,Elk,Kansas,2016,160,1048,51,1259,0.12708498808578236,0.8324066719618745,0.04050833995234313,-121,12,-1,-110,-0.07817432528163912,0.012020392545476807,0.06615393273616221,-888,-120,-0.7053216838760921,-0.14432825801780136
4419,20051,Ellis,Kansas,2000,3926,6516,718,11160,0.3517921146953405,0.5838709677419355,0.06433691756272401,0,0,0,0,0.0,0.0,0.0,-2590,0,-0.23207885304659498,0.0
4420,20051,Ellis,Kansas,2004,4033,7891,263,12187,0.33092639698038895,0.6474932304915073,0.021580372528103717,107,-455,1375,1027,-0.020865717714951548,-0.0427565450346203,0.06362226274957183,-3858,-1268,-0.31656683351111836,-0.08448798046452338
4421,20051,Ellis,Kansas,2008,4010,8207,230,12447,0.3221659837711898,0.6593556680324576,0.018478348196352534,-23,-33,316,260,-0.008760413209199125,-0.003102024331751184,0.011862437540950288,-4197,-339,-0.3371896842612678,-0.020622850750149413
4422,20051,Ellis,Kansas,2012,3057,8399,258,11714,0.2609697797507256,0.7170052928120199,0.022024927437254566,-953,28,192,-733,-0.06119620402046422,0.003546579240902032,0.05764962477956226,-5342,-1145,-0.45603551306129425,-0.11884582880002648
4423,20051,Ellis,Kansas,2016,2742,8466,739,11947,0.22951368544404452,0.7086297815351135,0.061856533020842056,-315,481,67,233,-0.03145609430668109,0.03983160558358749,-0.008375511276906389,-5724,-382,-0.479116096091069,-0.023080583029774726
4424,20053,Ellsworth,Kansas,2000,825,1845,169,2839,0.2905952800281789,0.6498767171539275,0.059528002817893624,0,0,0,0,0.0,0.0,0.0,-1020,0,-0.35928143712574856,0.0
4425,20053,Ellsworth,Kansas,2004,801,2259,42,3102,0.25822050290135395,0.7282398452611218,0.013539651837524178,-24,-127,414,263,-0.03237477712682496,-0.04598835098036945,0.07836312810719437,-1458,-438,-0.4700193423597679,-0.11073790523401933
4426,20053,Ellsworth,Kansas,2008,851,2021,66,2938,0.28965282505105516,0.6878829135466303,0.0224642614023145,50,24,-238,-164,0.03143232214970121,0.008924609564790322,-0.040356931714491506,-1170,288,-0.3982300884955752,0.07178925386419271
4427,20053,Ellsworth,Kansas,2012,702,1930,80,2712,0.2588495575221239,0.7116519174041298,0.029498525073746312,-149,14,-91,-226,-0.030803267528931255,0.007034263671431812,0.02376900385749947,-1228,-58,-0.4528023598820059,-0.054572271386430726
4428,20053,Ellsworth,Kansas,2016,521,1969,189,2679,0.1944755505785741,0.7349757372153789,0.07054871220604703,-181,109,39,-33,-0.0643740069435498,0.041050187132300714,0.02332381981124909,-1448,-220,-0.5405001866368048,-0.08769782675479887
4429,20055,Finney,Kansas,2000,2431,6442,277,9150,0.2656830601092896,0.7040437158469945,0.03027322404371585,0,0,0,0,0.0,0.0,0.0,-4011,0,-0.43836065573770494,0.0
4430,20055,Finney,Kansas,2004,2351,7479,103,9933,0.2366857948253297,0.7529447296889157,0.010369475485754556,-80,-174,1037,783,-0.028997265283959905,-0.019903748557961294,0.04890101384192114,-5128,-1117,-0.516258934863586,-0.07789827912588104
4431,20055,Finney,Kansas,2008,3275,6926,153,10354,0.3163028781147383,0.668920224067993,0.014776897817268689,924,50,-553,421,0.07961708328940859,0.004407422331514133,-0.08402450562092267,-3651,1477,-0.3526173459532547,0.16364158891033126
4432,20055,Finney,Kansas,2012,2682,6219,183,9084,0.2952443857331572,0.6846103038309115,0.020145310435931308,-593,30,-707,-1270,-0.021058492381581084,0.005368412618662619,0.015690079762918474,-3537,114,-0.3893659180977543,-0.03674857214449956
4433,20055,Finney,Kansas,2016,3195,6350,614,10159,0.3144994586081307,0.6250615218033271,0.06043901958854218,513,431,131,1075,0.019255072874973522,0.040293709152610865,-0.0595487820275844,-3155,382,-0.31056206319519636,0.07880385490255792
4434,20057,Ford,Kansas,2000,2566,6050,301,8917,0.28776494336660313,0.6784793091847033,0.03375574744869351,0,0,0,0,0.0,0.0,0.0,-3484,0,-0.3907143658181002,0.0
4435,20057,Ford,Kansas,2004,2286,6632,98,9016,0.2535492457852706,0.735581188997338,0.010869565217391304,-280,-203,582,99,-0.03421569758133253,-0.022886182231302205,0.057101879812634704,-4346,-862,-0.48203194321206744,-0.09131757739396723
4436,20057,Ford,Kansas,2008,2991,5730,143,8864,0.3374323104693141,0.6464350180505415,0.016132671480144405,705,45,-902,-152,0.0838830646840435,0.0052631062627531006,-0.08914617094679655,-2739,1607,-0.3090027075812274,0.17302923563084005
4437,20057,Ford,Kansas,2012,2600,5602,160,8362,0.31093039942597467,0.6699354221478115,0.019134178426213823,-391,17,-128,-502,-0.026501911043339432,0.0030015069460694183,0.023500404097270056,-3002,-263,-0.3590050227218369,-0.05000231514060949
4438,20057,Ford,Kansas,2016,2149,5114,455,7718,0.27844001036537963,0.6626068929774553,0.05895309665716507,-451,295,-488,-644,-0.03249038906059504,0.039818918230951246,-0.007328529170356202,-2965,37,-0.3841668826120757,-0.025161859890238836
4439,20059,Franklin,Kansas,2000,3321,5925,412,9658,0.3438600124249327,0.6134810519776351,0.04265893559743218,0,0,0,0,0.0,0.0,0.0,-2604,0,-0.26962103955270245,0.0
4440,20059,Franklin,Kansas,2004,3921,7391,164,11476,0.34166957127919134,0.6440397350993378,0.014290693621470896,600,-248,1466,1818,-0.002190441145741351,-0.028368241975961286,0.030558683121702623,-3470,-866,-0.3023701638201464,-0.032749124267443974
4441,20059,Franklin,Kansas,2008,4433,7079,279,11791,0.37596471885336274,0.600373165974048,0.023662115172589263,512,115,-312,315,0.0342951475741714,0.009371421551118368,-0.04366656912528977,-2646,824,-0.22440844712068525,0.07796171669946117
4442,20059,Franklin,Kansas,2012,3694,6984,312,10990,0.3361237488626024,0.6354868061874431,0.028389444949954504,-739,33,-95,-801,-0.039840969990760366,0.0047273297773652405,0.035113640213395136,-3290,-644,-0.29936305732484075,-0.0749546102041555
4443,20059,Franklin,Kansas,2016,2892,7185,888,10965,0.2637482900136799,0.655266757865937,0.08098495212038304,-802,576,201,-25,-0.07237545884892249,0.05259550717042853,0.01977995167849389,-4293,-1003,-0.39151846785225713,-0.09215541052741638
4444,20061,Geary,Kansas,2000,2660,3977,229,6866,0.3874162540052432,0.5792309933003205,0.033352752694436355,0,0,0,0,0.0,0.0,0.0,-1317,0,-0.19181473929507725,0.0
4445,20061,Geary,Kansas,2004,2531,4703,94,7328,0.34538755458515286,0.6417849344978166,0.012827510917030568,-129,-135,726,462,-0.042028699420090354,-0.020525241777405785,0.06255394119749613,-2172,-855,-0.29639737991266374,-0.10458264061758649
4446,20061,Geary,Kansas,2008,3491,4492,111,8094,0.43130714109216706,0.554978996787744,0.013713862120088955,960,17,-211,766,0.0859195865070142,0.0008863512030583866,-0.08680593771007261,-1001,1171,-0.12367185569557693,0.1727255242170868
4447,20061,Geary,Kansas,2012,3332,4372,141,7845,0.4247291268323773,0.5572976418100701,0.01797323135755258,-159,30,-120,-249,-0.006578014259789766,0.004259369237463626,0.002318645022326149,-1040,-39,-0.13256851497769284,-0.008896659282115915
4448,20061,Geary,Kansas,2016,2722,4274,508,7504,0.3627398720682303,0.5695628997867804,0.06769722814498934,-610,367,-98,-341,-0.06198925476414702,0.04972399678743676,0.012265257976710298,-1552,-512,-0.20682302771855016,-0.07425451274085731
4449,20063,Gove,Kansas,2000,296,1122,77,1495,0.1979933110367893,0.7505016722408027,0.05150501672240803,0,0,0,0,0.0,0.0,0.0,-826,0,-0.5525083612040134,0.0
4450,20063,Gove,Kansas,2004,247,1196,24,1467,0.1683708248125426,0.8152692569870484,0.016359918200409,-49,-53,74,-28,-0.029622486224246708,-0.03514509852199903,0.06476758474624578,-949,-123,-0.6468984321745058,-0.09439007097049246
4451,20063,Gove,Kansas,2008,261,1136,21,1418,0.18406205923836388,0.8011283497884344,0.014809590973201692,14,-3,-60,-49,0.015691234425821293,-0.0015503272272073074,-0.01414090719861405,-875,74,-0.6170662905500706,0.02983214162443526
4452,20063,Gove,Kansas,2012,176,1168,39,1383,0.1272595806218366,0.8445408532176428,0.028199566160520606,-85,18,32,-35,-0.05680247861652729,0.013389975187318914,0.04341250342920844,-992,-117,-0.7172812725958062,-0.10021498204573565
4453,20063,Gove,Kansas,2016,149,1140,54,1343,0.11094564408041697,0.8488458674609084,0.040208488458674606,-27,15,-28,-40,-0.01631393654141962,0.012008922298154,0.00430501424326557,-991,1,-0.7379002233804914,-0.02061895078468523
4454,20065,Graham,Kansas,2000,346,1058,70,1474,0.23473541383989144,0.7177747625508819,0.04748982360922659,0,0,0,0,0.0,0.0,0.0,-712,0,-0.48303934871099047,0.0
4455,20065,Graham,Kansas,2004,334,1082,24,1440,0.23194444444444445,0.7513888888888889,0.016666666666666666,-12,-46,24,-34,-0.002790969395446985,-0.030823156942559927,0.03361412633800698,-748,-36,-0.5194444444444444,-0.03640509573345391
4456,20065,Graham,Kansas,2008,325,1060,38,1423,0.22839072382290934,0.7449051300070274,0.026704146170063246,-9,14,-22,-17,-0.0035537206215351114,0.01003747950339658,-0.006483758881861479,-735,13,-0.516514406184118,0.0029300382603263397
4457,20065,Graham,Kansas,2012,256,1056,28,1340,0.191044776119403,0.7880597014925373,0.020895522388059702,-69,-10,-4,-83,-0.037345947703506355,-0.005808623782003544,0.04315457148550994,-800,-65,-0.5970149253731344,-0.08050051918901635
4458,20065,Graham,Kansas,2016,188,1025,71,1284,0.14641744548286603,0.7982866043613707,0.05529595015576324,-68,43,-31,-56,-0.044627330636536955,0.03440042776770354,0.01022690286883332,-837,-37,-0.6518691588785046,-0.05485423350537022
4459,20067,Grant,Kansas,2000,683,2126,47,2856,0.23914565826330533,0.7443977591036415,0.016456582633053222,0,0,0,0,0.0,0.0,0.0,-1443,0,-0.5052521008403361,0.0
4460,20067,Grant,Kansas,2004,561,2169,28,2758,0.2034082668600435,0.7864394488759971,0.01015228426395939,-122,-19,43,-98,-0.03573739140326182,-0.006304298369093832,0.04204168977235567,-1608,-165,-0.5830311820159536,-0.07777908117561749
4461,20067,Grant,Kansas,2008,635,1995,31,2661,0.23863209319804585,0.7497181510710259,0.011649755730928222,74,3,-174,-97,0.035223826338002334,0.0014974714669688319,-0.03672129780497124,-1360,248,-0.5110860578729801,0.0719451241429735
4462,20067,Grant,Kansas,2012,456,1811,39,2306,0.19774501300954034,0.7853425845620121,0.016912402428447527,-179,8,-184,-355,-0.04088708018850551,0.0052626466975193055,0.03562443349098621,-1355,5,-0.5875975715524717,-0.0765115136794916
4463,20067,Grant,Kansas,2016,441,1804,144,2389,0.1845960652992884,0.7551276684805358,0.0602762662201758,-15,105,-7,83,-0.013148947710251935,0.043363863791728276,-0.030214916081476306,-1363,-8,-0.5705316031812474,0.017065968371224316
4464,20069,Gray,Kansas,2000,482,1631,47,2160,0.22314814814814815,0.7550925925925925,0.02175925925925926,0,0,0,0,0.0,0.0,0.0,-1149,0,-0.5319444444444443,0.0
4465,20069,Gray,Kansas,2004,408,1816,21,2245,0.18173719376391984,0.8089086859688196,0.009354120267260579,-74,-26,185,85,-0.041410954384228316,-0.01240513899199868,0.05381609337622706,-1408,-259,-0.6271714922048998,-0.09522704776045543
4466,20069,Gray,Kansas,2008,436,1643,40,2119,0.2057574327512978,0.7753657385559226,0.018876828692779613,28,19,-173,-126,0.024020238987377956,0.009522708425519034,-0.033542947412896984,-1207,201,-0.5696083058046248,0.05756318640027491
4467,20069,Gray,Kansas,2012,324,1603,31,1958,0.16547497446373852,0.8186925434116445,0.015832482124616958,-112,-9,-40,-161,-0.040282458287559275,-0.0030443465681626557,0.043326804855721934,-1279,-72,-0.6532175689479061,-0.08360926314328121
4468,20069,Gray,Kansas,2016,263,1698,105,2066,0.12729912875121008,0.8218780251694094,0.050822846079380445,-61,74,95,108,-0.03817584571252844,0.03499036395476349,0.0031854817577648964,-1435,-156,-0.6945788964181994,-0.04136132747029331
4469,20071,Greeley,Kansas,2000,143,628,32,803,0.1780821917808219,0.7820672478206725,0.039850560398505604,0,0,0,0,0.0,0.0,0.0,-485,0,-0.6039850560398505,0.0
4470,20071,Greeley,Kansas,2004,138,584,13,735,0.18775510204081633,0.7945578231292517,0.017687074829931974,-5,-19,-44,-68,0.009672910259994422,-0.02216348556857363,0.012490575308579221,-446,39,-0.6068027210884354,-0.0028176650485848276
4471,20071,Greeley,Kansas,2008,151,591,3,745,0.20268456375838925,0.7932885906040269,0.004026845637583893,13,-10,7,10,0.014929461717572923,-0.013660229192348081,-0.0012692325252248171,-440,6,-0.5906040268456376,0.01619869424279774
4472,20071,Greeley,Kansas,2012,113,543,14,670,0.16865671641791044,0.8104477611940298,0.020895522388059702,-38,11,-48,-75,-0.03402784734047881,0.01686867675047581,0.017159170590002937,-430,10,-0.6417910447761194,-0.05118701793048175
4473,20071,Greeley,Kansas,2016,83,534,33,650,0.1276923076923077,0.8215384615384616,0.05076923076923077,-30,19,-9,-20,-0.04096440872560275,0.029873708381171066,0.011090700344431714,-451,-21,-0.6938461538461539,-0.05205510907003452
4474,20073,Greenwood,Kansas,2000,1027,2392,142,3561,0.2884021342319573,0.6717214265655714,0.03987643920247121,0,0,0,0,0.0,0.0,0.0,-1365,0,-0.3833192923336141,0.0
4475,20073,Greenwood,Kansas,2004,911,2282,51,3244,0.280826140567201,0.7034525277435265,0.015721331689272502,-116,-91,-110,-317,-0.007575993664756309,-0.02415510751319871,0.03173110117795508,-1371,-6,-0.4226263871763255,-0.03930709484271139
4476,20073,Greenwood,Kansas,2008,622,1619,38,2279,0.27292672224659936,0.710399297937692,0.016673979815708645,-289,-13,-663,-965,-0.007899418320601648,0.0009526481264361432,0.0069467701941654525,-997,374,-0.4374725756910926,-0.0148461885147671
4477,20073,Greenwood,Kansas,2012,478,1590,55,2123,0.2251530852567122,0.7489401789919925,0.025906735751295335,-144,17,-29,-156,-0.04777363698988715,0.00923275593558669,0.038540881054300535,-1112,-115,-0.5237870937352803,-0.08631451804418772
4478,20073,Greenwood,Kansas,2016,485,2160,195,2840,0.17077464788732394,0.7605633802816901,0.06866197183098592,7,140,570,717,-0.05437843736938827,0.04275523607969059,0.011623201289697627,-1675,-563,-0.5897887323943662,-0.06600163865908593
4479,20075,Hamilton,Kansas,2000,264,901,27,1192,0.2214765100671141,0.7558724832214765,0.022651006711409395,0,0,0,0,0.0,0.0,0.0,-637,0,-0.5343959731543624,0.0
4480,20075,Hamilton,Kansas,2004,229,888,13,1130,0.20265486725663717,0.7858407079646018,0.011504424778761062,-35,-14,-13,-62,-0.018821642810476935,-0.011146581932648333,0.029968224743125327,-659,-22,-0.5831858407079646,-0.04878986755360226
4481,20075,Hamilton,Kansas,2008,233,844,19,1096,0.2125912408759124,0.7700729927007299,0.017335766423357664,4,6,-44,-34,0.00993637361927524,0.005831341644596602,-0.015767715263871884,-611,48,-0.5574817518248175,0.025704088883147125
4482,20075,Hamilton,Kansas,2012,163,693,21,877,0.18586088939566706,0.790193842645382,0.02394526795895097,-70,2,-151,-219,-0.026730351480245357,0.006609501535593306,0.02012084994465202,-530,81,-0.6043329532497149,-0.046851201424897404
4483,20075,Hamilton,Kansas,2016,121,705,50,876,0.13812785388127855,0.8047945205479452,0.05707762557077625,-42,29,12,-1,-0.04773303551438851,0.033132357611825286,0.014600677902563253,-584,-54,-0.6666666666666666,-0.06233371341695171
4484,20077,Harper,Kansas,2000,869,2076,110,3055,0.2844517184942717,0.6795417348608838,0.03600654664484452,0,0,0,0,0.0,0.0,0.0,-1207,0,-0.39509001636661206,0.0
4485,20077,Harper,Kansas,2004,727,2154,49,2930,0.24812286689419796,0.7351535836177474,0.016723549488054608,-142,-61,78,-125,-0.036328851600073736,-0.01928299715678991,0.05561184875686365,-1427,-220,-0.4870307167235495,-0.09194070035693741
4486,20077,Harper,Kansas,2008,736,1999,61,2796,0.2632331902718169,0.7149499284692418,0.021816881258941344,9,12,-155,-134,0.015110323377618945,0.005093331770886736,-0.02020365514850564,-1263,164,-0.45171673819742486,0.03531397852612461
4487,20077,Harper,Kansas,2012,550,1759,80,2389,0.23022185014650481,0.7362913352867309,0.033486814566764334,-186,19,-240,-407,-0.033011340125312094,0.01166993330782299,0.021341406817489084,-1209,54,-0.5060694851402261,-0.05435274694280123
4488,20077,Harper,Kansas,2016,393,1996,189,2578,0.15244375484871994,0.7742435996896819,0.07331264546159814,-157,109,237,189,-0.07777809529778487,0.03982583089483381,0.037952264402951075,-1603,-394,-0.621799844840962,-0.11573035970073586
4489,20079,Harvey,Kansas,2000,4591,8271,822,13684,0.3355013154048524,0.6044285296696872,0.06007015492546039,0,0,0,0,0.0,0.0,0.0,-3680,0,-0.2689272142648348,0.0
4490,20079,Harvey,Kansas,2004,5331,9534,245,15110,0.3528127068166777,0.6309728656518862,0.016214427531436135,740,-577,1263,1426,0.017311391411825305,-0.043855727394024255,0.026544335982198963,-4203,-523,-0.27816015883520845,-0.009232944570373658
4491,20079,Harvey,Kansas,2008,6318,9006,367,15691,0.40265120132560067,0.573959594672105,0.023389204002294307,987,122,-528,581,0.04983849450892297,0.007174776470858173,-0.05701327097978115,-2688,1515,-0.17130839334650433,0.10685176548870412
4492,20079,Harvey,Kansas,2012,5373,8588,333,14294,0.37589198265006296,0.6008115293129984,0.023296488036938574,-945,-34,-418,-1397,-0.02675921867553771,-9.271596535573301e-05,0.026851934640893416,-3215,-527,-0.22491954666293545,-0.053611153316431126
4493,20079,Harvey,Kansas,2016,5068,8668,1180,14916,0.33976937516760525,0.5811209439528023,0.07910968087959239,-305,847,80,622,-0.036122607482457714,0.05581319284265381,-0.019690585360196078,-3600,-385,-0.2413515687851971,-0.016432022122261636
4494,20081,Haskell,Kansas,2000,263,1323,30,1616,0.16274752475247525,0.8186881188118812,0.018564356435643563,0,0,0,0,0.0,0.0,0.0,-1060,0,-0.655940594059406,0.0
4495,20081,Haskell,Kansas,2004,227,1356,16,1599,0.14196372732958099,0.8480300187617261,0.010006253908692933,-36,-14,33,-17,-0.020783797422894268,-0.00855810252695063,0.02934189994984493,-1129,-69,-0.7060662914321452,-0.0501256973727392
4496,20081,Haskell,Kansas,2008,278,1277,15,1570,0.1770700636942675,0.813375796178344,0.009554140127388535,51,-1,-79,-29,0.03510633636468652,-0.00045211378130439843,-0.03465422258338213,-999,130,-0.6363057324840765,0.06976055894806865
4497,20081,Haskell,Kansas,2012,215,1159,22,1396,0.15401146131805157,0.8302292263610315,0.015759312320916905,-63,7,-118,-174,-0.02305860237621593,0.0062051721935283705,0.01685343018268748,-944,55,-0.6762177650429799,-0.03991203255890341
4498,20081,Haskell,Kansas,2016,245,1040,69,1354,0.1809453471196455,0.7680945347119645,0.05096011816838995,30,47,-119,-42,0.02693388580159392,0.03520080584747305,-0.06213469164906693,-795,149,-0.587149187592319,0.08906857745066088
4499,20083,Hodgeman,Kansas,2000,217,835,36,1088,0.19944852941176472,0.7674632352941176,0.03308823529411765,0,0,0,0,0.0,0.0,0.0,-618,0,-0.5680147058823529,0.0
4500,20083,Hodgeman,Kansas,2004,223,953,7,1183,0.18850380388841928,0.8055790363482671,0.005917159763313609,6,-29,118,95,-0.010944725523345439,-0.02717107553080404,0.03811580105414947,-730,-112,-0.6170752324598479,-0.049060526577494934
4501,20083,Hodgeman,Kansas,2008,211,865,20,1096,0.19251824817518248,0.7892335766423357,0.01824817518248175,-12,13,-88,-87,0.004014444286763202,0.012331015419168142,-0.016345459705931376,-654,76,-0.5967153284671532,0.020359903992694606
4502,20083,Hodgeman,Kansas,2012,179,868,13,1060,0.16886792452830188,0.8188679245283019,0.012264150943396227,-32,-7,3,-36,-0.023650323646880606,-0.005984024239085523,0.029634347885966195,-689,-35,-0.65,-0.05328467153284677
4503,20083,Hodgeman,Kansas,2016,124,855,38,1017,0.12192723697148476,0.8407079646017699,0.03736479842674533,-55,25,-13,-43,-0.046940687556817115,0.025100647483349104,0.02184004007346796,-731,-42,-0.7187807276302851,-0.06878072763028509
4504,20085,Jackson,Kansas,2000,1990,3001,259,5250,0.379047619047619,0.5716190476190476,0.04933333333333333,0,0,0,0,0.0,0.0,0.0,-1011,0,-0.19257142857142856,0.0
4505,20085,Jackson,Kansas,2004,2064,3730,94,5888,0.35054347826086957,0.6334918478260869,0.01596467391304348,74,-165,729,638,-0.028504140786749455,-0.03336865942028985,0.061872800207039336,-1666,-655,-0.28294836956521735,-0.09037694099378879
4506,20085,Jackson,Kansas,2008,2308,3811,134,6253,0.3691028306412922,0.6094674556213018,0.021429713737406045,244,40,81,365,0.01855935238042261,0.005465039824362566,-0.02402439220478514,-1503,163,-0.2403646249800096,0.04258374458520775
4507,20085,Jackson,Kansas,2012,1901,3527,133,5561,0.3418449919079302,0.6342384463226038,0.023916561769465924,-407,-1,-284,-692,-0.02725783873336196,0.002486848032059879,0.024770990701302065,-1626,-123,-0.2923934544146736,-0.052028829434664026
4508,20085,Jackson,Kansas,2016,1512,3939,367,5818,0.2598831213475421,0.67703678239945,0.06308009625300791,-389,234,412,257,-0.08196187056038812,0.039163534483541984,0.04279833607684613,-2427,-801,-0.4171536610519079,-0.12476020663723425
4509,20087,Jefferson,Kansas,2000,3000,4423,454,7877,0.3808556557064872,0.5615081883965977,0.05763615589691507,0,0,0,0,0.0,0.0,0.0,-1423,0,-0.18065253269011045,0.0
4510,20087,Jefferson,Kansas,2004,3253,5408,132,8793,0.3699533720004549,0.6150346866825884,0.01501194131695667,253,-322,985,916,-0.0109022837060323,-0.0426242145799584,0.053526498285990765,-2155,-732,-0.2450813146821335,-0.06442878199202307
4511,20087,Jefferson,Kansas,2008,3542,5220,188,8950,0.3957541899441341,0.5832402234636872,0.02100558659217877,289,56,-188,157,0.025800817943679166,0.005993645275222101,-0.031794463218901226,-1678,477,-0.18748603351955312,0.05759528116258039
4512,20087,Jefferson,Kansas,2012,2977,4827,209,8013,0.3715212779233745,0.6023961063272183,0.026082615749407213,-565,21,-393,-937,-0.024232912020759556,0.005077029157228442,0.019155882863531093,-1850,-172,-0.23087482840384377,-0.04338879488429065
4513,20087,Jefferson,Kansas,2016,2518,5213,606,8337,0.30202710807244815,0.6252848746551517,0.07268801727240014,-459,397,386,324,-0.06949416985092638,0.046605401522992924,0.022888768327933406,-2695,-845,-0.32325776658270355,-0.09238293817885979
4514,20089,Jewell,Kansas,2000,380,1400,97,1877,0.20245071923281832,0.7458710708577517,0.051678209909429944,0,0,0,0,0.0,0.0,0.0,-1020,0,-0.5434203516249334,0.0
4515,20089,Jewell,Kansas,2004,385,1495,35,1915,0.2010443864229765,0.7806788511749347,0.018276762402088774,5,-62,95,38,-0.0014063328098418149,-0.03340144750734117,0.03480778031718301,-1110,-90,-0.5796344647519582,-0.03621411312702483
4516,20089,Jewell,Kansas,2008,313,1231,40,1584,0.1976010101010101,0.7771464646464646,0.025252525252525252,-72,5,-264,-331,-0.003443376321966396,0.006975762850436478,-0.0035323865284700995,-918,192,-0.5795454545454546,8.901020650364799e-05
4517,20089,Jewell,Kansas,2012,229,1235,33,1497,0.15297261189044756,0.8249832999331997,0.022044088176352707,-84,-7,4,-87,-0.04462839821056255,-0.0032084370761725454,0.0478368352867351,-1006,-88,-0.6720106880427522,-0.09246523349729763
4518,20089,Jewell,Kansas,2016,180,1223,91,1494,0.12048192771084337,0.8186077643908969,0.06091030789825971,-49,58,-12,-3,-0.032490684179604185,0.038866219721907,-0.006375535542302857,-1043,-37,-0.6981258366800536,-0.026115148637301355
4519,20091,Johnson,Kansas,2000,79118,129965,8453,217536,0.36370072080023536,0.5974413430420712,0.03885793615769344,0,0,0,0,0.0,0.0,0.0,-50847,0,-0.23374062224183584,0.0
4520,20091,Johnson,Kansas,2004,97866,158103,2718,258687,0.3783181992137216,0.6111748947569843,0.01050690602929409,18748,-5735,28138,41151,0.014617478413486262,-0.028351030128399346,0.013733551714913084,-60237,-9390,-0.23285669554326266,0.0008839266985731786
4521,20091,Johnson,Kansas,2008,127091,152627,4493,284211,0.4471712917515508,0.5370200308925411,0.015808677355908112,29225,1775,-5476,25524,0.06885309253782917,0.0053017713266140225,-0.07415486386444314,-25536,34701,-0.08984873914099034,0.14300795640227232
4522,20091,Johnson,Kansas,2012,110526,158401,6147,275074,0.4018046053062085,0.575848680718643,0.022346713975148504,-16565,1654,5774,-9137,-0.04536668644534231,0.006538036619240392,0.0388286498261019,-47875,-22339,-0.17404407541243455,-0.08419533627144421
4523,20091,Johnson,Kansas,2016,129852,137490,26866,294208,0.44136121383510984,0.4673224385468784,0.09131634761801175,19326,20719,-20911,19134,0.03955660852890136,0.06896963364286324,-0.10852624217176465,-7638,40237,-0.025961224711768538,0.148082850700666
4524,20093,Kearny,Kansas,2000,320,1084,31,1435,0.2229965156794425,0.7554006968641115,0.021602787456445994,0,0,0,0,0.0,0.0,0.0,-764,0,-0.5324041811846689,0.0
4525,20093,Kearny,Kansas,2004,272,1177,6,1455,0.18694158075601375,0.8089347079037801,0.004123711340206186,-48,-25,93,20,-0.03605493492342876,-0.01747907611623981,0.053534011039668594,-905,-141,-0.6219931271477663,-0.08958894596309741
4526,20093,Kearny,Kansas,2008,309,1159,14,1482,0.20850202429149797,0.782051282051282,0.009446693657219974,37,8,-18,27,0.021560443535484225,0.005322982317013788,-0.026883425852498033,-850,55,-0.573549257759784,0.048443869387982286
4527,20093,Kearny,Kansas,2012,268,1097,21,1386,0.19336219336219337,0.7914862914862915,0.015151515151515152,-41,7,-62,-96,-0.015139830929304599,0.005704821494295178,0.009435009435009412,-829,21,-0.5981240981240981,-0.02457484036431401
4528,20093,Kearny,Kansas,2016,174,1075,67,1316,0.13221884498480244,0.8168693009118541,0.050911854103343465,-94,46,-22,-70,-0.06114334837739094,0.03576033895182831,0.025383009425562597,-901,-72,-0.6846504559270516,-0.08652635780295359
4529,20095,Kingman,Kansas,2000,991,2672,145,3808,0.2602415966386555,0.7016806722689075,0.03807773109243697,0,0,0,0,0.0,0.0,0.0,-1681,0,-0.44143907563025203,0.0
4530,20095,Kingman,Kansas,2004,904,2801,59,3764,0.24017003188097769,0.7441551540913921,0.01567481402763018,-87,-86,129,-44,-0.020071564757677796,-0.02240291706480679,0.04247448182248459,-1897,-216,-0.5039851222104144,-0.06254604658016233
4531,20095,Kingman,Kansas,2008,963,2603,98,3664,0.26282751091703055,0.7104257641921398,0.026746724890829694,59,39,-198,-100,0.022657479036052863,0.011071910863199513,-0.03372938989925234,-1640,257,-0.4475982532751092,0.056386868935305146
4532,20095,Kingman,Kansas,2012,733,2397,101,3231,0.22686474775611265,0.7418755803156918,0.031259671928195606,-230,3,-206,-433,-0.0359627631609179,0.004512947037365912,0.03144981612355202,-1664,-24,-0.5150108325595791,-0.06741257928446992
4533,20095,Kingman,Kansas,2016,599,2530,205,3334,0.1796640671865627,0.7588482303539292,0.061487702459508096,-134,104,133,103,-0.04720068056954996,0.03022803053131249,0.016972650038237447,-1931,-267,-0.5791841631673665,-0.0641733306077874
4534,20097,Kiowa,Kansas,2000,294,1262,52,1608,0.1828358208955224,0.7848258706467661,0.03233830845771144,0,0,0,0,0.0,0.0,0.0,-968,0,-0.6019900497512437,0.0
4535,20097,Kiowa,Kansas,2004,256,1275,34,1565,0.1635782747603834,0.8146964856230032,0.021725239616613417,-38,-18,13,-43,-0.019257546135138998,-0.010613068841098024,0.02987061497623711,-1019,-51,-0.6511182108626199,-0.04912816111137619
4536,20097,Kiowa,Kansas,2008,200,912,23,1135,0.1762114537444934,0.8035242290748899,0.02026431718061674,-56,-11,-363,-430,0.01263317898411001,-0.0014609224359966762,-0.01117225654811338,-712,307,-0.6273127753303964,0.023805435532223473
4537,20097,Kiowa,Kansas,2012,163,976,5,1144,0.14248251748251747,0.8531468531468531,0.004370629370629371,-37,-18,64,9,-0.03372893626197593,-0.01589368780998737,0.04962262407196327,-813,-101,-0.7106643356643356,-0.0833515603339392
4538,20097,Kiowa,Kansas,2016,114,900,65,1079,0.1056533827618165,0.8341056533827618,0.060240963855421686,-49,60,-76,-65,-0.03682913472070097,0.05587033448479232,-0.019041199764091354,-786,27,-0.7284522706209453,-0.017787934956609686
4539,20099,Labette,Kansas,2000,3745,4475,318,8538,0.4386273131881003,0.5241274303115484,0.03724525650035137,0,0,0,0,0.0,0.0,0.0,-730,0,-0.08550011712344813,0.0
4540,20099,Labette,Kansas,2004,3615,5400,124,9139,0.3955575008206587,0.5908742750848014,0.013568224094539885,-130,-194,925,601,-0.04306981236744156,-0.023677032405811482,0.06674684477325299,-1785,-1055,-0.19531677426414268,-0.10981665714069455
4541,20099,Labette,Kansas,2008,3839,5001,191,9031,0.42509135200974424,0.5537592736131104,0.021149374377145386,224,67,-399,-108,0.029533851189085525,0.0075811502826055015,-0.037115001471691,-1162,623,-0.12866792160336615,0.06664885266077653
4542,20099,Labette,Kansas,2012,3117,4742,178,8037,0.3878312803284808,0.5900211521712082,0.02214756750031106,-722,-13,-259,-994,-0.03726007168126344,0.0009981931231656735,0.036261878558097815,-1625,-463,-0.2021898718427274,-0.07352195023936126
4543,20099,Labette,Kansas,2016,2291,5335,481,8107,0.28259528802269646,0.6580732700135685,0.05933144196373504,-826,303,593,70,-0.10523599230578434,0.037183874463423985,0.06805211784236032,-3044,-1419,-0.37547798199087207,-0.17328811014814466
4544,20101,Lane,Kansas,2000,252,846,35,1133,0.22241835834068843,0.7466902030008826,0.03089143865842895,0,0,0,0,0.0,0.0,0.0,-594,0,-0.5242718446601942,0.0
4545,20101,Lane,Kansas,2004,181,823,10,1014,0.17850098619329388,0.8116370808678501,0.009861932938856016,-71,-25,-23,-119,-0.04391737214739455,-0.021029505719572933,0.06494687786696751,-642,-48,-0.6331360946745562,-0.10886425001436206
4546,20101,Lane,Kansas,2008,193,814,20,1027,0.18792599805258034,0.7925998052580331,0.019474196689386564,12,10,-9,13,0.009425011859286458,0.009612263750530549,-0.01903727560981705,-621,21,-0.6046738072054527,0.02846228746910351
4547,20101,Lane,Kansas,2012,172,739,17,928,0.1853448275862069,0.7963362068965517,0.018318965517241378,-21,-3,-75,-99,-0.0025811704663734336,-0.0011552311721451866,0.003736401638518627,-567,54,-0.6109913793103448,-0.006317572104892033
4548,20101,Lane,Kansas,2016,106,718,47,871,0.12169919632606199,0.8243398392652124,0.0539609644087256,-66,30,-21,-57,-0.06364563126014491,0.03564199889148423,0.028003632368660658,-612,-45,-0.7026406429391504,-0.09164926362880566
4549,20103,Leavenworth,Kansas,2000,9733,12583,955,23271,0.41824588543680974,0.5407159125091315,0.0410382020540587,0,0,0,0,0.0,0.0,0.0,-2850,0,-0.1224700270723218,0.0
4550,20103,Leavenworth,Kansas,2004,11039,15949,343,27331,0.4039003329552523,0.5835498152281292,0.012549851816618492,1306,-612,3366,4060,-0.014345552481557444,-0.028488350237440205,0.042833902718997674,-4910,-2060,-0.17964948227287691,-0.05717945520055512
4551,20103,Leavenworth,Kansas,2008,13255,16791,545,30591,0.43329737504494786,0.5488869275277042,0.017815697427347912,2216,202,842,3260,0.02939704208969557,0.00526584561072942,-0.03466288770042503,-3536,1374,-0.11558955248275632,0.0640599297901206
4552,20103,Leavenworth,Kansas,2012,11357,17059,669,29085,0.3904761904761905,0.5865222623345367,0.02300154718927282,-1898,124,268,-1506,-0.04282118456875739,0.005185849761924908,0.037635334806832565,-5702,-2166,-0.19604607185834627,-0.08045651937558995
4553,20103,Leavenworth,Kansas,2016,10209,17638,2792,30639,0.33320278076960735,0.5756715297496655,0.09112568948072718,-1148,2123,579,1554,-0.05727340970658312,0.06812414229145436,-0.010850732584871237,-7429,-1727,-0.24246874898005816,-0.046422677121711886
4554,20105,Lincoln,Kansas,2000,469,1295,126,1890,0.24814814814814815,0.6851851851851852,0.06666666666666667,0,0,0,0,0.0,0.0,0.0,-826,0,-0.4370370370370371,0.0
4555,20105,Lincoln,Kansas,2004,391,1368,41,1800,0.21722222222222223,0.76,0.02277777777777778,-78,-85,73,-90,-0.030925925925925912,-0.04388888888888889,0.07481481481481478,-977,-151,-0.5427777777777778,-0.10574074074074069
4556,20105,Lincoln,Kansas,2008,347,1204,35,1586,0.21878940731399749,0.7591424968474149,0.022068095838587643,-44,-6,-164,-214,0.0015671850917752528,-0.0007096819391901356,-0.0008575031525851484,-857,120,-0.5403530895334174,0.0024246882443603734
4557,20105,Lincoln,Kansas,2012,289,1165,29,1483,0.19487525286581253,0.7855697909642616,0.019554956169925825,-58,-6,-39,-103,-0.023914154448184954,-0.002513139668661818,0.026427294116846745,-876,-19,-0.5906945380984491,-0.05034144856503164
4558,20105,Lincoln,Kansas,2016,215,1179,70,1464,0.14685792349726776,0.805327868852459,0.04781420765027322,-74,41,14,-19,-0.048017329368544776,0.028259251480347396,0.01975807788819739,-964,-88,-0.6584699453551912,-0.06777540725674214
4559,20107,Linn,Kansas,2000,1587,2513,159,4259,0.3726226813806058,0.5900446114111294,0.03733270720826485,0,0,0,0,0.0,0.0,0.0,-926,0,-0.21742193003052362,0.0
4560,20107,Linn,Kansas,2004,1631,3048,62,4741,0.34402024889263866,0.6429023412782113,0.013077409829149969,44,-97,535,482,-0.028602432487967122,-0.02425529737911488,0.052857729867081926,-1417,-491,-0.2988820923855727,-0.08146016235504905
4561,20107,Linn,Kansas,2008,1425,3086,106,4617,0.30864197530864196,0.6683993935455924,0.02295863114576565,-206,44,38,-124,-0.0353782735839967,0.00988122131661568,0.025497052267381082,-1661,-244,-0.35975741823695045,-0.06087532585137778
4562,20107,Linn,Kansas,2012,1170,3177,120,4467,0.2619207521826729,0.7112155809267965,0.026863666890530557,-255,14,91,-150,-0.04672122312596905,0.003905035744764907,0.042816187381204074,-2007,-346,-0.4492948287441236,-0.08953741050717312
4563,20107,Linn,Kansas,2016,736,3484,234,4454,0.16524472384373598,0.7822182308037718,0.052537045352492144,-434,114,307,-13,-0.09667602833893693,0.025673378461961587,0.07100264987697535,-2748,-741,-0.6169735069600358,-0.16767867821591226
4564,20109,Logan,Kansas,2000,231,1088,78,1397,0.16535433070866143,0.7788117394416607,0.05583392984967788,0,0,0,0,0.0,0.0,0.0,-857,0,-0.6134574087329993,0.0
4565,20109,Logan,Kansas,2004,248,1255,20,1523,0.16283650689428758,0.8240315167432699,0.013131976362442548,17,-58,167,126,-0.0025178238143738485,-0.042701953487235336,0.0452197773016092,-1007,-150,-0.6611950098489823,-0.04773760111598302
4566,20109,Logan,Kansas,2008,225,1187,28,1440,0.15625,0.8243055555555555,0.019444444444444445,-23,8,-68,-83,-0.00658650689428758,0.0063124680820018965,0.0002740388122856041,-962,45,-0.6680555555555555,-0.00686054570657324
4567,20109,Logan,Kansas,2012,197,1126,27,1350,0.14592592592592593,0.8340740740740741,0.02,-28,-1,-61,-90,-0.010324074074074069,0.0005555555555555557,0.009768518518518565,-929,33,-0.6881481481481482,-0.020092592592592662
4568,20109,Logan,Kansas,2016,149,1132,76,1357,0.10980103168754606,0.8341930729550479,0.05600589535740604,-48,49,6,7,-0.036124894238379876,0.036005895357406045,0.0001189988809737752,-983,-54,-0.7243920412675018,-0.03624389311935361
4569,20111,Lyon,Kansas,2000,5190,6652,613,12455,0.4167001204335608,0.5340826977117623,0.049217181854676835,0,0,0,0,0.0,0.0,0.0,-1462,0,-0.1173825772782015,0.0
4570,20111,Lyon,Kansas,2004,5234,7951,255,13440,0.3894345238095238,0.5915922619047619,0.018973214285714284,44,-358,1299,985,-0.027265596624036992,-0.03024396756896255,0.057509564192999574,-2717,-1255,-0.20215773809523807,-0.08477516081703657
4571,20111,Lyon,Kansas,2008,5924,6698,289,12911,0.4588335527844474,0.5187824335837657,0.02238401363178685,690,34,-1253,-529,0.06939902897492356,0.0034107993460725655,-0.07280982832099614,-774,1943,-0.05994888079931837,0.1422088572959197
4572,20111,Lyon,Kansas,2012,5111,6470,294,11875,0.4304,0.5448421052631579,0.024757894736842104,-813,5,-228,-1036,-0.02843355278444737,0.002373881105055254,0.02605967167939216,-1359,-585,-0.1144421052631579,-0.05449322446383953
4573,20111,Lyon,Kansas,2016,4649,6552,1271,12472,0.37275497113534317,0.5253367543296985,0.1019082745349583,-462,977,82,597,-0.05764502886465683,0.0771503797981162,-0.019505350933459398,-1903,-544,-0.15258178319435534,-0.038139677931197435
4574,20113,McPherson,Kansas,2000,3272,8501,688,12461,0.26257924725142445,0.6822084904903298,0.05521226225824573,0,0,0,0,0.0,0.0,0.0,-5229,0,-0.4196292432389054,0.0
4575,20113,McPherson,Kansas,2004,3589,9595,183,13367,0.2684970449614723,0.7178125233784693,0.013690431660058353,317,-505,1094,906,0.005917797710047856,-0.04152183059818738,0.035604032888139514,-6006,-777,-0.44931547841699704,-0.029686235178091658
4576,20113,McPherson,Kansas,2008,4218,8937,231,13386,0.3151053339309727,0.6676378305692514,0.017256835499775885,629,48,-658,19,0.04660828896950037,0.0035664038397175326,-0.050174692809217936,-4719,1287,-0.35253249663827874,0.0967829817787183
4577,20113,McPherson,Kansas,2012,3449,8545,303,12297,0.28047491258030416,0.694884931284053,0.02464015613564284,-769,72,-392,-1089,-0.03463042135066852,0.007383320635866955,0.02724710071480163,-5096,-377,-0.4144100187037489,-0.06187752206547015
4578,20113,McPherson,Kansas,2016,3226,8549,967,12742,0.25317846491916496,0.670930780097316,0.07589075498351908,-223,664,4,445,-0.0272964476611392,0.051250598847876236,-0.02395415118673705,-5323,-227,-0.41775231517815103,-0.003342296474402151
4579,20115,Marion,Kansas,2000,1475,4156,272,5903,0.24987294595968151,0.7040487887514822,0.046078265288836184,0,0,0,0,0.0,0.0,0.0,-2681,0,-0.45417584279180073,0.0
4580,20115,Marion,Kansas,2004,1536,4516,107,6159,0.24939113492450074,0.7332359149212534,0.01737295015424582,61,-165,360,256,-0.0004818110351807736,-0.028705315134590365,0.02918712616977115,-2980,-299,-0.4838447799967527,-0.02966893720495195
4581,20115,Marion,Kansas,2008,1801,4159,99,6059,0.2972437695989437,0.6864169004786268,0.016339329922429445,265,-8,-357,-100,0.04785263467444298,-0.001033620231816374,-0.046819014442626594,-2358,622,-0.3891731308796831,0.0946716491170696
4582,20115,Marion,Kansas,2012,1385,3889,135,5409,0.25605472360880016,0.7189868737289702,0.024958402662229616,-416,36,-270,-650,-0.04118904599014356,0.008619072739800171,0.03256997325034339,-2504,-146,-0.46293215012017,-0.07375901924048694
4583,20115,Marion,Kansas,2016,1204,4003,417,5624,0.21408250355618777,0.7117709815078236,0.07414651493598862,-181,282,114,215,-0.04197222005261239,0.049188112273759,-0.0072158922211466026,-2799,-295,-0.49768847795163584,-0.034756327831465816
4584,20117,Marshall,Kansas,2000,1831,3066,218,5115,0.3579667644183773,0.5994134897360703,0.042619745845552295,0,0,0,0,0.0,0.0,0.0,-1235,0,-0.241446725317693,0.0
4585,20117,Marshall,Kansas,2004,1789,3261,58,5108,0.3502349256068912,0.6384103367267032,0.011354737666405637,-42,-160,195,-7,-0.007731838811486147,-0.03126500817914666,0.03899684699063288,-1472,-237,-0.28817541111981204,-0.04672868580211903
4586,20117,Marshall,Kansas,2008,1784,3157,95,5036,0.35424940428911833,0.6268864177918984,0.01886417791898332,-5,37,-104,-72,0.004014478682227152,0.007509440252577682,-0.011523918934804867,-1373,99,-0.27263701350278,0.015538397617032018
4587,20117,Marshall,Kansas,2012,1469,3195,109,4773,0.30777288916823803,0.6693903205531112,0.022836790278650744,-315,14,38,-263,-0.0464765151208803,0.003972612359667425,0.04250390276121285,-1726,-353,-0.3616174313848732,-0.08898041788209315
4588,20117,Marshall,Kansas,2016,1072,3307,294,4673,0.22940295313503103,0.7076824309865183,0.06291461587845068,-397,185,112,-100,-0.078369936033207,0.040077825599799936,0.03829211043340708,-2235,-509,-0.4782794778514873,-0.1166620464666141
4589,20119,Meade,Kansas,2000,400,1604,49,2053,0.1948368241597662,0.7812956648806625,0.023867510959571358,0,0,0,0,0.0,0.0,0.0,-1204,0,-0.5864588407208963,0.0
4590,20119,Meade,Kansas,2004,356,1748,17,2121,0.16784535596416786,0.8241395568128241,0.008015087223008015,-44,-32,144,68,-0.026991468195598334,-0.015852423736563342,0.04284389193216165,-1392,-188,-0.6562942008486563,-0.06983536012776004
4591,20119,Meade,Kansas,2008,357,1540,34,1931,0.18487830139823924,0.797514241325738,0.017607457276022784,1,17,-208,-190,0.017032945434071384,0.009592370053014769,-0.026625315487086132,-1183,209,-0.6126359399274988,0.04365826092115754
4592,20119,Meade,Kansas,2012,258,1428,23,1709,0.15096547688706846,0.8355763604447045,0.013458162668227034,-99,-11,-112,-222,-0.03391282451117078,-0.004149294607795751,0.03806211911896651,-1170,13,-0.6846108835576361,-0.07197494363013734
4593,20119,Meade,Kansas,2016,210,1415,107,1732,0.12124711316397228,0.8169745958429562,0.0617782909930716,-48,84,-13,23,-0.029718363723096178,0.048320128324844565,-0.01860176460174834,-1205,-35,-0.6957274826789839,-0.01111659912134777
4594,20121,Miami,Kansas,2000,4554,6611,442,11607,0.39234944430085295,0.5695700870164556,0.03808046868269148,0,0,0,0,0.0,0.0,0.0,-2057,0,-0.17722064271560267,0.0
4595,20121,Miami,Kansas,2004,4838,9013,165,14016,0.3451769406392694,0.643050799086758,0.011772260273972603,284,-277,2402,2409,-0.04717250366158354,-0.026308208408718878,0.07348071207030238,-4175,-2118,-0.2978738584474886,-0.12065321573188592
4596,20121,Miami,Kansas,2008,5742,9382,253,15377,0.3734148403459713,0.6101320153475971,0.016453144306431685,904,88,369,1361,0.028237899706701874,0.004680884032459082,-0.032918783739160906,-3640,535,-0.2367171750016258,0.06115668344586278
4597,20121,Miami,Kansas,2012,4712,9858,286,14856,0.31717824448034465,0.6635702746365105,0.019251480883144857,-1030,33,476,-521,-0.056236595865626626,0.0027983365767131722,0.05343825928891344,-5146,-1506,-0.3463920301561659,-0.10967485515454006
4598,20121,Miami,Kansas,2016,3991,10003,1028,15022,0.2656770070563174,0.6658900279589934,0.06843296498468912,-721,742,145,166,-0.051501237424027235,0.049181484101544264,0.0023197533224829092,-6012,-866,-0.400213020902676,-0.053820990746510144
4599,20123,Mitchell,Kansas,2000,751,2350,165,3266,0.2299448867115738,0.7195345988977342,0.05052051439069198,0,0,0,0,0.0,0.0,0.0,-1599,0,-0.48958971218616043,0.0
4600,20123,Mitchell,Kansas,2004,693,2609,47,3349,0.20692744102717228,0.7790385189608838,0.014034040011943864,-58,-118,259,83,-0.023017445684401505,-0.03648647437874812,0.05950392006314964,-1916,-317,-0.5721110779337115,-0.08252136574755109
4601,20123,Mitchell,Kansas,2008,701,2440,62,3203,0.21885732126131752,0.7617858257883234,0.01935685295035904,8,15,-169,-146,0.011929880234145235,0.005322812938415175,-0.017252693172560396,-1739,177,-0.5429285045270059,0.029182573406705603
4602,20123,Mitchell,Kansas,2012,584,2327,54,2965,0.196964586846543,0.784822934232715,0.01821247892074199,-117,-8,-113,-238,-0.021892734414774517,-0.0011443740296170485,0.023037108444391552,-1743,-4,-0.587858347386172,-0.044929842859166125
4603,20123,Mitchell,Kansas,2016,477,2308,157,2942,0.16213460231135282,0.7845003399048266,0.05336505778382053,-107,103,-19,-23,-0.03482998453519018,0.03515257886307854,-0.0003225943278883925,-1831,-88,-0.6223657375934738,-0.03450739020730176
4604,20125,Montgomery,Kansas,2000,4770,8496,479,13745,0.34703528555838487,0.6181156784285194,0.03484903601309567,0,0,0,0,0.0,0.0,0.0,-3726,0,-0.2710803928701346,0.0
4605,20125,Montgomery,Kansas,2004,4338,9598,180,14116,0.30731085293284216,0.679937659393596,0.012751487673561915,-432,-299,1102,371,-0.039724432625542705,-0.022097548339533757,0.06182198096507652,-5260,-1534,-0.3726268064607538,-0.10154641359061922
4606,20125,Montgomery,Kansas,2008,4338,9309,260,13907,0.3119292442654778,0.6693751348241893,0.018695620910332927,0,80,-289,-209,0.004618391332635641,0.0059441332367710115,-0.01056252456940665,-4971,289,-0.3574458905587115,0.015180915902042291
4607,20125,Montgomery,Kansas,2012,3501,8630,286,12417,0.2819521623580575,0.6950148989288878,0.023032938713054684,-837,26,-679,-1490,-0.029977081907420322,0.004337317802721757,0.02563976410469848,-5129,-158,-0.4130627365708303,-0.055616846012118804
4608,20125,Montgomery,Kansas,2016,2637,8679,688,12004,0.21967677440853048,0.7230089970009996,0.05731422859046984,-864,402,49,-413,-0.062275387949527,0.03428128987741516,0.02799409807211184,-6042,-913,-0.5033322225924691,-0.09026948602163881
4609,20127,Morris,Kansas,2000,882,1599,160,2641,0.3339644074214313,0.6054524801211663,0.0605831124574025,0,0,0,0,0.0,0.0,0.0,-717,0,-0.27148807269973496,0.0
4610,20127,Morris,Kansas,2004,931,1961,44,2936,0.3170980926430518,0.6679155313351499,0.014986376021798364,49,-116,362,295,-0.01686631477837952,-0.045596736435604135,0.062463051213983656,-1030,-313,-0.35081743869209814,-0.07932936599236318
4611,20127,Morris,Kansas,2008,907,1875,59,2841,0.3192537838789159,0.6599788806758183,0.020767335445265753,-24,15,-86,-95,0.002155691235864121,0.005780959423467388,-0.007936650659331579,-968,62,-0.34072509679690244,0.0100923418951957
4612,20127,Morris,Kansas,2012,718,1773,71,2562,0.28024980483996875,0.6920374707259953,0.02771272443403591,-189,12,-102,-279,-0.039003979038947145,0.006945388988770156,0.03205859005017697,-1055,-87,-0.41178766588602655,-0.07106256908912412
4613,20127,Morris,Kansas,2016,601,1820,203,2624,0.22903963414634146,0.6935975609756098,0.07736280487804878,-117,132,47,62,-0.051210170693627294,0.04965008044401287,0.0015600902496144542,-1219,-164,-0.46455792682926833,-0.052770260943241776
4614,20129,Morton,Kansas,2000,321,1203,33,1557,0.20616570327552985,0.7726396917148363,0.02119460500963391,0,0,0,0,0.0,0.0,0.0,-882,0,-0.5664739884393064,0.0
4615,20129,Morton,Kansas,2004,276,1287,13,1576,0.1751269035532995,0.8166243654822335,0.008248730964467006,-45,-20,84,19,-0.031038799722230365,-0.012945874045166905,0.04398467376739723,-1011,-129,-0.641497461928934,-0.07502347348962757
4616,20129,Morton,Kansas,2008,229,1153,20,1402,0.16333808844507847,0.8223965763195435,0.014265335235378032,-47,7,-134,-174,-0.011788815108221024,0.006016604270911026,0.0057722108373100545,-924,87,-0.6590584878744651,-0.017561025945531106
4617,20129,Morton,Kansas,2012,189,1072,17,1278,0.14788732394366197,0.838810641627543,0.013302034428794992,-40,-3,-81,-124,-0.015450764501416497,-0.0009633008065830402,0.016414065307999492,-883,41,-0.690923317683881,-0.03186482980941596
4618,20129,Morton,Kansas,2016,147,995,50,1192,0.12332214765100671,0.834731543624161,0.04194630872483222,-42,33,-77,-86,-0.024565176292655255,0.028644274296037227,-0.00407909800338202,-848,35,-0.7114093959731543,-0.02048607828927329
4619,20131,Nemaha,Kansas,2000,1494,3578,218,5290,0.2824196597353497,0.6763705103969754,0.04120982986767486,0,0,0,0,0.0,0.0,0.0,-2084,0,-0.39395085066162566,0.0
4620,20131,Nemaha,Kansas,2004,1355,4027,81,5463,0.24803221673073403,0.7371407651473549,0.014827018121911038,-139,-137,449,173,-0.034387443004615686,-0.02638281174576382,0.06077025475037956,-2672,-588,-0.4891085484166209,-0.09515769775499522
4621,20131,Nemaha,Kansas,2008,1432,3817,110,5359,0.26721403246874414,0.7122597499533495,0.020526217577906326,77,29,-210,-104,0.019181815738010116,0.005699199455995289,-0.02488101519400543,-2385,287,-0.44504571748460536,0.04406283093201552
4622,20131,Nemaha,Kansas,2012,1000,3930,96,5026,0.19896538002387584,0.781933943493832,0.01910067648229208,-432,-14,113,-333,-0.0682486524448683,-0.0014255410956142446,0.06967419354048254,-2930,-545,-0.5829685634699562,-0.13792284598535082
4623,20131,Nemaha,Kansas,2016,725,4124,273,5122,0.14154627098789535,0.8051542366263178,0.0532994923857868,-275,177,194,96,-0.05741910903598049,0.03419881590349472,0.023220293132485748,-3399,-469,-0.6636079656384224,-0.08063940216846621
4624,20133,Neosho,Kansas,2000,2588,4014,284,6886,0.3758350275922161,0.5829218704618065,0.04124310194597734,0,0,0,0,0.0,0.0,0.0,-1426,0,-0.20708684286959045,0.0
4625,20133,Neosho,Kansas,2004,2424,4705,102,7231,0.3352233439358318,0.6506707232747891,0.014105932789379062,-164,-182,691,345,-0.04061168365638429,-0.02713716915659828,0.0677488528129826,-2281,-855,-0.31544737933895733,-0.10836053646936689
4626,20133,Neosho,Kansas,2008,2563,4473,156,7192,0.35636818687430477,0.6219410456062291,0.021690767519466074,139,54,-232,-39,0.021144842938472963,0.007584834730087012,-0.02872967766856005,-1910,371,-0.2655728587319243,0.04987452060703301
4627,20133,Neosho,Kansas,2012,2050,4272,158,6480,0.31635802469135804,0.6592592592592592,0.024382716049382715,-513,2,-201,-712,-0.04001016218294673,0.0026919485299166414,0.03731821365303012,-2222,-312,-0.34290123456790117,-0.07732837583597685
4628,20133,Neosho,Kansas,2016,1501,4431,382,6314,0.23772568894520113,0.7017738359201774,0.06050047513462148,-549,224,159,-166,-0.07863233574615691,0.03611775908523876,0.04251457666091818,-2930,-708,-0.46404814697497626,-0.12114691240707509
4629,20135,Ness,Kansas,2000,383,1420,73,1876,0.20415778251599148,0.7569296375266524,0.03891257995735608,0,0,0,0,0.0,0.0,0.0,-1037,0,-0.552771855010661,0.0
4630,20135,Ness,Kansas,2004,382,1407,29,1818,0.21012101210121012,0.7739273927392739,0.01595159515951595,-1,-44,-13,-58,0.005963229585218638,-0.022960984797840128,0.01699775521262148,-1025,12,-0.5638063806380638,-0.011034525627402814
4631,20135,Ness,Kansas,2008,289,1207,29,1525,0.18950819672131147,0.7914754098360656,0.01901639344262295,-93,0,-200,-293,-0.020612815379898647,0.003064798283107,0.017548017096791657,-918,107,-0.6019672131147541,-0.03816083247669033
4632,20135,Ness,Kansas,2012,218,1209,17,1444,0.15096952908587258,0.8372576177285319,0.011772853185595568,-71,-12,2,-81,-0.038538667635438895,-0.0072435402570273835,0.04578220789246634,-991,-73,-0.6862880886426593,-0.08432087552790524
4633,20135,Ness,Kansas,2016,162,1228,64,1454,0.11141678129298486,0.844566712517194,0.04401650618982118,-56,47,19,10,-0.03955274779288771,0.03224365300422562,0.0073090947886620405,-1066,-75,-0.7331499312242091,-0.046861842581549795
4634,20137,Norton,Kansas,2000,598,1744,109,2451,0.24398204814361485,0.711546307629539,0.044471644226846185,0,0,0,0,0.0,0.0,0.0,-1146,0,-0.4675642594859241,0.0
4635,20137,Norton,Kansas,2004,473,2092,34,2599,0.1819930742593305,0.8049249711427472,0.013081954597922277,-125,-75,348,148,-0.06198897388428434,-0.03138968962892391,0.09337866351320823,-1619,-473,-0.6229318968834167,-0.15536763739749254
4636,20137,Norton,Kansas,2008,497,1878,40,2415,0.20579710144927535,0.7776397515527951,0.016563146997929608,24,6,-214,-184,0.023804027189944843,0.0034811924000073304,-0.027285219589952114,-1381,238,-0.5718426501035198,0.0510892467798969
4637,20137,Norton,Kansas,2012,398,1878,49,2325,0.17118279569892472,0.807741935483871,0.021075268817204302,-99,9,0,-90,-0.03461430575035063,0.004512121819274694,0.030102183931075888,-1480,-99,-0.6365591397849463,-0.06471648968142651
4638,20137,Norton,Kansas,2016,281,1840,113,2234,0.12578334825425247,0.8236347358997315,0.050581915846016116,-117,64,-38,-91,-0.04539944744467225,0.029506647028811814,0.015892800415860497,-1559,-79,-0.697851387645479,-0.06129224786053278
4639,20139,Osage,Kansas,2000,2530,3770,313,6613,0.3825797671253591,0.5700892182065628,0.04733101466807803,0,0,0,0,0.0,0.0,0.0,-1240,0,-0.18750945108120365,0.0
4640,20139,Osage,Kansas,2004,2537,4800,126,7463,0.3399437223636607,0.6431729867345571,0.016883290901782127,7,-187,1030,850,-0.04263604476169841,-0.0304477237662959,0.07308376852799436,-2263,-1023,-0.3032292643708964,-0.11571981328969277
4641,20139,Osage,Kansas,2008,2534,4820,190,7544,0.33589607635206786,0.6389183457051962,0.02518557794273595,-3,64,20,81,-0.004047646011592854,0.008302287040953822,-0.004254641029360906,-2286,-23,-0.30302226935312837,0.0002069950177680524
4642,20139,Osage,Kansas,2012,2268,4427,211,6906,0.32841007819287577,0.6410367796119316,0.030553142195192586,-266,21,-393,-638,-0.007485998159192098,0.005367564252456637,0.002118433906735384,-2159,127,-0.31262670141905585,-0.009604432065927482
4643,20139,Osage,Kansas,2016,1753,4826,467,7046,0.24879364178257168,0.6849276185069543,0.06627873971047403,-515,256,399,140,-0.07961643641030408,0.03572559751528144,0.043890838895022655,-3073,-914,-0.4361339767243826,-0.12350727530532674
4644,20141,Osborne,Kansas,2000,484,1432,114,2030,0.23842364532019705,0.7054187192118226,0.0561576354679803,0,0,0,0,0.0,0.0,0.0,-948,0,-0.4669950738916256,0.0
4645,20141,Osborne,Kansas,2004,454,1587,34,2075,0.21879518072289156,0.7648192771084338,0.0163855421686747,-30,-80,155,45,-0.019628464597305495,-0.0397720932993056,0.05940055789661114,-1133,-185,-0.5460240963855423,-0.07902902249391669
4646,20141,Osborne,Kansas,2008,403,1490,37,1930,0.20880829015544042,0.772020725388601,0.01917098445595855,-51,3,-97,-145,-0.00998689056745114,0.002785442287283852,0.007201448280167222,-1087,46,-0.5632124352331606,-0.01718833884761828
4647,20141,Osborne,Kansas,2012,324,1479,35,1838,0.176278563656148,0.8046789989118607,0.019042437431991296,-79,-2,-11,-92,-0.03252972649929242,-0.00012854702396725495,0.03265827352325967,-1155,-68,-0.6284004352557127,-0.0651880000225521
4648,20141,Osborne,Kansas,2016,233,1460,95,1788,0.1303131991051454,0.8165548098434005,0.053131991051454136,-91,60,-19,-50,-0.045965364551002585,0.03408955361946284,0.011875810931539776,-1227,-72,-0.6862416107382551,-0.05784117548254242
4649,20143,Ottawa,Kansas,2000,631,1977,183,2791,0.22608384091723396,0.7083482622715872,0.06556789681117879,0,0,0,0,0.0,0.0,0.0,-1346,0,-0.4822644213543532,0.0
4650,20143,Ottawa,Kansas,2004,595,2333,43,2971,0.2002692696061932,0.7852574890609223,0.014473241332884551,-36,-140,356,180,-0.025814571311040757,-0.05109465547829424,0.0769092267893351,-1738,-392,-0.5849882194547291,-0.10272379810037591
4651,20143,Ottawa,Kansas,2008,704,2323,59,3086,0.22812702527543746,0.7527543745949449,0.01911860012961763,109,16,-10,115,0.027857755669244255,0.0046453587967330776,-0.03250311446597742,-1619,119,-0.5246273493195074,0.060360870135221734
4652,20143,Ottawa,Kansas,2012,558,2295,80,2933,0.1902488919195363,0.7824752812819639,0.02727582679849983,-146,21,-28,-153,-0.03787813335590115,0.0081572266688822,0.02972090668701899,-1737,-118,-0.5922263893624276,-0.06759904004292017
4653,20143,Ottawa,Kansas,2016,424,2283,196,2903,0.14605580434033757,0.7864278332759215,0.06751636238374095,-134,116,-12,-30,-0.04419308757919874,0.04024053558524113,0.003952551993957609,-1859,-122,-0.6403720289355839,-0.04814563957315632
4654,20145,Pawnee,Kansas,2000,968,1850,122,2940,0.3292517006802721,0.6292517006802721,0.04149659863945578,0,0,0,0,0.0,0.0,0.0,-882,0,-0.30000000000000004,0.0
4655,20145,Pawnee,Kansas,2004,773,2172,43,2988,0.25870147255689424,0.7269076305220884,0.014390896921017403,-195,-79,322,48,-0.07055022812337786,-0.02710570171843838,0.09765592984181626,-1399,-517,-0.46820615796519416,-0.16820615796519411
4656,20145,Pawnee,Kansas,2008,882,1946,51,2879,0.30635637374088226,0.6759291420632164,0.017714484195901353,109,8,-226,-109,0.04765490118398802,0.00332358727488395,-0.050978488458871984,-1064,335,-0.36957276832233416,0.09863338964286
4657,20145,Pawnee,Kansas,2012,718,1836,54,2608,0.2753067484662577,0.7039877300613497,0.020705521472392636,-164,3,-110,-271,-0.03104962527462457,0.002991037276491283,0.028058587998133322,-1118,-54,-0.42868098159509205,-0.05910821327275789
4658,20145,Pawnee,Kansas,2016,579,1904,178,2661,0.21758737316798196,0.7155204810221721,0.06689214580984593,-139,124,68,53,-0.05771937529827573,0.04618662433745329,0.011532750960822402,-1325,-207,-0.4979331078541902,-0.06925212625909816
4659,20147,Phillips,Kansas,2000,611,2057,124,2792,0.21883954154727794,0.7367478510028653,0.044412607449856735,0,0,0,0,0.0,0.0,0.0,-1446,0,-0.5179083094555874,0.0
4660,20147,Phillips,Kansas,2004,557,2256,34,2847,0.19564453811029153,0.7924130663856691,0.01194239550403934,-54,-90,199,55,-0.02319500343698641,-0.032470211945817395,0.05566521538280378,-1699,-253,-0.5967685282753776,-0.07886021881979022
4661,20147,Phillips,Kansas,2008,525,2105,37,2667,0.1968503937007874,0.7892763404574428,0.013873265841769778,-32,3,-151,-180,0.00120585559049588,0.0019308703377304386,-0.003136725928226336,-1580,119,-0.5924259467566554,0.004342581518722244
4662,20147,Phillips,Kansas,2012,382,2135,48,2565,0.14892787524366471,0.8323586744639376,0.01871345029239766,-143,11,30,-102,-0.0479225184571227,0.004840184450627883,0.04308233400649486,-1753,-173,-0.6834307992202729,-0.09100485246361756
4663,20147,Phillips,Kansas,2016,300,2233,131,2664,0.11261261261261261,0.8382132132132132,0.049174174174174176,-82,83,98,99,-0.0363152626310521,0.030460723881776515,0.005854538749275551,-1933,-180,-0.7256006006006006,-0.042169801380327665
4664,20149,Pottawatomie,Kansas,2000,2037,4985,709,7731,0.26348467209934034,0.6448066226878799,0.09170870521277971,0,0,0,0,0.0,0.0,0.0,-2948,0,-0.38132195058853957,0.0
4665,20149,Pottawatomie,Kansas,2004,2176,6326,321,8823,0.2466281310211946,0.7169896860478295,0.03638218293097586,139,-388,1341,1092,-0.016856541078145743,-0.055326522281803854,0.07218306335994962,-4150,-1202,-0.4703615550266349,-0.08903960443809533
4666,20149,Pottawatomie,Kansas,2008,2599,6929,349,9877,0.26313657993317807,0.7015288042928015,0.03533461577402045,423,28,603,1054,0.01650844891198347,-0.0010475671569554063,-0.015460881755028022,-4330,-180,-0.43839222435962344,0.031969330667011464
4667,20149,Pottawatomie,Kansas,2012,2335,6804,340,9479,0.24633400147694903,0.7177972359953582,0.0358687625276928,-264,-9,-125,-398,-0.01680257845622904,0.000534146753672346,0.01626843170255665,-4469,-139,-0.4714632345184091,-0.03307101015878566
4668,20149,Pottawatomie,Kansas,2016,2225,7612,856,10693,0.2080800523707098,0.71186757691948,0.08005237070981015,-110,516,808,1214,-0.03825394910623922,0.044183608182117355,-0.005929659075878169,-5387,-918,-0.5037875245487702,-0.03232429003036108
4669,20151,Pratt,Kansas,2000,1314,2885,217,4416,0.297554347826087,0.6533061594202898,0.04913949275362319,0,0,0,0,0.0,0.0,0.0,-1571,0,-0.3557518115942028,0.0
4670,20151,Pratt,Kansas,2004,1200,3121,63,4384,0.2737226277372263,0.7119069343065694,0.01437043795620438,-114,-154,236,-32,-0.023831720088860697,-0.03476905479741881,0.05860077488627957,-1921,-350,-0.4381843065693431,-0.08243249497514027
4671,20151,Pratt,Kansas,2008,1294,2822,74,4190,0.3088305489260143,0.673508353221957,0.01766109785202864,94,11,-299,-194,0.03510792118878803,0.00329065989582426,-0.03839858108461236,-1528,393,-0.3646778042959427,0.07350650227340039
4672,20151,Pratt,Kansas,2012,980,2771,50,3801,0.2578268876611418,0.7290186792949224,0.013154433043935806,-314,-24,-51,-389,-0.05100366126487249,-0.004506664808092833,0.055510326072965355,-1791,-263,-0.47119179163378055,-0.10651398733783785
4673,20151,Pratt,Kansas,2016,771,2838,233,3842,0.20067673086933888,0.7386777719937533,0.06064549713690786,-209,183,67,41,-0.057150156791802936,0.04749106409297205,0.009659092698830918,-2067,-276,-0.5380010411244144,-0.06680924949063383
4674,20153,Rawlins,Kansas,2000,306,1349,85,1740,0.17586206896551723,0.7752873563218391,0.04885057471264368,0,0,0,0,0.0,0.0,0.0,-1043,0,-0.5994252873563218,0.0
4675,20153,Rawlins,Kansas,2004,289,1414,17,1720,0.1680232558139535,0.8220930232558139,0.009883720930232558,-17,-68,65,-20,-0.007838813151563734,-0.038966853782411125,0.04680566693397481,-1125,-82,-0.6540697674418604,-0.05464448008553857
4676,20153,Rawlins,Kansas,2008,273,1247,29,1549,0.1762427372498386,0.8050355067785668,0.01872175597159458,-16,12,-167,-171,0.008219481435885106,0.00883803504136202,-0.01705751647724707,-974,151,-0.6287927695287282,0.025276997913132204
4677,20153,Rawlins,Kansas,2012,190,1223,31,1444,0.13157894736842105,0.8469529085872576,0.02146814404432133,-83,2,-24,-105,-0.04466378988141756,0.0027463880727267506,0.041917401808690746,-1033,-59,-0.7153739612188366,-0.08658119169010836
4678,20153,Rawlins,Kansas,2016,163,1220,89,1472,0.11073369565217392,0.8288043478260869,0.06046195652173913,-27,58,-3,28,-0.020845251716247126,0.0389938124774178,-0.018148560761170662,-1057,-24,-0.718070652173913,-0.0026966909550764084
4679,20155,Reno,Kansas,2000,9025,15179,1226,25430,0.3548957923712151,0.5968934329532048,0.04821077467558002,0,0,0,0,0.0,0.0,0.0,-6154,0,-0.24199764058198975,0.0
4680,20155,Reno,Kansas,2004,9114,17748,462,27324,0.33355292050944224,0.6495388669301713,0.016908212560386472,89,-764,2569,1894,-0.02134287186177286,-0.03130256211519355,0.052645433976966416,-8634,-2480,-0.315985946420729,-0.07398830583873928
4681,20155,Reno,Kansas,2008,9916,16112,574,26602,0.37275392827606946,0.6056687467107736,0.021577325013156904,802,112,-1636,-722,0.039201007766627216,0.004669112452770432,-0.043870120219397624,-6196,2438,-0.23291481843470419,0.08307112798602484
4682,20155,Reno,Kansas,2012,8085,15718,619,24422,0.3310539677340103,0.6436000327573499,0.02534599950863975,-1831,45,-394,-2180,-0.041699960542059156,0.0037686744954828454,0.03793128604657625,-7633,-1437,-0.3125460650233396,-0.07963124658863541
4683,20155,Reno,Kansas,2016,6837,15513,2186,24536,0.27865177698076293,0.632254646234105,0.08909357678513205,-1248,1567,-205,114,-0.05240219075324737,0.0637475772764923,-0.011345386523244905,-8676,-1043,-0.35360286925334206,-0.041056804230002464
4684,20157,Republic,Kansas,2000,604,2239,142,2985,0.20234505862646565,0.7500837520938023,0.047571189279731994,0,0,0,0,0.0,0.0,0.0,-1635,0,-0.5477386934673366,0.0
4685,20157,Republic,Kansas,2004,607,2238,44,2889,0.21010730356524748,0.77466251298027,0.01523018345448252,3,-98,-1,-96,0.0077622449387818315,-0.03234100582524947,0.02457876088646771,-1631,4,-0.5645552094150226,-0.01681651594768596
4686,20157,Republic,Kansas,2008,640,1978,53,2671,0.23961063272182703,0.7405466117558966,0.019842755522276302,33,9,-260,-218,0.02950332915657955,0.0046125720677937816,-0.03411590122437336,-1338,293,-0.5009359790340696,0.06361923038095296
4687,20157,Republic,Kansas,2012,477,2134,75,2686,0.17758749069247953,0.7944899478778853,0.027922561429635145,-163,22,156,15,-0.0620231420293475,0.008079805907358843,0.05394333612198865,-1657,-319,-0.6169024571854058,-0.1159664781513362
4688,20157,Republic,Kansas,2016,375,2024,130,2529,0.14827995255041518,0.8003163305654409,0.051403716884143934,-102,55,-110,-157,-0.029307538142064354,0.02348115545450879,0.005826382687555642,-1649,8,-0.6520363780150258,-0.03513392082961997
4689,20159,Rice,Kansas,2000,1422,2903,195,4520,0.3146017699115044,0.6422566371681416,0.04314159292035398,0,0,0,0,0.0,0.0,0.0,-1481,0,-0.32765486725663723,0.0
4690,20159,Rice,Kansas,2004,1130,3182,64,4376,0.25822669104204754,0.7271480804387569,0.014625228519195612,-292,-131,279,-144,-0.05637507886945686,-0.028516364401158366,0.08489144327061526,-2052,-571,-0.46892138939670935,-0.14126652214007213
4691,20159,Rice,Kansas,2008,1163,2780,78,4021,0.2892315344441681,0.6913703058940562,0.019398159661775678,33,14,-402,-355,0.031004843402120563,0.004772931142580065,-0.03577777454470066,-1617,435,-0.40213877144988813,0.06678261794682122
4692,20159,Rice,Kansas,2012,911,2676,94,3681,0.24748709589785384,0.7269763651181744,0.025536538983971745,-252,16,-104,-340,-0.041744438546314266,0.006138379322196068,0.03560605922411819,-1765,-148,-0.4794892692203206,-0.07735049777043246
4693,20159,Rice,Kansas,2016,695,2837,272,3804,0.1827024185068349,0.7457939011566772,0.07150368033648791,-216,178,161,123,-0.06478467739101892,0.04596714135251616,0.01881753603850278,-2142,-377,-0.5630914826498423,-0.08360221342952173
4694,20161,Riley,Kansas,2000,6188,10672,1393,18253,0.3390127650249274,0.584671012984167,0.07631622199090561,0,0,0,0,0.0,0.0,0.0,-4484,0,-0.24565824795923963,0.0
4695,20161,Riley,Kansas,2004,7908,12672,331,20911,0.3781741667065181,0.6059968437664387,0.01582898952704318,1720,-1062,2000,2658,0.03916140168159071,-0.06048723246386243,0.021325830782271682,-4764,-280,-0.2278226770599206,0.01783557089931903
4696,20161,Riley,Kansas,2008,10495,12111,494,23100,0.4543290043290043,0.5242857142857142,0.021385281385281386,2587,163,-561,2189,0.0761548376224862,0.005556291858238204,-0.08171112948072445,-1616,3148,-0.06995670995670994,0.15786596710321066
4697,20161,Riley,Kansas,2012,8977,11507,617,21101,0.42543007440405667,0.5453296052319795,0.029240320363963793,-1518,123,-604,-1999,-0.028898929924947636,0.007855038978682408,0.021043890946265242,-2530,-914,-0.11989953082792282,-0.04994282087121288
4698,20161,Riley,Kansas,2016,9341,10107,2526,21974,0.4250932920724493,0.45995267133885503,0.11495403658869573,364,1909,-1400,873,-0.00033678233160738813,0.08571371622473194,-0.08537693389312445,-766,1764,-0.034859379266405754,0.08504015156151706
4699,20163,Rooks,Kansas,2000,597,2016,162,2775,0.21513513513513513,0.7264864864864865,0.05837837837837838,0,0,0,0,0.0,0.0,0.0,-1419,0,-0.5113513513513513,0.0
4700,20163,Rooks,Kansas,2004,534,2121,55,2710,0.1970479704797048,0.7826568265682656,0.02029520295202952,-63,-107,105,-65,-0.018087164655430338,-0.038083175426348856,0.056170340081779124,-1587,-168,-0.5856088560885608,-0.07425750473720949
4701,20163,Rooks,Kansas,2008,468,2068,52,2588,0.18083462132921174,0.7990726429675425,0.02009273570324575,-66,-3,-53,-122,-0.01621334915049305,-0.0002024672487837692,0.016415816399276917,-1600,-13,-0.6182380216383307,-0.03262916554976991
4702,20163,Rooks,Kansas,2012,361,2038,61,2460,0.1467479674796748,0.8284552845528456,0.024796747967479674,-107,9,-30,-128,-0.034086653849536935,0.004704012264233923,0.029382641585303015,-1677,-77,-0.6817073170731708,-0.06346929543484003
4703,20163,Rooks,Kansas,2016,275,2031,113,2419,0.11368334022323275,0.8396031417941298,0.046713517982637454,-86,52,-7,-41,-0.03306462725644206,0.02191677001515778,0.011147857241284198,-1756,-79,-0.725919801570897,-0.04421248449772619
4704,20165,Rush,Kansas,2000,505,1235,114,1854,0.27238403451995685,0.6661272923408845,0.061488673139158574,0,0,0,0,0.0,0.0,0.0,-730,0,-0.3937432578209277,0.0
4705,20165,Rush,Kansas,2004,517,1226,46,1789,0.2889882615986585,0.6852990497484628,0.025712688652878703,12,-68,-9,-65,0.016604227078701628,-0.035775984486279874,0.01917175740757826,-709,21,-0.3963107881498043,-0.0025675303288766327
4706,20165,Rush,Kansas,2008,504,1225,52,1781,0.28298708590679394,0.6878158338012352,0.029197080291970802,-13,6,-1,-8,-0.006001175691864535,0.0034843916390920986,0.002516784052772447,-721,-12,-0.4048287478944413,-0.008517959744636983
4707,20165,Rush,Kansas,2012,367,1166,37,1570,0.2337579617834395,0.7426751592356687,0.02356687898089172,-137,-15,-59,-211,-0.04922912412335445,-0.0056302013110790805,0.054859325434433504,-799,-78,-0.5089171974522293,-0.10408844955778801
4708,20165,Rush,Kansas,2016,233,1197,73,1503,0.1550232867598137,0.7964071856287425,0.04856952761144378,-134,36,31,-67,-0.0787346750236258,0.025002648630552057,0.05373202639307373,-964,-165,-0.6413838988689288,-0.13246670141669947
4709,20167,Russell,Kansas,2000,886,2434,162,3482,0.25445146467547386,0.6990235496840896,0.04652498564043653,0,0,0,0,0.0,0.0,0.0,-1548,0,-0.4445720850086158,0.0
4710,20167,Russell,Kansas,2004,810,2671,44,3525,0.2297872340425532,0.7577304964539007,0.0124822695035461,-76,-118,237,43,-0.02466423063292067,-0.03404271613689043,0.05870694676981103,-1861,-313,-0.5279432624113475,-0.0833711774027317
4711,20167,Russell,Kansas,2008,736,2509,48,3293,0.22350440327968418,0.7619192225933799,0.014576374126935925,-74,4,-162,-232,-0.006282830762869007,0.0020941046233898253,0.004188726139479182,-1773,88,-0.5384148193136957,-0.010471556902348245
4712,20167,Russell,Kansas,2012,593,2553,54,3200,0.1853125,0.7978125,0.016875,-143,6,44,-93,-0.03819190327968419,0.002298625873064076,0.03589327740662018,-1960,-187,-0.6125,-0.07408518068630432
4713,20167,Russell,Kansas,2016,461,2574,158,3193,0.14437832759160665,0.8061384278108362,0.04948324459755716,-132,104,21,-7,-0.04093417240839334,0.03260824459755716,0.008325927810836187,-2113,-153,-0.6617601002192296,-0.04926010021922955
4714,20169,Saline,Kansas,2000,7487,12412,1628,21527,0.3477957913318159,0.5765782505690528,0.07562595809913132,0,0,0,0,0.0,0.0,0.0,-4925,0,-0.2287824592372369,0.0
4715,20169,Saline,Kansas,2004,7524,15111,406,23041,0.32654832689553404,0.6558309101167484,0.017620762987717548,37,-1222,2699,1514,-0.021247464436281838,-0.058005195111413776,0.07925265954769567,-7587,-2662,-0.3292825832212144,-0.10050012398397751
4716,20169,Saline,Kansas,2008,8186,14165,437,22788,0.35922415306301564,0.6215990872388977,0.01917675969808671,662,31,-946,-253,0.0326758261674816,0.0015559967103691633,-0.03423182287785076,-5979,1608,-0.26237493417588204,0.06690764904533236
4717,20169,Saline,Kansas,2012,7040,13840,616,21496,0.3275027912169706,0.6438407145515445,0.028656494231484926,-1146,179,-325,-1292,-0.031721361846045015,0.009479734533398215,0.022241627312646783,-6800,-821,-0.31633792333457383,-0.0539629891586918
4718,20169,Saline,Kansas,2016,6317,13828,1919,22064,0.2863034807831762,0.6267222625090645,0.08697425670775924,-723,1303,-12,568,-0.041199310433794434,0.058317762476274314,-0.01711845204247997,-7511,-711,-0.3404187817258883,-0.024080858391314464
4719,20171,Scott,Kansas,2000,418,1811,74,2303,0.18150238818931827,0.7863656100738168,0.03213200173686496,0,0,0,0,0.0,0.0,0.0,-1393,0,-0.6048632218844985,0.0
4720,20171,Scott,Kansas,2004,347,1924,28,2299,0.1509351892127012,0.8368856024358416,0.012179208351457155,-71,-46,113,-4,-0.030567198976617083,-0.019952793385407803,0.05051999236202487,-1577,-184,-0.6859504132231404,-0.08108719133864195
4721,20171,Scott,Kansas,2008,321,1823,35,2179,0.14731528223955942,0.8366223038090868,0.016062413951353834,-26,7,-101,-120,-0.0036199069731417677,0.003883205599896678,-0.00026329862675489313,-1502,75,-0.6893070215695274,-0.003356608346386958
4722,20171,Scott,Kansas,2012,277,1728,47,2052,0.13499025341130605,0.8421052631578947,0.02290448343079922,-44,12,-95,-127,-0.01232502882825337,0.006842069479445385,0.0054829593488079365,-1451,51,-0.7071150097465886,-0.017807988177061196
4723,20171,Scott,Kansas,2016,236,1865,101,2202,0.10717529518619437,0.8469573115349682,0.04586739327883742,-41,54,137,150,-0.02781495822511168,0.0229629098480382,0.004852048377073537,-1629,-178,-0.7397820163487738,-0.032667006602185245
4724,20173,Sedgwick,Kansas,2000,62561,93724,7132,163417,0.38283042767888287,0.5735266220772625,0.04364295024385468,0,0,0,0,0.0,0.0,0.0,-31163,0,-0.1906961943983796,0.0
4725,20173,Sedgwick,Kansas,2004,64839,110381,2459,177679,0.36492213486118225,0.6212383005307324,0.013839564608085367,2278,-4673,16657,14262,-0.017908292817700622,-0.029803385635769314,0.04771167845346991,-45542,-14379,-0.2563161656695501,-0.06561997127117053
4726,20173,Sedgwick,Kansas,2008,82337,106849,4544,193730,0.4250090331905229,0.5515356423888917,0.02345532442058535,17498,2085,-3532,16051,0.060086898329340666,0.009615759812499984,-0.06970265814184062,-24512,21030,-0.12652660919836883,0.1297895564711813
4727,20173,Sedgwick,Kansas,2012,71977,106506,4412,182895,0.39354274310396675,0.582334126137948,0.02412313075808524,-10360,-132,-343,-10835,-0.03146629008655616,0.0006678063374998891,0.03079848374905625,-34529,-10017,-0.18879138303398124,-0.06226477383561241
4728,20173,Sedgwick,Kansas,2016,69627,104353,17818,191798,0.36302255497971825,0.5440776233328815,0.09289982168740028,-2350,13406,-2153,8903,-0.030520188124248504,0.06877669092931504,-0.03825650280506654,-34726,-197,-0.1810550683531632,0.007736314680818035
4729,20175,Seward,Kansas,2000,1126,3869,101,5096,0.22095761381475668,0.7592229199372057,0.019819466248037678,0,0,0,0,0.0,0.0,0.0,-2743,0,-0.538265306122449,0.0
4730,20175,Seward,Kansas,2004,1122,4272,45,5439,0.20628792057363485,0.785438499724214,0.00827357970215113,-4,-56,403,343,-0.014669693241121828,-0.011545886545886548,0.02621557978700828,-3150,-407,-0.5791505791505791,-0.040885273028130054
4731,20175,Seward,Kansas,2008,1493,3791,52,5336,0.2797976011994003,0.7104572713643178,0.009745127436281859,371,7,-481,-103,0.07350968062576543,0.0014715477341307286,-0.07498122835989618,-2298,852,-0.4306596701649175,0.14849090898566158
4732,20175,Seward,Kansas,2012,1490,3617,69,5176,0.28786707882534773,0.6988021638330757,0.013330757341576507,-3,17,-174,-160,0.008069477625947452,0.003585629905294648,-0.011655107531242104,-2127,171,-0.41093508500772796,0.019724585157189556
4733,20175,Seward,Kansas,2016,1628,3159,251,5038,0.3231441048034934,0.6270345375148869,0.04982135768161969,138,182,-458,-138,0.03527702597814569,0.03649060034004318,-0.07176762631818878,-1531,596,-0.3038904327113935,0.10704465229633447
4734,20177,Shawnee,Kansas,2000,34818,35894,3661,74373,0.46815376547940785,0.4826213814152986,0.049224853105293585,0,0,0,0,0.0,0.0,0.0,-1076,0,-0.014467615935890743,0.0
4735,20177,Shawnee,Kansas,2004,36264,44188,1125,81577,0.4445370631427976,0.5416722850803535,0.013790651776848867,1446,-2536,8294,7204,-0.02361670233661023,-0.035434201328444714,0.05905090366505489,-7924,-6848,-0.09713522193755586,-0.08266760600166512
4736,20177,Shawnee,Kansas,2008,41235,41476,1839,84550,0.48769958604376107,0.49054997043169724,0.021750443524541693,4971,714,-2712,2973,0.04316252290096345,0.007959791747692825,-0.05112231464865624,-241,7683,-0.0028503843879361668,0.0942848375496197
4737,20177,Shawnee,Kansas,2012,36975,37782,1751,76508,0.48328279395618756,0.4938307105139332,0.022886495529879227,-4260,-88,-3694,-8042,-0.004416792087573507,0.0011360520053375345,0.0032807400822359445,-807,-566,-0.010547916557745618,-0.007697532169809451
4738,20177,Shawnee,Kansas,2016,33926,35934,6906,76766,0.4419404423833468,0.4680978558215877,0.08996170179506552,-3049,5155,-1848,258,-0.041342351572840774,0.06707520626518629,-0.025732854692345486,-2008,-1201,-0.026157413438240906,-0.015609496880495288
4739,20179,Sheridan,Kansas,2000,281,1132,76,1489,0.18871725990597715,0.7602417730020148,0.05104096709200806,0,0,0,0,0.0,0.0,0.0,-851,0,-0.5715245130960376,0.0
4740,20179,Sheridan,Kansas,2004,239,1144,23,1406,0.16998577524893316,0.813655761024182,0.016358463726884778,-42,-53,12,-83,-0.018731484657043995,-0.03468250336512328,0.053413988022167236,-905,-54,-0.6436699857752488,-0.07214547267921123
4741,20179,Sheridan,Kansas,2008,254,1108,14,1376,0.18459302325581395,0.8052325581395349,0.010174418604651164,15,-9,-36,-30,0.01460724800688079,-0.006184045122233615,-0.008423202884647152,-854,51,-0.6206395348837209,0.023030450891527887
4742,20179,Sheridan,Kansas,2012,168,1154,20,1342,0.12518628912071536,0.8599105812220567,0.014903129657228018,-86,6,46,-34,-0.05940673413509859,0.004728711052576854,0.05467802308252179,-986,-132,-0.7347242921013413,-0.11408475721762035
4743,20179,Sheridan,Kansas,2016,127,1197,50,1374,0.09243085880640466,0.87117903930131,0.036390101892285295,-41,30,43,32,-0.032755430314310705,0.02148697223505728,0.011268458079253363,-1070,-84,-0.7787481804949054,-0.04402388839356408
4744,20181,Sherman,Kansas,2000,681,1894,107,2682,0.2539149888143177,0.7061894108873975,0.039895600298284865,0,0,0,0,0.0,0.0,0.0,-1213,0,-0.45227442207307983,0.0
4745,20181,Sherman,Kansas,2004,632,2088,42,2762,0.22881969587255613,0.7559739319333816,0.015206372194062274,-49,-65,194,80,-0.02509529294176155,-0.02468922810422259,0.049784521045984076,-1456,-243,-0.5271542360608255,-0.07487981398774562
4746,20181,Sherman,Kansas,2008,688,1959,57,2704,0.25443786982248523,0.7244822485207101,0.021079881656804734,56,15,-129,-58,0.0256181739499291,0.00587350946274246,-0.0314916834126715,-1271,185,-0.47004437869822485,0.0571098573626006
4747,20181,Sherman,Kansas,2012,577,1976,70,2623,0.21997712542889822,0.7533358749523447,0.02668699961875715,-111,13,17,-81,-0.03446074439358701,0.005607117961952415,0.028853626431634583,-1399,-128,-0.5333587495234464,-0.06331437082522157
4748,20181,Sherman,Kansas,2016,347,2089,176,2612,0.13284839203675344,0.7997702909647779,0.06738131699846861,-230,106,113,-11,-0.08712873339214477,0.040694317379711464,0.046434416012433255,-1742,-343,-0.6669218989280244,-0.13356314940457803
4749,20183,Smith,Kansas,2000,534,1534,116,2184,0.2445054945054945,0.7023809523809523,0.05311355311355311,0,0,0,0,0.0,0.0,0.0,-1000,0,-0.4578754578754578,0.0
4750,20183,Smith,Kansas,2004,540,1803,27,2370,0.22784810126582278,0.760759493670886,0.01139240506329114,6,-89,269,186,-0.01665739323967172,-0.041721148050261975,0.058378541289933694,-1263,-263,-0.5329113924050632,-0.07503593452960544
4751,20183,Smith,Kansas,2008,446,1719,45,2210,0.20180995475113123,0.7778280542986425,0.020361990950226245,-94,18,-84,-160,-0.02603814651469155,0.008969585886935106,0.017068560627756524,-1273,-10,-0.5760180995475113,-0.04310670714244802
4752,20183,Smith,Kansas,2012,358,1624,41,2023,0.17696490360850223,0.8027681660899654,0.020266930301532378,-88,-4,-95,-187,-0.024845051142629,-9.506064869386696e-05,0.024940111791322828,-1266,7,-0.6258032624814631,-0.049785162933951854
4753,20183,Smith,Kansas,2016,297,1661,84,2042,0.1454456415279138,0.8134182174338883,0.04113614103819784,-61,43,37,19,-0.03151926208058842,0.020869210736665464,0.01065005134392294,-1364,-98,-0.6679725759059745,-0.04216931342451136
4754,20185,Stafford,Kansas,2000,567,1546,87,2200,0.25772727272727275,0.7027272727272728,0.03954545454545454,0,0,0,0,0.0,0.0,0.0,-979,0,-0.445,0.0
4755,20185,Stafford,Kansas,2004,506,1649,31,2186,0.23147301006404392,0.7543458371454712,0.014181152790484904,-61,-56,103,-14,-0.026254262663228833,-0.02536430175496964,0.051618564418198454,-1143,-164,-0.5228728270814273,-0.07787282708142734
4756,20185,Stafford,Kansas,2008,542,1495,37,2074,0.26133076181292186,0.7208293153326905,0.017839922854387655,36,6,-154,-112,0.029857751748877948,0.0036587700639027516,-0.03351652181278075,-953,190,-0.4594985535197686,0.06337427356165876
4757,20185,Stafford,Kansas,2012,404,1385,50,1839,0.21968461120174007,0.7531266992930941,0.027188689505165852,-138,13,-110,-235,-0.04164615061118179,0.009348766650778197,0.0322973839604036,-981,-28,-0.533442088091354,-0.07394353457158537
4758,20185,Stafford,Kansas,2016,304,1490,102,1896,0.16033755274261605,0.7858649789029536,0.05379746835443038,-100,52,105,57,-0.059347058459124025,0.02660877884926453,0.03273827960985953,-1186,-205,-0.6255274261603375,-0.09208533806898356
4759,20187,Stanton,Kansas,2000,215,785,29,1029,0.20894071914480078,0.7628765792031098,0.028182701652089408,0,0,0,0,0.0,0.0,0.0,-570,0,-0.5539358600583091,0.0
4760,20187,Stanton,Kansas,2004,165,796,5,966,0.17080745341614906,0.8240165631469979,0.005175983436853002,-50,-24,11,-63,-0.03813326572865172,-0.023006718215236407,0.06113998394388809,-631,-61,-0.6532091097308488,-0.0992732496725397
4761,20187,Stanton,Kansas,2008,188,628,11,827,0.22732769044740025,0.7593712212817413,0.013301088270858524,23,6,-168,-139,0.0565202370312512,0.008125104834005522,-0.06464534186525661,-440,191,-0.532043530834341,0.12116557889650781
4762,20187,Stanton,Kansas,2012,143,605,11,759,0.18840579710144928,0.7971014492753623,0.014492753623188406,-45,0,-23,-68,-0.038921893345950975,0.001191665352329882,0.037730227993621024,-462,-22,-0.6086956521739131,-0.07665212133957211
4763,20187,Stanton,Kansas,2016,115,492,30,637,0.18053375196232338,0.7723704866562009,0.04709576138147567,-28,19,-113,-122,-0.0078720451391259,0.03260300775828726,-0.024730962619161412,-377,85,-0.5918367346938775,0.01685891748003554
4764,20189,Stevens,Kansas,2000,345,1714,52,2111,0.1634296541923259,0.8119374703931785,0.0246328754144955,0,0,0,0,0.0,0.0,0.0,-1369,0,-0.6485078162008526,0.0
4765,20189,Stevens,Kansas,2004,310,1936,19,2265,0.1368653421633554,0.8547461368653422,0.008388520971302429,-35,-33,222,154,-0.0265643120289705,-0.016244354443193068,0.04280866647216364,-1626,-257,-0.7178807947019867,-0.06937297850113411
4766,20189,Stevens,Kansas,2008,283,1815,29,2127,0.13305124588622472,0.8533145275035261,0.013634226610249177,-27,10,-121,-138,-0.0038140962771306963,0.005245705638946748,-0.0014316093618160775,-1532,94,-0.7202632816173014,-0.002382486915314619
4767,20189,Stevens,Kansas,2012,252,1749,33,2034,0.12389380530973451,0.859882005899705,0.016224188790560472,-31,4,-66,-93,-0.009157440576490206,0.002589962180311295,0.006567478396178883,-1497,35,-0.7359882005899705,-0.015724918972669144
4768,20189,Stevens,Kansas,2016,220,1599,72,1891,0.11634056054997356,0.8455843469063987,0.03807509254362771,-32,39,-150,-143,-0.007553244759760949,0.02185090375306724,-0.014297658993306261,-1379,118,-0.7292437863564252,0.006744414233545326
4769,20191,Sumner,Kansas,2000,3549,6176,507,10232,0.3468530101641908,0.6035965598123534,0.04955043002345583,0,0,0,0,0.0,0.0,0.0,-2627,0,-0.2567435496481626,0.0
4770,20191,Sumner,Kansas,2004,3217,7092,179,10488,0.30673150266971777,0.6762013729977117,0.017067124332570557,-332,-328,916,256,-0.04012150749447302,-0.03248330569088527,0.07260481318535827,-3875,-1248,-0.3694698703279939,-0.1127263206798313
4771,20191,Sumner,Kansas,2008,3353,6737,247,10337,0.3243687723710941,0.6517364806036567,0.023894747025249106,136,68,-355,-151,0.017637269701376357,0.006827622692678548,-0.024464892394054916,-3384,491,-0.3273677082325626,0.04210216209543127
4772,20191,Sumner,Kansas,2012,2658,6260,223,9141,0.29077781424351823,0.6848266054042227,0.024395580352259052,-695,-24,-477,-1196,-0.0335909581275759,0.000500833327009946,0.033090124800565945,-3602,-218,-0.39404879116070446,-0.06668108292814184
4773,20191,Sumner,Kansas,2016,2076,6984,662,9722,0.21353630940135773,0.7183707056161284,0.06809298498251388,-582,439,724,581,-0.0772415048421605,0.04369740463025483,0.03354410021190568,-4908,-1306,-0.5048343962147707,-0.1107856050540662
4774,20193,Thomas,Kansas,2000,807,2822,151,3780,0.21349206349206348,0.7465608465608465,0.039947089947089946,0,0,0,0,0.0,0.0,0.0,-2015,0,-0.533068783068783,0.0
4775,20193,Thomas,Kansas,2004,816,3007,47,3870,0.21085271317829457,0.7770025839793282,0.01214470284237726,9,-104,185,90,-0.0026393503137689123,-0.027802387104712688,0.030441737418481662,-2191,-176,-0.5661498708010336,-0.0330810877322506
4776,20193,Thomas,Kansas,2008,787,2837,49,3673,0.21426626735638443,0.7723931391233324,0.013340593520283148,-29,2,-170,-197,0.0034135541780898615,0.0011958906779058875,-0.004609444855995792,-2050,141,-0.558126871766948,0.008022999034085654
4777,20193,Thomas,Kansas,2012,598,2788,88,3474,0.17213586643638457,0.8025331030512378,0.025331030512377662,-189,39,-49,-199,-0.042130400919999866,0.011990436992094514,0.03013996392790541,-2190,-140,-0.6303972366148533,-0.07227036484790528
4778,20193,Thomas,Kansas,2016,473,2908,195,3576,0.13227069351230425,0.8131991051454138,0.05453020134228188,-125,107,120,102,-0.03986517292408032,0.029199170829904215,0.010666002094176008,-2435,-245,-0.6809284116331096,-0.050531175018256325
4779,20195,Trego,Kansas,2000,516,1220,101,1837,0.2808927599346761,0.6641262928688079,0.054980947196516056,0,0,0,0,0.0,0.0,0.0,-704,0,-0.38323353293413176,0.0
4780,20195,Trego,Kansas,2004,434,1225,27,1686,0.25741399762752076,0.7265717674970344,0.01601423487544484,-82,-74,5,-151,-0.023478762307155343,-0.03896671232107121,0.06244547462822658,-791,-87,-0.4691577698695137,-0.08592423693538193
4781,20195,Trego,Kansas,2008,420,1225,26,1671,0.2513464991023339,0.7330939557151407,0.015559545182525433,-14,-1,0,-15,-0.006067498525186843,-0.00045468969291940706,0.00652218821810624,-805,-14,-0.48174745661280677,-0.012589686743293083
4782,20195,Trego,Kansas,2012,291,1261,27,1579,0.18429385687143762,0.798606713109563,0.017099430018999367,-129,1,36,-92,-0.0670526422308963,0.0015398848364739336,0.0655127573944223,-970,-165,-0.6143128562381254,-0.1325653996253186
4783,20195,Trego,Kansas,2016,198,1227,57,1482,0.13360323886639677,0.8279352226720648,0.038461538461538464,-93,30,-34,-97,-0.05069061800504085,0.021362108442539097,0.02932850956250177,-1029,-59,-0.694331983805668,-0.08001912756754259
4784,20197,Wabaunsee,Kansas,2000,1025,2182,213,3420,0.2997076023391813,0.6380116959064327,0.062280701754385964,0,0,0,0,0.0,0.0,0.0,-1157,0,-0.3383040935672514,0.0
4785,20197,Wabaunsee,Kansas,2004,1001,2531,72,3604,0.27774694783573806,0.7022752497225305,0.01997780244173141,-24,-141,349,184,-0.021960654503443255,-0.04230289931265455,0.06426355381609783,-1530,-373,-0.42452830188679247,-0.08622420831954108
4786,20197,Wabaunsee,Kansas,2008,1036,2395,90,3521,0.294234592445328,0.680204487361545,0.025560920193126953,35,18,-136,-83,0.016487644609589958,0.0055831177513955416,-0.022070762360985485,-1359,171,-0.385969894916217,0.03855840697057544
4787,20197,Wabaunsee,Kansas,2012,918,2256,93,3267,0.2809917355371901,0.6905417814508723,0.028466483011937556,-118,3,-139,-254,-0.013242856908137923,0.002905562818810603,0.010337294089327265,-1338,21,-0.4095500459136822,-0.023580150997465188
4788,20197,Wabaunsee,Kansas,2016,776,2372,232,3380,0.22958579881656804,0.7017751479289941,0.06863905325443787,-142,139,116,113,-0.05140593672062205,0.04017257024250031,0.011233366478121787,-1596,-258,-0.47218934911242605,-0.06263930319874383
4789,20199,Wallace,Kansas,2000,103,737,21,861,0.11962833914053426,0.8559814169570267,0.024390243902439025,0,0,0,0,0.0,0.0,0.0,-634,0,-0.7363530778164924,0.0
4790,20199,Wallace,Kansas,2004,112,742,22,876,0.1278538812785388,0.8470319634703196,0.02511415525114155,9,1,5,15,0.00822554213800454,0.0007239113487025259,-0.00894945348670706,-630,4,-0.7191780821917808,0.017174995624711586
4791,20199,Wallace,Kansas,2008,96,690,18,804,0.11940298507462686,0.8582089552238806,0.022388059701492536,-16,-4,-52,-72,-0.008450896203911942,-0.002726095549649015,0.011176991753561016,-594,36,-0.7388059701492538,-0.019627887957472945
4792,20199,Wallace,Kansas,2012,68,719,11,798,0.08521303258145363,0.9010025062656641,0.013784461152882205,-28,-7,29,-6,-0.034189952493173234,-0.008603598548610331,0.042793551041783506,-651,-57,-0.8157894736842105,-0.07698350353495675
4793,20199,Wallace,Kansas,2016,46,721,31,798,0.05764411027568922,0.9035087719298246,0.03884711779448621,-22,20,2,0,-0.02756892230576441,0.02506265664160401,0.0025062656641604564,-675,-24,-0.8458646616541354,-0.03007518796992492
4794,20201,Washington,Kansas,2000,687,2446,134,3267,0.21028466483011937,0.7486991123354759,0.041016222834404654,0,0,0,0,0.0,0.0,0.0,-1759,0,-0.5384144475053565,0.0
4795,20201,Washington,Kansas,2004,643,2498,49,3190,0.20156739811912225,0.7830721003134796,0.015360501567398118,-44,-85,52,-77,-0.008717266710997124,-0.025655721267006534,0.0343729879780037,-1855,-96,-0.5815047021943573,-0.04309025468900085
4796,20201,Washington,Kansas,2008,659,2248,73,2980,0.22114093959731543,0.7543624161073825,0.024496644295302013,16,24,-250,-210,0.01957354147819318,0.009136142727903895,-0.028709684206097097,-1589,266,-0.5332214765100671,0.04828322568429022
4797,20201,Washington,Kansas,2012,524,2316,49,2889,0.18137763932156456,0.8016614745586709,0.016960886119764623,-135,-24,68,-91,-0.03976330027575087,-0.00753575817553739,0.047299058451288345,-1792,-203,-0.6202838352371063,-0.08706235872703916
4798,20201,Washington,Kansas,2016,387,2194,184,2765,0.1399638336347197,0.7934900542495479,0.06654611211573237,-137,135,-122,-124,-0.04141380568684486,0.04958522599596775,-0.00817142030912299,-1807,-15,-0.6535262206148282,-0.03324238537772195
4799,20203,Wichita,Kansas,2000,207,859,24,1090,0.18990825688073396,0.7880733944954128,0.022018348623853212,0,0,0,0,0.0,0.0,0.0,-652,0,-0.5981651376146788,0.0
4800,20203,Wichita,Kansas,2004,183,869,10,1062,0.17231638418079095,0.8182674199623352,0.009416195856873822,-24,-14,10,-28,-0.017591872699943,-0.01260215276697939,0.030194025466922403,-686,-34,-0.6459510357815442,-0.047785898166865404
4801,20203,Wichita,Kansas,2008,163,840,16,1019,0.15996074582924436,0.8243375858684985,0.015701668302257114,-20,6,-29,-43,-0.0123556383515466,0.006285472445383291,0.006070165906163272,-677,9,-0.6643768400392541,-0.0184258042577099
4802,20203,Wichita,Kansas,2012,157,821,9,987,0.1590678824721378,0.8318135764944276,0.00911854103343465,-6,-7,-19,-32,-0.0008928633571065603,-0.006583127268822464,0.007475990625929074,-664,13,-0.6727456940222898,-0.008368853983035662
4803,20203,Wichita,Kansas,2016,140,769,47,956,0.14644351464435146,0.8043933054393305,0.049163179916317995,-17,38,-52,-31,-0.012624367827786337,0.04004463888288334,-0.027420271055097034,-629,35,-0.6579497907949791,0.014795903227310725
4804,20205,Wilson,Kansas,2000,1186,2748,161,4095,0.28962148962148965,0.671062271062271,0.039316239316239315,0,0,0,0,0.0,0.0,0.0,-1562,0,-0.38144078144078136,0.0
4805,20205,Wilson,Kansas,2004,1060,3263,75,4398,0.24101864483856297,0.7419281491587085,0.017053206002728513,-126,-86,515,303,-0.048602844782926674,-0.022263033313510802,0.07086587809643752,-2203,-641,-0.5009095043201456,-0.11946872287936422
4806,20205,Wilson,Kansas,2008,1170,2850,101,4121,0.28391167192429023,0.6915797136617325,0.02450861441397719,110,26,-413,-277,0.04289302708572726,0.007455408411248678,-0.050348435496975985,-1680,523,-0.4076680417374423,0.09324146258270327
4807,20205,Wilson,Kansas,2012,818,2825,74,3717,0.2200699488835082,0.7600215227333872,0.019908528383104654,-352,-27,-25,-404,-0.06384172304078203,-0.004600086030872537,0.06844180907165465,-2007,-327,-0.539951573849879,-0.1322835321124367
4808,20205,Wilson,Kansas,2016,594,2788,209,3591,0.16541353383458646,0.7763854079643553,0.0582010582010582,-224,135,-37,-126,-0.05465641504892174,0.038292529817953544,0.0163638852309681,-2194,-187,-0.6109718741297688,-0.07102030027988981
4809,20207,Woodson,Kansas,2000,521,974,100,1595,0.3266457680250784,0.6106583072100313,0.06269592476489028,0,0,0,0,0.0,0.0,0.0,-453,0,-0.28401253918495295,0.0
4810,20207,Woodson,Kansas,2004,530,1204,29,1763,0.30062393647192287,0.6829268292682927,0.016449234259784458,9,-71,230,168,-0.026021831553155517,-0.04624669050510582,0.0722685220582614,-674,-221,-0.38230289279636986,-0.09829035361141691
4811,20207,Woodson,Kansas,2008,512,1055,32,1599,0.32020012507817386,0.6597873671044403,0.020012507817385866,-18,3,-149,-164,0.019576188606250988,0.0035632735576014082,-0.02313946216385243,-543,131,-0.33958724202626644,0.04271565077010342
4812,20207,Woodson,Kansas,2012,380,1035,32,1447,0.2626123013130615,0.7152729785763648,0.0221147201105736,-132,0,-20,-152,-0.057587823765112345,0.0021022122931877336,0.055485611471924545,-655,-112,-0.45266067726330333,-0.11307343523703689
4813,20207,Woodson,Kansas,2016,273,1082,88,1443,0.1891891891891892,0.7498267498267498,0.060984060984060985,-107,56,47,-4,-0.07342311212387231,0.03886934087348738,0.034553771250384946,-809,-154,-0.5606375606375607,-0.10797688337425732
4814,20209,Wyandotte,Kansas,2000,32411,14024,1837,48272,0.6714244282399735,0.2905203844879019,0.038055187272124626,0,0,0,0,0.0,0.0,0.0,18387,0,0.3809040437520716,0.0
4815,20209,Wyandotte,Kansas,2004,34923,17919,559,53401,0.6539765172936837,0.3355555139416865,0.010467968764629876,2512,-1278,3895,5129,-0.017447910946289835,-0.02758721850749475,0.04503512945378457,17004,-1383,0.3184210033519972,-0.06248304040007441
4816,20209,Wyandotte,Kansas,2008,39865,16506,1038,57409,0.6944033165531537,0.28751589472034,0.018080788726506297,4942,479,-1413,4008,0.040426799259470014,0.00761281996187642,-0.048039619221346475,23359,6355,0.4068874218328137,0.08846641848081649
4817,20209,Wyandotte,Kansas,2012,34302,15496,1095,50893,0.6740023185899829,0.3044819523313619,0.02151572907865522,-5563,57,-1010,-6516,-0.02040099796317074,0.003434940352148922,0.01696605761102188,18806,-4553,0.36952036625862106,-0.03736705557419262
4818,20209,Wyandotte,Kansas,2016,30146,15806,3291,49243,0.6121885344109823,0.3209796316227687,0.066831833966249,-4156,2196,310,-1650,-0.06181378417900063,0.045316104887593786,0.01649767929140683,14340,-4466,0.2912089027882136,-0.07831146347040746
4819,21001,Adair,Kentucky,2000,1779,5460,89,7328,0.2427674672489083,0.7450873362445415,0.012145196506550219,0,0,0,0,0.0,0.0,0.0,-3681,0,-0.5023198689956332,0.0
4820,21001,Adair,Kentucky,2004,1764,5628,55,7447,0.23687390895662683,0.7557405666711428,0.007385524372230428,-15,-34,168,119,-0.00589355829228147,-0.004759672134319791,0.010653230426601268,-3864,-183,-0.5188666577145159,-0.01654678871888271
4821,21001,Adair,Kentucky,2008,1668,5512,118,7298,0.22855576870375446,0.7552754179227186,0.016168813373526995,-96,63,-116,-149,-0.008318140252872364,0.008783289001296567,-0.0004651487484241823,-3844,20,-0.5267196492189641,-0.007852991504448181
4822,21001,Adair,Kentucky,2012,1660,5841,99,7600,0.21842105263157896,0.7685526315789474,0.013026315789473684,-8,-19,329,302,-0.010134716072175504,-0.0031424975840533102,0.013277213656228803,-4181,-337,-0.5501315789473684,-0.023411929728404335
4823,21001,Adair,Kentucky,2016,1323,6637,273,8233,0.1606947649702417,0.8061459978136767,0.033159237216081626,-337,174,796,633,-0.05772628766133725,0.02013292142660794,0.03759336623472931,-5314,-1133,-0.645451232843435,-0.09531965389606656
4824,21003,Allen,Kentucky,2000,1950,4415,64,6429,0.30331311245916937,0.6867319956447347,0.009954891896095816,0,0,0,0,0.0,0.0,0.0,-2465,0,-0.3834188831855654,0.0
4825,21003,Allen,Kentucky,2004,1923,5202,38,7163,0.26846293452464054,0.7262320256875611,0.005305039787798408,-27,-26,787,734,-0.034850177934528825,-0.004649852108297408,0.03950003004282632,-3279,-814,-0.4577690911629205,-0.07435020797735514
4826,21003,Allen,Kentucky,2008,2024,5258,108,7390,0.27388362652232745,0.7115020297699594,0.014614343707713126,101,70,56,227,0.005420691997686911,0.009309303919914719,-0.014729995917601713,-3234,45,-0.4376184032476319,0.020150687915288623
4827,21003,Allen,Kentucky,2012,1808,5184,108,7100,0.25464788732394367,0.7301408450704225,0.015211267605633802,-216,0,-74,-290,-0.019235739198383783,0.0005969238979206763,0.018638815300463185,-3376,-142,-0.4754929577464789,-0.03787455449884697
4828,21003,Allen,Kentucky,2016,1349,6466,281,8096,0.16662549407114624,0.7986660079051383,0.034708498023715416,-459,173,1282,996,-0.08802239325279743,0.019497230418081615,0.06852516283471577,-5117,-1741,-0.6320405138339921,-0.1565475560875132
4829,21005,Anderson,Kentucky,2000,2902,4909,156,7967,0.36425254173465543,0.6161666875862934,0.019580770679051087,0,0,0,0,0.0,0.0,0.0,-2007,0,-0.251914145851638,0.0
4830,21005,Anderson,Kentucky,2004,3141,6363,87,9591,0.3274945261182359,0.663434469815452,0.009071004066312168,239,-69,1454,1624,-0.03675801561641956,-0.010509766612738919,0.047267782229158506,-3222,-1215,-0.3359399436972161,-0.08402579784557807
4831,21005,Anderson,Kentucky,2008,3462,6885,205,10552,0.32808946171341924,0.6524829416224412,0.0194275966641395,321,118,522,961,0.0005949355951833657,0.01035659259782733,-0.010951528193010707,-3423,-201,-0.324393479909022,0.011546463788194072
4832,21005,Anderson,Kentucky,2012,3315,6822,183,10320,0.32122093023255816,0.661046511627907,0.017732558139534883,-147,-22,-63,-232,-0.006868531480861084,-0.001695038524604616,0.008563570005465704,-3507,-84,-0.3398255813953488,-0.015432101486326788
4833,21005,Anderson,Kentucky,2016,2634,8242,546,11422,0.23060759936963754,0.7215899142006654,0.047802486429697075,-681,363,1420,1102,-0.09061333086292062,0.030069928290162192,0.060543402572758476,-5608,-2101,-0.4909823148310279,-0.1511567334356791
4834,21007,Ballard,Kentucky,2000,1880,1824,66,3770,0.4986737400530504,0.48381962864721484,0.01750663129973475,0,0,0,0,0.0,0.0,0.0,56,0,0.014854111405835535,0.0
4835,21007,Ballard,Kentucky,2004,1759,2389,29,4177,0.4211156332295906,0.5719415848695236,0.006942781900885803,-121,-37,565,407,-0.07755810682345976,-0.010563849398848947,0.08812195622230878,-630,-686,-0.150825951639933,-0.16568006304576854
4836,21007,Ballard,Kentucky,2008,1427,2537,96,4060,0.3514778325123153,0.6248768472906404,0.023645320197044337,-332,67,148,-117,-0.06963780071727532,0.016702538296158535,0.05293526242111679,-1110,-480,-0.2733990147783251,-0.12257306313839211
4837,21007,Ballard,Kentucky,2012,1189,2647,59,3895,0.30526315789473685,0.679589216944801,0.015147625160462131,-238,-37,110,-165,-0.046214674617578444,-0.008497695036582206,0.0547123696541606,-1458,-348,-0.37432605905006416,-0.10092704427173904
4838,21007,Ballard,Kentucky,2016,816,3161,124,4101,0.19897585954645208,0.7707876127773714,0.03023652767617654,-373,65,514,206,-0.10628729834828476,0.01508890251571441,0.09119839583257039,-2345,-887,-0.5718117532309193,-0.1974856941808551
4839,21009,Barren,Kentucky,2000,4930,8741,173,13844,0.35611095059231435,0.6313926610806125,0.0124963883270731,0,0,0,0,0.0,0.0,0.0,-3811,0,-0.2752817104882982,0.0
4840,21009,Barren,Kentucky,2004,5216,10822,102,16140,0.3231722428748451,0.6705080545229244,0.006319702602230483,286,-71,2081,2296,-0.03293870771746926,-0.006176685724842617,0.03911539344231185,-5606,-1795,-0.3473358116480793,-0.07205410115978111
4841,21009,Barren,Kentucky,2008,5434,11133,240,16807,0.32331766525852323,0.6624025703575891,0.014279764383887665,218,138,311,667,0.00014542238367815097,0.007960061781657181,-0.008105484165335297,-5699,-93,-0.33908490509906586,0.008250906549013448
4842,21009,Barren,Kentucky,2012,5400,10922,246,16568,0.32592950265572185,0.6592225977788508,0.01484789956542733,-34,6,-211,-239,0.002611837397198613,0.0005681351815396644,-0.003179972578738255,-5522,177,-0.333293095123129,0.005791809975936868
4843,21009,Barren,Kentucky,2016,4275,13483,730,18488,0.2312310688013847,0.729283859800952,0.03948507139766335,-1125,484,2561,1920,-0.09469843385433716,0.024637171832236023,0.07006126202210117,-9208,-3686,-0.49805279099956734,-0.16475969587643835
4844,21011,Bath,Kentucky,2000,2087,2303,83,4473,0.46657724122512856,0.514866979655712,0.018555779119159403,0,0,0,0,0.0,0.0,0.0,-216,0,-0.048289738430583484,0.0
4845,21011,Bath,Kentucky,2004,2608,2269,42,4919,0.5301890628176459,0.4612726163854442,0.008538320796909941,521,-41,-34,446,0.06361182159251733,-0.010017458322249461,-0.05359436327026784,339,555,0.06891644643220168,0.11720618486278517
4846,21011,Bath,Kentucky,2008,2210,2234,99,4543,0.48646268985252034,0.49174554259300024,0.021791767554479417,-398,57,-35,-376,-0.04372637296512555,0.013253446757569476,0.03047292620755604,-24,-363,-0.005282852740479904,-0.07419929917268159
4847,21011,Bath,Kentucky,2012,1770,2275,77,4122,0.4294032023289665,0.5519165453663271,0.018680252304706452,-440,-22,41,-421,-0.05705948752355383,-0.003111515249772965,0.06017100277332682,-505,-481,-0.12251334303736056,-0.11723049029688065
4848,21011,Bath,Kentucky,2016,1361,3082,144,4587,0.29670808807499455,0.671898844560715,0.031393067364290386,-409,67,807,465,-0.13269511425397196,0.012712815059583934,0.11998229919438796,-1721,-1216,-0.3751907564857205,-0.2526774134483599
4849,21013,Bell,Kentucky,2000,4787,5585,239,10611,0.45113561398548674,0.5263405899538215,0.022523796060691735,0,0,0,0,0.0,0.0,0.0,-798,0,-0.07520497596833475,0.0
4850,21013,Bell,Kentucky,2004,4210,6722,70,11002,0.3826576986002545,0.6109798218505726,0.006362479549172878,-577,-169,1137,391,-0.06847791538523224,-0.016161316511518857,0.08463923189675115,-2512,-1714,-0.22832212325031814,-0.1531171472819834
4851,21013,Bell,Kentucky,2008,2782,6681,135,9598,0.28985205251093976,0.6960825171910815,0.014065430297978746,-1428,65,-41,-1404,-0.09280564608931474,0.007702950748805868,0.08510269534050885,-3899,-1387,-0.40623046468014173,-0.1779083414298236
4852,21013,Bell,Kentucky,2012,2224,7127,131,9482,0.23454967306475427,0.7516346762286438,0.013815650706601982,-558,-4,446,-116,-0.05530237944618549,-0.00024977959137676385,0.055552159037562276,-4903,-1004,-0.5170850031638895,-0.11085453848374777
4853,21013,Bell,Kentucky,2016,1720,7764,234,9718,0.17699115044247787,0.7989298209508129,0.0240790286067092,-504,103,637,236,-0.0575585226222764,0.010263377900107217,0.047295144722169113,-6044,-1141,-0.621938670508335,-0.10485366734444546
4854,21015,Boone,Kentucky,2000,9248,22016,720,31984,0.2891445722861431,0.688344172086043,0.022511255627813906,0,0,0,0,0.0,0.0,0.0,-12768,0,-0.39919959979989994,0.0
4855,21015,Boone,Kentucky,2004,12391,32329,362,45082,0.2748547091965751,0.7171154784614702,0.00802981234195466,3143,-358,10313,13098,-0.014289863089567978,-0.014481443285859246,0.02877130637542713,-19938,-7170,-0.44226076926489505,-0.04306116946499511
4856,21015,Boone,Kentucky,2008,16292,33812,670,50774,0.3208728876984283,0.66593138220349,0.013195730098081695,3901,308,1483,5692,0.04601817850185319,0.005165917756127035,-0.05118409625798015,-17520,2418,-0.3450584945050617,0.09720227475983334
4857,21015,Boone,Kentucky,2012,15629,35922,960,52511,0.2976328769210261,0.6840852392831978,0.018281883795776124,-663,290,2110,1737,-0.02324001077740223,0.0050861536976944295,0.018153857079707736,-20293,-2773,-0.3864523623621717,-0.04139386785710997
4858,21015,Boone,Kentucky,2016,15026,39082,3510,57618,0.2607865597556319,0.6782949772640494,0.06091846298031865,-603,2550,3160,5107,-0.03684631716539416,0.04263657918454253,-0.00579026201914834,-24056,-3763,-0.4175084175084175,-0.03105605514624582
4859,21017,Bourbon,Kentucky,2000,3048,3881,173,7102,0.42917488031540413,0.5464657842861166,0.0243593353984793,0,0,0,0,0.0,0.0,0.0,-833,0,-0.11729090397071246,0.0
4860,21017,Bourbon,Kentucky,2004,3198,4953,66,8217,0.389193136181088,0.6027747353048558,0.008032128514056224,150,-107,1072,1115,-0.039981744134316155,-0.016327206884423077,0.05630895101873923,-1755,-922,-0.21358159912376784,-0.09629069515305538
4861,21017,Bourbon,Kentucky,2008,3385,4820,125,8330,0.4063625450180072,0.5786314525810324,0.015006002400960384,187,59,-133,113,0.017169408836919253,0.00697387388690416,-0.024143282723823378,-1435,320,-0.1722689075630252,0.04131269156074263
4862,21017,Bourbon,Kentucky,2012,3075,4692,156,7923,0.38811056418023476,0.5921999242711095,0.01968951154865581,-310,31,-128,-407,-0.018251980837772463,0.004683509147695428,0.013568471690077022,-1617,-182,-0.2040893600908747,-0.031820452527849485
4863,21017,Bourbon,Kentucky,2016,2791,5569,443,8803,0.3170510053390889,0.632625241394979,0.05032375326593207,-284,287,877,880,-0.07105955884114584,0.030634241717276255,0.04042531712386954,-2778,-1161,-0.3155742360558901,-0.11148487596501538
4864,21019,Boyd,Kentucky,2000,9541,9247,394,19182,0.4973933896361172,0.4820665206964863,0.020540089667396517,0,0,0,0,0.0,0.0,0.0,294,0,0.015326868939630867,0.0
4865,21019,Boyd,Kentucky,2004,10132,11501,144,21777,0.4652615144418423,0.5281260045001607,0.006612481057996969,591,-250,2254,2595,-0.03213187519427485,-0.01392760860939955,0.04605948380367436,-1369,-1663,-0.06286449005831835,-0.07819135899794921
4866,21019,Boyd,Kentucky,2008,8886,11430,354,20670,0.42989840348330915,0.5529753265602322,0.017126269956458634,-1246,210,-71,-1107,-0.03536311095853317,0.010513788898461666,0.02484932206007151,-2544,-1175,-0.12307692307692303,-0.06021243301860468
4867,21019,Boyd,Kentucky,2012,7776,10884,389,19049,0.40821040474565595,0.5713685757782561,0.020421019476087984,-1110,35,-546,-1621,-0.021687998737653202,0.0032947495196293496,0.018393249218023877,-3108,-564,-0.1631581710326001,-0.04008124795567708
4868,21019,Boyd,Kentucky,2016,6021,13591,842,20454,0.29436784980932823,0.6644666079984355,0.04116554219223624,-1755,453,2707,1405,-0.11384255493632772,0.020744522716148257,0.09309803222017943,-7570,-4462,-0.37009875818910726,-0.20694058715650715
4869,21021,Boyle,Kentucky,2000,3963,6126,237,10326,0.38378849506101104,0.5932597327135386,0.02295177222545032,0,0,0,0,0.0,0.0,0.0,-2163,0,-0.20947123765252756,0.0
4870,21021,Boyle,Kentucky,2004,4646,7764,80,12490,0.3719775820656525,0.621617293835068,0.006405124099279423,683,-157,1638,2164,-0.011810912995358525,-0.016546648126170897,0.02835756112152943,-3118,-955,-0.24963971176941552,-0.04016847411688795
4871,21021,Boyle,Kentucky,2008,4769,7701,165,12635,0.3774436090225564,0.6094974277799763,0.013058963197467353,123,85,-63,145,0.005466026956903902,0.00665383909818793,-0.012119866055091744,-2932,186,-0.23205381875741987,0.017585893011995646
4872,21021,Boyle,Kentucky,2012,4471,7703,199,12373,0.36135132950779925,0.6225652630728199,0.01608340741938091,-298,34,2,-262,-0.01609227951475717,0.0030244442219135564,0.01306783529284361,-3232,-300,-0.26121393356502065,-0.02916011480760078
4873,21021,Boyle,Kentucky,2016,4281,8040,625,12946,0.3306812915186158,0.6210412482620115,0.04827746021937278,-190,426,337,573,-0.03067003798918344,0.032194052799991865,-0.0015240148108084384,-3759,-527,-0.29035995674339565,-0.029146023178375002
4874,21023,Bracken,Kentucky,2000,888,2065,66,3019,0.29413713150049686,0.6840013249420338,0.02186154355746936,0,0,0,0,0.0,0.0,0.0,-1177,0,-0.38986419344153694,0.0
4875,21023,Bracken,Kentucky,2004,1213,2363,34,3610,0.33601108033240995,0.6545706371191136,0.009418282548476454,325,-32,298,591,0.04187394883191309,-0.012443261008992906,-0.029430687822920243,-1150,27,-0.3185595567867036,0.07130463665483333
4876,21023,Bracken,Kentucky,2008,1241,2066,92,3399,0.36510738452486025,0.607825831126802,0.027066784348337748,28,58,-297,-211,0.029096304192450295,0.017648501799861292,-0.04674480599231157,-825,325,-0.24271844660194175,0.07584111018476186
4877,21023,Bracken,Kentucky,2012,1147,2029,56,3232,0.35488861386138615,0.6277846534653465,0.017326732673267328,-94,-36,-37,-167,-0.010218770663474097,-0.00974005167507042,0.019958822338544513,-882,-57,-0.27289603960396036,-0.03017759300201861
4878,21023,Bracken,Kentucky,2016,705,2711,111,3527,0.19988658916926566,0.7686419053019563,0.031471505528778,-442,55,682,295,-0.1550020246921205,0.01414477285551067,0.1408572518366098,-2006,-1124,-0.5687553161326906,-0.29585927652873023
4879,21025,Breathitt,Kentucky,2000,2902,2084,87,5073,0.5720480977725212,0.41080228661541496,0.01714961561206387,0,0,0,0,0.0,0.0,0.0,818,0,0.16124581115710623,0.0
4880,21025,Breathitt,Kentucky,2004,3327,2542,75,5944,0.5597240915208613,0.4276581426648721,0.012617765814266487,425,-12,458,871,-0.012324006251659858,-0.004531849797797381,0.016855856049457163,785,-33,0.1320659488559892,-0.02917986230111702
4881,21025,Breathitt,Kentucky,2008,2205,2671,154,5030,0.4383697813121272,0.531013916500994,0.03061630218687873,-1122,79,129,-914,-0.1213543102087341,0.017998536372612242,0.10335577383612193,-466,-1251,-0.09264413518886683,-0.22471008404485604
4882,21025,Breathitt,Kentucky,2012,1562,3318,128,5008,0.31190095846645366,0.6625399361022364,0.025559105431309903,-643,-26,647,-22,-0.12646882284567357,-0.005057196755568826,0.13152601960124233,-1756,-1290,-0.3506389776357827,-0.2579948424469159
4883,21025,Breathitt,Kentucky,2016,1537,3991,210,5738,0.2678633670268386,0.6955385151620774,0.036598117811084,-25,82,673,730,-0.044037591439615054,0.011039012379774095,0.03299857905984105,-2454,-698,-0.4276751481352388,-0.0770361704994561
4884,21027,Breckinridge,Kentucky,2000,2595,4763,95,7453,0.3481819401583255,0.6390715148262445,0.012746545015430029,0,0,0,0,0.0,0.0,0.0,-2168,0,-0.290889574667919,0.0
4885,21027,Breckinridge,Kentucky,2004,2884,5580,56,8520,0.33849765258215964,0.6549295774647887,0.006572769953051643,289,-39,817,1067,-0.009684287576165851,-0.006173775062378386,0.01585806263854428,-2696,-528,-0.3164319248826291,-0.02554235021471013
4886,21027,Breckinridge,Kentucky,2008,3110,5281,131,8522,0.3649378080262849,0.6196902135648908,0.015371978408824219,226,75,-299,2,0.026440155444125257,0.008799208455772575,-0.0352393638998979,-2171,525,-0.25475240553860595,0.06167951934402316
4887,21027,Breckinridge,Kentucky,2012,2825,5025,119,7969,0.35449868239427784,0.6305684527544234,0.014932864851298782,-285,-12,-256,-553,-0.010439125632007051,-0.00043911355752543693,0.010878239189532568,-2200,-29,-0.27606977036014557,-0.02131736482153962
4888,21027,Breckinridge,Kentucky,2016,1960,6484,330,8774,0.22338728060177798,0.7390015956234328,0.03761112377478915,-865,211,1459,805,-0.13111140179249986,0.02267825892349037,0.1084331428690094,-4524,-2324,-0.5156143150216548,-0.2395445446615092
4889,21029,Bullitt,Kentucky,2000,8195,14054,452,22701,0.3609973128937051,0.6190916699704859,0.019911017135808996,0,0,0,0,0.0,0.0,0.0,-5859,0,-0.2580943570767808,0.0
4890,21029,Bullitt,Kentucky,2004,9043,19433,151,28627,0.3158905927970098,0.6788346665735145,0.0052747406294756695,848,-301,5379,5926,-0.04510672009669531,-0.014636276506333326,0.05974299660302862,-10390,-4531,-0.3629440737765047,-0.10484971669972393
4891,21029,Bullitt,Kentucky,2008,10177,20102,447,30726,0.33121786109483825,0.6542341990496647,0.014547939855496973,1134,296,669,2099,0.015327268297828434,0.009273199226021303,-0.02460046752384981,-9925,465,-0.3230163379548265,0.039927735821678245
4892,21029,Bullitt,Kentucky,2012,9971,21306,502,31779,0.31376065955505206,0.6704427452091003,0.01579659523584757,-206,55,1204,1053,-0.017457201539786193,0.0012486553803505978,0.016208546159435566,-11335,-1410,-0.35668208565404824,-0.03366574769922176
4893,21029,Bullitt,Kentucky,2016,8255,26210,1604,36069,0.22886689400870552,0.7266627852172225,0.04447032077407192,-1716,1102,4904,4290,-0.08489376554634653,0.028673725538224348,0.056220040008122196,-17955,-6620,-0.49779589120851697,-0.14111380555446873
4894,21031,Butler,Kentucky,2000,1299,3654,57,5010,0.2592814371257485,0.7293413173652694,0.011377245508982036,0,0,0,0,0.0,0.0,0.0,-2355,0,-0.4700598802395209,0.0
4895,21031,Butler,Kentucky,2004,1436,4109,33,5578,0.25743994263176767,0.7366439584080315,0.0059160989602007885,137,-24,455,568,-0.0018414944939808553,-0.005461146548781248,0.007302641042762126,-2673,-318,-0.47920401577626387,-0.009144135536742981
4896,21031,Butler,Kentucky,2008,1555,3696,56,5307,0.29300923308837384,0.6964386659129451,0.010552100998680987,119,23,-413,-271,0.03556929045660617,0.004636002038480198,-0.04020529249508642,-2141,532,-0.4034294328245713,0.07577458295169259
4897,21031,Butler,Kentucky,2012,1293,3716,51,5060,0.2555335968379447,0.7343873517786561,0.01007905138339921,-262,-5,20,-247,-0.037475636250429156,-0.0004730496152817766,0.037948685865710985,-2423,-282,-0.4788537549407114,-0.07542432211614014
4898,21031,Butler,Kentucky,2016,947,4428,201,5576,0.16983500717360114,0.7941176470588235,0.036047345767575324,-346,150,712,516,-0.08569858966434354,0.025968294384176114,0.05973029528016738,-3481,-1058,-0.6242826398852224,-0.14542888494451095
4899,21033,Caldwell,Kentucky,2000,2223,3161,98,5482,0.4055089383436702,0.5766143743159431,0.01787668734038672,0,0,0,0,0.0,0.0,0.0,-938,0,-0.1711054359722729,0.0
4900,21033,Caldwell,Kentucky,2004,2245,4066,38,6349,0.35359899196723893,0.6404158135139392,0.0059851945188218614,22,-60,905,867,-0.05190994637643126,-0.01189149282156486,0.06380143919799608,-1821,-883,-0.28681682154670024,-0.11571138557442734
4901,21033,Caldwell,Kentucky,2008,2212,3866,121,6199,0.35683174705597676,0.6236489756412325,0.019519277302790773,-33,83,-200,-150,0.0032327550887378265,0.013534082783968912,-0.01676683787270672,-1654,167,-0.2668172285852557,0.019999592961444546
4902,21033,Caldwell,Kentucky,2012,1852,3904,104,5860,0.31604095563139933,0.6662116040955631,0.017747440273037544,-360,-17,38,-339,-0.04079079142457742,-0.0017718370297532295,0.042562628454330675,-2052,-398,-0.3501706484641638,-0.0833534198789081
4903,21033,Caldwell,Kentucky,2016,1260,4507,208,5975,0.2108786610878661,0.7543096234309623,0.03481171548117155,-592,104,603,115,-0.10516229454353324,0.017064275208134003,0.08809801933539918,-3247,-1195,-0.5434309623430962,-0.1932603138789324
4904,21035,Calloway,Kentucky,2000,5635,7705,333,13673,0.4121260879104805,0.5635193446939223,0.024354567395597163,0,0,0,0,0.0,0.0,0.0,-2070,0,-0.1513932567834418,0.0
4905,21035,Calloway,Kentucky,2004,5728,9293,124,15145,0.37821063057114557,0.6136018487949818,0.008187520633872566,93,-209,1588,1472,-0.03391545733933493,-0.016167046761724597,0.05008250410105952,-3565,-1495,-0.23539121822383624,-0.08399796144039445
4906,21035,Calloway,Kentucky,2008,6165,8991,248,15404,0.4002207218904181,0.5836795637496754,0.01609971435990652,437,124,-302,259,0.022010091319272507,0.007912193726033953,-0.029922285045306363,-2826,739,-0.18345884185925737,0.05193237636457887
4907,21035,Calloway,Kentucky,2012,5317,9440,315,15072,0.35277335456475584,0.6263269639065817,0.02089968152866242,-848,67,449,-332,-0.04744736732566224,0.0047999671687559,0.04264740015690627,-4123,-1297,-0.2735536093418259,-0.0900947674825685
4908,21035,Calloway,Kentucky,2016,4749,10367,933,16049,0.2959062869960745,0.6459592497974952,0.05813446320643031,-568,618,927,977,-0.05686706756868132,0.03723478167776789,0.01963228589091348,-5618,-1495,-0.3500529628014207,-0.0764993534595948
4909,21037,Campbell,Kentucky,2000,12040,20789,1000,33829,0.35590765319696116,0.6145319104909989,0.029560436312039966,0,0,0,0,0.0,0.0,0.0,-8749,0,-0.2586242572940377,0.0
4910,21037,Campbell,Kentucky,2004,14253,25540,382,40175,0.35477286869943997,0.635718730553827,0.009508400746733044,2213,-618,4751,6346,-0.0011347844975211907,-0.020052035565306922,0.021186820062828127,-11287,-2538,-0.280945861854387,-0.022321604560349317
4911,21037,Campbell,Kentucky,2008,15622,24046,629,40297,0.3876715388242301,0.5967193587611981,0.015609102414571804,1369,247,-1494,122,0.03289867012479014,0.00610070166783876,-0.03899937179262891,-8424,2863,-0.20904781993696797,0.07189804191741905
4912,21037,Campbell,Kentucky,2012,15080,24240,857,40177,0.37533912437464223,0.6033302635836424,0.021330612041715408,-542,228,194,-120,-0.01233241444958788,0.005721509627143604,0.006610904822444308,-9160,-736,-0.22799113920900016,-0.01894331927203219
4913,21037,Campbell,Kentucky,2016,14658,25050,2802,42510,0.3448129851799577,0.589273112208892,0.06591390261115032,-422,1945,810,2333,-0.030526139194684554,0.044583290569434914,-0.014057151374750387,-10392,-1232,-0.24446012702893433,-0.016468987819934167
4914,21039,Carlisle,Kentucky,2000,1149,1405,39,2593,0.4431160817585808,0.541843424604705,0.01504049363671423,0,0,0,0,0.0,0.0,0.0,-256,0,-0.09872734284612422,0.0
4915,21039,Carlisle,Kentucky,2004,1102,1734,9,2845,0.3873462214411248,0.6094903339191564,0.003163444639718805,-47,-30,329,252,-0.05576986031745601,-0.011877048996995425,0.06764690931445139,-632,-376,-0.22214411247803162,-0.1234167696319074
4916,21039,Carlisle,Kentucky,2008,879,1699,39,2617,0.3358807795185327,0.6492166602980513,0.014902560183416125,-223,30,-35,-228,-0.051465441922592114,0.01173911554369732,0.03972632637889484,-820,-188,-0.31333588077951857,-0.09119176830148695
4917,21039,Carlisle,Kentucky,2012,750,1835,34,2619,0.286368843069874,0.7006491027109584,0.012982054219167621,-129,-5,136,2,-0.0495119364486587,-0.0019205059642485034,0.05143244241290712,-1085,-265,-0.4142802596410844,-0.10094437886156582
4918,21039,Carlisle,Kentucky,2016,432,2094,75,2601,0.16608996539792387,0.8050749711649365,0.02883506343713956,-318,41,259,-18,-0.12027887767195011,0.01585300921797194,0.10442586845397817,-1662,-577,-0.6389850057670127,-0.22470474612592828
4919,21041,Carroll,Kentucky,2000,1601,1818,80,3499,0.45755930265790223,0.5195770220062875,0.02286367533581023,0,0,0,0,0.0,0.0,0.0,-217,0,-0.06201771934838529,0.0
4920,21041,Carroll,Kentucky,2004,1688,2175,34,3897,0.4331537079804978,0.5581216320246344,0.008724659994867847,87,-46,357,398,-0.02440559467740444,-0.014139015340942383,0.03854461001834686,-487,-270,-0.12496792404413659,-0.0629502046957513
4921,21041,Carroll,Kentucky,2008,1716,2032,87,3835,0.44745762711864406,0.5298565840938723,0.0226857887874837,28,53,-143,-62,0.01430391913814627,0.013961128792615855,-0.02826504793076212,-316,171,-0.0823989569752282,0.04256896706890839
4922,21041,Carroll,Kentucky,2012,1629,1999,52,3680,0.44266304347826085,0.5432065217391304,0.014130434782608696,-87,-35,-33,-155,-0.00479458364038321,-0.008555354004875006,0.013349937645258159,-370,-54,-0.10054347826086957,-0.01814452128564137
4923,21041,Carroll,Kentucky,2016,1106,2588,161,3855,0.2869001297016861,0.6713359273670557,0.041763942931258104,-523,109,589,175,-0.15576291377657475,0.027633508148649406,0.1281294056279253,-1482,-1112,-0.3844357976653696,-0.28389231940450005
4924,21043,Carter,Kentucky,2000,4182,4617,160,8959,0.4667931688804554,0.5153476950552517,0.017859136064292888,0,0,0,0,0.0,0.0,0.0,-435,0,-0.048554526174796275,0.0
4925,21043,Carter,Kentucky,2004,5577,5422,118,11117,0.5016641180174507,0.4877215076009715,0.010614374381577764,1395,-42,805,2158,0.03487094913699529,-0.007244761682715125,-0.027626187454280193,155,590,0.013942610416479206,0.06249713659127548
4926,21043,Carter,Kentucky,2008,4316,5252,245,9813,0.4398247223071436,0.5352083970243554,0.024966880668500967,-1261,127,-170,-1304,-0.06183939571030711,0.014352506286923203,0.047486889423383916,-936,-1091,-0.09538367471721182,-0.10932628513369103
4927,21043,Carter,Kentucky,2012,3383,5279,246,8908,0.3797709923664122,0.5926133812303548,0.02761562640323305,-933,1,27,-905,-0.06005372994073138,0.0026487457347320817,0.057404984205999376,-1896,-960,-0.21284238886394258,-0.11745871414673076
4928,21043,Carter,Kentucky,2016,2276,7587,415,10278,0.22144386067328273,0.7381786339754816,0.040377505351235646,-1107,169,2308,1370,-0.15832713169312948,0.012761878948002597,0.14556525274512677,-5311,-3415,-0.5167347733021989,-0.3038923844382563
4929,21045,Casey,Kentucky,2000,1122,4284,63,5469,0.20515633571036754,0.7833241908941305,0.01151947339550192,0,0,0,0,0.0,0.0,0.0,-3162,0,-0.578167855183763,0.0
4930,21045,Casey,Kentucky,2004,1174,5109,38,6321,0.18573010599588674,0.8082581869957285,0.006011707008384749,52,-25,825,852,-0.019426229714480797,-0.005507766387117171,0.024933996101597966,-3935,-773,-0.6225280809998417,-0.04436022581607868
4931,21045,Casey,Kentucky,2008,1219,4679,59,5957,0.20463320463320464,0.785462481114655,0.009904314252140339,45,21,-430,-364,0.0189030986373179,0.0038926072437555897,-0.02279570588107349,-3460,475,-0.5808292764814503,0.041698804518391364
4932,21045,Casey,Kentucky,2012,1086,4904,101,6091,0.1782958463306518,0.8051223116072894,0.016581842062058774,-133,42,225,134,-0.02633735830255285,0.006677527809918435,0.019659830492634423,-3818,-358,-0.6268264652766377,-0.04599718879518733
4933,21045,Casey,Kentucky,2016,767,5482,190,6439,0.1191178754464979,0.8513744370243826,0.02950768752911943,-319,89,578,348,-0.059177970884153885,0.012925845467060656,0.046252125417093226,-4715,-897,-0.7322565615778848,-0.10543009630124711
4934,21047,Christian,Kentucky,2000,6778,10787,208,17773,0.3813649918415574,0.6069318629381646,0.01170314522027795,0,0,0,0,0.0,0.0,0.0,-4009,0,-0.22556687109660717,0.0
4935,21047,Christian,Kentucky,2004,6970,13935,110,21015,0.33166785629312395,0.6630977872947894,0.005234356412086605,192,-98,3148,3242,-0.04969713554843347,-0.006468788808191345,0.05616592435662482,-6965,-2956,-0.33142993100166546,-0.10586305990505829
4936,21047,Christian,Kentucky,2008,8880,13699,199,22778,0.3898498551233647,0.6014136447449293,0.008736500131706033,1910,89,-236,1763,0.05818199883024072,0.0035021437196194275,-0.0616841425498601,-4819,2146,-0.21156378962156464,0.11986614138010082
4937,21047,Christian,Kentucky,2012,8252,13475,228,21955,0.3758597130494193,0.6137554087907082,0.010384878159872466,-628,29,-224,-823,-0.013990142073945389,0.0016483780281664334,0.012341764045778914,-5223,-404,-0.23789569574128894,-0.026331906119724302
4938,21047,Christian,Kentucky,2016,7188,14108,787,22083,0.32549925281891046,0.6388624733958248,0.035638273785264685,-1064,559,633,128,-0.05036046023050883,0.02525339562539222,0.02510706460511658,-6920,-1697,-0.31336322057691435,-0.07546752483562541
4939,21049,Clark,Kentucky,2000,4918,7297,258,12473,0.3942916700072156,0.5850236510863465,0.020684678906437905,0,0,0,0,0.0,0.0,0.0,-2379,0,-0.19073198107913086,0.0
4940,21049,Clark,Kentucky,2004,5661,9540,116,15317,0.36958934517203107,0.6228373702422145,0.007573284585754391,743,-142,2243,2844,-0.02470232483518453,-0.013111394320683515,0.037813719155868064,-3879,-1500,-0.25324802507018346,-0.0625160439910526
4941,21049,Clark,Kentucky,2008,5749,9664,215,15628,0.367865369848989,0.6183772715638597,0.013757358587151268,88,99,124,311,-0.0017239753230420818,0.006184074001396877,-0.00446009867835484,-3915,-36,-0.2505119017148707,0.0027361233553127584
4942,21049,Clark,Kentucky,2012,5228,9931,257,15416,0.3391281785158277,0.6442008303061754,0.016670991177996888,-521,42,267,-212,-0.02873719133316127,0.00291363259084562,0.025823558742315678,-4703,-788,-0.30507265179034765,-0.05456075007547695
4943,21049,Clark,Kentucky,2016,4706,10710,789,16205,0.2904041962357297,0.6609071274298056,0.04868867633446467,-522,532,779,789,-0.048723982280098,0.03201768515646779,0.016706297123630254,-6004,-1301,-0.3705029311940759,-0.06543027940372825
4944,21051,Clay,Kentucky,2000,1723,4926,70,6719,0.25643696978717073,0.7331448132162525,0.010418216996576872,0,0,0,0,0.0,0.0,0.0,-3203,0,-0.47670784342908173,0.0
4945,21051,Clay,Kentucky,2004,1901,5726,60,7687,0.2473006374398335,0.7448939768440224,0.007805385716144139,178,-10,800,968,-0.00913633234733724,-0.002612831280432733,0.011749163627769899,-3825,-622,-0.4975933394041889,-0.020885495975107138
4946,21051,Clay,Kentucky,2008,1552,5710,102,7364,0.21075502444323738,0.7753938077131993,0.013851167843563281,-349,42,-16,-323,-0.036545612996596116,0.006045782127419142,0.030499830869176958,-4158,-333,-0.564638783269962,-0.0670454438657731
4947,21051,Clay,Kentucky,2012,1111,6176,96,7383,0.15048083434918055,0.8365163212786131,0.01300284437220642,-441,-6,466,19,-0.06027419009405682,-0.0008483234713568613,0.06112251356541376,-5065,-907,-0.6860354869294325,-0.12139670365947053
4948,21051,Clay,Kentucky,2016,752,5861,154,6767,0.1111275306635141,0.8661149697059258,0.02275749963056007,-359,58,-315,-616,-0.039353303685666446,0.00975465525835365,0.029598648427312746,-5109,-44,-0.7549874390424117,-0.06895195211297922
4949,21053,Clinton,Kentucky,2000,1032,3224,49,4305,0.2397212543554007,0.7488966318234611,0.011382113821138212,0,0,0,0,0.0,0.0,0.0,-2192,0,-0.5091753774680604,0.0
4950,21053,Clinton,Kentucky,2004,952,3369,31,4352,0.21875,0.7741268382352942,0.007123161764705882,-80,-18,145,47,-0.020971254355400704,-0.00425895205643233,0.025230206411833045,-2417,-225,-0.5553768382352942,-0.04620146076723375
4951,21053,Clinton,Kentucky,2008,761,3366,45,4172,0.1824065196548418,0.8068072866730585,0.010786193672099712,-191,14,-3,-180,-0.03634348034515819,0.00366303190739383,0.0326804484377643,-2605,-188,-0.6244007670182167,-0.06902392878292252
4952,21053,Clinton,Kentucky,2012,752,3569,72,4393,0.17118142499430913,0.8124288641019805,0.01638971090371045,-9,27,203,221,-0.011225094660532675,0.005603517231610736,0.005621577428921998,-2817,-212,-0.6412474391076713,-0.016846672089454673
4953,21053,Clinton,Kentucky,2016,547,3809,106,4462,0.12259076647243389,0.8536530703720305,0.023756163155535633,-205,34,240,69,-0.048590658521875246,0.007366452251825185,0.04122420627005008,-3262,-445,-0.7310623038995967,-0.08981486479192535
4954,21055,Crittenden,Kentucky,2000,1610,2469,75,4154,0.38757823784304285,0.5943668753009148,0.018054886856042368,0,0,0,0,0.0,0.0,0.0,-859,0,-0.20678863745787196,0.0
4955,21055,Crittenden,Kentucky,2004,1438,2726,26,4190,0.3431980906921241,0.6505966587112172,0.006205250596658711,-172,-49,257,36,-0.04438014715091876,-0.011849636259383657,0.05622978341030238,-1288,-429,-0.3073985680190931,-0.10060993056122114
4956,21055,Crittenden,Kentucky,2008,1254,2604,72,3930,0.3190839694656489,0.6625954198473283,0.0183206106870229,-184,46,-122,-260,-0.024114121226475216,0.01211536009036419,0.011998761136111091,-1350,-62,-0.3435114503816794,-0.03611288236258631
4957,21055,Crittenden,Kentucky,2012,960,2839,55,3854,0.24909185262065386,0.7366372599896212,0.014270887389724962,-294,-17,235,-76,-0.06999211684499501,-0.00404972329729794,0.07404184014229287,-1879,-529,-0.4875454073689673,-0.14403395698728788
4958,21055,Crittenden,Kentucky,2016,617,3290,130,4037,0.15283626455288582,0.8149616051523408,0.03220213029477335,-343,75,451,183,-0.09625558806776804,0.017931242905048383,0.07832434516271969,-2673,-794,-0.662125340599455,-0.17457993323048776
4959,21057,Cumberland,Kentucky,2000,736,2220,50,3006,0.24484364604125083,0.7385229540918163,0.0166333998669328,0,0,0,0,0.0,0.0,0.0,-1484,0,-0.4936793080505655,0.0
4960,21057,Cumberland,Kentucky,2004,848,2356,35,3239,0.2618092003704847,0.7273849953689411,0.010805804260574252,112,-15,136,233,0.016965554329233884,-0.005827595606358548,-0.011137958722875263,-1508,-24,-0.46557579499845636,0.02810351305210912
4961,21057,Cumberland,Kentucky,2008,697,2056,44,2797,0.2491955666785842,0.735073292813729,0.015731140507686807,-151,9,-300,-442,-0.012613633691900522,0.004925336247112555,0.007688297444787939,-1359,149,-0.4858777261351448,-0.020301931136688434
4962,21057,Cumberland,Kentucky,2012,599,2216,39,2854,0.20988086895585142,0.7764540995094604,0.013665031534688158,-98,-5,160,57,-0.03931469772273277,-0.002066108972998649,0.04138080669573141,-1617,-258,-0.566573230553609,-0.08069550441846418
4963,21057,Cumberland,Kentucky,2016,459,2502,105,3066,0.149706457925636,0.8160469667318982,0.03424657534246575,-140,66,286,212,-0.060174411030215424,0.020581543807777596,0.03959286722243782,-2043,-426,-0.6663405088062623,-0.0997672782526533
4964,21059,Daviess,Kentucky,2000,14126,21361,753,36240,0.38979028697571744,0.5894315673289183,0.02077814569536424,0,0,0,0,0.0,0.0,0.0,-7235,0,-0.1996412803532009,0.0
4965,21059,Daviess,Kentucky,2004,15788,25372,323,41483,0.3805896391292819,0.6116240387628668,0.007786322107851409,1662,-430,4011,5243,-0.009200647846435539,-0.01299182358751283,0.022192471433948424,-9584,-2349,-0.23103439963358485,-0.03139311928038396
4966,21059,Daviess,Kentucky,2008,19282,23692,648,43622,0.4420246664527073,0.543120443812755,0.014854889734537618,3494,325,-1680,2139,0.06143502732342543,0.0070685676266862086,-0.06850359495011171,-4410,5174,-0.10109577736004771,0.12993862227353714
4967,21059,Daviess,Kentucky,2012,16208,25092,787,42087,0.38510704017867753,0.5961935989735547,0.01869936084776772,-3074,139,1400,-1535,-0.0569176262740298,0.003844471113230101,0.05307315516079969,-8884,-4474,-0.2110865587948772,-0.10999078143482949
4968,21059,Daviess,Kentucky,2016,14163,28907,2737,45807,0.3091885519680398,0.6310607549064553,0.059750693125504836,-2045,1950,3815,3720,-0.07591848821063774,0.04105133227773712,0.03486715593290057,-14744,-5860,-0.3218722029384155,-0.11078564414353831
4969,21061,Edmonson,Kentucky,2000,1710,3250,35,4995,0.34234234234234234,0.6506506506506506,0.007007007007007007,0,0,0,0,0.0,0.0,0.0,-1540,0,-0.3083083083083083,0.0
4970,21061,Edmonson,Kentucky,2004,1856,3595,30,5481,0.3386243386243386,0.6559022076263455,0.005473453749315818,146,-5,345,486,-0.0037180037180037373,-0.0015335532576911887,0.005251556975694904,-1739,-199,-0.31727786900200694,-0.008969560693698642
4971,21061,Edmonson,Kentucky,2008,1652,3562,56,5270,0.31347248576850095,0.6759013282732448,0.01062618595825427,-204,26,-33,-211,-0.025151852855837653,0.005152732208938451,0.019999120646899238,-1910,-171,-0.36242884250474383,-0.04515097350273689
4972,21061,Edmonson,Kentucky,2012,1374,3232,62,4668,0.2943444730077121,0.6923736075407027,0.013281919451585262,-278,6,-330,-602,-0.01912801276078885,0.0026557334933309928,0.016472279267457868,-1858,52,-0.39802913453299055,-0.035600292028246716
4973,21061,Edmonson,Kentucky,2016,979,4135,130,5244,0.18668954996186118,0.7885202135774219,0.02479023646071701,-395,68,903,576,-0.10765492304585092,0.011508317009131748,0.0961466060367192,-3156,-1298,-0.6018306636155607,-0.20380152908257015
4974,21063,Elliott,Kentucky,2000,1525,827,29,2381,0.6404871902561948,0.3473330533389332,0.012179756404871903,0,0,0,0,0.0,0.0,0.0,698,0,0.2931541369172616,0.0
4975,21063,Elliott,Kentucky,2004,2064,871,22,2957,0.6980047345282381,0.294555292526209,0.0074399729455529254,539,-7,44,576,0.05751754427204325,-0.004739783459318978,-0.05277776081272423,1193,495,0.4034494420020291,0.11029530508476748
4976,21063,Elliott,Kentucky,2008,1535,902,78,2515,0.610337972166998,0.35864811133200797,0.031013916500994037,-529,56,31,-442,-0.08766676236124005,0.02357394355544111,0.06409281880579898,633,-560,0.25168986083499006,-0.15175958116703903
4977,21063,Elliott,Kentucky,2012,1186,1126,87,2399,0.4943726552730304,0.46936223426427676,0.03626511046269279,-349,9,224,-116,-0.11596531689396761,0.005251193961698753,0.11071412293226879,60,-573,0.02501042100875367,-0.2266794398262364
4978,21063,Elliott,Kentucky,2016,740,2000,115,2855,0.2591943957968476,0.7005253940455342,0.040280210157618214,-446,28,874,456,-0.23517825947618282,0.004015099694925424,0.2311631597812574,-1260,-1320,-0.44133099824868655,-0.4663414192574402
4979,21065,Estill,Kentucky,2000,1591,3033,86,4710,0.33779193205944796,0.6439490445859872,0.018259023354564755,0,0,0,0,0.0,0.0,0.0,-1442,0,-0.30615711252653927,0.0
4980,21065,Estill,Kentucky,2004,1907,3633,35,5575,0.3420627802690583,0.6516591928251121,0.006278026905829596,316,-51,600,865,0.004270848209610323,-0.011980996448735159,0.007710148239124859,-1726,-284,-0.3095964125560538,-0.003439300029514536
4981,21065,Estill,Kentucky,2008,1555,3685,74,5314,0.2926232593150169,0.6934512608204743,0.013925479864508844,-352,39,52,-261,-0.04943952095404136,0.007647452958679248,0.04179206799536217,-2130,-404,-0.40082800150545733,-0.09123158894940353
4982,21065,Estill,Kentucky,2012,1356,3749,79,5184,0.26157407407407407,0.7231867283950617,0.015239197530864198,-199,5,64,-130,-0.031049185240942856,0.0013137176663553535,0.02973546757458745,-2393,-263,-0.46161265432098764,-0.060784652815530305
4983,21065,Estill,Kentucky,2016,1108,4236,201,5545,0.19981965734896304,0.763931469792606,0.03624887285843102,-248,122,487,361,-0.06175441672511103,0.021009675327566826,0.04074474139754425,-3128,-735,-0.564111812443643,-0.10249915812265531
4984,21067,Fayette,Kentucky,2000,47277,54495,3705,105477,0.4482209391620922,0.5166529195938451,0.035126141244062686,0,0,0,0,0.0,0.0,0.0,-7218,0,-0.06843198043175286,0.0
4985,21067,Fayette,Kentucky,2004,57994,66406,1176,125576,0.46182391539784673,0.5288112378161433,0.009364846786010066,10717,-2529,11911,20099,0.013602976235754516,-0.02576129445805262,0.012158318222298181,-8412,-1194,-0.06698732241829652,0.0014446580134563347
4986,21067,Fayette,Kentucky,2008,66042,59884,1722,127648,0.5173759087490599,0.4691338681373778,0.013490223113562296,8048,546,-6522,2072,0.05555199335121319,0.00412537632755223,-0.05967736967876547,6158,14570,0.048242040611682135,0.11522936302997866
4987,21067,Fayette,Kentucky,2012,62080,60795,2991,125866,0.493222951392751,0.4830136812165319,0.023763367390717112,-3962,1269,911,-1782,-0.0241529573563089,0.010273144277154816,0.01387981307915409,1285,-4873,0.010209270176219143,-0.03803277043546299
4988,21067,Fayette,Kentucky,2016,69778,56894,9643,136315,0.5118879066867182,0.41737152917874043,0.07074056413454131,7698,6652,-3901,10449,0.018664955293967223,0.0469771967438242,-0.06564215203779145,12884,11599,0.09451637750797781,0.08430710733175867
4989,21069,Fleming,Kentucky,2000,1813,3282,84,5179,0.35006758061401816,0.6337130720216257,0.016219347364356054,0,0,0,0,0.0,0.0,0.0,-1469,0,-0.2836454914076076,0.0
4990,21069,Fleming,Kentucky,2004,2406,3749,48,6203,0.38787683379010157,0.6043849750120909,0.007738191197807513,593,-36,467,1024,0.03780925317608341,-0.008481156166548542,-0.02932809700953487,-1343,126,-0.2165081412219893,0.06713735018561828
4991,21069,Fleming,Kentucky,2008,2279,3432,121,5832,0.3907750342935528,0.588477366255144,0.020747599451303157,-127,73,-317,-371,0.0028982005034512426,0.013009408253495645,-0.015907608756946856,-1153,190,-0.1977023319615912,0.0188058092603981
4992,21069,Fleming,Kentucky,2012,1911,3780,91,5782,0.3305084745762712,0.6537530266343826,0.015738498789346248,-368,-30,348,-50,-0.06026655971728162,-0.005009100661956908,0.0652756603792386,-1869,-716,-0.3232445520581114,-0.12554222009652022
4993,21069,Fleming,Kentucky,2016,1348,4722,190,6260,0.21533546325878594,0.7543130990415335,0.03035143769968051,-563,99,942,478,-0.11517301131748525,0.014612938910334262,0.10056007240715092,-3374,-1505,-0.5389776357827476,-0.21573308372463618
4994,21071,Floyd,Kentucky,2000,10088,5068,238,15394,0.6553202546446667,0.3292191763024555,0.015460569052877744,0,0,0,0,0.0,0.0,0.0,5020,0,0.3261010783422112,0.0
4995,21071,Floyd,Kentucky,2004,11132,6612,141,17885,0.6224210232038021,0.3696952753704221,0.00788370142577579,1044,-97,1544,2491,-0.032899231440864596,-0.007576867627101955,0.04047609906796662,4520,-500,0.25272574783338,-0.07337533050883122
4996,21071,Floyd,Kentucky,2008,7530,7741,388,15659,0.480873619005045,0.49434829810332714,0.024778082891627817,-3602,247,1129,-2226,-0.1415474041987571,0.016894381465852027,0.12465302273290502,-211,-4731,-0.01347467909828215,-0.2662004269316621
4997,21071,Floyd,Kentucky,2012,4733,9784,373,14890,0.3178643384822028,0.6570852921423774,0.025050369375419743,-2797,-15,2043,-769,-0.1630092805228422,0.0002722864837919267,0.1627369940390503,-5051,-4840,-0.33922095366017463,-0.3257462745618925
4998,21071,Floyd,Kentucky,2016,4015,11993,532,16540,0.24274486094316808,0.7250906892382104,0.03216444981862152,-718,159,2209,1650,-0.07511947753903472,0.007114080443201779,0.06800539709583298,-7978,-2927,-0.48234582829504236,-0.14312487463486773
4999,21073,Franklin,Kentucky,2000,10853,10209,592,21654,0.5012007019488316,0.471460238293156,0.027339059758012377,0,0,0,0,0.0,0.0,0.0,644,0,0.02974046365567562,0.0
5000,21073,Franklin,Kentucky,2004,11620,12281,232,24133,0.4814983632370613,0.5088882443127668,0.009613392450171964,767,-360,2072,2479,-0.019702338711770295,-0.017725667307840413,0.03742800601961083,-661,-1305,-0.027389881075705502,-0.05713034473138112
5001,21073,Franklin,Kentucky,2008,11767,11911,401,24079,0.4886830848457162,0.4946633996428423,0.016653515511441504,147,169,-370,-54,0.007184721608654909,0.00704012306126954,-0.014224844669924519,-144,517,-0.005980314797126074,0.02140956627857943
5002,21073,Franklin,Kentucky,2012,11535,11345,457,23337,0.49427947036894204,0.4861378926168745,0.019582637014183484,-232,56,-566,-742,0.005596385523225833,0.00292912150274198,-0.008525507025967771,190,334,0.00814157775206753,0.014121892549193604
5003,21073,Franklin,Kentucky,2016,10717,11819,1329,23865,0.44906767232348627,0.49524408129059294,0.055688246385920806,-818,872,474,528,-0.045211798045455776,0.03610560937173732,0.00910618867371843,-1102,-1292,-0.046176408967106675,-0.054317986719174205
5004,21075,Fulton,Kentucky,2000,1452,1293,43,2788,0.5208034433285509,0.46377331420373025,0.015423242467718794,0,0,0,0,0.0,0.0,0.0,159,0,0.05703012912482064,0.0
5005,21075,Fulton,Kentucky,2004,1340,1527,23,2890,0.46366782006920415,0.5283737024221453,0.00795847750865052,-112,-20,234,102,-0.057135623259346735,-0.007464764959068275,0.06460038821841507,-187,-346,-0.06470588235294117,-0.12173601147776181
5006,21075,Fulton,Kentucky,2008,1238,1530,57,2825,0.4382300884955752,0.5415929203539823,0.020176991150442476,-102,34,3,-65,-0.02543773157362894,0.012218513641791957,0.013219217931837002,-292,-105,-0.10336283185840711,-0.03865694950546594
5007,21075,Fulton,Kentucky,2012,1022,1425,34,2481,0.41193067311567916,0.5743651753325272,0.013704151551793631,-216,-23,-105,-344,-0.02629941537989605,-0.006472839598648845,0.03277225497854486,-403,-111,-0.16243450221684802,-0.05907167035844091
5008,21075,Fulton,Kentucky,2016,774,1549,59,2382,0.3249370277078086,0.6502938706968934,0.02476910159529807,-248,25,124,-99,-0.08699364540787058,0.011064950043504438,0.0759286953643662,-775,-372,-0.3253568429890848,-0.16292234077223677
5009,21077,Gallatin,Kentucky,2000,1049,1345,65,2459,0.4265961773078487,0.5469703131354209,0.026433509556730378,0,0,0,0,0.0,0.0,0.0,-296,0,-0.12037413582757217,0.0
5010,21077,Gallatin,Kentucky,2004,1188,1869,16,3073,0.38659290595509277,0.6082004555808656,0.005206638464041653,139,-49,524,614,-0.04000327135275594,-0.021226871092688726,0.06123014244544467,-681,-385,-0.22160754962577278,-0.10123341379820061
5011,21077,Gallatin,Kentucky,2008,1278,1840,75,3193,0.4002505480739117,0.5762605699968681,0.02348888192922017,90,59,-29,120,0.013657642118818925,0.018282243465178517,-0.03193988558399741,-562,119,-0.17601002192295645,0.04559752770281633
5012,21077,Gallatin,Kentucky,2012,1238,1758,65,3061,0.40444299248611565,0.5743221169552434,0.021234890558640966,-40,-10,-82,-132,0.004192444412203955,-0.002253991370579203,-0.0019384530416247658,-520,42,-0.16987912446912773,0.006130897453828721
5013,21077,Gallatin,Kentucky,2016,749,2443,146,3338,0.2243858597962852,0.7318753744757339,0.04373876572798083,-489,81,685,277,-0.18005713268983045,0.02250387516933986,0.15755325752049054,-1694,-1174,-0.5074895146794487,-0.33761039021032097
5014,21079,Garrard,Kentucky,2000,1713,4043,67,5823,0.29417825862957236,0.6943156448566031,0.011506096513824489,0,0,0,0,0.0,0.0,0.0,-2330,0,-0.40013738622703077,0.0
5015,21079,Garrard,Kentucky,2004,1841,4784,33,6658,0.27650946230099127,0.7185340943226194,0.0049564433763893065,128,-34,741,835,-0.017668796328581093,-0.006549653137435182,0.024218449466016256,-2943,-613,-0.4420246320216281,-0.04188724579459735
5016,21079,Garrard,Kentucky,2008,2012,5118,80,7210,0.27905686546463243,0.7098474341192788,0.011095700416088766,171,47,334,552,0.00254740316364116,0.006139257039699459,-0.008686660203340635,-3106,-163,-0.4307905686546463,0.011234063366981795
5017,21079,Garrard,Kentucky,2012,1661,5310,106,7077,0.23470397060901513,0.7503179313268334,0.014978098064151476,-351,26,192,-133,-0.0443528948556173,0.0038823976480627104,0.04047049720755469,-3649,-543,-0.5156139607178183,-0.08482339206317197
5018,21079,Garrard,Kentucky,2016,1453,5904,266,7623,0.19060737242555426,0.7744982290436836,0.03489439853076217,-208,160,594,546,-0.04409659818346087,0.019916300466610692,0.024180297716850152,-4451,-802,-0.5838908566181293,-0.06827689590031105
5019,21081,Grant,Kentucky,2000,2568,4405,130,7103,0.3615373785724342,0.6201604955652541,0.0183021258623117,0,0,0,0,0.0,0.0,0.0,-1837,0,-0.2586231169928199,0.0
5020,21081,Grant,Kentucky,2004,2818,5951,55,8824,0.31935630099728013,0.6744106980961015,0.006233000906618314,250,-75,1546,1721,-0.04218107757515405,-0.012069124955693386,0.05425020253084745,-3133,-1296,-0.3550543970988214,-0.0964312801060015
5021,21081,Grant,Kentucky,2008,3112,5510,132,8754,0.35549463102581674,0.6294265478638337,0.015078821110349555,294,77,-441,-70,0.036138330028536614,0.008845820203731241,-0.04498415023226787,-2398,735,-0.27393191683801693,0.08112248026080449
5022,21081,Grant,Kentucky,2012,2810,5664,134,8608,0.32644052044609667,0.6579925650557621,0.015566914498141264,-302,2,154,-146,-0.02905411057972007,0.0004880933877917087,0.028566017191928417,-2854,-456,-0.3315520446096654,-0.05762012777164849
5023,21081,Grant,Kentucky,2016,1910,7268,381,9559,0.19981169578407784,0.7603305785123967,0.03985772570352547,-900,247,1604,951,-0.12662882466201883,0.024290811205384205,0.10233801345663462,-5358,-2504,-0.5605188827283188,-0.22896683811865343
5024,21083,Graves,Kentucky,2000,6097,7849,285,14231,0.42843089030988685,0.5515424074204202,0.020026702269692925,0,0,0,0,0.0,0.0,0.0,-1752,0,-0.12311151711053331,0.0
5025,21083,Graves,Kentucky,2004,6206,9903,120,16229,0.3824018731899686,0.6102039558814468,0.007394170928584632,109,-165,2054,1998,-0.04602901711991825,-0.012632531341108293,0.05866154846102667,-3697,-1945,-0.22780208269147822,-0.10469056558094492
5026,21083,Graves,Kentucky,2008,5843,10056,256,16155,0.36168368926029093,0.6224698235840297,0.015846487155679358,-363,136,153,-74,-0.02071818392967767,0.008452316227094726,0.012265867702582867,-4213,-516,-0.26078613432373876,-0.032984051632260536
5027,21083,Graves,Kentucky,2012,4547,10699,257,15503,0.29329807134103075,0.6901244920337999,0.016577436625169324,-1296,1,643,-652,-0.06838561791926018,0.0007309494694899658,0.0676546684497702,-6152,-1939,-0.39682642069276913,-0.13604028636903037
5028,21083,Graves,Kentucky,2016,3308,12671,627,16606,0.19920510658798024,0.7630374563410816,0.03775743707093822,-1239,370,1972,1103,-0.09409296475305051,0.021180000445768895,0.07291296430728167,-9363,-3211,-0.5638323497531013,-0.16700592906033213
5029,21085,Grayson,Kentucky,2000,2604,5843,111,8558,0.3042767001635896,0.6827529796681467,0.012970320168263614,0,0,0,0,0.0,0.0,0.0,-3239,0,-0.37847627950455714,0.0
5030,21085,Grayson,Kentucky,2004,2905,7170,68,10143,0.2864044168391994,0.7068914522330672,0.006704130927733412,301,-43,1327,1585,-0.01787228332439017,-0.006266189240530202,0.02413847256492041,-4265,-1026,-0.4204870353938677,-0.04201075588931058
5031,21085,Grayson,Kentucky,2008,3154,6605,144,9903,0.31848934666262746,0.6669696051701505,0.014541048167222055,249,76,-565,-240,0.03208492982342803,0.007836917239488643,-0.03992184706291668,-3451,814,-0.348480258507523,0.07200677688634471
5032,21085,Grayson,Kentucky,2012,2744,6404,123,9271,0.29597670154244415,0.6907561212382699,0.013267177219285945,-410,-21,-201,-632,-0.022512645120183306,-0.0012738709479361097,0.023786516068119434,-3660,-209,-0.39477941969582575,-0.04629916118830274
5033,21085,Grayson,Kentucky,2016,1959,8219,398,10576,0.18523071104387293,0.7771369137670197,0.03763237518910741,-785,275,1815,1305,-0.11074599049857123,0.024365197969821468,0.08638079252874975,-6260,-2600,-0.5919062027231468,-0.197126783027321
5034,21087,Green,Kentucky,2000,1085,3615,56,4756,0.22813288477712362,0.7600925147182507,0.011774600504625737,0,0,0,0,0.0,0.0,0.0,-2530,0,-0.5319596299411271,0.0
5035,21087,Green,Kentucky,2004,1312,3866,28,5206,0.2520169035728006,0.742604686899731,0.005378409527468306,227,-28,251,450,0.023884018795676976,-0.006396190977157431,-0.017487827818519652,-2554,-24,-0.4905877833269304,0.04137184661419668
5036,21087,Green,Kentucky,2008,1204,3785,90,5079,0.23705453829493994,0.7452254380783618,0.01772002362669817,-108,62,-81,-127,-0.014962365277860656,0.012341614099229865,0.002620751178630809,-2581,-27,-0.5081708997834219,-0.017583116456491465
5037,21087,Green,Kentucky,2012,1165,3634,57,4856,0.23990939044481055,0.7483525535420099,0.011738056013179572,-39,-33,-151,-223,0.002854852149870607,-0.005981967613518598,0.003127115463648078,-2469,112,-0.5084431630971994,-0.0002722633137774988
5038,21087,Green,Kentucky,2016,832,4372,129,5333,0.15600975060941308,0.8198012375773486,0.024189011813238327,-333,72,738,477,-0.08389963983539747,0.012450955800058755,0.07144868403533866,-3540,-1071,-0.6637914869679356,-0.15534832387073616
5039,21089,Greenup,Kentucky,2000,7164,7233,266,14663,0.48857668962695217,0.4932824115119689,0.018140898861078905,0,0,0,0,0.0,0.0,0.0,-69,0,-0.004705721885016723,0.0
5040,21089,Greenup,Kentucky,2004,7630,8696,109,16435,0.46425311834499544,0.5291146942500761,0.006632187404928506,466,-157,1463,1772,-0.024323571281956724,-0.0115087114561504,0.03583228273810718,-1066,-997,-0.06486157590508063,-0.060155854020063904
5041,21089,Greenup,Kentucky,2008,6621,8849,328,15798,0.41910368401063425,0.5601341942017977,0.020762121787568047,-1009,219,153,-637,-0.045149434334361194,0.014129934382639542,0.031019499951721596,-2228,-1162,-0.14103051019116342,-0.07616893428608279
5042,21089,Greenup,Kentucky,2012,6027,8855,286,15168,0.3973496835443038,0.5837948312236287,0.01885548523206751,-594,-42,6,-630,-0.02175400046633047,-0.0019066365555005377,0.023660637021831077,-2828,-600,-0.18644514767932496,-0.04541463748816155
5043,21089,Greenup,Kentucky,2016,4146,11546,585,16277,0.2547152423665295,0.7093444737973829,0.03594028383608773,-1881,299,2691,1109,-0.1426344411777743,0.01708479860402022,0.12554964257375412,-7400,-4572,-0.4546292314308534,-0.2681840837515284
5044,21091,Hancock,Kentucky,2000,1508,2032,70,3610,0.41772853185595565,0.5628808864265928,0.019390581717451522,0,0,0,0,0.0,0.0,0.0,-524,0,-0.1451523545706372,0.0
5045,21091,Hancock,Kentucky,2004,1709,2286,34,4029,0.424174733184413,0.5673864482501861,0.008438818565400843,201,-36,254,419,0.006446201328457357,-0.010951763152050679,0.004505561823593296,-577,-53,-0.14321171506577313,0.0019406395048640612
5046,21091,Hancock,Kentucky,2008,2135,1928,81,4144,0.5152027027027027,0.46525096525096526,0.019546332046332045,426,47,-358,115,0.09102796951828973,0.011107513480931202,-0.10213548299922087,207,784,0.04995173745173748,0.1931634525175106
5047,21091,Hancock,Kentucky,2012,1833,2212,89,4134,0.44339622641509435,0.5350749879051766,0.021528785679729077,-302,8,284,-10,-0.07180647628760839,0.0019824536333970313,0.06982402265421134,-379,-586,-0.09167876149008225,-0.14163049894181973
5048,21091,Hancock,Kentucky,2016,1244,2788,263,4295,0.289639115250291,0.649126891734575,0.061233993015133874,-589,174,576,161,-0.15375711116480334,0.039705207335404794,0.11405190382939845,-1544,-1165,-0.35948777648428404,-0.2678090149942018
5049,21093,Hardin,Kentucky,2000,11095,18964,631,30690,0.36151840990550665,0.617921146953405,0.020560443141088302,0,0,0,0,0.0,0.0,0.0,-7869,0,-0.2564027370478984,0.0
5050,21093,Hardin,Kentucky,2004,11507,24627,307,36441,0.31577069784034467,0.6758047254466123,0.008424576713043001,412,-324,5663,5751,-0.04574771206516198,-0.012135866428045301,0.057883578493207244,-13120,-5251,-0.3600340276062676,-0.10363129055836923
5051,21093,Hardin,Kentucky,2008,15650,23896,444,39990,0.3913478369592398,0.5975493873468367,0.011102775693923482,4143,137,-731,3549,0.07557713911889513,0.0026781989808804807,-0.07825533809977558,-8246,4874,-0.2062015503875969,0.15383247721867072
5052,21093,Hardin,Kentucky,2012,15214,23357,647,39218,0.3879341118873986,0.5955683614666735,0.01649752664592789,-436,203,-539,-772,-0.0034137250718411782,0.005394750952004408,-0.001981025880163245,-8143,103,-0.20763424957927484,-0.001432699191677933
5053,21093,Hardin,Kentucky,2016,13944,26971,2241,43156,0.32310686810640465,0.6249652423764945,0.05192788951710075,-1270,1594,3614,3938,-0.06482724378099397,0.03543036287117286,0.029396880909821066,-13027,-4884,-0.3018583742700899,-0.09422412469081504
5054,21095,Harlan,Kentucky,2000,5365,4980,190,10535,0.5092548647365923,0.47271001423825343,0.018035121025154248,0,0,0,0,0.0,0.0,0.0,385,0,0.03654485049833889,0.0
5055,21095,Harlan,Kentucky,2004,4332,6659,79,11070,0.3913279132791328,0.601535682023487,0.007136404697380307,-1033,-111,1679,535,-0.11792695145745952,-0.010898716327773941,0.12882566778523352,-2327,-2712,-0.21020776874435415,-0.24675261924269304
5056,21095,Harlan,Kentucky,2008,2586,7165,163,9914,0.2608432519669155,0.722715352027436,0.01644139600564858,-1746,84,506,-1156,-0.1304846613122173,0.009304991308268272,0.12117967000394902,-4579,-2252,-0.4618721000605205,-0.25166433131616633
5057,21095,Harlan,Kentucky,2012,1830,8652,175,10657,0.1717181195458384,0.8118607488036033,0.016421131650558318,-756,12,1487,743,-0.08912513242107709,-2.0264355090261754e-05,0.08914539677616728,-6822,-2243,-0.6401426292577649,-0.1782705291972444
5058,21095,Harlan,Kentucky,2016,1372,9129,256,10757,0.12754485451334016,0.8486566886678442,0.023798456818815653,-458,81,477,100,-0.04417326503249824,0.007377325168257336,0.0367959398642409,-7757,-935,-0.721111834154504,-0.08096920489673909
5059,21097,Harrison,Kentucky,2000,2658,3793,160,6611,0.40205717743155345,0.5737407351384057,0.02420208743004084,0,0,0,0,0.0,0.0,0.0,-1135,0,-0.17168355770685229,0.0
5060,21097,Harrison,Kentucky,2004,2807,4855,69,7731,0.36308368904410815,0.6279912042426594,0.00892510671323244,149,-91,1062,1120,-0.0389734883874453,-0.0152769807168084,0.054250469104253685,-2048,-913,-0.26490751519855127,-0.09322395749169898
5061,21097,Harrison,Kentucky,2008,2916,4520,154,7590,0.3841897233201581,0.5955204216073782,0.020289855072463767,109,85,-335,-141,0.021106034276049956,0.011364748359231326,-0.03247078263528125,-1604,444,-0.21133069828722006,0.053576816911331204
5062,21097,Harrison,Kentucky,2012,2471,4556,136,7163,0.3449671925171018,0.6360463492949882,0.018986458187910095,-445,-18,36,-427,-0.03922253080305632,-0.0013033968845536717,0.040525927687609986,-2085,-481,-0.29107915677788637,-0.07974845849066631
5063,21097,Harrison,Kentucky,2016,2031,5435,315,7781,0.2610204343914664,0.6984963372317183,0.04048322837681532,-440,179,879,618,-0.0839467581256354,0.021496770188905223,0.06244998793673018,-3404,-1319,-0.43747590284025195,-0.14639674606236558
5064,21099,Hart,Kentucky,2000,2201,3725,93,6019,0.36567536135570694,0.6188735670377139,0.015451071606579166,0,0,0,0,0.0,0.0,0.0,-1524,0,-0.25319820568200696,0.0
5065,21099,Hart,Kentucky,2004,2470,4269,45,6784,0.36409198113207547,0.6292747641509434,0.006633254716981132,269,-48,544,765,-0.0015833802236314698,-0.008817816889598033,0.01040119711322951,-1799,-275,-0.26518278301886794,-0.01198457733686098
5066,21099,Hart,Kentucky,2008,2290,4397,131,6818,0.335875623349956,0.644910530947492,0.01921384570255207,-180,86,128,34,-0.02821635778211945,0.012580590985570936,0.015635766796548545,-2107,-308,-0.30903490759753593,-0.043852124578667995
5067,21099,Hart,Kentucky,2012,2283,4257,82,6622,0.3447598912715192,0.6428571428571429,0.012382965871337965,-7,-49,-140,-196,0.00888426792156316,-0.006830879831214104,-0.002053388090349051,-1974,133,-0.2980972515856237,0.010937656011912211
5068,21099,Hart,Kentucky,2016,1730,5320,214,7264,0.23816079295154186,0.7323788546255506,0.02946035242290749,-553,132,1063,642,-0.10659909831997733,0.017077386551569526,0.08952171176840773,-3590,-1616,-0.4942180616740088,-0.19612081008838506
5069,21101,Henderson,Kentucky,2000,8054,7698,287,16039,0.502151006920631,0.47995510942078684,0.017893883658582205,0,0,0,0,0.0,0.0,0.0,356,0,0.02219589749984413,0.0
5070,21101,Henderson,Kentucky,2004,8101,10467,133,18701,0.43318539115555316,0.5597026896957382,0.007111919148708625,47,-154,2769,2662,-0.06896561576507781,-0.01078196450987358,0.07974758027495138,-2366,-2722,-0.12651729854018506,-0.1487131960400292
5071,21101,Henderson,Kentucky,2008,10049,9523,289,19861,0.5059664669452696,0.47948240269875636,0.01455113035597402,1948,156,-944,1160,0.07278107578971643,0.007439211207265395,-0.08022028699698186,526,2892,0.026484064246513228,0.1530013627866983
5072,21101,Henderson,Kentucky,2012,8091,10296,235,18622,0.4344860917194716,0.5528944259478037,0.012619482332724734,-1958,-54,773,-1239,-0.07148037522579798,-0.0019316480232492855,0.07341202324904733,-2205,-2731,-0.11840833422833208,-0.1448923984748453
5073,21101,Henderson,Kentucky,2016,6707,12159,844,19710,0.3402841197361745,0.6168949771689498,0.0428209030948757,-1384,609,1863,1088,-0.0942019719832971,0.030201420762150964,0.06400055122114612,-5452,-3247,-0.2766108574327753,-0.15820252320444322
5074,21103,Henry,Kentucky,2000,2117,3244,112,5473,0.3868079663804129,0.5927279371459894,0.020464096473597662,0,0,0,0,0.0,0.0,0.0,-1127,0,-0.20591997076557644,0.0
5075,21103,Henry,Kentucky,2004,2366,4094,39,6499,0.3640560086167103,0.629943068164333,0.0060009232189567625,249,-73,850,1026,-0.022751957763702646,-0.0144631732546409,0.03721513101834362,-1728,-601,-0.2658870595476227,-0.05996708878204626
5076,21103,Henry,Kentucky,2008,2725,4081,113,6919,0.39384304090186445,0.589825119236884,0.016331839861251626,359,74,-13,420,0.02978703228515417,0.010330916642294864,-0.04011794892744902,-1356,372,-0.19598207833501952,0.06990498121260319
5077,21103,Henry,Kentucky,2012,2530,3940,120,6590,0.38391502276176026,0.5978755690440061,0.018209408194233688,-195,7,-141,-329,-0.009928018140104189,0.0018775683329820617,0.008050449807122106,-1410,-54,-0.2139605462822458,-0.017978467947226295
5078,21103,Henry,Kentucky,2016,1828,4944,377,7149,0.2557000979157924,0.6915652538816618,0.05273464820254581,-702,257,1004,559,-0.12821492484596786,0.03452524000831212,0.09368968483765572,-3116,-1706,-0.4358651559658694,-0.22190460968362358
5079,21105,Hickman,Kentucky,2000,940,1151,33,2124,0.4425612052730697,0.5419020715630886,0.015536723163841809,0,0,0,0,0.0,0.0,0.0,-211,0,-0.09934086629001887,0.0
5080,21105,Hickman,Kentucky,2004,926,1395,21,2342,0.39538855678906915,0.5956447480785654,0.008966695132365499,-14,-12,244,218,-0.047172648484000546,-0.00657002803147631,0.05374267651547682,-469,-258,-0.20025619128949623,-0.10091532499947736
5081,21105,Hickman,Kentucky,2008,812,1406,32,2250,0.36088888888888887,0.6248888888888889,0.014222222222222223,-114,11,11,-92,-0.034499667900180275,0.005255527089856724,0.02924414081032356,-594,-125,-0.26400000000000007,-0.06374380871050384
5082,21105,Hickman,Kentucky,2012,686,1431,22,2139,0.32071061243571763,0.6690042075736325,0.010285179990649837,-126,-10,25,-111,-0.040178276453171236,-0.003937042231572386,0.04411531868474361,-745,-151,-0.3482935951379149,-0.08429359513791485
5083,21105,Hickman,Kentucky,2016,449,1657,51,2157,0.20815948076031526,0.7681965693092258,0.02364394993045897,-237,29,226,18,-0.11255113167540237,0.013358769939809135,0.0991923617355932,-1208,-463,-0.5600370885489105,-0.21174349341099563
5084,21107,Hopkins,Kentucky,2000,6734,9490,265,16489,0.4083934744375038,0.5755352052883741,0.01607132027412214,0,0,0,0,0.0,0.0,0.0,-2756,0,-0.1671417308508703,0.0
5085,21107,Hopkins,Kentucky,2004,6420,12314,109,18843,0.34071007801305525,0.6535052804755082,0.0057846415114366076,-314,-156,2824,2354,-0.06768339642444854,-0.010286678762685533,0.07797007518713406,-5894,-3138,-0.3127952024624529,-0.1456534716115826
5086,21107,Hopkins,Kentucky,2008,7104,11916,328,19348,0.367169733305768,0.6158776100888981,0.016952656605333884,684,219,-398,505,0.02645965529271277,0.011168015093897275,-0.03762767038661008,-4812,1082,-0.24870787678313006,0.06408732567932285
5087,21107,Hopkins,Kentucky,2012,5789,13681,297,19767,0.2928618404411393,0.6921131178226336,0.015025041736227046,-1315,-31,1765,419,-0.07430789286462874,-0.001927614869106838,0.07623550773373555,-7892,-3080,-0.39925127738149435,-0.1505434005983643
5088,21107,Hopkins,Kentucky,2016,4310,15277,758,20345,0.21184566232489555,0.7508970262963873,0.03725731137871713,-1479,461,1596,578,-0.08101617811624373,0.02223226964249008,0.0587839084737537,-10967,-3075,-0.5390513639714918,-0.13980008658999743
5089,21109,Jackson,Kentucky,2000,701,4079,75,4855,0.1443872296601442,0.8401647785787848,0.015447991761071062,0,0,0,0,0.0,0.0,0.0,-3378,0,-0.6957775489186406,0.0
5090,21109,Jackson,Kentucky,2004,769,4369,40,5178,0.1485129393588258,0.8437620702974121,0.00772499034376207,68,-35,290,323,0.004125709698681618,-0.007723001417308991,0.0035972917186273268,-3600,-222,-0.6952491309385863,0.0005284179800543187
5091,21109,Jackson,Kentucky,2008,743,4407,74,5224,0.1422281776416539,0.8436064318529862,0.014165390505359877,-26,34,38,46,-0.006284761717171905,0.006440400161597807,-0.00015563844442589847,-3664,-64,-0.7013782542113323,-0.006129123272745951
5092,21109,Jackson,Kentucky,2012,612,4365,84,5061,0.12092471843509188,0.8624777711914642,0.016597510373443983,-131,10,-42,-163,-0.021303459206562028,0.0024321198680841063,0.018871339338477955,-3753,-89,-0.7415530527563723,-0.040174798545040025
5093,21109,Jackson,Kentucky,2016,482,4889,130,5501,0.08762043264860934,0.8887475004544628,0.02363206689692783,-130,46,524,440,-0.033304285786482535,0.007034556523483847,0.026269729262998642,-4407,-654,-0.8011270678058535,-0.05957401504948123
5094,21111,Jefferson,Kentucky,2000,149901,145052,7409,302362,0.4957666638003453,0.47972959565024703,0.024503740549407665,0,0,0,0,0.0,0.0,0.0,4849,0,0.016037068150098255,0.0
5095,21111,Jefferson,Kentucky,2004,170158,164566,2845,337569,0.5040687977865266,0.4875032956225246,0.008427906590948813,20257,-4564,19514,35207,0.008302133986181293,-0.01607583395845885,0.007773699972277559,5592,743,0.01656550216400199,0.0005284340139037336
5096,21111,Jefferson,Kentucky,2008,196435,153957,4544,354936,0.5534378028715036,0.43375988910676855,0.012802308021727861,26277,1699,-10609,17367,0.04936900508497699,0.004374401430779048,-0.05374340651575604,42478,36886,0.11967791376473502,0.10311241160073303
5097,21111,Jefferson,Kentucky,2012,186181,148423,5808,340412,0.5469284279050092,0.43600989389328226,0.017061678201708518,-10254,1264,-5534,-14524,-0.006509374966494397,0.004259370179980657,0.002250004786513715,37758,-4720,0.11091853401172691,-0.008759379753008112
5098,21111,Jefferson,Kentucky,2016,190836,143768,18495,353099,0.5404603241583805,0.4071605980192524,0.0523790778223671,4655,12687,-4655,12687,-0.006468103746628651,0.03531739962065858,-0.028849295874029846,47068,9310,0.1332997261391281,0.022381192127401195
5099,21113,Jessamine,Kentucky,2000,4633,10074,354,15061,0.3076156961689131,0.6688798884536219,0.023504415377464977,0,0,0,0,0.0,0.0,0.0,-5441,0,-0.3612641922847088,0.0
5100,21113,Jessamine,Kentucky,2004,5476,12972,132,18580,0.29472551130247576,0.6981700753498385,0.007104413347685684,843,-222,2898,3519,-0.012890184866437338,-0.016400002029779294,0.029290186896216652,-7496,-2055,-0.4034445640473628,-0.04218037176265399
5101,21113,Jessamine,Kentucky,2008,6236,13711,267,20214,0.308499060057386,0.6782922726822994,0.013208667260314633,760,135,739,1634,0.013773548754910214,0.006104253912628949,-0.019877802667539135,-7475,21,-0.36979321262491344,0.03365135142244935
5102,21113,Jessamine,Kentucky,2012,6001,14233,399,20633,0.290844763243348,0.6898172829932632,0.019337953763388746,-235,132,522,419,-0.017654296814037962,0.006129286503074113,0.011525010310963757,-8232,-757,-0.39897251974991516,-0.02917930712500172
5103,21113,Jessamine,Kentucky,2016,6144,15474,1708,23326,0.2633970676498328,0.663379919403241,0.07322301294692618,143,1309,1241,2693,-0.02744769559351523,0.053885059183537434,-0.026437363590022134,-9330,-1098,-0.39998285175340825,-0.0010103320034930974
5104,21115,Johnson,Kentucky,2000,3251,4783,146,8180,0.39743276283618584,0.5847188264058679,0.01784841075794621,0,0,0,0,0.0,0.0,0.0,-1532,0,-0.18728606356968208,0.0
5105,21115,Johnson,Kentucky,2004,3288,5940,76,9304,0.35339638865004297,0.6384350816852966,0.00816852966466036,37,-70,1157,1124,-0.04403637418614287,-0.00967988109328585,0.05371625527942869,-2652,-1120,-0.28503869303525364,-0.09775262946557156
5106,21115,Johnson,Kentucky,2008,2407,5948,162,8517,0.2826112480920512,0.698367969942468,0.019020781965480803,-881,86,8,-787,-0.07078514055799179,0.010852252300820443,0.05993288825717136,-3541,-889,-0.4157567218504168,-0.13071802881516315
5107,21115,Johnson,Kentucky,2012,1723,7095,217,9035,0.1907028223574986,0.7852794687327062,0.02401770890979524,-684,55,1147,518,-0.09190842573455257,0.004996926944314438,0.08691149879023818,-5372,-1831,-0.5945766463752076,-0.17881992452479079
5108,21115,Johnson,Kentucky,2016,1250,8043,279,9572,0.13058921855411618,0.8402632678646051,0.02914751358127873,-473,62,948,537,-0.06011360380338243,0.0051298046714834886,0.05498379913189899,-6793,-1421,-0.7096740493104889,-0.11509740293528137
5109,21117,Kenton,Kentucky,2000,19100,35363,1786,56249,0.3395615922060837,0.6286867322085726,0.03175167558534374,0,0,0,0,0.0,0.0,0.0,-16263,0,-0.28912514000248896,0.0
5110,21117,Kenton,Kentucky,2004,22834,43664,625,67123,0.34018145792053395,0.6505072776842513,0.009311264395214755,3734,-1161,8301,10874,0.0006198657144502739,-0.022440411190128982,0.021820545475678688,-20830,-4567,-0.31032581976371737,-0.021200679761228414
5111,21117,Kenton,Kentucky,2008,26480,40714,1019,68213,0.38819579845484,0.5968657000864938,0.014938501458666237,3646,394,-2950,1090,0.04801434053430603,0.005627237063451482,-0.05364157759775756,-14234,6596,-0.20866990163165378,0.1016559181320636
5112,21117,Kenton,Kentucky,2012,24920,41389,1395,67704,0.3680727874276261,0.6113228169679783,0.020604395604395604,-1560,376,675,-509,-0.020123011027213866,0.005665894145729367,0.014457116881484544,-16469,-2235,-0.2432500295403522,-0.03458012790869841
5113,21117,Kenton,Kentucky,2016,24214,42958,4826,71998,0.33631489763604544,0.5966554626517403,0.06702963971221423,-706,3431,1569,4294,-0.031757889791580673,0.04642524410781863,-0.014667354316238002,-18744,-2275,-0.26034056501569486,-0.017090535475342672
5114,21119,Knott,Kentucky,2000,4349,2029,80,6458,0.6734283059770827,0.3141839578816971,0.012387736141220192,0,0,0,0,0.0,0.0,0.0,2320,0,0.3592443480953856,0.0
5115,21119,Knott,Kentucky,2004,4685,2648,61,7394,0.633621855558561,0.35812821206383555,0.008249932377603462,336,-19,619,936,-0.03980645041852171,-0.0041378037636167295,0.04394425418213843,2037,-283,0.27549364349472544,-0.08375070460066014
5116,21119,Knott,Kentucky,2008,2612,3070,138,5820,0.44879725085910654,0.5274914089347079,0.023711340206185566,-2073,77,422,-1574,-0.18482460469945444,0.015461407828582104,0.16936319687087237,-458,-2495,-0.07869415807560137,-0.3541878015703268
5117,21119,Knott,Kentucky,2012,1420,4130,143,5693,0.24942912348498156,0.725452309854207,0.025118566660811522,-1192,5,1060,-127,-0.199368127374125,0.001407226454625956,0.19796090091949903,-2710,-2252,-0.47602318636922536,-0.397329028293624
5118,21119,Knott,Kentucky,2016,1245,4357,161,5763,0.21603331598125977,0.7560298455665452,0.027936838452195037,-175,18,227,70,-0.033395807503721786,0.002818271791383515,0.030577535712338233,-3112,-402,-0.5399965295852854,-0.06397334321606007
5119,21121,Knox,Kentucky,2000,3690,6058,162,9910,0.37235116044399597,0.6113017154389505,0.016347124117053483,0,0,0,0,0.0,0.0,0.0,-2368,0,-0.23895055499495454,0.0
5120,21121,Knox,Kentucky,2004,3822,8108,98,12028,0.3177585633521782,0.674093781177253,0.008147655470568673,132,-64,2050,2118,-0.05459259709181774,-0.00819946864648481,0.06279206573830254,-4286,-1918,-0.3563352178250748,-0.11738466283012028
5121,21121,Knox,Kentucky,2008,3074,8150,165,11389,0.2699095618579331,0.715602774607077,0.014487663534989903,-748,67,42,-639,-0.04784900149424515,0.00634000806442123,0.04150899342982395,-5076,-790,-0.4456932127491439,-0.0893579949240691
5122,21121,Knox,Kentucky,2012,2484,8467,149,11100,0.22378378378378377,0.7627927927927928,0.013423423423423423,-590,-16,317,-289,-0.046125778074149304,-0.0010642401115664793,0.047190018185715776,-5983,-907,-0.5390090090090089,-0.09331579625986502
5123,21121,Knox,Kentucky,2016,1761,9885,366,12012,0.1466033966033966,0.8229270729270729,0.030469530469530468,-723,217,1418,912,-0.07718038718038717,0.017046107046107047,0.06013428013428013,-8124,-2141,-0.6763236763236763,-0.13731466731466735
5124,21123,LaRue,Kentucky,2000,1727,3384,68,5179,0.33346205831241554,0.653407993821201,0.013129947866383471,0,0,0,0,0.0,0.0,0.0,-1657,0,-0.3199459355087854,0.0
5125,21123,LaRue,Kentucky,2004,1823,4111,34,5968,0.3054624664879357,0.6888404825737265,0.005697050938337802,96,-34,727,789,-0.027999591824479864,-0.007432896928045669,0.03543248875252558,-2288,-631,-0.38337801608579086,-0.06343208057700545
5126,21123,LaRue,Kentucky,2008,1913,4153,112,6178,0.30964713499514407,0.6722240207186791,0.018128844286176757,90,78,42,210,0.004184668507208389,0.012431793347838956,-0.016616461855047393,-2240,48,-0.3625768857235351,0.020801130362255782
5127,21123,LaRue,Kentucky,2012,1733,3911,120,5764,0.3006592643997224,0.6785218598195697,0.020818875780707843,-180,8,-242,-414,-0.008987870595421665,0.002690031494531085,0.0062978391008905454,-2178,62,-0.3778625954198473,-0.01528570969631221
5128,21123,LaRue,Kentucky,2016,1278,4799,290,6367,0.20072247526307524,0.7537301711952253,0.045547353541699385,-455,170,888,603,-0.09993678913664716,0.024728477760991543,0.07520831137565565,-3521,-1343,-0.5530076959321502,-0.17514510051230286
5129,21125,Laurel,Kentucky,2000,4856,13029,235,18120,0.26799116997792494,0.7190397350993377,0.012969094922737307,0,0,0,0,0.0,0.0,0.0,-8173,0,-0.4510485651214128,0.0
5130,21125,Laurel,Kentucky,2004,5297,16819,148,22264,0.23791771469637082,0.7554347826086957,0.006647502694933525,441,-87,3790,4144,-0.030073455281554112,-0.006321592227803782,0.03639504750935796,-11522,-3349,-0.5175170679123249,-0.0664685027909121
5131,21125,Laurel,Kentucky,2008,4618,17660,222,22500,0.20524444444444445,0.7848888888888889,0.009866666666666666,-679,74,841,236,-0.03267327025192637,0.0032191639717331407,0.029454106280193182,-13042,-1520,-0.5796444444444444,-0.06212737653211953
5132,21125,Laurel,Kentucky,2012,3905,18151,352,22408,0.17426811852909674,0.8100232059978579,0.01570867547304534,-713,130,491,-92,-0.030976325915347713,0.005842008806378675,0.025134317108969073,-14246,-1204,-0.6357550874687612,-0.056110643024316786
5133,21125,Laurel,Kentucky,2016,3440,20592,801,24833,0.1385253493335481,0.8292191841501229,0.03225546651632908,-465,449,2441,2425,-0.03574276919554864,0.01654679104328374,0.019195978152264925,-17152,-2906,-0.6906938348165748,-0.054938747347813566
5134,21127,Lawrence,Kentucky,2000,2258,2969,80,5307,0.4254757866968155,0.5594497833050688,0.015074429998115696,0,0,0,0,0.0,0.0,0.0,-711,0,-0.13397399660825327,0.0
5135,21127,Lawrence,Kentucky,2004,2705,3755,53,6513,0.41532319975433746,0.57653922923384,0.00813757101182251,447,-27,786,1206,-0.010152586942478059,-0.006936858986293187,0.017089445928771263,-1050,-339,-0.1612160294795026,-0.027242032871249322
5136,21127,Lawrence,Kentucky,2008,2036,3503,110,5649,0.36041777305717826,0.6201097539387502,0.019472473004071518,-669,57,-252,-864,-0.0549054266971592,0.011334901992249008,0.043570524704910185,-1467,-417,-0.25969198088157197,-0.09847595140206938
5137,21127,Lawrence,Kentucky,2012,1520,3995,77,5592,0.2718168812589413,0.7144134477825465,0.01376967095851216,-516,-33,492,-57,-0.08860089179823694,-0.005702802045559358,0.09430369384379622,-2475,-1008,-0.44259656652360513,-0.18290458564203316
5138,21127,Lawrence,Kentucky,2016,1045,4816,181,6042,0.17295597484276728,0.797087057265806,0.02995696789142668,-475,104,821,450,-0.09886090641617404,0.01618729693291452,0.08267360948325952,-3771,-1296,-0.6241310824230387,-0.1815345158994336
5139,21129,Lee,Kentucky,2000,836,1893,35,2764,0.3024602026049204,0.684876989869754,0.012662807525325614,0,0,0,0,0.0,0.0,0.0,-1057,0,-0.3824167872648336,0.0
5140,21129,Lee,Kentucky,2004,878,2018,24,2920,0.30068493150684933,0.6910958904109589,0.00821917808219178,42,-11,125,156,-0.001775271098071074,-0.0044436294431338345,0.006218900541204886,-1140,-83,-0.39041095890410954,-0.00799417163927596
5141,21129,Lee,Kentucky,2008,752,1978,43,2773,0.2711864406779661,0.7133068878470971,0.015506671474936892,-126,19,-40,-147,-0.029498490828883228,0.0072874933927451115,0.02221099743613819,-1226,-86,-0.44212044716913096,-0.05170948826502142
5142,21129,Lee,Kentucky,2012,595,1977,51,2623,0.22683949675943577,0.7537171178040412,0.019443385436523065,-157,8,-1,-150,-0.044346943918530335,0.003936713961586173,0.0404102299569441,-1382,-156,-0.5268776210446053,-0.08475717387547438
5143,21129,Lee,Kentucky,2016,444,2151,72,2667,0.16647919010123735,0.8065241844769404,0.02699662542182227,-151,21,174,44,-0.060360306658198415,0.007553239985299207,0.05280706667289925,-1707,-325,-0.6400449943757031,-0.11316737333109772
5144,21131,Leslie,Kentucky,2000,1210,3159,65,4434,0.2728912945421741,0.7124492557510149,0.014659449706811005,0,0,0,0,0.0,0.0,0.0,-1949,0,-0.43955796120884083,0.0
5145,21131,Leslie,Kentucky,2004,1266,3661,37,4964,0.2550362610797744,0.7375100725221595,0.007453666398066076,56,-28,502,530,-0.017855033462399694,-0.007205783308744929,0.02506081677114458,-2395,-446,-0.4824738114423851,-0.04291585023354427
5146,21131,Leslie,Kentucky,2008,766,3574,57,4397,0.1742096884239254,0.8128269274505344,0.01296338412554014,-500,20,-87,-567,-0.080826572655849,0.005509717727474064,0.07531685492837492,-2808,-413,-0.638617239026609,-0.15614342758422395
5147,21131,Leslie,Kentucky,2012,433,4439,81,4953,0.08742176458711892,0.8962245103977388,0.01635372501514234,-333,24,865,556,-0.08678792383680647,0.003390340889602198,0.08339758294720434,-4006,-1198,-0.8088027458106198,-0.1701855067840108
5148,21131,Leslie,Kentucky,2016,400,4015,77,4492,0.08904719501335707,0.8938112199465716,0.01714158504007124,-33,-4,-424,-461,0.001625430426238153,0.0007878600249289006,-0.002413290451167116,-3615,391,-0.8047640249332145,0.004038720877405311
5149,21133,Letcher,Kentucky,2000,4698,4092,195,8985,0.5228714524207012,0.45542570951585976,0.021702838063439065,0,0,0,0,0.0,0.0,0.0,606,0,0.06744574290484145,0.0
5150,21133,Letcher,Kentucky,2004,4192,4801,72,9065,0.4624379481522339,0.529619415333701,0.007942636514065085,-506,-123,709,80,-0.06043350426846733,-0.01376020154937398,0.0741937058178413,-609,-1215,-0.06718146718146717,-0.13462721008630862
5151,21133,Letcher,Kentucky,2008,2623,5367,245,8235,0.31851851851851853,0.6517304189435337,0.029751062537947785,-1569,173,566,-830,-0.14391942963371535,0.0218084260238827,0.12211100360983262,-2744,-2135,-0.33321190042501514,-0.26603043324354797
5152,21133,Letcher,Kentucky,2012,1702,6811,245,8758,0.1943366065311715,0.7776889700844942,0.027974423384334323,-921,0,1444,523,-0.12418191198734704,-0.0017766391536134622,0.12595855114096055,-5109,-2365,-0.5833523635533228,-0.2501404631283076
5153,21133,Letcher,Kentucky,2016,1542,7293,299,9134,0.1688197941756076,0.7984453689511715,0.03273483687322093,-160,54,482,376,-0.025516812355563884,0.004760413488886606,0.02075639886667724,-5751,-642,-0.6296255747755639,-0.04627321122224115
5154,21135,Lewis,Kentucky,2000,1293,3217,58,4568,0.2830560420315236,0.704246935201401,0.012697022767075307,0,0,0,0,0.0,0.0,0.0,-1924,0,-0.4211908931698774,0.0
5155,21135,Lewis,Kentucky,2004,1667,3778,39,5484,0.3039752005835157,0.6889132020423049,0.007111597374179431,374,-19,561,916,0.020919158551992056,-0.005585425392895875,-0.015333733159096141,-2111,-187,-0.3849380014587892,0.0362528917110882
5156,21135,Lewis,Kentucky,2008,1510,3213,68,4791,0.31517428511792944,0.6706324358171571,0.01419327906491338,-157,29,-565,-693,0.011199084534413761,0.007081681690733949,-0.018280766225147738,-1703,408,-0.3554581506992277,0.0294798507595615
5157,21135,Lewis,Kentucky,2012,1342,3326,101,4769,0.2814007129377228,0.6974208429440134,0.021178444118263785,-168,33,113,-22,-0.03377357218020666,0.0069851650533504055,0.026788407126856262,-1984,-281,-0.4160201300062906,-0.06056197930706292
5158,21135,Lewis,Kentucky,2016,785,4363,150,5298,0.14816912042280106,0.823518308795772,0.028312570781426953,-557,49,1037,529,-0.13323159251492173,0.007134126663163168,0.12609746585175863,-3578,-1594,-0.675349188372971,-0.25932905836668035
5159,21137,Lincoln,Kentucky,2000,2678,4795,124,7597,0.3525075687771489,0.6311701987626694,0.016322232460181652,0,0,0,0,0.0,0.0,0.0,-2117,0,-0.27866262998552055,0.0
5160,21137,Lincoln,Kentucky,2004,2796,5996,71,8863,0.3154688028884125,0.6765203655647072,0.008010831546880289,118,-53,1201,1266,-0.03703876588873639,-0.008311400913301363,0.04535016680203774,-3200,-1083,-0.3610515626762947,-0.08238893269077413
5161,21137,Lincoln,Kentucky,2008,2752,6273,126,9151,0.30073216041962625,0.685498852584417,0.013768986995956725,-44,55,277,288,-0.014736642468786254,0.005758155449076437,0.008978487019709824,-3521,-321,-0.38476669216479076,-0.02371512948849608
5162,21137,Lincoln,Kentucky,2012,2582,6416,154,9152,0.2821241258741259,0.701048951048951,0.016826923076923076,-170,28,143,1,-0.018608034545500363,0.0030579360809663506,0.015550098464534035,-3834,-313,-0.41892482517482516,-0.0341581330100344
5163,21137,Lincoln,Kentucky,2016,1865,7338,358,9561,0.19506327789980127,0.7674929400690305,0.037443782031168285,-717,204,922,409,-0.08706084797432462,0.02061685895424521,0.06644398902007942,-5473,-1639,-0.5724296621692292,-0.15350483699440404
5164,21139,Livingston,Kentucky,2000,2022,2118,90,4230,0.47801418439716314,0.500709219858156,0.02127659574468085,0,0,0,0,0.0,0.0,0.0,-96,0,-0.02269503546099283,0.0
5165,21139,Livingston,Kentucky,2004,2007,2675,24,4706,0.426476838079048,0.5684232894177645,0.005099872503187421,-15,-66,557,476,-0.05153734631811513,-0.01617672324149343,0.06771406955960857,-668,-572,-0.14194645133871653,-0.1192514158777237
5166,21139,Livingston,Kentucky,2008,1622,2890,81,4593,0.35314609187894624,0.6292183757892446,0.017635532331809273,-385,57,215,-113,-0.07333074620010177,0.012535659828621853,0.06079508637148001,-1268,-600,-0.2760722839102983,-0.13412583257158178
5167,21139,Livingston,Kentucky,2012,1346,3089,76,4511,0.298381733540235,0.6847705608512525,0.016847705608512526,-276,-5,199,-82,-0.05476435833871124,-0.0007878267232967473,0.055552185062007986,-1743,-475,-0.38638882731101754,-0.11031654340071922
5168,21139,Livingston,Kentucky,2016,887,3570,188,4645,0.19095801937567278,0.7685683530678149,0.040473627556512376,-459,112,481,134,-0.10742371416456223,0.02362592194799985,0.08379779221656236,-2683,-940,-0.5776103336921421,-0.19122150638112456
5169,21141,Logan,Kentucky,2000,3885,5344,103,9332,0.41630947278182595,0.5726532361765967,0.011037291041577368,0,0,0,0,0.0,0.0,0.0,-1459,0,-0.15634376339477074,0.0
5170,21141,Logan,Kentucky,2004,3768,6815,61,10644,0.35400225479143177,0.6402668169860954,0.005730928222472754,-117,-42,1471,1312,-0.06230721799039418,-0.005306362819104613,0.06761358080949875,-3047,-1588,-0.2862645621946637,-0.12992079879989293
5171,21141,Logan,Kentucky,2008,3811,6925,154,10890,0.3499540863177227,0.6359044995408631,0.014141414141414142,43,93,110,246,-0.004048168473709091,0.008410485918941387,-0.0043623174452323,-3114,-67,-0.28595041322314046,0.0003141489715232093
5172,21141,Logan,Kentucky,2012,3469,6899,142,10510,0.3300666032350143,0.6564224548049477,0.01351094196003806,-342,-12,-26,-380,-0.01988748308270838,-0.0006304721813760825,0.02051795526408451,-3430,-316,-0.32635585156993335,-0.04040543834679289
5173,21141,Logan,Kentucky,2016,2755,7778,366,10899,0.25277548398935684,0.7136434535278466,0.03358106248279659,-714,224,879,389,-0.07729111924565746,0.020070120522758528,0.057220998722898986,-5023,-1593,-0.4608679695384898,-0.13451211796855644
5174,21143,Lyon,Kentucky,2000,1680,1688,52,3420,0.49122807017543857,0.4935672514619883,0.0152046783625731,0,0,0,0,0.0,0.0,0.0,-8,0,-0.002339181286549752,0.0
5175,21143,Lyon,Kentucky,2004,1769,2132,24,3925,0.45070063694267515,0.5431847133757962,0.006114649681528662,89,-28,444,505,-0.04052743323276342,-0.009090028681044436,0.04961746191380789,-363,-355,-0.09248407643312107,-0.09014489514657131
5176,21143,Lyon,Kentucky,2008,1577,2220,58,3855,0.40907911802853436,0.5758754863813229,0.015045395590142672,-192,34,88,-70,-0.04162151891414079,0.00893074590861401,0.032690773005526697,-643,-280,-0.16679636835278855,-0.07431229191966748
5177,21143,Lyon,Kentucky,2012,1373,2412,54,3839,0.35764522010940347,0.6282886168272988,0.014066163063297733,-204,-4,192,-16,-0.05143389791913089,-0.0009792325268449392,0.05241313044597584,-1039,-396,-0.2706433967178953,-0.10384702836510673
5178,21143,Lyon,Kentucky,2016,1045,2789,128,3962,0.2637556789500252,0.7039374053508329,0.03230691569914185,-328,74,377,123,-0.09388954115937825,0.018240752635844112,0.07564878852353418,-1744,-705,-0.4401817264008077,-0.16953832968291244
5179,21145,McCracken,Kentucky,2000,11412,14745,532,26689,0.42759189179062534,0.5524748023530294,0.019933305856345312,0,0,0,0,0.0,0.0,0.0,-3333,0,-0.12488291056240403,0.0
5180,21145,McCracken,Kentucky,2004,11361,18218,218,29797,0.3812799946303319,0.6114038326005974,0.007316172769070712,-51,-314,3473,3108,-0.046311897160293436,-0.0126171330872746,0.058929030247568015,-6857,-3524,-0.23012383797026548,-0.10524092740786145
5181,21145,McCracken,Kentucky,2008,11285,19043,426,30754,0.36694413734798725,0.6192040059829615,0.01385185666905118,-76,208,825,957,-0.014335857282344655,0.006535683899980468,0.007800173382364162,-7758,-901,-0.2522598686349743,-0.022136030664708817
5182,21145,McCracken,Kentucky,2012,10062,19979,510,30551,0.32935092141010114,0.6539556806651173,0.016693397924781514,-1223,84,936,-203,-0.037593215937886115,0.002841541255730334,0.034751674682155786,-9917,-2159,-0.3246047592550162,-0.0723448906200419
5183,21145,McCracken,Kentucky,2016,9134,20774,1399,31307,0.29175583735266875,0.6635576708084454,0.04468649183888587,-928,889,795,756,-0.03759508405743239,0.02799309391410436,0.009601990143328076,-11640,-1723,-0.37180183345577666,-0.04719707420076047
5184,21147,McCreary,Kentucky,2000,1418,3321,60,4799,0.2954782246301313,0.6920191706605543,0.012502604709314441,0,0,0,0,0.0,0.0,0.0,-1903,0,-0.396540946030423,0.0
5185,21147,McCreary,Kentucky,2004,1530,4121,42,5693,0.26875109783945195,0.7238714210433866,0.007377481117161426,112,-18,800,894,-0.026727126790679345,-0.005125123592153015,0.03185225038283235,-2591,-688,-0.4551203232039347,-0.05857937717351169
5186,21147,McCreary,Kentucky,2008,1258,4078,71,5407,0.23266136489735528,0.7542075087849085,0.013131126317736268,-272,29,-43,-286,-0.036089732942096664,0.005753645200574841,0.030336087741521855,-2820,-229,-0.5215461438875533,-0.06642582068361857
5187,21147,McCreary,Kentucky,2012,1069,4564,74,5707,0.18731382512703698,0.7997196425442439,0.012966532328719117,-189,3,486,300,-0.0453475397703183,-0.0001645939890171505,0.04551213375933538,-3495,-675,-0.6124058174172069,-0.09085967352965363
5188,21147,McCreary,Kentucky,2016,664,5012,100,5776,0.1149584487534626,0.8677285318559557,0.01731301939058172,-405,26,448,69,-0.07235537637357438,0.004346487061862601,0.06800888931171178,-4348,-853,-0.752770083102493,-0.14036426568528615
5189,21149,McLean,Kentucky,2000,1747,2219,56,4022,0.43436101442068625,0.5517155643958229,0.0139234211834908,0,0,0,0,0.0,0.0,0.0,-472,0,-0.11735454997513667,0.0
5190,21149,McLean,Kentucky,2004,1823,2584,28,4435,0.41104847801578354,0.5826381059751973,0.006313416009019166,76,-28,365,413,-0.023312536404902717,-0.007610005174471635,0.030922541579374352,-761,-289,-0.17158962795941374,-0.05423507798427707
5191,21149,McLean,Kentucky,2008,1963,2386,73,4422,0.44391677973767524,0.5395748530076888,0.016508367254635913,140,45,-198,-13,0.0328683017218917,0.010194951245616746,-0.04306325296750846,-423,338,-0.09565807327001358,0.07593155468940016
5192,21149,McLean,Kentucky,2012,1432,2705,63,4200,0.34095238095238095,0.6440476190476191,0.015,-531,-10,319,-222,-0.10296439878529429,-0.001508367254635913,0.10447276603993028,-1273,-850,-0.30309523809523814,-0.20743716482522456
5193,21149,McLean,Kentucky,2016,988,3381,197,4566,0.21638195356986423,0.740473061760841,0.04314498466929479,-444,134,676,366,-0.12457042738251672,0.02814498466929479,0.09642544271322195,-2393,-1120,-0.5240911081909768,-0.22099587009573868
5194,21151,Madison,Kentucky,2000,9309,13682,675,23666,0.39334910842558946,0.5781289613791938,0.028521930195216767,0,0,0,0,0.0,0.0,0.0,-4373,0,-0.18477985295360433,0.0
5195,21151,Madison,Kentucky,2004,11525,18922,260,30707,0.3753215879115511,0.6162112873286222,0.00846712475982675,2216,-415,5240,7041,-0.01802752051403833,-0.020054805435390018,0.0380823259494284,-7397,-3024,-0.24088969941707106,-0.05610984646346673
5196,21151,Madison,Kentucky,2008,12392,19694,451,32537,0.38085871469404065,0.6052801426068783,0.013861142699081046,867,191,772,1830,0.005537126782489521,0.005394017939254297,-0.010931144721743835,-7302,95,-0.2244214279128377,0.016468271504233356
5197,21151,Madison,Kentucky,2012,11512,21128,682,33322,0.3454774623371946,0.634055578896825,0.020466958765980432,-880,231,1434,785,-0.03538125235684603,0.006605816066899386,0.02877543628994661,-9616,-2314,-0.28857811655963034,-0.06415668864679264
5198,21151,Madison,Kentucky,2016,11793,23431,2147,37371,0.31556554547643895,0.6269834898718257,0.057450964651735305,281,1465,2303,4049,-0.029911916860755672,0.03698400588575487,-0.0070720890249992285,-11638,-2022,-0.3114179443953868,-0.022839827835756443
5199,21153,Magoffin,Kentucky,2000,2603,2785,65,5453,0.47735191637630664,0.5107280396112232,0.0119200440124702,0,0,0,0,0.0,0.0,0.0,-182,0,-0.03337612323491651,0.0
5200,21153,Magoffin,Kentucky,2004,2843,2836,39,5718,0.4972018188177684,0.4959776145505421,0.006820566631689402,240,-26,51,265,0.019849902441461786,-0.005099477380780797,-0.014750425060681027,7,189,0.0012242042672263032,0.034600327502142814
5201,21153,Magoffin,Kentucky,2008,2105,2434,112,4651,0.4525908406794238,0.5233283164910771,0.024080842829499034,-738,73,-402,-1067,-0.04461097813834464,0.01726027619780963,0.027350701940535016,-329,-336,-0.07073747581165335,-0.07196168007887965
5202,21153,Magoffin,Kentucky,2012,1433,3391,82,4906,0.2920913167549939,0.6911944557684468,0.016714227476559314,-672,-30,957,255,-0.1604995239244299,-0.007366615352939719,0.1678661392773697,-1958,-1629,-0.39910313901345296,-0.3283656632017996
5203,21153,Magoffin,Kentucky,2016,1172,3824,120,5116,0.2290852228303362,0.7474589523064894,0.023455824863174355,-261,38,433,210,-0.0630060939246577,0.0067415973866150405,0.05626449653804255,-2652,-694,-0.5183737294761532,-0.11927059046270028
5204,21155,Marion,Kentucky,2000,2778,3259,139,6176,0.4498056994818653,0.5276878238341969,0.022506476683937824,0,0,0,0,0.0,0.0,0.0,-481,0,-0.0778821243523316,0.0
5205,21155,Marion,Kentucky,2004,3399,3905,50,7354,0.4621974435681262,0.5310035354908893,0.006799020940984498,621,-89,646,1178,0.012391744086260925,-0.015707455742953326,0.0033157116566924216,-506,-25,-0.0688060919227631,0.009076032429568504
5206,21155,Marion,Kentucky,2008,3596,3842,177,7615,0.472225869993434,0.5045305318450427,0.02324359816152331,197,127,-63,261,0.010028426425307824,0.01644457722053881,-0.026473003645846593,-246,260,-0.032304661851608685,0.03650143007115442
5207,21155,Marion,Kentucky,2012,3418,3800,100,7318,0.4670675047827275,0.5192675594424706,0.013664935774801858,-178,-77,-42,-297,-0.005158365210706506,-0.009578662386721452,0.014737027597427899,-382,-136,-0.05220005465974309,-0.019895392808134404
5208,21155,Marion,Kentucky,2016,2679,5122,310,8111,0.3302921957835039,0.6314881025767476,0.03821970163974849,-739,210,1322,793,-0.13677530899922363,0.024554765864946634,0.11222054313427698,-2443,-2061,-0.3011959067932437,-0.24899585213350062
5209,21157,Marshall,Kentucky,2000,6203,7294,264,13761,0.4507666593997529,0.5300486883220696,0.019184652278177457,0,0,0,0,0.0,0.0,0.0,-1091,0,-0.07928202892231673,0.0
5210,21157,Marshall,Kentucky,2004,6383,9049,89,15521,0.4112492751755686,0.5830165582114555,0.005734166612975968,180,-175,1755,1760,-0.039517384224184327,-0.01345048566520149,0.052967869889385844,-2666,-1575,-0.1717672830358869,-0.09248525411357017
5211,21157,Marshall,Kentucky,2008,5683,9512,292,15487,0.36695292826241366,0.6141925485891393,0.018854523148447086,-700,203,463,-34,-0.04429634691315493,0.013120356535471119,0.031175990377683815,-3829,-1163,-0.24723962032672564,-0.07547233729083874
5212,21157,Marshall,Kentucky,2012,5022,10402,295,15719,0.3194859723901011,0.6617469304663146,0.018767097143584197,-661,3,890,232,-0.04746695587231253,-8.742600486288943e-05,0.04755438187717531,-5380,-1551,-0.3422609580762135,-0.09502133774948784
5213,21157,Marshall,Kentucky,2016,3672,12322,704,16698,0.21990657563780094,0.7379326865492873,0.04216073781291173,-1350,409,1920,979,-0.09957939675230018,0.02339364066932753,0.07618575608297273,-8650,-3270,-0.5180261109114864,-0.17576515283527294
5214,21159,Martin,Kentucky,2000,1714,2667,75,4456,0.3846499102333932,0.5985188509874326,0.016831238779174147,0,0,0,0,0.0,0.0,0.0,-953,0,-0.21386894075403945,0.0
5215,21159,Martin,Kentucky,2004,1504,2996,39,4539,0.331350517735184,0.6600572813395021,0.008592200925313946,-210,-36,329,83,-0.0532993924982092,-0.0082390378538602,0.06153843035206952,-1492,-539,-0.32870676360431816,-0.11483782285027871
5216,21159,Martin,Kentucky,2008,808,2824,60,3692,0.218851570964247,0.7648970747562297,0.016251354279523293,-696,21,-172,-847,-0.11249894677093697,0.007659153354209346,0.10483979341672756,-2016,-524,-0.5460455037919827,-0.21733874018766453
5217,21159,Martin,Kentucky,2012,574,3180,70,3824,0.15010460251046026,0.8315899581589958,0.018305439330543932,-234,10,356,132,-0.06874696845378675,0.0020540850510206397,0.06669288340276613,-2606,-590,-0.6814853556485356,-0.13543985185655294
5218,21159,Martin,Kentucky,2016,363,3503,87,3953,0.09182899064002024,0.8861624082974956,0.02200860106248419,-211,17,323,129,-0.05827561187044002,0.0037031617319402584,0.05457245013849976,-3140,-534,-0.7943334176574753,-0.11284806200893971
5219,21161,Mason,Kentucky,2000,2178,3572,123,5873,0.37084965094500255,0.6082070492082411,0.020943299846756344,0,0,0,0,0.0,0.0,0.0,-1394,0,-0.23735739826323854,0.0
5220,21161,Mason,Kentucky,2004,2644,4381,54,7079,0.37349908179121344,0.618872722135895,0.007628196072891651,466,-69,809,1206,0.0026494308462108873,-0.013315103773864693,0.010665672927653858,-1737,-343,-0.2453736403446815,-0.00801624208144297
5221,21161,Mason,Kentucky,2008,2891,4102,128,7121,0.4059823058559191,0.576042690633338,0.017975003510742875,247,74,-279,42,0.03248322406470566,0.010346807437851224,-0.04283003150255693,-1211,526,-0.17006038477741892,0.0753132555672626
5222,21161,Mason,Kentucky,2012,2592,4197,92,6881,0.37668943467519256,0.609940415637262,0.013370149687545414,-299,-36,95,-240,-0.029292871180726543,-0.004604853823197461,0.03389772500392396,-1605,-394,-0.23325098096206942,-0.0631905961846505
5223,21161,Mason,Kentucky,2016,1970,4944,305,7219,0.272890982130489,0.6848593988086993,0.04224961906081175,-622,213,747,338,-0.10379845254470355,0.028879469373266332,0.0749189831714373,-2974,-1369,-0.41196841667821027,-0.17871743571614085
5224,21163,Meade,Kentucky,2000,3596,5319,156,9071,0.3964281777091831,0.586374159409106,0.017197662881710946,0,0,0,0,0.0,0.0,0.0,-1723,0,-0.18994598169992288,0.0
5225,21163,Meade,Kentucky,2004,3724,7152,75,10951,0.340060268468633,0.6530910419139805,0.00684868961738654,128,-81,1833,1880,-0.056367909240550074,-0.010348973264324407,0.06671688250487451,-3428,-1705,-0.31303077344534747,-0.12308479174542458
5226,21163,Meade,Kentucky,2008,4343,6691,172,11206,0.38756023558807784,0.5970908441906122,0.015348920221310012,619,97,-461,255,0.04749996711944482,0.008500230603923471,-0.056000197723368283,-2348,1080,-0.20953060860253436,0.1035001648428131
5227,21163,Meade,Kentucky,2012,4122,6606,188,10916,0.3776108464639062,0.6051667277390985,0.017222425796995237,-221,16,-85,-290,-0.009949389124171648,0.0018735055756852245,0.008075883548486318,-2484,-136,-0.22755588127519233,-0.018025272672657966
5228,21163,Meade,Kentucky,2016,3026,8660,545,12231,0.2474041370288611,0.7080369552775734,0.04455890769356553,-1096,357,2054,1315,-0.1302067094350451,0.027336481896570296,0.10287022753847486,-5634,-3150,-0.4606328182487123,-0.23307693697351994
5229,21165,Menifee,Kentucky,2000,1038,1170,41,2249,0.46153846153846156,0.5202312138728323,0.01823032458870609,0,0,0,0,0.0,0.0,0.0,-132,0,-0.05869275233437077,0.0
5230,21165,Menifee,Kentucky,2004,1284,1215,29,2528,0.5079113924050633,0.48061708860759494,0.011471518987341773,246,-12,45,279,0.04637293086660177,-0.006758805601364317,-0.03961412526523739,69,201,0.02729430379746839,0.08598705613183916
5231,21165,Menifee,Kentucky,2008,1276,1155,58,2489,0.5126556850140619,0.4640417838489353,0.023302531137002813,-8,29,-60,-39,0.004744292608998557,0.01183101214966104,-0.016575304758659648,121,52,0.048613901165126594,0.021319597367658205
5232,21165,Menifee,Kentucky,2012,1048,1484,66,2598,0.403387220939184,0.5712086220169361,0.025404157043879907,-228,8,329,109,-0.10926846407487789,0.0021016259068770936,0.10716683816800082,-436,-557,-0.16782140107775212,-0.2164353022428787
5233,21165,Menifee,Kentucky,2016,700,2010,69,2779,0.2518891687657431,0.723281756027348,0.02482907520690896,-348,3,526,181,-0.15149805217344092,-0.0005750818369709455,0.1520731340104119,-1310,-874,-0.47139258726160493,-0.3035711861838528
5234,21167,Mercer,Kentucky,2000,3092,5362,178,8632,0.35820203892493047,0.621177015755329,0.0206209453197405,0,0,0,0,0.0,0.0,0.0,-2270,0,-0.26297497683039855,0.0
5235,21167,Mercer,Kentucky,2004,3224,6745,59,10028,0.32149980055843635,0.6726166733147187,0.005883526126844834,132,-119,1383,1396,-0.03670223836649411,-0.014737419192895666,0.05143965755938973,-3521,-1251,-0.3511168727562824,-0.08814189592588384
5236,21167,Mercer,Kentucky,2008,3159,6781,120,10060,0.3140159045725646,0.6740556660039762,0.011928429423459244,-65,61,36,32,-0.007483895985871736,0.00604490329661441,0.0014389926892574012,-3622,-101,-0.36003976143141153,-0.008922888675129137
5237,21167,Mercer,Kentucky,2012,2966,6820,153,9939,0.29842036422175267,0.6861857329711238,0.015393902807123452,-193,33,39,-121,-0.015595540350811954,0.003465473383664208,0.01213006696714769,-3854,-232,-0.3877653687493712,-0.027725607317959644
5238,21167,Mercer,Kentucky,2016,2395,7740,450,10585,0.22626358053849788,0.7312234293811998,0.042512990080302314,-571,297,920,646,-0.07215678368325479,0.02711908727317886,0.045037696410075934,-5345,-1491,-0.5049598488427018,-0.11719448009333067
5239,21169,Metcalfe,Kentucky,2000,1318,2476,55,3849,0.3424266043128085,0.6432839698623019,0.014289425824889582,0,0,0,0,0.0,0.0,0.0,-1158,0,-0.3008573655494933,0.0
5240,21169,Metcalfe,Kentucky,2004,1472,2645,40,4157,0.3541015155159971,0.6362761606928073,0.009622323791195573,154,-15,169,308,0.011674911203188587,-0.004667102033694009,-0.0070078091694945055,-1173,-15,-0.28217464517681023,0.018682720372683093
5241,21169,Metcalfe,Kentucky,2008,1350,2734,115,4199,0.32150512026673017,0.6511074065253631,0.027387473207906646,-122,75,89,42,-0.03259639524926694,0.017765149416711073,0.014831245832555795,-1384,-211,-0.32960228625863297,-0.047427641081822736
5242,21169,Metcalfe,Kentucky,2012,1425,2676,83,4184,0.3405831739961759,0.6395793499043977,0.019837476099426387,75,-32,-58,-15,0.01907805372944571,-0.007549997108480259,-0.011528056620965454,-1251,133,-0.2989961759082218,0.030606110350411164
5243,21169,Metcalfe,Kentucky,2016,976,3491,153,4620,0.21125541125541125,0.7556277056277056,0.033116883116883114,-449,70,815,436,-0.12932776274076463,0.013279407017456727,0.11604835572330796,-2515,-1264,-0.5443722943722944,-0.2453761184640726
5244,21171,Monroe,Kentucky,2000,1158,4377,34,5569,0.2079367929610343,0.785957981684324,0.006105225354641767,0,0,0,0,0.0,0.0,0.0,-3219,0,-0.5780211887232897,0.0
5245,21171,Monroe,Kentucky,2004,1158,4657,28,5843,0.1981858634263221,0.7970220776998117,0.004792058873866164,0,-6,280,274,-0.009750929534712183,-0.0013131664807756026,0.011064096015487745,-3499,-280,-0.5988362142734895,-0.020815025550199873
5246,21171,Monroe,Kentucky,2008,1067,3537,61,4665,0.2287245444801715,0.7581993569131833,0.01307609860664523,-91,33,-1120,-1178,0.03053868105384938,0.008284039732779067,-0.038822720786628406,-2470,1029,-0.5294748124330118,0.06936140184047779
5247,21171,Monroe,Kentucky,2012,936,3762,48,4746,0.1972187104930468,0.7926675094816688,0.010113780025284451,-131,-13,225,81,-0.0315058339871247,-0.002962318581360779,0.034468152568485455,-2826,-356,-0.5954487989886219,-0.06597398655561015
5248,21171,Monroe,Kentucky,2016,601,4278,112,4991,0.1204167501502705,0.8571428571428571,0.02244039270687237,-335,64,516,245,-0.0768019603427763,0.012326612681587919,0.06447534766118834,-3677,-851,-0.7367261069925866,-0.14127730800396465
5249,21173,Montgomery,Kentucky,2000,3833,4534,152,8519,0.44993543843174083,0.5322220917948116,0.017842469773447587,0,0,0,0,0.0,0.0,0.0,-701,0,-0.08228665336307078,0.0
5250,21173,Montgomery,Kentucky,2004,4506,5647,77,10230,0.4404692082111437,0.5520039100684262,0.007526881720430108,673,-75,1113,1711,-0.009466230220597116,-0.01031558805301748,0.019781818273614582,-1141,-440,-0.11153470185728248,-0.029248048494211698
5251,21173,Montgomery,Kentucky,2008,4234,5947,150,10331,0.40983447875326684,0.5756461136385636,0.014519407608169587,-272,73,300,101,-0.030634729457876875,0.0069925258877394795,0.023642203570137355,-1713,-572,-0.1658116348852967,-0.05427693302801423
5252,21173,Montgomery,Kentucky,2012,3701,6398,149,10248,0.36114363778298203,0.6243169398907104,0.014539422326307573,-533,-1,451,-83,-0.04869084097028481,2.0014718137985332e-05,0.048670826252146804,-2697,-984,-0.2631733021077283,-0.09736166722243161
5253,21173,Montgomery,Kentucky,2016,3158,7856,438,11452,0.2757596926301083,0.6859937128885785,0.03824659448131331,-543,289,1458,1204,-0.08538394515287373,0.023707172155005736,0.06167677299786811,-4698,-2001,-0.41023402025847017,-0.14706071815074184
5254,21175,Morgan,Kentucky,2000,1875,2295,70,4240,0.44221698113207547,0.5412735849056604,0.01650943396226415,0,0,0,0,0.0,0.0,0.0,-420,0,-0.09905660377358488,0.0
5255,21175,Morgan,Kentucky,2004,2532,2682,58,5272,0.4802731411229135,0.5087253414264037,0.011001517450682853,657,-12,387,1032,0.03805615999083806,-0.005507916511581298,-0.03254824347925667,-150,270,-0.02845220030349016,0.07060440347009472
5256,21175,Morgan,Kentucky,2008,1879,2396,104,4379,0.4290934003197077,0.5471568851335922,0.02374971454670016,-653,46,-286,-893,-0.05117974080320581,0.012748197096017306,0.03843154370718849,-517,-367,-0.11806348481388446,-0.0896112845103943
5257,21175,Morgan,Kentucky,2012,1369,3021,82,4472,0.30612701252236135,0.6755366726296959,0.018336314847942754,-510,-22,625,93,-0.12296638779734637,-0.005413399698757405,0.12837978749610368,-1652,-1135,-0.3694096601073345,-0.25134617529345005
5258,21175,Morgan,Kentucky,2016,1006,3628,141,4775,0.2106806282722513,0.7597905759162303,0.029528795811518325,-363,59,607,303,-0.09544638425011004,0.011192480963575571,0.08425390328653448,-2622,-970,-0.549109947643979,-0.17970028753664452
5259,21177,Muhlenberg,Kentucky,2000,6295,5518,143,11956,0.5265138842422215,0.46152559384409503,0.011960521913683506,0,0,0,0,0.0,0.0,0.0,777,0,0.06498829039812642,0.0
5260,21177,Muhlenberg,Kentucky,2004,6636,6749,94,13479,0.49232138882706433,0.5007048000593516,0.006973811113584093,341,-49,1231,1523,-0.03419249541515712,-0.004986710800099412,0.03917920621525656,-113,-890,-0.008383411232287252,-0.07337170163041368
5261,21177,Muhlenberg,Kentucky,2008,6221,6447,221,12889,0.4826596322445496,0.5001939638451393,0.01714640391031112,-415,127,-302,-590,-0.009661756582514724,0.010172592796727026,-0.000510836214212329,-226,-113,-0.017534331600589648,-0.009150920368302395
5262,21177,Muhlenberg,Kentucky,2012,4771,7762,206,12739,0.37451919302928016,0.6093099929350813,0.01617081403563859,-1450,-15,1315,-150,-0.10814043921526945,-0.0009755898746725278,0.109116029089942,-2991,-2765,-0.2347907999058011,-0.21725646830521145
5263,21177,Muhlenberg,Kentucky,2016,3272,9393,395,13060,0.25053598774885144,0.719218989280245,0.03024502297090352,-1499,189,1631,321,-0.12398320528042872,0.01407420893526493,0.10990899634516371,-6121,-3130,-0.46868300153139353,-0.23389220162559243
5264,21179,Nelson,Kentucky,2000,5481,7714,293,13488,0.40636120996441283,0.5719157769869514,0.021723013048635824,0,0,0,0,0.0,0.0,0.0,-2233,0,-0.16555456702253857,0.0
5265,21179,Nelson,Kentucky,2004,6524,10161,159,16844,0.3873189266207552,0.6032415103300879,0.00943956304915697,1043,-134,2447,3356,-0.01904228334365765,-0.012283449999478854,0.031325733343136486,-3637,-1404,-0.2159225837093327,-0.05036801668679414
5266,21179,Nelson,Kentucky,2008,7654,10139,353,18146,0.4218009478672986,0.5587457290863,0.019453323046401412,1130,194,-22,1302,0.034482021246543426,0.010013759997244442,-0.044495781243787835,-2485,1152,-0.13694478121900144,0.07897780249033126
5267,21179,Nelson,Kentucky,2012,7611,10673,249,18533,0.41067285382830626,0.575891652727567,0.013435493444126693,-43,-104,534,387,-0.011128094038992342,-0.0060178296022747185,0.01714592364126699,-3062,-577,-0.16521879889926078,-0.028274017680259333
5268,21179,Nelson,Kentucky,2016,6434,13431,937,20802,0.3092971829631766,0.6456590712431497,0.045043745793673685,-1177,688,2758,2269,-0.10137567086512966,0.03160825234954699,0.06976741851558266,-6997,-3935,-0.3363618882799731,-0.17114308938071232
5269,21181,Nicholas,Kentucky,2000,994,1613,66,2673,0.37186681631126073,0.6034418256640479,0.024691358024691357,0,0,0,0,0.0,0.0,0.0,-619,0,-0.2315750093527872,0.0
5270,21181,Nicholas,Kentucky,2004,1332,1700,27,3059,0.435436417129781,0.5557371690094802,0.008826413860738803,338,-39,87,386,0.06356960081852026,-0.015864944163952552,-0.04770465665456769,-368,251,-0.12030075187969924,0.11127425747308795
5271,21181,Nicholas,Kentucky,2008,1272,1634,64,2970,0.42828282828282827,0.5501683501683502,0.02154882154882155,-60,37,-66,-89,-0.007153588846952719,0.012722407688082747,-0.00556881884113003,-362,6,-0.12188552188552193,-0.0015847700058226888
5272,21181,Nicholas,Kentucky,2012,948,1583,50,2581,0.3672994963192561,0.6133281673769857,0.019372336303758234,-324,-14,-51,-389,-0.06098333196357214,-0.0021764852450633157,0.0631598172086355,-635,-273,-0.24602867105772958,-0.12414314917220765
5273,21181,Nicholas,Kentucky,2016,787,1957,97,2841,0.2770151355156635,0.6888419570573742,0.03414290742696234,-161,47,374,260,-0.09028436080359264,0.014770571123204106,0.07551378968038847,-1170,-535,-0.4118268215417107,-0.1657981504839811
5274,21183,Ohio,Kentucky,2000,3303,5413,166,8882,0.3718757036703445,0.609434811979284,0.018689484350371537,0,0,0,0,0.0,0.0,0.0,-2110,0,-0.23755910830893945,0.0
5275,21183,Ohio,Kentucky,2004,3627,6311,90,10028,0.36168727562824093,0.6293378540087754,0.008974870362983646,324,-76,898,1146,-0.01018842804210357,-0.00971461398738789,0.019903042029491447,-2684,-574,-0.26765057838053447,-0.030091470071595017
5276,21183,Ohio,Kentucky,2008,4059,5687,192,9938,0.40843228013684846,0.5722479372107063,0.01931978265244516,432,102,-624,-90,0.046745004508607524,0.010344912289461515,-0.057089916798069074,-1628,1056,-0.16381565707385787,0.1038349213066766
5277,21183,Ohio,Kentucky,2012,2987,6470,189,9646,0.30966203607713044,0.6707443499896331,0.019593613933236574,-1072,-3,783,-292,-0.09877024405971802,0.0002738312807914131,0.09849641277892673,-3483,-1855,-0.3610823139125026,-0.19726665683864475
5278,21183,Ohio,Kentucky,2016,2080,7942,376,10398,0.20003846893633392,0.7638007309097904,0.036160800153875745,-907,187,1472,752,-0.10962356714079652,0.01656718622063917,0.09305638092015733,-5862,-2379,-0.5637622619734565,-0.20267994806095385
5279,21185,Oldham,Kentucky,2000,6236,13580,452,20268,0.3076771265048352,0.6700217090980857,0.02230116439707914,0,0,0,0,0.0,0.0,0.0,-7344,0,-0.3623445825932505,0.0
5280,21185,Oldham,Kentucky,2004,8080,18801,251,27132,0.29780333185905944,0.6929455992923486,0.009251068848592068,1844,-201,5221,6864,-0.009873794645775757,-0.013050095548487071,0.022923890194262886,-10721,-3377,-0.3951422674332891,-0.03279768484003864
5281,21185,Oldham,Kentucky,2008,10000,18997,319,29316,0.34111065629690274,0.6480079137672261,0.010881429935871196,1920,68,196,2184,0.0433073244378433,0.0016303610872791287,-0.04493768552512245,-8997,1724,-0.30689725747032337,0.08824500996296575
5282,21185,Oldham,Kentucky,2012,9240,20179,465,29884,0.3091955561504484,0.6752442778744479,0.015560165975103735,-760,146,1182,568,-0.03191510014645432,0.004678736039232538,0.027236364107221744,-10939,-1942,-0.36604872172399944,-0.05915146425367607
5283,21185,Oldham,Kentucky,2016,10268,20469,2116,32853,0.312543755517,0.6230481234590448,0.0644081210239552,1028,1651,290,2969,0.003348199366551563,0.04884795504885146,-0.05219615441540304,-10201,738,-0.31050436794204483,0.0555443537819546
5284,21187,Owen,Kentucky,2000,1394,2582,94,4070,0.34250614250614253,0.6343980343980344,0.023095823095823097,0,0,0,0,0.0,0.0,0.0,-1188,0,-0.2918918918918919,0.0
5285,21187,Owen,Kentucky,2004,1615,3084,42,4741,0.340645433452858,0.6504956760177177,0.008858890529424172,221,-52,502,671,-0.0018607090532845039,-0.014236932566398925,0.0160976416196833,-1469,-281,-0.3098502425648597,-0.017958350672967804
5286,21187,Owen,Kentucky,2008,1694,2969,88,4751,0.3565565144180173,0.6249210692485793,0.018522416333403496,79,46,-115,10,0.015911080965159252,0.009663525803979323,-0.025574606769138475,-1275,194,-0.268364554830562,0.04148568773429773
5287,21187,Owen,Kentucky,2012,1501,2971,85,4557,0.3293833662497257,0.651964011411016,0.018652622339258285,-193,-3,2,-194,-0.027173148168291583,0.00013020600585478964,0.027042942162436745,-1470,-195,-0.3225806451612903,-0.05421609033072833
5288,21187,Owen,Kentucky,2016,1062,3745,194,5001,0.21235752849430115,0.7488502299540092,0.038792241551689664,-439,109,774,444,-0.11702583775542455,0.02013961921243138,0.09688621854299317,-2683,-1213,-0.5364927014597081,-0.21391205629841775
5289,21189,Owsley,Kentucky,2000,339,1466,21,1826,0.18565169769989048,0.8028477546549836,0.011500547645125958,0,0,0,0,0.0,0.0,0.0,-1127,0,-0.6171960569550932,0.0
5290,21189,Owsley,Kentucky,2004,430,1558,11,1999,0.21510755377688845,0.7793896948474237,0.005502751375687844,91,-10,92,173,0.029455856076997966,-0.005997796269438114,-0.023458059807559883,-1128,-1,-0.5642821410705352,0.05291391588455796
5291,21189,Owsley,Kentucky,2008,381,1279,26,1686,0.22597864768683273,0.758600237247924,0.01542111506524318,-49,15,-279,-313,0.010871093909944285,0.009918363689555336,-0.020789457599499683,-898,230,-0.5326215895610913,0.03166055150944391
5292,21189,Owsley,Kentucky,2012,283,1279,18,1580,0.17911392405063292,0.8094936708860759,0.01139240506329114,-98,-8,0,-106,-0.04686472363619981,-0.0040287100019520405,0.05089343363815191,-996,-98,-0.6303797468354431,-0.09775815727435178
5293,21189,Owsley,Kentucky,2016,256,1474,29,1759,0.14553723706651506,0.8379761227970438,0.01648664013644116,-27,11,195,179,-0.033576686984117865,0.0050942350731500215,0.028482451910967876,-1218,-222,-0.6924388857305288,-0.06205913889508574
5294,21191,Pendleton,Kentucky,2000,1670,3044,89,4803,0.3476993545700604,0.633770560066625,0.018530085363314595,0,0,0,0,0.0,0.0,0.0,-1374,0,-0.2860712054965646,0.0
5295,21191,Pendleton,Kentucky,2004,1940,4045,40,6025,0.3219917012448133,0.6713692946058091,0.006639004149377593,270,-49,1001,1222,-0.025707653325247104,-0.011891081213937001,0.03759873453918405,-2105,-731,-0.3493775933609958,-0.06330638786443116
5296,21191,Pendleton,Kentucky,2008,2027,3676,99,5802,0.3493622888659083,0.6335746294381248,0.017063081695966906,87,59,-369,-223,0.02737058762109501,0.010424077546589312,-0.03779466516768426,-1649,456,-0.2842123405722165,0.06516525278877927
5297,21191,Pendleton,Kentucky,2012,1859,3556,119,5534,0.3359233827249729,0.6425731839537405,0.021503433321286593,-168,20,-120,-268,-0.013438906140935403,0.004440351625319687,0.008998554515615709,-1697,-48,-0.3066498012287676,-0.02243746065655111
5298,21191,Pendleton,Kentucky,2016,1164,4604,239,6007,0.1937739304145164,0.76643915431996,0.039786915265523554,-695,120,1048,473,-0.1421494523104565,0.01828348194423696,0.12386597036621949,-3440,-1743,-0.5726652239054436,-0.266015422676676
5299,21193,Perry,Kentucky,2000,5514,5300,186,11000,0.5012727272727273,0.4818181818181818,0.01690909090909091,0,0,0,0,0.0,0.0,0.0,214,0,0.019454545454545502,0.0
5300,21193,Perry,Kentucky,2004,5400,6187,68,11655,0.46332046332046334,0.5308451308451309,0.005834405834405834,-114,-118,887,655,-0.037952263952263976,-0.011074685074685075,0.04902694902694904,-787,-1001,-0.06752466752466751,-0.08697921297921302
5301,21193,Perry,Kentucky,2008,3444,6762,169,10375,0.33195180722891565,0.6517590361445783,0.016289156626506023,-1956,101,575,-1280,-0.1313686560915477,0.01045475079210019,0.12091390529944746,-3318,-2531,-0.31980722891566266,-0.25228256139099514
5302,21193,Perry,Kentucky,2012,2047,8040,154,10241,0.19988282394297432,0.7850795820720633,0.015037593984962405,-1397,-15,1278,-134,-0.13206898328594133,-0.001251562641543618,0.133320545927485,-5993,-2675,-0.585196758129089,-0.26538952921342635
5303,21193,Perry,Kentucky,2016,2136,8158,278,10572,0.20204313280363223,0.7716609912977677,0.026295875898600076,89,124,118,331,0.0021603088606579057,0.011258281913637671,-0.013418590774295636,-6022,-29,-0.5696178584941354,0.015578899634953625
5304,21195,Pike,Kentucky,2000,13611,11005,319,24935,0.5458592340084218,0.4413475035091237,0.012793262482454382,0,0,0,0,0.0,0.0,0.0,2606,0,0.10451173049929813,0.0
5305,21195,Pike,Kentucky,2004,14002,12611,157,26770,0.523048188270452,0.4710870377288009,0.005864774000747105,391,-162,1606,1835,-0.02281104573796988,-0.0069284884817072765,0.029739534219677177,1391,-1215,0.05196115054165107,-0.05255057995764706
5306,21195,Pike,Kentucky,2008,9525,12655,463,22643,0.4206598065627346,0.5588923729187828,0.020447820518482533,-4477,306,44,-4127,-0.10238838170771736,0.014583046517735428,0.0878053351899819,-3130,-4521,-0.1382325663560482,-0.19019371689769926
5307,21195,Pike,Kentucky,2012,5646,17590,400,23636,0.23887290573701134,0.7442037569808766,0.016923337282112032,-3879,-63,4935,993,-0.18178690082572327,-0.0035244832363705014,0.1853113840620938,-11944,-8814,-0.5053308512438652,-0.36709828488781704
5308,21195,Pike,Kentucky,2016,4280,19747,638,24665,0.1735252381917697,0.8006081491992703,0.025866612608960064,-1366,238,2157,1029,-0.06534766754524163,0.008943275326848032,0.05640439221839366,-15467,-3523,-0.6270829110075006,-0.12175205976363535
5309,21197,Powell,Kentucky,2000,2008,2258,96,4362,0.4603392939018799,0.5176524530032095,0.02200825309491059,0,0,0,0,0.0,0.0,0.0,-250,0,-0.057313159101329614,0.0
5310,21197,Powell,Kentucky,2004,2249,2687,24,4960,0.4534274193548387,0.541733870967742,0.004838709677419355,241,-72,429,598,-0.006911874547041175,-0.01716954341749124,0.024081417964532448,-438,-188,-0.08830645161290324,-0.030993292511573622
5311,21197,Powell,Kentucky,2008,2065,2837,70,4972,0.41532582461786,0.5705953338696702,0.01407884151246983,-184,46,150,12,-0.03810159473697872,0.009240131835050475,0.02886146290192826,-772,-334,-0.1552695092518102,-0.06696305763890698
5312,21197,Powell,Kentucky,2012,1620,2766,95,4481,0.3615264449899576,0.6172729301495202,0.021200624860522203,-445,25,-71,-491,-0.05379937962790238,0.007121783348052373,0.04667759627985002,-1146,-374,-0.2557464851595626,-0.1004769759077524
5313,21197,Powell,Kentucky,2016,1272,3513,172,4957,0.25660681864030666,0.7086947750655639,0.034698406294129513,-348,77,747,476,-0.10491962634965096,0.01349778143360731,0.09142184491604366,-2241,-1095,-0.45208795642525723,-0.19634147126569462
5314,21199,Pulaski,Kentucky,2000,5415,15845,281,21541,0.25138108722900515,0.7355740216331647,0.013044891137830184,0,0,0,0,0.0,0.0,0.0,-10430,0,-0.4841929344041595,0.0
5315,21199,Pulaski,Kentucky,2004,5829,19535,152,25516,0.22844489731932904,0.7655980561216491,0.00595704655902179,414,-129,3690,3975,-0.022936189909676108,-0.007087844578808394,0.030024034488484452,-13706,-3276,-0.5371531588023201,-0.05296022439816056
5316,21199,Pulaski,Kentucky,2008,5590,19862,314,25766,0.21695257315842584,0.7708608243421563,0.012186602499417838,-239,162,327,250,-0.011492324160903206,0.006229555940396048,0.005262768220507197,-14272,-566,-0.5539082511837304,-0.016755092381410375
5317,21199,Pulaski,Kentucky,2012,4976,20714,313,26003,0.19136253509210477,0.7966003922624313,0.012037072645463985,-614,-1,852,237,-0.02559003806632107,-0.00014952985395385275,0.025739567920274986,-15738,-1466,-0.6052378571703265,-0.05132960598659608
5318,21199,Pulaski,Kentucky,2016,4208,22902,931,28041,0.15006597482258122,0.8167326414892478,0.03320138368817089,-768,618,2188,2038,-0.04129656026952355,0.021164311042706906,0.020132249226816556,-18694,-2956,-0.6666666666666666,-0.06142880949634011
5319,21201,Robertson,Kentucky,2000,341,630,27,998,0.34168336673346694,0.6312625250501002,0.027054108216432865,0,0,0,0,0.0,0.0,0.0,-289,0,-0.2895791583166332,0.0
5320,21201,Robertson,Kentucky,2004,413,670,7,1090,0.37889908256880733,0.6146788990825688,0.006422018348623854,72,-20,40,92,0.03721571583534039,-0.02063208986780901,-0.01658362596753138,-257,32,-0.23577981651376145,0.05379934180287177
5321,21201,Robertson,Kentucky,2008,451,533,31,1015,0.44433497536945815,0.5251231527093596,0.030541871921182268,38,24,-137,-75,0.06543589280065082,0.024119853572558414,-0.08955574637320918,-82,175,-0.08078817733990146,0.15499163917386
5322,21201,Robertson,Kentucky,2012,340,579,16,935,0.36363636363636365,0.6192513368983957,0.017112299465240642,-111,-15,46,-80,-0.0806986117330945,-0.013429572455941625,0.09412818418903612,-239,-157,-0.2556149732620321,-0.17482679592213063
5323,21201,Robertson,Kentucky,2016,222,759,32,1013,0.21915103652517276,0.7492596248766041,0.0315893385982231,-118,16,180,78,-0.1444853271111909,0.014477039132982455,0.1300082879782084,-537,-298,-0.5301085883514314,-0.2744936150893993
5324,21203,Rockcastle,Kentucky,2000,1174,3992,81,5247,0.223746902992186,0.7608157042119307,0.015437392795883362,0,0,0,0,0.0,0.0,0.0,-2818,0,-0.5370688012197447,0.0
5325,21203,Rockcastle,Kentucky,2004,1320,4804,42,6166,0.21407719753486865,0.7791112552708401,0.006811547194291274,146,-39,812,919,-0.009669705457317351,-0.008625845601592089,0.018295551058909454,-3484,-666,-0.5650340577359715,-0.027965256516226833
5326,21203,Rockcastle,Kentucky,2008,1410,4757,107,6274,0.22473700988205292,0.7582084794389544,0.01705451067899267,90,65,-47,108,0.010659812347184272,0.010242963484701394,-0.02090277583188571,-3347,137,-0.5334714695569015,0.031562588179069984
5327,21203,Rockcastle,Kentucky,2012,1097,5028,91,6216,0.17648005148005147,0.8088803088803089,0.01463963963963964,-313,-16,271,-58,-0.04825695840200145,-0.0024148710393530302,0.05067182944135451,-3931,-584,-0.6324002574002574,-0.0989287878433559
5328,21203,Rockcastle,Kentucky,2016,915,5609,167,6691,0.13675085936332387,0.8382902406217306,0.02495890001494545,-182,76,581,475,-0.039729192116727596,0.010319260375305811,0.029409931741421702,-4694,-763,-0.7015393812584068,-0.06913912385814935
5329,21205,Rowan,Kentucky,2000,3505,3546,175,7226,0.48505397176861337,0.49072792693052864,0.024218101300858014,0,0,0,0,0.0,0.0,0.0,-41,0,-0.005673955161915267,0.0
5330,21205,Rowan,Kentucky,2004,4556,4063,87,8706,0.5233172524695612,0.46668963932919827,0.009993108201240523,1051,-88,517,1480,0.03826328070094781,-0.014224993099617491,-0.024038287601330366,493,534,0.05662761314036291,0.062301568302278176
5331,21205,Rowan,Kentucky,2008,4074,3907,173,8154,0.49963208241353935,0.4791513367672308,0.021216580819229825,-482,86,-156,-552,-0.02368517005602183,0.011223472617989302,0.012461697438032548,167,-326,0.02048074564630853,-0.03614686749405438
5332,21205,Rowan,Kentucky,2012,3438,4035,192,7665,0.44853228962818004,0.5264187866927593,0.025048923679060666,-636,19,128,-489,-0.05109979278535931,0.003832342859830841,0.047267449925528504,-597,-764,-0.07788649706457929,-0.09836724271088781
5333,21205,Rowan,Kentucky,2016,3295,5174,379,8848,0.3724005424954792,0.5847649186256781,0.04283453887884268,-143,187,1139,1183,-0.07613174713270082,0.01778561519978201,0.05834613193291882,-1879,-1282,-0.21236437613019893,-0.13447787906561964
5334,21207,Russell,Kentucky,2000,1710,5268,96,7074,0.24173027989821882,0.7446988973706531,0.013570822731128074,0,0,0,0,0.0,0.0,0.0,-3558,0,-0.5029686174724343,0.0
5335,21207,Russell,Kentucky,2004,1772,6009,40,7821,0.2265694923922772,0.7683160721135405,0.005114435494182329,62,-56,741,747,-0.01516078750594163,-0.008456387236945745,0.02361717474288738,-4237,-679,-0.5417465797212633,-0.03877796224882901
5336,21207,Russell,Kentucky,2008,1569,5779,127,7475,0.20989966555183948,0.7731103678929766,0.016989966555183946,-203,87,-230,-346,-0.016669826840437718,0.011875531061001617,0.004794295779436131,-4210,27,-0.5632107023411371,-0.02146412261987385
5337,21207,Russell,Kentucky,2012,1445,6346,118,7909,0.1827032494626375,0.8023770388165381,0.014919711720824378,-124,-9,567,434,-0.02719641608920198,-0.002070254834359568,0.0292666709235615,-4901,-691,-0.6196737893539006,-0.05646308701276348
5338,21207,Russell,Kentucky,2016,1093,6863,218,8174,0.13371666258869586,0.8396134083679961,0.02666992904330805,-352,100,517,265,-0.04898658687394164,0.011750217322483672,0.03723636955145804,-5770,-869,-0.7058967457793003,-0.08622295642539968
5339,21209,Scott,Kentucky,2000,5472,7952,362,13786,0.39692441607427825,0.5768170607863049,0.0262585231394168,0,0,0,0,0.0,0.0,0.0,-2480,0,-0.17989264471202665,0.0
5340,21209,Scott,Kentucky,2004,6325,10600,125,17050,0.3709677419354839,0.6217008797653959,0.007331378299120235,853,-237,2648,3264,-0.025956674138794378,-0.018927144840296565,0.044883818979090995,-4275,-1795,-0.250733137829912,-0.07084049311788537
5341,21209,Scott,Kentucky,2008,7712,11782,236,19730,0.39087683730359857,0.5971616827166751,0.011961479979726306,1387,111,1182,2680,0.019909095368114693,0.004630101680606071,-0.024539197048720762,-4070,205,-0.20628484541307657,0.044448292416835455
5342,21209,Scott,Kentucky,2012,7532,12679,362,20573,0.3661109220823409,0.6162931998250134,0.0175958780926457,-180,126,897,843,-0.02476591522125765,0.005634398112919393,0.01913151710833827,-5147,-1077,-0.2501822777426725,-0.04389743232959592
5343,21209,Scott,Kentucky,2016,7715,15052,1433,24200,0.31880165289256196,0.6219834710743801,0.059214876033057855,183,1071,2373,3627,-0.04730926918977896,0.041618997940412156,0.0056902712493667185,-7337,-2190,-0.30318181818181816,-0.052999540439145676
5344,21211,Shelby,Kentucky,2000,4435,8068,235,12738,0.34817082744543887,0.6333804364892448,0.018448736065316378,0,0,0,0,0.0,0.0,0.0,-3633,0,-0.28520960904380593,0.0
5345,21211,Shelby,Kentucky,2004,5277,10909,127,16313,0.32348433764482315,0.6687304603690308,0.007785201986146018,842,-108,2841,3575,-0.02468648980061572,-0.01066353407917036,0.03535002387978603,-5632,-1999,-0.3452461227242077,-0.06003651368040175
5346,21211,Shelby,Kentucky,2008,6871,11451,218,18540,0.3706040992448759,0.6176375404530744,0.011758360302049622,1594,91,542,2227,0.04711976160005277,0.003973158315903604,-0.051092919915956436,-4580,1052,-0.24703344120819848,0.0982126815160092
5347,21211,Shelby,Kentucky,2012,6634,11790,239,18663,0.355462680169319,0.6317312329207523,0.012806086909928736,-237,21,339,123,-0.015141419075556939,0.001047726607879114,0.014093692467677887,-5156,-576,-0.2762685527514333,-0.029235111543234826
5348,21211,Shelby,Kentucky,2016,6276,13196,1108,20580,0.30495626822157434,0.6412050534499514,0.05383867832847425,-358,869,1406,1917,-0.050506411947744634,0.04103259141854551,0.009473820529199095,-6920,-1764,-0.33624878522837703,-0.05998023247694373
5349,21213,Simpson,Kentucky,2000,2583,3169,72,5824,0.44350961538461536,0.5441277472527473,0.012362637362637362,0,0,0,0,0.0,0.0,0.0,-586,0,-0.1006181318681319,0.0
5350,21213,Simpson,Kentucky,2004,2730,4273,40,7043,0.3876189123952861,0.6067016896209002,0.0056793979838137155,147,-32,1104,1219,-0.055890702989329244,-0.006683239378823647,0.06257394236815295,-1543,-957,-0.2190827772256141,-0.11846464535748219
5351,21213,Simpson,Kentucky,2008,2775,4437,97,7309,0.37966890135449444,0.6070597893008619,0.01327130934464359,45,57,164,266,-0.007950011040791682,0.0075919113608298745,0.00035809967996169867,-1662,-119,-0.22739088794636747,-0.008308110720753381
5352,21213,Simpson,Kentucky,2012,2650,4355,88,7093,0.37360778232059777,0.6139856196249823,0.01240659805441985,-125,-9,-82,-216,-0.006061119033896667,-0.0008647112902237398,0.006925830324120419,-1705,-43,-0.24037783730438456,-0.012986949358017086
5353,21213,Simpson,Kentucky,2016,2144,5077,310,7531,0.2846899482140486,0.6741468596467932,0.041163192139158145,-506,222,722,438,-0.08891783410654919,0.028756594084738296,0.06016124002181089,-2933,-1228,-0.38945691143274463,-0.14907907412836008
5354,21215,Spencer,Kentucky,2000,1554,3150,68,4772,0.3256496227996647,0.6601005867560771,0.014249790444258172,0,0,0,0,0.0,0.0,0.0,-1596,0,-0.3344509639564124,0.0
5355,21215,Spencer,Kentucky,2004,1970,4816,36,6822,0.2887716212254471,0.7059513339196717,0.005277044854881266,416,-32,1666,2050,-0.03687800157421761,-0.008972745589376906,0.04585074716359461,-2846,-1250,-0.4171797126942246,-0.08272874873781222
5356,21215,Spencer,Kentucky,2008,2519,5378,152,8049,0.3129581314449,0.6681575350975276,0.01888433345757237,549,116,562,1227,0.024186510219452895,0.013607288602691102,-0.037793798822144065,-2859,-13,-0.35519940365262764,0.06198030904159696
5357,21215,Spencer,Kentucky,2012,2549,5726,156,8431,0.30233661487368046,0.6791602419641798,0.01850314316213972,30,4,348,382,-0.010621516571219514,-0.0003811902954326471,0.011002706866652168,-3177,-318,-0.3768236270904993,-0.02162422343787168
5358,21215,Spencer,Kentucky,2016,1921,7196,398,9515,0.20189174986862848,0.7562795585916973,0.041828691539674195,-628,242,1470,1084,-0.10044486500505198,0.023325548377534474,0.07711931662751748,-5275,-2098,-0.5543878087230688,-0.17756418163256948
5359,21217,Taylor,Kentucky,2000,2790,6151,110,9051,0.3082532316871064,0.679593415092255,0.012153353220638603,0,0,0,0,0.0,0.0,0.0,-3361,0,-0.3713401834051486,0.0
5360,21217,Taylor,Kentucky,2004,2979,7247,69,10295,0.28936376881981546,0.7039339485186984,0.006702282661486159,189,-41,1096,1244,-0.01888946286729093,-0.0054510705591524445,0.024340533426443378,-4268,-907,-0.41457017969888293,-0.04322999629373431
5361,21217,Taylor,Kentucky,2008,3165,7568,127,10860,0.2914364640883978,0.6968692449355433,0.011694290976058931,186,58,321,565,0.0020726952685823363,0.004992008314572772,-0.007064703583155141,-4403,-135,-0.40543278084714546,0.009137398851737477
5362,21217,Taylor,Kentucky,2012,3285,7551,114,10950,0.3,0.6895890410958904,0.010410958904109589,120,-13,-17,90,0.008563535911602194,-0.0012833320719493422,-0.007280203839652888,-4266,137,-0.3895890410958904,0.01584373975125508
5363,21217,Taylor,Kentucky,2016,2553,8320,433,11306,0.22580930479391473,0.7358924464885901,0.03829824871749513,-732,319,769,356,-0.07419069520608526,0.027887289813385542,0.046303405392699726,-5767,-1501,-0.5100831416946754,-0.12049410059878501
5364,21219,Todd,Kentucky,2000,1496,2646,45,4187,0.3572963935992357,0.6319560544542632,0.010747551946501075,0,0,0,0,0.0,0.0,0.0,-1150,0,-0.27465966085502747,0.0
5365,21219,Todd,Kentucky,2004,1491,3242,21,4754,0.3136306268405553,0.6819520403870425,0.004417332772402188,-5,-24,596,567,-0.04366576675868039,-0.006330219174098887,0.04999598593277932,-1751,-601,-0.3683214135464872,-0.09366175269145971
5366,21219,Todd,Kentucky,2008,1543,3336,62,4941,0.3122849625581866,0.6751669702489375,0.012548067192875935,52,41,94,187,-0.0013456642823687082,0.008130734420473747,-0.006785070138105032,-1793,-42,-0.36288200769075085,0.005439405855736323
5367,21219,Todd,Kentucky,2012,1403,3247,68,4718,0.2973717676981772,0.6882153454853751,0.014412886816447647,-140,6,-89,-223,-0.014913194860009416,0.0018648196235717118,0.013048375236437648,-1844,-51,-0.3908435777871979,-0.027961570096447064
5368,21219,Todd,Kentucky,2016,1042,3612,125,4779,0.21803724628583385,0.7558066541117389,0.026156099602427287,-361,57,365,61,-0.07933452141234335,0.01174321278597964,0.06759130862636376,-2570,-726,-0.537769407825905,-0.14692583003870707
5369,21221,Trigg,Kentucky,2000,2110,3130,104,5344,0.3948353293413174,0.5857035928143712,0.019461077844311378,0,0,0,0,0.0,0.0,0.0,-1020,0,-0.19086826347305386,0.0
5370,21221,Trigg,Kentucky,2004,2046,4023,42,6111,0.33480608738340695,0.658321060382916,0.006872852233676976,-64,-62,893,767,-0.06002924195791043,-0.012588225610634402,0.07261746756854481,-1977,-957,-0.3235149729995091,-0.13264670952645524
5371,21221,Trigg,Kentucky,2008,2246,4189,92,6527,0.34410908533782747,0.6417956182013176,0.01409529646085491,200,50,166,416,0.009302997954420522,0.007222444227177934,-0.01652544218159846,-1943,34,-0.2976865328634901,0.025828440136018982
5372,21221,Trigg,Kentucky,2012,2115,4520,107,6742,0.31370513200830613,0.6704242064669238,0.015870661524770097,-131,15,331,215,-0.030403953329521338,0.0017753650639151866,0.028628588265606214,-2405,-462,-0.35671907445861767,-0.05903254159512755
5373,21221,Trigg,Kentucky,2016,1587,4931,233,6751,0.2350762849948156,0.7304103095837654,0.03451340542141905,-528,126,411,9,-0.07862884701349054,0.018642743896648953,0.059986103116841605,-3344,-939,-0.4953340245889498,-0.13861495013033215
5374,21223,Trimble,Kentucky,2000,1181,1837,63,3081,0.38331710483609216,0.596234988640052,0.02044790652385589,0,0,0,0,0.0,0.0,0.0,-656,0,-0.21291788380395982,0.0
5375,21223,Trimble,Kentucky,2004,1428,2332,30,3790,0.37678100263852243,0.6153034300791557,0.0079155672823219,247,-33,495,709,-0.0065361021975697264,-0.01253233924153399,0.01906844143910369,-904,-248,-0.23852242744063323,-0.025604543636673416
5376,21223,Trimble,Kentucky,2008,1484,2239,89,3812,0.38929695697796435,0.5873557187827911,0.02334732423924449,56,59,-93,22,0.012515954339441915,0.015431756956922591,-0.02794771129636453,-755,149,-0.1980587618048268,0.040463665635806445
5377,21223,Trimble,Kentucky,2012,1355,2133,55,3543,0.38244425627998874,0.6020321761219306,0.015523567598080722,-129,-34,-106,-269,-0.006852700697975611,-0.007823756641163769,0.01467645733913947,-778,-23,-0.21958791984194187,-0.02152915803711508
5378,21223,Trimble,Kentucky,2016,879,2771,148,3798,0.23143759873617695,0.729594523433386,0.03896787783043707,-476,93,638,255,-0.1510066575438118,0.02344431023235635,0.12756234731145544,-1892,-1114,-0.49815692469720907,-0.2785690048552672
5379,21225,Union,Kentucky,2000,2547,2749,72,5368,0.474478390461997,0.5121087928464978,0.013412816691505217,0,0,0,0,0.0,0.0,0.0,-202,0,-0.03763040238450077,0.0
5380,21225,Union,Kentucky,2004,2398,3534,45,5977,0.40120461770118787,0.5912665216663878,0.0075288606324242936,-149,-27,785,609,-0.07327377276080915,-0.005883956059080923,0.07915772881989003,-1136,-934,-0.19006190396519995,-0.15243150158069918
5381,21225,Union,Kentucky,2008,2804,3120,110,6034,0.4647000331455088,0.5170699370235333,0.018230029830957905,406,65,-414,57,0.06349541544432091,0.010701169198533611,-0.0741965846428545,-316,820,-0.05236990387802454,0.13769200008717541
5382,21225,Union,Kentucky,2012,1942,3955,82,5979,0.32480347884261584,0.6614818531527011,0.013714668004683057,-862,-28,835,-55,-0.13989655430289294,-0.004515361826274848,0.14441191612916782,-2013,-1697,-0.3366783743100853,-0.28430847043206076
5383,21225,Union,Kentucky,2016,1331,4701,179,6211,0.21429721461922396,0.7568829496055386,0.02881983577523748,-611,97,746,232,-0.11050626422339188,0.015105167770554423,0.09540109645283745,-3370,-1357,-0.5425857349863146,-0.20590736067622928
5384,21227,Warren,Kentucky,2000,12180,20235,560,32975,0.36937073540561033,0.6136467020470053,0.01698256254738438,0,0,0,0,0.0,0.0,0.0,-8055,0,-0.244275966641395,0.0
5385,21227,Warren,Kentucky,2004,14326,25100,285,39711,0.36075646546296997,0.6320666817758304,0.007176852761199668,2146,-275,4865,6736,-0.008614269942640362,-0.009805709786184714,0.01841997972882503,-10774,-2719,-0.2713102163128604,-0.027034249671465393
5386,21227,Warren,Kentucky,2008,17669,25993,483,44145,0.40024917884245104,0.5888096047117454,0.010941216445803603,3343,198,893,4434,0.03949271337948107,0.003764363684603935,-0.04325707706408499,-8324,2450,-0.18856042586929433,0.08274979044356606
5387,21227,Warren,Kentucky,2012,16805,26384,714,43903,0.3827756645331754,0.6009612099400952,0.016263125526729382,-864,231,391,-242,-0.01747351430927563,0.00532190908092578,0.012151605228349793,-9579,-1255,-0.21818554540691976,-0.02962511953762542
5388,21227,Warren,Kentucky,2016,16966,28673,2815,48454,0.3501465307301771,0.5917571304742643,0.05809633879555867,161,2101,2289,4551,-0.03262913380299831,0.041833213268829286,-0.009204079465830906,-11707,-2128,-0.24161059974408716,-0.023425054337167406
5389,21229,Washington,Kentucky,2000,1458,3044,86,4588,0.3177855274629468,0.6634699215344376,0.018744551002615517,0,0,0,0,0.0,0.0,0.0,-1586,0,-0.3456843940714908,0.0
5390,21229,Washington,Kentucky,2004,1724,3479,33,5236,0.3292589763177998,0.6644385026737968,0.0063025210084033615,266,-53,435,648,0.011473448854853019,-0.012442029994212156,0.0009685811393591592,-1755,-169,-0.33517952635599696,0.01050486771549386
5391,21229,Washington,Kentucky,2008,1890,3305,80,5275,0.3582938388625592,0.6265402843601896,0.015165876777251185,166,47,-174,39,0.0290348625447594,0.008863355768847824,-0.03789821831360718,-1415,340,-0.2682464454976304,0.06693308085836658
5392,21229,Washington,Kentucky,2012,1669,3495,55,5219,0.3197930638053267,0.6696685188733473,0.010538417321325924,-221,-25,190,-56,-0.03850077505723254,-0.0046274594559252615,0.043128234513157726,-1826,-411,-0.34987545506802065,-0.08162900957039027
5393,21229,Washington,Kentucky,2016,1420,4013,203,5636,0.25195173882185945,0.7120298083747338,0.036018452803406674,-249,148,518,417,-0.06784132498346723,0.02548003548208075,0.04236128950138651,-2593,-767,-0.4600780695528744,-0.11020261448485374
5394,21231,Wayne,Kentucky,2000,2312,4069,93,6474,0.3571207908557306,0.6285140562248996,0.014365152919369786,0,0,0,0,0.0,0.0,0.0,-1757,0,-0.271393265369169,0.0
5395,21231,Wayne,Kentucky,2004,2616,5027,42,7685,0.34040338321405333,0.654131424853611,0.005465191932335719,304,-51,958,1211,-0.016717407641677284,-0.008899960987034067,0.025617368628711334,-2411,-654,-0.31372804163955764,-0.04233477627038862
5396,21231,Wayne,Kentucky,2008,2201,4868,127,7196,0.3058643690939411,0.6764869371873263,0.01764869371873263,-415,85,-159,-489,-0.03453901412011223,0.012183501786396909,0.022355512333715355,-2667,-256,-0.37062256809338523,-0.05689452645382759
5397,21231,Wayne,Kentucky,2012,1855,5289,66,7210,0.25728155339805825,0.7335644937586685,0.009153952843273232,-346,-61,421,14,-0.04858281569588285,-0.008494740875459397,0.05707755657134217,-3434,-767,-0.47628294036061025,-0.10566037226722502
5398,21231,Wayne,Kentucky,2016,1431,6371,190,7992,0.17905405405405406,0.7971721721721722,0.023773773773773772,-424,124,1082,782,-0.07822749934400419,0.01461982093050054,0.06360767841350368,-4940,-1506,-0.6181181181181181,-0.14183517775750787
5399,21233,Webster,Kentucky,2000,2388,2599,85,5072,0.47082018927444796,0.5124211356466877,0.016758675078864353,0,0,0,0,0.0,0.0,0.0,-211,0,-0.04160094637223971,0.0
5400,21233,Webster,Kentucky,2004,2304,3207,36,5547,0.4153596538669551,0.5781503515413737,0.006489994591671174,-84,-49,608,475,-0.05546053540749285,-0.01026868048719318,0.06572921589468605,-903,-692,-0.16279069767441862,-0.1211897513021789
5401,21233,Webster,Kentucky,2008,2390,3037,113,5540,0.4314079422382672,0.5481949458483755,0.0203971119133574,86,77,-170,-7,0.01604828837131206,0.013907117321686226,-0.02995540569299826,-647,256,-0.1167870036101083,0.04600369406431032
5402,21233,Webster,Kentucky,2012,1765,3607,98,5470,0.3226691042047532,0.6594149908592322,0.017915904936014627,-625,-15,570,-70,-0.10873883803351397,-0.0024812069773427724,0.1112200450108567,-1842,-1195,-0.33674588665447897,-0.21995888304437067
5403,21233,Webster,Kentucky,2016,1240,4397,168,5805,0.2136089577950043,0.7574504737295435,0.028940568475452195,-525,70,790,335,-0.1090601464097489,0.011024663539437568,0.09803548287031139,-3157,-1315,-0.5438415159345392,-0.20709562928006026
5404,21235,Whitley,Kentucky,2000,4101,7502,171,11774,0.3483098352301682,0.637166638355699,0.014523526414132836,0,0,0,0,0.0,0.0,0.0,-3401,0,-0.2888568031255308,0.0
5405,21235,Whitley,Kentucky,2004,3985,9559,85,13629,0.2923912245946144,0.7013720742534302,0.006236701151955389,-116,-86,2057,1855,-0.055918610635553756,-0.008286825262177448,0.0642054358977312,-5574,-2173,-0.40898084965881576,-0.12012404653328496
5406,21235,Whitley,Kentucky,2008,3484,10015,205,13704,0.2542323409223584,0.7308085230589609,0.014959136018680676,-501,120,456,75,-0.038158883672256005,0.008722434866725286,0.029436448805530757,-6531,-957,-0.4765761821366025,-0.06759533247778676
5407,21235,Whitley,Kentucky,2012,2683,10232,157,13072,0.20524785801713585,0.7827417380660955,0.012010403916768666,-801,-48,217,-632,-0.04898448290522256,-0.002948732101912011,0.05193321500713455,-7549,-1018,-0.5774938800489596,-0.10091769791235711
5408,21235,Whitley,Kentucky,2016,2067,11312,395,13774,0.15006534049658776,0.8212574415565558,0.028677217946856397,-616,238,1080,702,-0.05518251752054809,0.016666814030087733,0.038515703490460296,-9245,-1696,-0.671192101059968,-0.09369822101100833
5409,21237,Wolfe,Kentucky,2000,1136,1267,22,2425,0.46845360824742266,0.5224742268041237,0.009072164948453608,0,0,0,0,0.0,0.0,0.0,-131,0,-0.05402061855670104,0.0
5410,21237,Wolfe,Kentucky,2004,1744,1385,26,3155,0.5527733755942947,0.43898573692551507,0.008240887480190175,608,4,118,730,0.08431976734687208,-0.0008312774682634333,-0.08348848987860863,359,490,0.11378763866877967,0.1678082572254807
5411,21237,Wolfe,Kentucky,2008,1493,1408,67,2968,0.503032345013477,0.4743935309973046,0.02257412398921833,-251,41,23,-187,-0.04974103058081769,0.014333236509028156,0.03540779407178951,85,-274,0.028638814016172465,-0.0851488246526072
5412,21237,Wolfe,Kentucky,2012,976,1542,41,2559,0.38139898397811645,0.6025791324736225,0.016021883548261038,-517,-26,134,-409,-0.1216333610353606,-0.006552240440957292,0.1281856014763179,-566,-651,-0.22118014849550605,-0.2498189625116785
5413,21237,Wolfe,Kentucky,2016,753,1804,78,2635,0.2857685009487666,0.6846299810246679,0.029601518026565465,-223,37,262,76,-0.09563048302934984,0.013579634478304427,0.08205084855104539,-1051,-485,-0.3988614800759013,-0.17768133158039523
5414,21239,Woodford,Kentucky,2000,3995,5890,252,10137,0.39410081878267733,0.581039755351682,0.024859425865640723,0,0,0,0,0.0,0.0,0.0,-1895,0,-0.18693893656900462,0.0
5415,21239,Woodford,Kentucky,2004,4480,6937,85,11502,0.38949747869935664,0.6031125021735351,0.007390019127108329,485,-167,1047,1365,-0.004603340083320695,-0.017469406738532395,0.022072746821853118,-2457,-562,-0.21361502347417843,-0.026676086905173813
5416,21239,Woodford,Kentucky,2008,5027,7130,140,12297,0.40879889403919656,0.5798162153370741,0.011384890623729365,547,55,193,795,0.019301415339839922,0.003994871496621036,-0.02329628683646101,-2103,354,-0.1710173212978775,0.04259770217630093
5417,21239,Woodford,Kentucky,2012,4883,7219,230,12332,0.39596172559195586,0.5853876094712942,0.018650664936749918,-144,90,89,35,-0.012837168447240699,0.007265774313020553,0.005571394134220142,-2336,-233,-0.18942588387933834,-0.01840856258146084
5418,21239,Woodford,Kentucky,2016,4958,7697,908,13563,0.36555334365553344,0.5674998156749982,0.0669468406694684,75,678,478,1231,-0.030408381936422424,0.04829617573271849,-0.017887793796296014,-2739,-403,-0.20194647201946475,-0.01252058814012641
5419,22001,Acadia,Louisiana,2000,8892,13814,532,23238,0.3826491092176607,0.5944573543334194,0.022893536448919873,0,0,0,0,0.0,0.0,0.0,-4922,0,-0.2118082451157587,0.0
5420,22001,Acadia,Louisiana,2004,8937,16083,210,25230,0.35422116527942926,0.6374554102259216,0.008323424494649227,45,-322,2269,1992,-0.028427943938231448,-0.014570111954270645,0.04299805589250216,-7146,-2224,-0.2832342449464923,-0.07142599983073361
5421,22001,Acadia,Louisiana,2008,7028,19229,454,26711,0.2631125753434915,0.7198906817416045,0.01699674291490397,-1909,244,3146,1481,-0.09110858993593779,0.008673318420254744,0.08243527151568297,-12201,-5055,-0.45677810639811306,-0.17354386145162076
5422,22001,Acadia,Louisiana,2012,6560,19931,344,26835,0.24445686603316563,0.7427240544065586,0.012819079560275759,-468,-110,702,124,-0.01865570931032584,-0.004177663354628212,0.02283337266495411,-13371,-1170,-0.498267188373393,-0.04148908197527995
5423,22001,Acadia,Louisiana,2016,5638,21162,589,27389,0.20584906349264304,0.7726459527547556,0.02150498375260141,-922,245,1231,554,-0.038607802540522596,0.008685904192325651,0.029921898348196918,-15524,-2153,-0.5667968892621125,-0.06852970088871946
5424,22003,Allen,Louisiana,2000,3914,4035,343,8292,0.4720212252773758,0.4866136034732272,0.04136517124939701,0,0,0,0,0.0,0.0,0.0,-121,0,-0.014592378195851408,0.0
5425,22003,Allen,Louisiana,2004,3791,5140,193,9124,0.4154975887768523,0.5633494081543183,0.02115300306882946,-123,-150,1105,832,-0.0565236365005235,-0.02021216818056755,0.07673580468109115,-1349,-1228,-0.14785181937746605,-0.13325944118161465
5426,22003,Allen,Louisiana,2008,2891,6333,243,9467,0.3053765712474913,0.6689553184747016,0.02566811027780712,-900,50,1193,343,-0.11012101752936099,0.004515107208977659,0.10560591032038324,-3442,-2093,-0.3635787472272103,-0.21572692784974423
5427,22003,Allen,Louisiana,2012,2617,6495,195,9307,0.2811862039325239,0.6978618244332223,0.020951971634253788,-274,-48,162,-160,-0.024190367314967376,-0.00471613864355333,0.028906505958520734,-3878,-436,-0.4166756205006984,-0.05309687327348811
5428,22003,Allen,Louisiana,2016,2106,6867,272,9245,0.22779881016765818,0.7427798810167658,0.029421308815575985,-511,77,372,-62,-0.05338739376486573,0.008469337181322197,0.04491805658354353,-4761,-883,-0.5149810708491076,-0.0983054503484092
5429,22005,Ascension,Louisiana,2000,13385,16818,641,30844,0.4339579821034885,0.5452600181558812,0.020781999740630268,0,0,0,0,0.0,0.0,0.0,-3433,0,-0.1113020360523927,0.0
5430,22005,Ascension,Louisiana,2004,13955,24661,484,39100,0.35690537084398977,0.6307161125319694,0.01237851662404092,570,-157,7843,8256,-0.07705261125949875,-0.008403483116589347,0.08545609437608814,-10706,-7273,-0.2738107416879796,-0.1625087056355869
5431,22005,Ascension,Louisiana,2008,14625,31239,707,46571,0.314036632238947,0.6707822464623907,0.015181121298662257,670,223,6578,7471,-0.042868738605042755,0.0028026046746213364,0.040066133930421355,-16614,-5908,-0.3567456142234437,-0.08293487253546411
5432,22005,Ascension,Louisiana,2012,16349,33856,868,51073,0.3201104301685822,0.6628942885673448,0.016995281264072994,1724,161,2617,4502,0.006073797929635194,0.0018141599654107367,-0.007887957895045927,-17507,-893,-0.3427838583987626,0.013961755824681121
5433,22005,Ascension,Louisiana,2016,16476,36143,2059,54678,0.3013277735103698,0.6610153992464977,0.03765682724313252,127,1191,2287,3605,-0.018782656658212382,0.020661545979059524,-0.0018788893208471213,-19667,-2160,-0.35968762573612784,-0.01690376733736526
5434,22007,Assumption,Louisiana,2000,5222,4388,443,10053,0.5194469312642992,0.43648662090918133,0.044066447826519445,0,0,0,0,0.0,0.0,0.0,834,0,0.08296031035511786,0.0
5435,22007,Assumption,Louisiana,2004,5585,4966,184,10735,0.52026082906381,0.4625989753143922,0.017140195621797857,363,-259,578,682,0.0008138977995107988,-0.026926252204721588,0.02611235440521087,619,-215,0.05766185374941779,-0.02529845660570007
5436,22007,Assumption,Louisiana,2008,4756,5981,223,10960,0.43394160583941604,0.5457116788321168,0.020346715328467154,-829,39,1015,225,-0.08631922322439395,0.0032065197066692974,0.0831127035177246,-1225,-1844,-0.11177007299270075,-0.16943192674211854
5437,22007,Assumption,Louisiana,2012,4754,6083,155,10992,0.43249636098981076,0.5534024745269287,0.014101164483260552,-2,-68,102,32,-0.0014452448496052872,-0.006245550845206602,0.007690795694811903,-1329,-104,-0.12090611353711794,-0.00913604054441719
5438,22007,Assumption,Louisiana,2016,3931,6714,259,10904,0.360509904622157,0.6157373440939105,0.0237527512839325,-823,104,631,-88,-0.07198645636765377,0.009651586800671949,0.062334869566981754,-2783,-1454,-0.25522743947175347,-0.13432132593463553
5439,22009,Avoyelles,Louisiana,2000,6701,7329,623,14653,0.4573124957346618,0.5001706135262404,0.0425168907390978,0,0,0,0,0.0,0.0,0.0,-628,0,-0.042858117791578554,0.0
5440,22009,Avoyelles,Louisiana,2004,6976,8302,247,15525,0.44933977455716584,0.5347504025764895,0.015909822866344604,275,-376,973,872,-0.007972721177495978,-0.026607067872753194,0.034579789050249166,-1326,-698,-0.0854106280193237,-0.042552510227745144
5441,22009,Avoyelles,Louisiana,2008,6327,10236,375,16938,0.37353878852284805,0.6043216436415161,0.022139567835635848,-649,128,1934,1413,-0.07580098603431779,0.006229744969291243,0.06957124106502655,-3909,-2583,-0.23078285511866803,-0.14537222709934433
5442,22009,Avoyelles,Louisiana,2012,6077,10670,285,17032,0.35679896665100985,0.6264678252700798,0.016733208078910287,-250,-90,434,94,-0.0167398218718382,-0.00540635975672556,0.022146181628563744,-4593,-684,-0.26966885861907,-0.038886003500401944
5443,22009,Avoyelles,Louisiana,2016,5035,11165,386,16586,0.3035692752924153,0.6731580851320391,0.02327263957554564,-1042,101,495,-446,-0.053229691358594566,0.006539431496635353,0.04669025986195929,-6130,-1537,-0.36958880983962383,-0.09991995122055386
5444,22011,Beauregard,Louisiana,2000,3958,7862,385,12205,0.32429332240884884,0.6441622285948382,0.031544448996312986,0,0,0,0,0.0,0.0,0.0,-3904,0,-0.31986890618598934,0.0
5445,22011,Beauregard,Louisiana,2004,3666,9470,145,13281,0.2760334312175288,0.7130487162111286,0.010917852571342519,-292,-240,1608,1076,-0.048259891191320015,-0.020626596424970466,0.06888648761629046,-5804,-1900,-0.4370152849935998,-0.11714637880761047
5446,22011,Beauregard,Louisiana,2008,3071,10718,285,14074,0.21820378001989485,0.7615461134005969,0.020250106579508313,-595,140,1248,793,-0.057829651197633974,0.009332254008165794,0.04849739718946822,-7647,-1843,-0.543342333380702,-0.10632704838710222
5447,22011,Beauregard,Louisiana,2012,2828,11112,285,14225,0.19880492091388402,0.7811599297012303,0.020035149384885764,-243,0,394,151,-0.01939885910601083,-0.00021495719462254897,0.019613816300633413,-8284,-637,-0.5823550087873463,-0.039012675406644215
5448,22011,Beauregard,Louisiana,2016,2393,12238,447,15078,0.15870805146571162,0.8116461069107309,0.0296458416235575,-435,162,1126,853,-0.040096869448172395,0.009610692238671736,0.030486177209500642,-9845,-1561,-0.6529380554450193,-0.07058304665767301
5449,22013,Bienville,Louisiana,2000,3413,3269,324,7006,0.48715386811304595,0.4666000570939195,0.04624607479303454,0,0,0,0,0.0,0.0,0.0,144,0,0.020553811019126456,0.0
5450,22013,Bienville,Louisiana,2004,3399,3612,146,7157,0.4749196590750314,0.5046807321503424,0.02039960877462624,-14,-178,343,151,-0.012234209038014532,-0.025846466018408298,0.038080675056422875,-213,-357,-0.02976107307531095,-0.050314884094437407
5451,22013,Bienville,Louisiana,2008,3589,3776,65,7430,0.48304172274562585,0.5082099596231494,0.008748317631224764,190,-81,164,273,0.008122063670594426,-0.011651291143401478,0.0035292274728070394,-187,26,-0.025168236877523564,0.004592836197787387
5452,22013,Bienville,Louisiana,2012,3490,3641,72,7203,0.484520338747744,0.5054838261835346,0.009995835068721367,-99,7,-135,-227,0.0014786160021181272,0.0012475174374966033,-0.0027261334396148085,-151,36,-0.02096348743579063,0.004204749441732936
5453,22013,Bienville,Louisiana,2016,3129,3756,120,7005,0.44668094218415416,0.5361884368308352,0.017130620985010708,-361,48,115,-198,-0.03783939656358981,0.007134785916289341,0.030704610647300568,-627,-476,-0.08950749464668101,-0.06854400721089038
5454,22015,Bossier,Louisiana,2000,11933,23224,758,35915,0.3322567172490603,0.6466378950299317,0.021105387721007934,0,0,0,0,0.0,0.0,0.0,-11291,0,-0.31438117778087143,0.0
5455,22015,Bossier,Louisiana,2004,12317,30040,348,42705,0.2884205596534364,0.7034305116496897,0.008148928696873902,384,-410,6816,6790,-0.043836157595623926,-0.012956459024134032,0.056792616619757985,-17723,-6432,-0.41500995199625335,-0.10062877421538191
5456,22015,Bossier,Louisiana,2008,12703,32713,419,45835,0.2771462855896149,0.7137122286462311,0.009141485764154031,386,71,2673,3130,-0.011274274063821477,0.0009925570672801292,0.010281716996541346,-20010,-2287,-0.43656594305661617,-0.021555991060362822
5457,22015,Bossier,Louisiana,2012,12956,34988,618,48562,0.2667929656933405,0.7204810345537663,0.012725999752893208,253,199,2275,2727,-0.010353319896274416,0.0035845139887391766,0.006768805907535258,-22032,-2022,-0.45368806886042584,-0.017122125803809674
5458,22015,Bossier,Louisiana,2016,12641,35474,1733,49848,0.2535909163858129,0.7116433959236078,0.03476568769057936,-315,1115,486,1286,-0.013202049307527608,0.022039687937686153,-0.008837638630158517,-22833,-801,-0.45805247953779493,-0.0043644106773690905
5459,22017,Caddo,Louisiana,2000,47530,46807,1302,95639,0.4969729921893788,0.4894133146519725,0.013613693158648668,0,0,0,0,0.0,0.0,0.0,723,0,0.007559677537406273,0.0
5460,22017,Caddo,Louisiana,2004,51739,54292,564,106595,0.4853792391763216,0.509329705896149,0.005291054927529434,4209,-738,7485,10956,-0.011593753013057206,-0.008322638231119235,0.01991639124417649,-2553,-3276,-0.023950466719827423,-0.031510144257233696
5461,22017,Caddo,Louisiana,2008,55536,52228,896,108660,0.5110988404196577,0.48065525492361494,0.008245904656727407,3797,332,-2064,2065,0.02571960124333611,0.0029548497291979727,-0.02867445097253407,3308,5861,0.030443585496042758,0.05439405221587018
5462,22017,Caddo,Louisiana,2012,58042,52459,1264,111765,0.519321791258444,0.46936876481903994,0.011309443922515993,2506,368,231,3105,0.008222950838786325,0.003063539265788586,-0.011286490104574998,5583,2275,0.04995302643940408,0.019509440943361323
5463,22017,Caddo,Louisiana,2016,53483,49006,3315,105804,0.5054912857736947,0.46317719556916565,0.031331518657139616,-4559,2051,-3453,-5961,-0.01383050548474929,0.020022074734623623,-0.006191569249874296,4477,-1106,0.04231409020452909,-0.007638936234874993
5464,22019,Calcasieu,Louisiana,2000,33919,38086,1631,73636,0.46063066978108536,0.5172198381226574,0.022149492096257266,0,0,0,0,0.0,0.0,0.0,-4167,0,-0.056589168341572016,0.0
5465,22019,Calcasieu,Louisiana,2004,32864,46075,759,79698,0.41235664633993324,0.5781199026324374,0.0095234510276293,-1055,-872,7989,6062,-0.048274023441152114,-0.012626041068627965,0.06090006450978003,-13211,-9044,-0.16576325629250416,-0.10917408795093214
5466,22019,Calcasieu,Louisiana,2008,30244,50449,1438,82131,0.3682409808720215,0.6142504048410466,0.017508614286931852,-2620,679,4374,2433,-0.044115665467911735,0.007985163259302552,0.03613050220860925,-20205,-6994,-0.24600942396902514,-0.08024616767652099
5467,22019,Calcasieu,Louisiana,2012,28359,51850,1517,81726,0.3470009544086337,0.6344370212661821,0.01856202432518415,-1885,79,1401,-405,-0.021240026463387796,0.0010534100382522983,0.020186616425135417,-23491,-3286,-0.28743606685754836,-0.04142664288852321
5468,22019,Calcasieu,Louisiana,2016,26296,54191,3298,83785,0.31385092797040043,0.6467864176165184,0.0393626544130811,-2063,1781,2341,2059,-0.03315002643823328,0.02080063008789695,0.012349396350336383,-27895,-4404,-0.332935489646118,-0.045499422788569666
5469,22021,Caldwell,Louisiana,2000,1359,2817,152,4328,0.3140018484288355,0.6508780036968577,0.03512014787430684,0,0,0,0,0.0,0.0,0.0,-1458,0,-0.33687615526802217,0.0
5470,22021,Caldwell,Louisiana,2004,1384,3308,60,4752,0.29124579124579125,0.6961279461279462,0.012626262626262626,25,-92,491,424,-0.022756057183044243,-0.022493885248044215,0.045249942431088486,-1924,-466,-0.4048821548821549,-0.06800599961413273
5471,22021,Caldwell,Louisiana,2008,1118,3696,79,4893,0.22848967913345597,0.7553648068669528,0.016145513999591254,-266,19,388,141,-0.06275611211233528,0.0035192513733286277,0.05923686073900669,-2578,-654,-0.5268751277334969,-0.12199297285134197
5472,22021,Caldwell,Louisiana,2012,1016,3640,60,4716,0.2154368108566582,0.7718405428329093,0.01272264631043257,-102,-19,-56,-177,-0.013052868276797774,-0.0034228676891586846,0.016475735965956417,-2624,-46,-0.556403731976251,-0.029528604242754164
5473,22021,Caldwell,Louisiana,2016,788,3822,82,4692,0.1679454390451833,0.8145780051150895,0.017476555839727195,-228,22,182,-24,-0.04749137181147489,0.004753909529294626,0.04273746228218023,-3034,-410,-0.6466325660699062,-0.09022883409365512
5474,22023,Cameron,Louisiana,2000,1435,2593,155,4183,0.34305522352378676,0.6198900310781735,0.037054745398039685,0,0,0,0,0.0,0.0,0.0,-1158,0,-0.2768348075543868,0.0
5475,22023,Cameron,Louisiana,2004,1367,3190,83,4640,0.2946120689655172,0.6875,0.01788793103448276,-68,-72,597,457,-0.04844315455826953,-0.019166814363556925,0.06760996892182647,-1823,-665,-0.3928879310344828,-0.116053123480096
5476,22023,Cameron,Louisiana,2008,613,3089,91,3793,0.16161349854996046,0.8143949380437648,0.023991563406274716,-754,8,-101,-847,-0.13299857041555677,0.006103632371791956,0.12689493804376484,-2476,-653,-0.6527814394938044,-0.25989350845932163
5477,22023,Cameron,Louisiana,2012,408,3260,76,3744,0.10897435897435898,0.8707264957264957,0.0202991452991453,-205,-15,171,-49,-0.052639139575601485,-0.003692418107129416,0.056331557682730904,-2852,-376,-0.7617521367521367,-0.1089706972583323
5478,22023,Cameron,Louisiana,2016,323,3256,113,3692,0.08748645720476707,0.8819068255687974,0.030606717226435536,-85,37,-4,-52,-0.021487901769591908,0.010307571927290236,0.011180329842301662,-2933,-81,-0.7944203683640303,-0.03266823161189358
5479,22025,Catahoula,Louisiana,2000,1718,2912,135,4765,0.3605456453305351,0.6111227701993704,0.02833158447009444,0,0,0,0,0.0,0.0,0.0,-1194,0,-0.2505771248688353,0.0
5480,22025,Catahoula,Louisiana,2004,1673,3219,62,4954,0.3377069035123133,0.6497779572062979,0.012515139281388777,-45,-73,307,189,-0.02283874181822182,-0.01581644518870566,0.038655187006927494,-1546,-352,-0.31207105369398463,-0.06149392882514931
5481,22025,Catahoula,Louisiana,2008,1659,3486,80,5225,0.317511961722488,0.667177033492823,0.015311004784688996,-14,18,267,271,-0.020194941789825283,0.002795865503300219,0.01739907628652504,-1827,-281,-0.34966507177033496,-0.03759401807635032
5482,22025,Catahoula,Louisiana,2012,1408,2744,41,4193,0.33579775816837587,0.654424040066778,0.009778201764846173,-251,-39,-742,-1032,0.018285796445887847,-0.005532803019842823,-0.012752993426044967,-1336,491,-0.31862628189840214,0.031038789871932815
5483,22025,Catahoula,Louisiana,2016,1322,3479,55,4856,0.27224052718286657,0.7164332784184514,0.011326194398682043,-86,14,735,663,-0.0635572309855093,0.0015479926338358707,0.06200923835167338,-2157,-821,-0.4441927512355848,-0.12556646933718268
5484,22027,Claiborne,Louisiana,2000,2721,3384,176,6281,0.4332112720904315,0.5387677121477472,0.028021015761821366,0,0,0,0,0.0,0.0,0.0,-663,0,-0.10555644005731574,0.0
5485,22027,Claiborne,Louisiana,2004,2854,3704,72,6630,0.43046757164404226,0.5586726998491705,0.01085972850678733,133,-104,320,349,-0.002743700446389219,-0.017161287255034036,0.019904987701423238,-850,-187,-0.1282051282051282,-0.022648688147812457
5486,22027,Claiborne,Louisiana,2008,3025,3750,66,6841,0.4421868147931589,0.5481654728840812,0.00964771232275983,171,-6,46,211,0.011719243149116654,-0.0012120161840274996,-0.010507226965089211,-725,125,-0.10597865809092233,0.022226470114205865
5487,22027,Claiborne,Louisiana,2012,3014,3649,69,6732,0.4477124183006536,0.542038027332145,0.010249554367201427,-11,3,-101,-109,0.005525603507494703,0.0006018420444415962,-0.006127445551936228,-635,90,-0.0943256090314914,0.011653049059430931
5488,22027,Claiborne,Louisiana,2016,2717,3585,119,6421,0.4231428126460053,0.5583242485594144,0.018532938794580282,-297,50,-64,-311,-0.02456960565464833,0.008283384427378856,0.016286221227269415,-868,-233,-0.13518143591340914,-0.040855826881917745
5489,22029,Concordia,Louisiana,2000,3569,4627,303,8499,0.41993175667725613,0.5444169902341452,0.03565125308859866,0,0,0,0,0.0,0.0,0.0,-1058,0,-0.12448523355688912,0.0
5490,22029,Concordia,Louisiana,2004,3446,5427,107,8980,0.38374164810690425,0.6043429844097995,0.011915367483296213,-123,-196,800,481,-0.036190108570351875,-0.023735885605302445,0.05992599417565425,-1981,-923,-0.22060133630289525,-0.09611610274600613
5491,22029,Concordia,Louisiana,2008,3766,5668,93,9527,0.3952975753122704,0.5949406948672195,0.009761729820510129,320,-14,241,547,0.011555927205366134,-0.0021536376627860846,-0.009402289542580045,-1902,79,-0.19964311955494907,0.02095821674794618
5492,22029,Concordia,Louisiana,2012,3833,5450,97,9380,0.40863539445629,0.5810234541577826,0.010341151385927505,67,4,-218,-147,0.013337819144019603,0.0005794215654173762,-0.013917240709436896,-1617,285,-0.17238805970149257,0.027255059853456498
5493,22029,Concordia,Louisiana,2016,3272,5477,123,8872,0.36880072137060416,0.6173354373309288,0.013863841298467088,-561,26,27,-508,-0.039834673085685834,0.003522689912539583,0.03631198317314621,-2205,-588,-0.24853471596032461,-0.07614665625883205
5494,22031,De Soto,Louisiana,2000,5036,5260,300,10596,0.47527368818422044,0.4964137410343526,0.028312570781426953,0,0,0,0,0.0,0.0,0.0,-224,0,-0.02114005285013215,0.0
5495,22031,De Soto,Louisiana,2004,5026,6211,99,11336,0.4433662667607622,0.5479004940014114,0.008733239237826394,-10,-201,951,740,-0.03190742142345826,-0.01957933154360056,0.05148675296705879,-1185,-961,-0.1045342272406492,-0.08339417439051705
5496,22031,De Soto,Louisiana,2008,5242,6883,132,12257,0.4276739822142449,0.5615566614995513,0.010769356286203803,216,33,672,921,-0.015692284546517277,0.0020361170483774085,0.013656167498139915,-1641,-456,-0.1338826792853064,-0.02934845204465719
5497,22031,De Soto,Louisiana,2012,5553,7353,145,13051,0.4254846371925523,0.563405103057237,0.011110259750210712,311,13,470,794,-0.0021893450216926014,0.0003409034640069093,0.0018484415576857094,-1800,-159,-0.1379204658646847,-0.004037786579378311
5498,22031,De Soto,Louisiana,2016,5165,8068,267,13500,0.3825925925925926,0.5976296296296296,0.019777777777777776,-388,122,715,449,-0.04289204459995971,0.008667518027567064,0.03422452657239261,-2903,-1103,-0.21503703703703703,-0.07711657117235232
5499,22033,East Baton Rouge,Louisiana,2000,76516,89128,3345,168989,0.45278686778429367,0.5274189444283356,0.019794187787370774,0,0,0,0,0.0,0.0,0.0,-12612,0,-0.07463207664404192,0.0
5500,22033,East Baton Rouge,Louisiana,2004,82298,99943,1401,183642,0.44814367083782575,0.5442273553980026,0.007628973764171595,5782,-1944,10815,14653,-0.00464319694646792,-0.01216521402319918,0.01680841096966701,-17645,-5033,-0.09608368456017685,-0.02145160791613493
5501,22033,East Baton Rouge,Louisiana,2008,99652,95390,2307,197349,0.5049531540570259,0.48335689565186546,0.011689950291108645,17354,906,-4553,13707,0.05680948321920015,0.00406097652693705,-0.06087045974613714,4262,21907,0.02159625840516044,0.11767994296533729
5502,22033,East Baton Rouge,Louisiana,2012,102656,92292,3223,198171,0.5180172679150834,0.4657190002573535,0.016263731827563063,3004,916,-3098,822,0.013064113858057502,0.004573781536454418,-0.017637895394511938,10364,6102,0.05229826765772988,0.03070200925256944
5503,22033,East Baton Rouge,Louisiana,2016,102828,84660,9003,196491,0.5233216788555201,0.4308594286761226,0.04581889246835733,172,5780,-7632,-1680,0.005304410940436655,0.02955516064079427,-0.03485957158123093,18168,7804,0.09246225017939746,0.040163982521667585
5504,22035,East Carroll,Louisiana,2000,1876,1280,89,3245,0.578120184899846,0.39445300462249616,0.027426810477657937,0,0,0,0,0.0,0.0,0.0,596,0,0.1836671802773498,0.0
5505,22035,East Carroll,Louisiana,2004,1980,1357,58,3395,0.5832106038291606,0.3997054491899853,0.017083946980854196,104,-31,77,150,0.005090418929314611,-0.010342863496803741,0.005252444567489134,623,27,0.18350515463917527,-0.0001620256381745233
5506,22035,East Carroll,Louisiana,2008,2267,1254,38,3559,0.6369766788423714,0.3523461646529924,0.010677156504636133,287,-20,-103,164,0.053766075013210846,-0.006406790476218062,-0.047359284536992896,1013,390,0.284630514189379,0.10112535955020374
5507,22035,East Carroll,Louisiana,2012,2478,1508,22,4008,0.6182634730538922,0.37624750499001997,0.0054890219560878245,211,-16,254,449,-0.018713205788479237,-0.005188134548548309,0.023901340337027566,970,-43,0.2420159680638722,-0.0426145461255068
5508,22035,East Carroll,Louisiana,2016,1838,1059,42,2939,0.6253827832596122,0.360326641714869,0.014290575025518884,-640,20,-449,-1069,0.007119310205719986,0.008801553069431058,-0.015920863275150965,779,-191,0.26505614154474316,0.02304017348087095
5509,22037,East Feliciana,Louisiana,2000,3870,4051,178,8099,0.4778367699716014,0.5001852080503766,0.02197802197802198,0,0,0,0,0.0,0.0,0.0,-181,0,-0.02234843807877518,0.0
5510,22037,East Feliciana,Louisiana,2004,4091,5021,89,9201,0.4446255841756331,0.5457015541788935,0.009672861645473319,221,-89,970,1102,-0.03321118579596832,-0.012305160332548661,0.04551634612851696,-930,-749,-0.10107597000326046,-0.07872753192448528
5511,22037,East Feliciana,Louisiana,2008,4383,5432,132,9947,0.4406353674474716,0.546094299788881,0.01327033276364733,292,43,411,746,-0.0039902167281614664,0.003597471118174012,0.0003927456099874771,-1049,-119,-0.1054589323414094,-0.0043829623381489435
5512,22037,East Feliciana,Louisiana,2012,4648,5397,164,10209,0.45528455284552843,0.5286511901263591,0.01606425702811245,265,32,-35,262,0.014649185398056819,0.002793924264465118,-0.01744310966252194,-749,300,-0.07336663728083065,0.03209229506057876
5513,22037,East Feliciana,Louisiana,2016,4235,5569,238,10042,0.4217287392949612,0.5545708026289584,0.023700458076080462,-413,74,172,-167,-0.03355581355056725,0.007636201047968014,0.025919612502599332,-1334,-585,-0.13284206333399723,-0.05947542605316658
5514,22039,Evangeline,Louisiana,2000,5763,7290,559,13612,0.4233764325595063,0.5355568615927123,0.04106670584778137,0,0,0,0,0.0,0.0,0.0,-1527,0,-0.11218042903320602,0.0
5515,22039,Evangeline,Louisiana,2004,5757,7949,273,13979,0.4118320337649331,0.5686386722941555,0.019529293940911366,-6,-286,659,367,-0.011544398794573196,-0.021537411906870002,0.033081810701443226,-2192,-665,-0.15680663852922244,-0.04462620949601642
5516,22039,Evangeline,Louisiana,2008,5853,9793,330,15976,0.3663620430645969,0.6129819729594391,0.020655983975963944,96,57,1844,1997,-0.045469990700336194,0.0011266900350525785,0.04434330066528358,-3940,-1748,-0.24661992989484222,-0.08981329136561977
5517,22039,Evangeline,Louisiana,2012,5330,10181,259,15770,0.3379835129993659,0.6455928979074191,0.016423589093214966,-523,-71,388,-206,-0.028378530065231,-0.0042323948827489785,0.03261092494798001,-4851,-911,-0.30760938490805323,-0.060989455013211014
5518,22039,Evangeline,Louisiana,2016,4208,10360,314,14882,0.28275769385835237,0.6961429915333961,0.02109931460825158,-1122,55,179,-888,-0.055225819141013544,0.004675725515036613,0.050550093625976955,-6152,-1301,-0.41338529767504373,-0.1057759127669905
5519,22041,Franklin,Louisiana,2000,2792,5363,201,8356,0.33413116323599806,0.6418142651986597,0.02405457156534227,0,0,0,0,0.0,0.0,0.0,-2571,0,-0.30768310196266163,0.0
5520,22041,Franklin,Louisiana,2004,2828,6141,134,9103,0.3106668131385258,0.6746127650225201,0.014720421838954192,36,-67,778,747,-0.023464350097472275,-0.009334149726388078,0.032798499823860405,-3313,-742,-0.3639459518839943,-0.05626284992133268
5521,22041,Franklin,Louisiana,2008,2961,6278,119,9358,0.31641376362470613,0.6708698439837573,0.012716392391536654,133,-15,137,255,0.005746950486180347,-0.002004029447417538,-0.0037429210387628364,-3317,-4,-0.35445608035905113,0.009489871524943183
5522,22041,Franklin,Louisiana,2012,2921,6294,121,9336,0.31287489288774634,0.6741645244215938,0.012960582690659812,-40,2,16,-22,-0.0035388707369597983,0.00024419029912315857,0.003294680437836539,-3373,-56,-0.36128963153384747,-0.006833551174796337
5523,22041,Franklin,Louisiana,2016,2506,6514,142,9162,0.2735210652695918,0.7109801353416285,0.015498799388779742,-415,21,220,-174,-0.039353827618154535,0.0025382166981199293,0.036815610920034714,-4008,-635,-0.4374590700720367,-0.07616943853818925
5524,22043,Grant,Louisiana,2000,2099,4784,172,7055,0.29751948972360026,0.6781006378454997,0.02437987243090007,0,0,0,0,0.0,0.0,0.0,-2685,0,-0.3805811481218994,0.0
5525,22043,Grant,Louisiana,2004,1977,5911,103,7991,0.24740332874483795,0.7397071705668877,0.012889500688274309,-122,-69,1127,936,-0.050116160978762314,-0.01149037174262576,0.06160653272138805,-3934,-1249,-0.4923038418220498,-0.11172269370015037
5526,22043,Grant,Louisiana,2008,1474,6907,177,8558,0.17223650385604114,0.8070810937134845,0.02068240243047441,-503,74,996,567,-0.07516682488879681,0.0077929017422001,0.06737392314659674,-5433,-1499,-0.6348445898574433,-0.14254074803539352
5527,22043,Grant,Louisiana,2012,1422,7082,163,8667,0.1640706126687435,0.8171224183685243,0.018806968962732203,-52,-14,175,109,-0.00816589118729763,-0.0018754334677422053,0.010041324655039818,-5660,-227,-0.6530518056997807,-0.01820721584233742
5528,22043,Grant,Louisiana,2016,1181,7408,232,8821,0.13388504704682008,0.8398140800362771,0.026300872916902845,-241,69,326,154,-0.030185565621923427,0.0074939039541706415,0.022691661667752827,-6227,-567,-0.705929032989457,-0.052877227289676254
5529,22045,Iberia,Louisiana,2000,11762,17236,1022,30020,0.39180546302465025,0.5741505662891405,0.03404397068620919,0,0,0,0,0.0,0.0,0.0,-5474,0,-0.18234510326449027,0.0
5530,22045,Iberia,Louisiana,2004,12426,19420,427,32273,0.3850277321600099,0.6017413937347008,0.013230874105289251,664,-595,2184,2253,-0.006777730864640341,-0.02081309658091994,0.027590827445560295,-6994,-1520,-0.2167136615746909,-0.034368558310200636
5531,22045,Iberia,Louisiana,2008,12492,20127,549,33168,0.37662807525325614,0.6068198263386396,0.016552098408104197,66,122,707,895,-0.00839965690675376,0.003321224302814946,0.0050784326039388095,-7635,-641,-0.23019175108538348,-0.01347808951069257
5532,22045,Iberia,Louisiana,2012,12132,20892,373,33397,0.3632661616312842,0.6255651705242986,0.011168667844417163,-360,-176,765,229,-0.013361913621971921,-0.005383430563687034,0.018745344185658985,-8760,-1125,-0.2622990088930144,-0.03210725780763091
5533,22045,Iberia,Louisiana,2016,10698,20903,853,32454,0.3296357921981882,0.6440808528994885,0.026283354902323287,-1434,480,11,-943,-0.033630369433096,0.015114687057906124,0.018515682375189857,-10205,-1445,-0.31444506070130024,-0.052146051808285854
5534,22047,Iberville,Louisiana,2000,8355,5573,575,14503,0.5760877059918638,0.38426532441563815,0.0396469695924981,0,0,0,0,0.0,0.0,0.0,2782,0,0.1918223815762256,0.0
5535,22047,Iberville,Louisiana,2004,8259,6333,235,14827,0.5570243474742025,0.4271261887097862,0.01584946381601133,-96,-340,760,324,-0.019063358517661277,-0.023797505776486774,0.04286086429414804,1926,-856,0.1298981587644163,-0.061924222811809315
5536,22047,Iberville,Louisiana,2008,9023,7185,213,16421,0.5494793252542476,0.43754947932525423,0.012971195420498143,764,-22,852,1594,-0.0075450222199549,-0.0028782683955131862,0.01042329061546804,1838,-88,0.11192984592899335,-0.01796831283542294
5537,22047,Iberville,Louisiana,2012,9548,7271,195,17014,0.561184906547549,0.4273539438109792,0.011461149641471729,525,-18,86,593,0.01170558129330146,-0.0015100457790264143,-0.010195535514275045,2277,439,0.13383096273656986,0.021901116807576504
5538,22047,Iberville,Louisiana,2016,8324,7320,399,16043,0.5188555756404662,0.45627376425855515,0.02487066010097862,-1224,204,49,-971,-0.042329330907082796,0.013409510459506892,0.02891982044757596,1004,-1273,0.0625818113819111,-0.07124915135465876
5539,22049,Jackson,Louisiana,2000,2582,4347,177,7106,0.36335491134252745,0.6117365606529693,0.024908528004503237,0,0,0,0,0.0,0.0,0.0,-1765,0,-0.24838164931044188,0.0
5540,22049,Jackson,Louisiana,2004,2525,5038,84,7647,0.33019484765267426,0.658820452465019,0.010984699882306787,-57,-93,691,541,-0.03316006368985319,-0.01392382812219645,0.04708389181204964,-2513,-748,-0.3286256048123447,-0.08024395550190283
5541,22049,Jackson,Louisiana,2008,2456,5190,90,7736,0.31747673216132366,0.6708893485005171,0.011633919338159255,-69,6,152,89,-0.012718115491350601,0.0006492194558524681,0.0120688960354981,-2734,-221,-0.3534126163391934,-0.0247870115268487
5542,22049,Jackson,Louisiana,2012,2305,5132,92,7529,0.306149555053792,0.6816310266967724,0.012219418249435517,-151,2,-58,-207,-0.011327177107531672,0.0005854989112762613,0.010741678196255378,-2827,-93,-0.37548147164298046,-0.02206885530378705
5543,22049,Jackson,Louisiana,2016,2139,5169,156,7464,0.2865755627009646,0.692524115755627,0.02090032154340836,-166,64,37,-65,-0.019573992352827363,0.008680903293972843,0.010893089058854555,-3030,-203,-0.4059485530546624,-0.030467081411681918
5544,22051,Jefferson,Louisiana,2000,70411,105003,3737,179151,0.39302599483117595,0.5861145067568699,0.020859498411954162,0,0,0,0,0.0,0.0,0.0,-34592,0,-0.19308851192569398,0.0
5545,22051,Jefferson,Louisiana,2004,72136,117882,1645,191663,0.376368939231881,0.6150482878802899,0.008582772887829158,1725,-2092,12879,12512,-0.01665705559929498,-0.012276725524125004,0.028933781123419933,-45746,-11154,-0.2386793486484089,-0.04559083672271491
5546,22051,Jefferson,Louisiana,2008,65096,113191,2833,181120,0.3594081272084806,0.6249503091872791,0.015641563604240283,-7040,1188,-4691,-10543,-0.016960812023400385,0.007058790716411125,0.00990202130698925,-48095,-2349,-0.26554218197879853,-0.026862833330389635
5547,22051,Jefferson,Louisiana,2012,70384,102536,3423,176343,0.3991312385521399,0.5814577272701497,0.019411034177710486,5288,590,-10655,-4777,0.0397231113436593,0.0037694705734702023,-0.04349258191712946,-32152,15943,-0.18232648871800977,0.08321569326078876
5548,22051,Jefferson,Louisiana,2016,73670,100398,7571,181639,0.4055847037255215,0.5527337190801535,0.041681577194325005,3286,4148,-2138,5296,0.006453465173381634,0.02227054301661452,-0.02872400818999621,-26728,5424,-0.14714901535463193,0.03517747336337784
5549,22053,Jefferson Davis,Louisiana,2000,5162,6945,439,12546,0.411445879164674,0.5535628885700622,0.03499123226526383,0,0,0,0,0.0,0.0,0.0,-1783,0,-0.14211700940538818,0.0
5550,22053,Jefferson Davis,Louisiana,2004,4745,8055,207,13007,0.36480356730991004,0.6192819251172446,0.01591450757284539,-417,-232,1110,461,-0.046642311854763974,-0.01907672469241844,0.06571903654718236,-3310,-1527,-0.2544783578073345,-0.11236134840194634
5551,22053,Jefferson Davis,Louisiana,2008,3923,9278,300,13501,0.2905710688097178,0.6872083549366713,0.022220576253610843,-822,93,1223,494,-0.07423249850019226,0.006306068680765452,0.06792642981942676,-5355,-2045,-0.39663728612695354,-0.14215892831961902
5552,22053,Jefferson Davis,Louisiana,2012,3484,10014,236,13734,0.25367700597058396,0.7291393621668851,0.017183631862530944,-439,-64,736,233,-0.03689406283913382,-0.005036944391079899,0.04193100723021381,-6530,-1175,-0.4754623561963012,-0.07882507006934764
5553,22053,Jefferson Davis,Louisiana,2016,3080,10775,422,14277,0.21573159627372698,0.7547103733277299,0.02955803039854311,-404,186,761,543,-0.037945409696856974,0.012374398536012167,0.025571011160844814,-7695,-1165,-0.538978777054003,-0.06351642085770182
5554,22055,Lafayette,Louisiana,2000,27190,48491,2612,78293,0.34728519791041346,0.6193529434304471,0.03336185865913939,0,0,0,0,0.0,0.0,0.0,-21301,0,-0.27206774552003365,0.0
5555,22055,Lafayette,Louisiana,2004,31210,57732,981,89923,0.3470747194822237,0.6420159469768579,0.010909333540918342,4020,-1631,9241,11630,-0.00021047842818977536,-0.02245252511822105,0.02266300354641082,-26522,-5221,-0.29494122749463425,-0.022873481974600596
5556,22055,Lafayette,Louisiana,2008,32145,62055,1442,95642,0.33609711214738297,0.6488258296564271,0.01507705819618996,935,461,4323,5719,-0.010977607334840711,0.004167724655271618,0.006809882679569168,-29910,-3388,-0.31272871750904413,-0.01778749001440988
5557,22055,Lafayette,Louisiana,2012,31768,64992,1882,98642,0.3220534863445591,0.6588674195575921,0.019079094097848786,-377,440,2937,3000,-0.014043625802823867,0.004002035901658827,0.010041589901164993,-33224,-3314,-0.336813933213033,-0.02408521570398886
5558,22055,Lafayette,Louisiana,2016,32726,68195,4682,105603,0.3098964991524862,0.6457676391769174,0.04433586167059648,958,2800,3203,6961,-0.012156987192072921,0.025256767572747692,-0.01309978038067472,-35469,-2245,-0.3358711400244312,0.0009427931886017982
5559,22057,Lafourche,Louisiana,2000,14627,18575,1247,34449,0.42459868210978546,0.5392028796191471,0.036198438271067376,0,0,0,0,0.0,0.0,0.0,-3948,0,-0.11460419750936168,0.0
5560,22057,Lafourche,Louisiana,2004,14417,22734,713,37864,0.380757447707585,0.6004120008451299,0.01883055144728502,-210,-534,4159,3415,-0.043841234402200446,-0.017367886823782357,0.061209121225982766,-8317,-4369,-0.2196545531375449,-0.10505035562818321
5561,22057,Lafourche,Louisiana,2008,9662,27089,1142,37893,0.25498113107961895,0.7148813765075344,0.0301374924128467,-4755,429,4355,29,-0.12577631662796607,0.01130694096556168,0.11446937566240445,-17427,-9110,-0.4599002454279154,-0.24024569229037052
5562,22057,Lafourche,Louisiana,2012,9623,28592,860,39075,0.24626999360204735,0.7317210492642354,0.02200895713371721,-39,-282,1503,1182,-0.008711137477571601,-0.00812853527912949,0.016839672756701063,-18969,-1542,-0.48545105566218805,-0.025550810234272636
5563,22057,Lafourche,Louisiana,2016,8423,31959,1263,41645,0.20225717373033977,0.7674150558290311,0.030327770440629127,-1200,403,3367,2570,-0.044012819871707576,0.008318813306911917,0.03569400656479571,-23536,-4567,-0.5651578820986913,-0.07970682643650329
5564,22059,LaSalle,Louisiana,2000,1397,4564,147,6108,0.22871643745907008,0.7472167648984938,0.02406679764243615,0,0,0,0,0.0,0.0,0.0,-3167,0,-0.5185003274394236,0.0
5565,22059,LaSalle,Louisiana,2004,1155,5015,68,6238,0.18515549855722988,0.8039435716575826,0.010900929785187561,-242,-79,451,130,-0.04356093890184021,-0.01316586785724859,0.05672680675908881,-3860,-693,-0.6187880731003527,-0.10028774566092902
5566,22059,LaSalle,Louisiana,2008,860,5602,91,6553,0.1312376010987334,0.8548756294826797,0.013886769418586907,-295,23,587,315,-0.05391789745849648,0.0029858396333993457,0.05093205782509713,-4742,-882,-0.7236380283839463,-0.10484995528359364
5567,22059,LaSalle,Louisiana,2012,764,5726,82,6572,0.1162507608034084,0.8712720632988435,0.012477175897748022,-96,-9,124,19,-0.014986840295324988,-0.0014095935208388848,0.016396433816163847,-4962,-220,-0.7550213024954351,-0.03138327411148878
5568,22059,LaSalle,Louisiana,2016,605,5836,128,6569,0.0920992540721571,0.8884152839092708,0.01948546201857208,-159,46,110,-3,-0.0241515067312513,0.007008286120824058,0.01714322061042728,-5231,-269,-0.7963160298371137,-0.041294727341678605
5569,22061,Lincoln,Louisiana,2000,6851,9246,454,16551,0.4139326928886472,0.558636940366141,0.02743036674521177,0,0,0,0,0.0,0.0,0.0,-2395,0,-0.14470424747749377,0.0
5570,22061,Lincoln,Louisiana,2004,7242,10791,185,18218,0.39751893731474364,0.5923262707212646,0.010154791963991657,391,-269,1545,1667,-0.016413755573903566,-0.01727557478122011,0.03368933035512367,-3549,-1154,-0.194807333406521,-0.050103085929027236
5571,22061,Lincoln,Louisiana,2008,8292,10680,207,19179,0.4323478804942906,0.5568590646019084,0.010793054903801032,1050,22,-111,961,0.03482894317954699,0.000638262939809375,-0.035467206119356276,-2388,1161,-0.12451118410761775,0.07029614929890327
5572,22061,Lincoln,Louisiana,2012,7956,10739,298,18993,0.4188911704312115,0.5654188385194545,0.015689991049333964,-336,91,59,-186,-0.013456710063079136,0.004896936145532932,0.008559773917546143,-2783,-395,-0.14652766808824302,-0.02201648398062528
5573,22061,Lincoln,Louisiana,2016,7107,10761,801,18669,0.3806845572874819,0.5764100915956933,0.04290535111682468,-849,503,22,-324,-0.038206613143729584,0.02721536006749072,0.010991253076238827,-3654,-871,-0.19572553430821144,-0.04919786621996841
5574,22063,Livingston,Louisiana,2000,11008,24889,968,36865,0.2986030109860301,0.6751390207513902,0.026257968262579683,0,0,0,0,0.0,0.0,0.0,-13881,0,-0.3765360097653601,0.0
5575,22063,Livingston,Louisiana,2004,9895,33976,382,44253,0.2236006598422706,0.767767157028902,0.008632183128827424,-1113,-586,9087,7388,-0.0750023511437595,-0.017625785133752257,0.09262813627751176,-24081,-10200,-0.5441664971866313,-0.16763048742127123
5576,22063,Livingston,Louisiana,2008,6681,43269,942,50892,0.1312780004715869,0.850212214100448,0.0185097854279651,-3214,560,9293,6639,-0.09232265937068371,0.009877602299137677,0.08244505707154604,-36588,-12507,-0.7189342136288611,-0.17476771644222977
5577,22063,Livingston,Louisiana,2012,7451,45513,1098,54062,0.1378232399837224,0.8418667455883985,0.0203100144278791,770,156,2244,3170,0.006545239512135509,0.0018002289999139998,-0.008345468512049536,-38062,-1474,-0.7040435056046761,0.014890708024185018
5578,22063,Livingston,Louisiana,2016,6950,48824,1956,57730,0.12038801316473237,0.8457301229863156,0.03388186384895202,-501,858,3311,3668,-0.017435226818990027,0.013571849421072917,0.0038633773979170893,-41874,-3812,-0.7253421098215832,-0.021298604216907102
5579,22065,Madison,Louisiana,2000,2489,2127,127,4743,0.5247733502002951,0.4484503478810879,0.02677630191861691,0,0,0,0,0.0,0.0,0.0,362,0,0.07632300231920724,0.0
5580,22065,Madison,Louisiana,2004,2334,2291,48,4673,0.49946501176974106,0.49026321420928737,0.010271774020971538,-155,-79,164,-70,-0.025308338430554078,-0.016504527897645373,0.04181286632819947,43,-319,0.009201797560453695,-0.06712120475875355
5581,22065,Madison,Louisiana,2008,3100,2152,48,5300,0.5849056603773585,0.4060377358490566,0.009056603773584906,766,0,-139,627,0.08544064860761741,-0.0012151702473866318,-0.08422547836023075,948,905,0.17886792452830186,0.16966612696784816
5582,22065,Madison,Louisiana,2012,3154,2000,33,5187,0.608058608058608,0.385579332947754,0.006362058993637941,54,-15,-152,-113,0.023152947681249536,-0.0026945447799469648,-0.02045840290130263,1154,206,0.22247927511085402,0.043611350582552166
5583,22065,Madison,Louisiana,2016,2744,1927,61,4732,0.5798816568047337,0.4072273879966188,0.012890955198647506,-410,28,-73,-455,-0.028176951253874316,0.006528896205009564,0.0216480550488648,817,-337,0.1726542688081149,-0.04982500630273912
5584,22067,Morehouse,Louisiana,2000,5289,6641,391,12321,0.42926710494278064,0.5389984579173769,0.031734437139842545,0,0,0,0,0.0,0.0,0.0,-1352,0,-0.10973135297459624,0.0
5585,22067,Morehouse,Louisiana,2004,5336,7471,164,12971,0.4113792305913191,0.5759771798627707,0.012643589545910107,47,-227,830,650,-0.017887874351461552,-0.01909084759393244,0.036978721945393866,-2135,-783,-0.16459794927145166,-0.05486659629685542
5586,22067,Morehouse,Louisiana,2008,5792,7258,150,13200,0.4387878787878788,0.5498484848484848,0.011363636363636364,456,-14,-213,229,0.027408648196559693,-0.0012799531822737433,-0.02612869501428594,-1466,669,-0.11106060606060603,0.053537343210845634
5587,22067,Morehouse,Louisiana,2012,5888,6591,135,12614,0.4667829395909307,0.522514666243856,0.010702394165213255,96,-15,-667,-586,0.02799506080305192,-0.0006612421984231089,-0.0273338186046288,-703,763,-0.055731726652925306,0.05532887940768072
5588,22067,Morehouse,Louisiana,2016,5155,6502,195,11852,0.43494768815389806,0.5485993925075937,0.01645291933850827,-733,60,-89,-762,-0.03183525143703264,0.005750525173295015,0.0260847262637377,-1347,-644,-0.11365170435369565,-0.05791997770077034
5589,22069,Natchitoches,Louisiana,2000,6924,7332,601,14857,0.4660429427206031,0.49350474523793497,0.040452312041461935,0,0,0,0,0.0,0.0,0.0,-408,0,-0.02746180251733188,0.0
5590,22069,Natchitoches,Louisiana,2004,7398,9261,307,16966,0.43604856772368267,0.5458564187197925,0.018095013556524816,474,-294,1929,2109,-0.029994374996920425,-0.02235729848493712,0.05235167348185754,-1863,-1455,-0.10980785099610985,-0.08234604847877797
5591,22069,Natchitoches,Louisiana,2008,7801,9054,212,17067,0.4570809163883518,0.5304974512216558,0.012421632389992382,403,-95,-207,101,0.02103234866466913,-0.005673381166532434,-0.0153589674981367,-1253,610,-0.07341653483330401,0.03639131616280583
5592,22069,Natchitoches,Louisiana,2012,7942,9077,239,17258,0.4601923745509329,0.5259589755475721,0.01384864990149496,141,27,23,191,0.0031114581625811266,0.0014270175115025773,-0.0045384756740837195,-1135,118,-0.06576660099663917,0.007649933836664846
5593,22069,Natchitoches,Louisiana,2016,7144,8968,509,16621,0.4298177004993683,0.5395583899885686,0.030623909512063053,-798,270,-109,-637,-0.030374674051564632,0.016775259610568093,0.013599414440996549,-1824,-689,-0.10974068948920035,-0.04397408849256118
5594,22071,Orleans,Louisiana,2000,137630,39404,4187,181221,0.7594594445456101,0.2174361690974004,0.023104386356989533,0,0,0,0,0.0,0.0,0.0,98226,0,0.5420232754482097,0.0
5595,22071,Orleans,Louisiana,2004,152610,42847,1646,197103,0.7742652318838373,0.21738380440683297,0.00835096370932964,14980,-2541,3443,15882,0.014805787338227239,-0.014753422647659893,-5.2364690567435757e-05,109763,11537,0.5568814274770044,0.014858152028794702
5596,22071,Orleans,Louisiana,2008,117102,28130,2207,147439,0.7942403298991447,0.19079076770732303,0.01496890239353224,-35508,561,-14717,-49664,0.01997509801530739,0.006617938684202601,-0.026593036699509937,88972,-20791,0.6034495621918217,0.046568134714817244
5597,22071,Orleans,Louisiana,2012,126722,28003,3088,157813,0.8029883469676136,0.1774441902758328,0.019567462756553643,9620,881,-127,10374,0.008748017068468839,0.004598560363021403,-0.01334657743149023,98719,9747,0.6255441566917808,0.022094594499959097
5598,22071,Orleans,Louisiana,2016,133996,24292,7524,165812,0.8081200395628785,0.14650326876221262,0.04537669167490893,7274,4436,-3711,7999,0.005131692595264914,0.025809228918355288,-0.030940921513620184,109704,10985,0.6616167708006658,0.03607261410888507
5599,22073,Ouachita,Louisiana,2000,21457,35107,1647,58211,0.36860730789713286,0.603099070622391,0.0282936214804762,0,0,0,0,0.0,0.0,0.0,-13650,0,-0.23449176272525812,0.0
5600,22073,Ouachita,Louisiana,2004,22016,41750,678,64444,0.34162994227546395,0.6478492955123828,0.010520762212153187,559,-969,6643,6233,-0.026977365621668914,-0.01777285926832301,0.04475022488999181,-19734,-6084,-0.30621935323691885,-0.07172759051166072
5601,22073,Ouachita,Louisiana,2008,24813,41741,690,67244,0.36899946463625005,0.6207393968235084,0.010261138540241509,2797,12,-9,2800,0.027369522360786103,-0.00025962367191167783,-0.027109898688874368,-16928,2806,-0.2517399321872584,0.05447942104966047
5602,22073,Ouachita,Louisiana,2012,26645,40948,881,68474,0.38912579957356075,0.5980080030376493,0.012866197388789906,1832,191,-793,1230,0.020126334937310697,0.002605058848548397,-0.02273139378585909,-14303,2625,-0.2088822034640886,0.042857728723169786
5603,22073,Ouachita,Louisiana,2016,24428,41734,1855,68017,0.35914550774071186,0.6135818986429863,0.027272593616301806,-2217,974,786,-457,-0.029980291832848893,0.0144063962275119,0.015573895605336951,-17306,-3003,-0.25443639090227443,-0.045554187438185845
5604,22075,Plaquemines,Louisiana,2000,4425,6302,204,10931,0.4048120025615223,0.5765254779983533,0.01866251944012442,0,0,0,0,0.0,0.0,0.0,-1877,0,-0.17171347543683102,0.0
5605,22075,Plaquemines,Louisiana,2004,4181,7866,106,12153,0.34403028058915497,0.6472475931868674,0.008722126223977618,-244,-98,1564,1222,-0.06078172197236731,-0.0099403932161468,0.07072211518851412,-3685,-1808,-0.30321731259771245,-0.13150383716088143
5606,22075,Plaquemines,Louisiana,2008,3380,6894,175,10449,0.32347593071107283,0.6597760551248923,0.016748014164034836,-801,69,-972,-1704,-0.020554349878082134,0.008025887940057218,0.012528461938024926,-3514,171,-0.3363001244138195,-0.03308281181610706
5607,22075,Plaquemines,Louisiana,2012,3599,6471,169,10239,0.35149916984080476,0.6319953120421916,0.016505518117003612,219,-6,-423,-210,0.028023239129731925,-0.00024249604703122443,-0.027780743082700732,-2872,642,-0.28049614220138686,0.05580398221243266
5608,22075,Plaquemines,Louisiana,2016,3347,6900,326,10573,0.3165610517355528,0.6526056937482266,0.03083325451622056,-252,157,429,334,-0.034938118105251936,0.014327736399216948,0.02061038170603502,-3553,-681,-0.3360446420126738,-0.055548499811286955
5609,22077,Pointe Coupee,Louisiana,2000,5813,4710,309,10832,0.5366506646971935,0.4348227474150665,0.02852658788774003,0,0,0,0,0.0,0.0,0.0,1103,0,0.10182791728212698,0.0
5610,22077,Pointe Coupee,Louisiana,2004,5712,5429,130,11271,0.5067873303167421,0.48167864430840207,0.011534025374855825,-101,-179,719,439,-0.029863334380451412,-0.016992562512884203,0.04685589689333558,283,-820,0.025108686008339987,-0.07671923127378699
5611,22077,Pointe Coupee,Louisiana,2008,5516,6702,217,12435,0.44358665058303176,0.538962605548854,0.017450743868114193,-196,87,1273,1164,-0.0632006797337103,0.005916718493258368,0.05728396124045193,-1186,-1469,-0.09537595496582224,-0.12048464097416223
5612,22077,Pointe Coupee,Louisiana,2012,5436,6548,163,12147,0.4475179056557175,0.5390631431629209,0.013418951181361653,-80,-54,-154,-288,0.003931255072685713,-0.00403179268675254,0.00010053761406692008,-1112,74,-0.09154523750720345,0.003830717458618793
5613,22077,Pointe Coupee,Louisiana,2016,4764,6789,208,11761,0.40506759629283223,0.577246832752317,0.01768557095485078,-672,45,241,-386,-0.04245030936288524,0.004266619773489126,0.03818368958939611,-2025,-913,-0.1721792364594848,-0.08063399895228135
5614,22079,Rapides,Louisiana,2000,18898,28831,1295,49024,0.38548466057441255,0.5880997062663186,0.02641563315926893,0,0,0,0,0.0,0.0,0.0,-9933,0,-0.20261504569190603,0.0
5615,22079,Rapides,Louisiana,2004,18904,34492,673,54069,0.34962732804379587,0.6379256135678485,0.012447058388355619,6,-622,5661,5045,-0.03585733253061668,-0.01396857477091331,0.049825907301529915,-15588,-5655,-0.2882982855240526,-0.0856832398321466
5616,22079,Rapides,Louisiana,2008,20127,36611,783,57521,0.34990699049042956,0.6364805896976756,0.013612419811894786,1223,110,2119,3452,0.00027966244663368833,0.0011653614235391675,-0.001445023870172868,-16484,-896,-0.28657359920724607,0.0017246863168065563
5617,22079,Rapides,Louisiana,2012,20045,37193,781,58019,0.34549027042865266,0.641048622003137,0.013461107568210414,-82,-2,582,498,-0.004416720061776902,-0.00015131224368437196,0.0045680323054613226,-17148,-664,-0.2955583515744843,-0.008984752367238225
5618,22079,Rapides,Louisiana,2016,18322,36816,1706,56844,0.3223207374568996,0.6476672999788896,0.030011962564210824,-1723,925,-377,-1175,-0.02316953297175306,0.01655085499600041,0.006618677975752663,-18494,-1346,-0.32534656252199,-0.029788210947505722
5619,22081,Red River,Louisiana,2000,2177,2200,145,4522,0.48142414860681115,0.4865103936311367,0.03206545776205219,0,0,0,0,0.0,0.0,0.0,-23,0,-0.005086245024325531,0.0
5620,22081,Red River,Louisiana,2004,2140,2507,70,4717,0.45367818528725884,0.5314818740725037,0.014839940640237439,-37,-75,307,195,-0.027745963319552314,-0.017225517121814752,0.04497148044136701,-367,-344,-0.07780368878524485,-0.07271744376091932
5621,22081,Red River,Louisiana,2008,2080,2484,65,4629,0.44934111039101315,0.5366169799092677,0.014041909699719161,-60,-5,-23,-88,-0.004337074896245685,-0.0007980309405182778,0.00513510583676402,-404,-37,-0.08727586951825456,-0.009472180733009705
5622,22081,Red River,Louisiana,2012,2253,2483,71,4807,0.4686914915747868,0.5165383815269399,0.014770126898273351,173,6,-1,178,0.019350381183773635,0.0007282171985541902,-0.02007859838232784,-230,174,-0.04784688995215308,0.039428979566101474
5623,22081,Red River,Louisiana,2016,1938,2391,93,4422,0.43826322930800543,0.5407055630936228,0.02103120759837178,-315,22,-92,-385,-0.03042826226678136,0.006261080700098428,0.02416718156668296,-453,-223,-0.1024423337856174,-0.05459544383346432
5624,22083,Richland,Louisiana,2000,3282,4895,308,8485,0.3868002357100766,0.576900412492634,0.03629935179728933,0,0,0,0,0.0,0.0,0.0,-1613,0,-0.19010017678255742,0.0
5625,22083,Richland,Louisiana,2004,3082,5471,112,8665,0.3556837853433353,0.6313906520484709,0.012925562608193884,-200,-196,576,180,-0.03111645036674132,-0.023373789189095447,0.05449023955583687,-2389,-776,-0.2757068667051356,-0.0856066899225782
5626,22083,Richland,Louisiana,2008,3311,5751,119,9181,0.3606360962858077,0.6264023526848927,0.01296155102929964,229,7,280,516,0.004952310942472393,3.5988421105756854e-05,-0.004988299363578141,-2440,-51,-0.2657662563990851,0.009940610306050535
5627,22083,Richland,Louisiana,2012,3387,5846,96,9329,0.36306142137420944,0.6266480866116411,0.010290492014149426,76,-23,95,148,0.002425325088401764,-0.0026710590151502143,0.00024573392674831496,-2459,-19,-0.2635866652374316,0.002179591161653449
5628,22083,Richland,Louisiana,2016,3157,6287,153,9597,0.3289569657184537,0.6551005522559133,0.01594248202563301,-230,57,441,268,-0.03410445565575576,0.005651990011483584,0.028452465644272285,-3130,-671,-0.3261435865374597,-0.06255692130002805
5629,22085,Sabine,Louisiana,2000,2846,5754,262,8862,0.32114646806589936,0.6492890995260664,0.029564432408034302,0,0,0,0,0.0,0.0,0.0,-2908,0,-0.32814263146016703,0.0
5630,22085,Sabine,Louisiana,2004,2743,6711,122,9576,0.2864452798663325,0.7008145363408521,0.012740183792815371,-103,-140,957,714,-0.03470118819956686,-0.01682424861521893,0.05152543681478572,-3968,-1060,-0.4143692564745196,-0.08622662501435258
5631,22085,Sabine,Louisiana,2008,2245,7226,181,9652,0.23259428097803564,0.7486531288852052,0.01875259013675922,-498,59,515,76,-0.053850998888296864,0.0060124063439438505,0.047838592544353076,-4981,-1013,-0.5160588479071695,-0.10168959143264988
5632,22085,Sabine,Louisiana,2012,2194,7738,121,10053,0.21824331045459067,0.7697204814483238,0.012036208097085447,-51,-60,512,401,-0.014350970523444972,-0.006716382039673775,0.021067352563118646,-5544,-563,-0.5514771709937332,-0.035418323086563674
5633,22085,Sabine,Louisiana,2016,1703,7879,205,9787,0.17400633493409626,0.8050475120057219,0.020946153060181875,-491,84,141,-266,-0.04423697552049441,0.008909944963096428,0.035327030557398054,-6176,-632,-0.6310411770716257,-0.07956400607789249
5634,22087,St. Bernard,Louisiana,2000,11682,16255,684,28621,0.4081618392089724,0.567939624751057,0.02389853603997065,0,0,0,0,0.0,0.0,0.0,-4573,0,-0.15977778554208455,0.0
5635,22087,St. Bernard,Louisiana,2004,9956,19597,285,29838,0.33366847643943964,0.6567799450365306,0.00955157852402976,-1726,-399,3342,1217,-0.07449336276953278,-0.01434695751594089,0.08884032028547362,-9641,-5068,-0.32311146859709095,-0.1633336830550064
5636,22087,St. Bernard,Louisiana,2008,3491,9643,407,13541,0.25780961524259655,0.7121335204194668,0.030056864337936636,-6465,122,-9954,-16297,-0.0758588611968431,0.020505285813906877,0.05535357538293617,-6152,3489,-0.4543239051768702,-0.13121243657977927
5637,22087,St. Bernard,Louisiana,2012,5059,8501,395,13955,0.36252239340738085,0.6091723396632032,0.02830526692941598,1568,-12,-1142,414,0.1047127781647843,-0.0017515974085206554,-0.10296118075626359,-3442,2710,-0.24664994625582232,0.2076739589210479
5638,22087,St. Bernard,Louisiana,2016,4960,10237,618,15815,0.31362630414163767,0.6472968700600695,0.03907682579829276,-99,223,1736,1860,-0.04889608926574318,0.01077155886887678,0.03812453039686636,-5277,-1835,-0.33367056591843186,-0.08702061966260954
5639,22089,St. Charles,Louisiana,2000,8918,11981,611,21510,0.41459786145978617,0.5569967456996746,0.028405392840539286,0,0,0,0,0.0,0.0,0.0,-3063,0,-0.14239888423988845,0.0
5640,22089,St. Charles,Louisiana,2004,8856,14747,234,23837,0.3715232621554726,0.6186600662835088,0.009816671561018585,-62,-377,2766,2327,-0.043074599304313566,-0.0185887212795207,0.06166332058383417,-5891,-2828,-0.24713680412803618,-0.10473791988814773
5641,22089,St. Charles,Louisiana,2008,8522,16457,418,25397,0.3355514430838288,0.6479899200692996,0.01645863684687168,-334,184,1710,1560,-0.03597181907164382,0.006641965285853094,0.029329853785790783,-7935,-2044,-0.3124384769854708,-0.0653016728574346
5642,22089,St. Charles,Louisiana,2012,8896,15937,500,25333,0.3511625152962539,0.629100382899775,0.019737101803971105,374,82,-520,-64,0.015611072212425137,0.003278464957099426,-0.018889537169524573,-7041,894,-0.27793786760352107,0.03450060938194971
5643,22089,St. Charles,Louisiana,2016,8559,16621,1012,26192,0.32677916921197314,0.6345830788026878,0.03863775198533904,-337,512,684,859,-0.024383346084280777,0.018900650181367933,0.0054826959029128375,-8062,-1021,-0.3078039095907147,-0.029866041987193614
5644,22091,St. Helena,Louisiana,2000,3059,1965,230,5254,0.5822230681385611,0.374000761324705,0.04377617053673392,0,0,0,0,0.0,0.0,0.0,1094,0,0.20822230681385606,0.0
5645,22091,St. Helena,Louisiana,2004,3173,2235,100,5508,0.5760711692084242,0.4057734204793028,0.01815541031227306,114,-130,270,254,-0.006151898930136901,-0.02562076022446086,0.031772659154597815,938,-156,0.17029774872912135,-0.037924558084734716
5646,22091,St. Helena,Louisiana,2008,3567,2522,95,6184,0.5768111254851229,0.4078266494178525,0.01536222509702458,394,-5,287,676,0.0007399562766987611,-0.002793185215248479,0.0020532289385497005,1045,107,0.1689844760672704,-0.0013132726618509394
5647,22091,St. Helena,Louisiana,2012,3780,2529,85,6394,0.5911792305286205,0.3955270566155771,0.013293712855802315,213,-10,7,210,0.014368105043497614,-0.002068512241222264,-0.012299592802275439,1251,206,0.19565217391304346,0.026667697845773053
5648,22091,St. Helena,Louisiana,2016,3353,2497,114,5964,0.562206572769953,0.4186787391012743,0.019114688128772636,-427,29,-32,-430,-0.02897265775866753,0.005820975272970321,0.02315168248569721,856,-395,0.14352783366867872,-0.05212434024436474
5649,22093,St. James,Louisiana,2000,6523,3813,369,10705,0.6093414292386735,0.3561886968706212,0.03446987389070528,0,0,0,0,0.0,0.0,0.0,2710,0,0.2531527323680523,0.0
5650,22093,St. James,Louisiana,2004,6407,4545,156,11108,0.5767915016204537,0.409164566078502,0.014043932301044292,-116,-213,732,403,-0.03254992761821984,-0.020425941589660986,0.05297586920788078,1862,-848,0.16762693554195168,-0.08552579682610062
5651,22093,St. James,Louisiana,2008,6994,5432,138,12564,0.5566698503661255,0.4323463865011143,0.010983763132760267,587,-18,887,1456,-0.020121651254328188,-0.0030601691682840253,0.023181820422612298,1562,-300,0.1243234638650112,-0.043303471676940486
5652,22093,St. James,Louisiana,2012,7059,5209,127,12395,0.5695038321903994,0.4202501008471158,0.010246066962484873,65,-11,-223,-169,0.012833981824273866,-0.000737696170275394,-0.012096285653998506,1850,288,0.14925373134328357,0.024930267478272372
5653,22093,St. James,Louisiana,2016,6418,5456,211,12085,0.5310715763342987,0.45146876292925114,0.017459660736450146,-641,84,247,-310,-0.03843225585610066,0.007213593773965273,0.031218662082135362,962,-888,0.07960281340504755,-0.06965091793823602
5654,22095,St. John the Baptist,Louisiana,2000,9745,7423,545,17713,0.550160898774911,0.4190707390052504,0.030768362219838537,0,0,0,0,0.0,0.0,0.0,2322,0,0.13109015976966065,0.0
5655,22095,St. John the Baptist,Louisiana,2004,10305,9039,273,19617,0.5253096803792628,0.4607738186267013,0.013916500994035786,560,-272,1616,1904,-0.02485121839564819,-0.01685186122580275,0.04170307962145092,1266,-1056,0.06453586175256154,-0.06655429801709911
5656,22095,St. John the Baptist,Louisiana,2008,12424,8912,320,21656,0.5736978204654599,0.4115256741780569,0.014776505356483192,2119,47,-127,2039,0.04838814008619707,0.0008600043624474064,-0.04924814444864439,3512,2246,0.162172146287403,0.09763628453484147
5657,22095,St. John the Baptist,Louisiana,2012,13179,7620,324,21123,0.6239170572361881,0.36074421246981964,0.01533873029399233,755,4,-1292,-533,0.05021923677072815,0.0005622249375091381,-0.050781461708237274,5559,2047,0.26317284476636843,0.10100069847896542
5658,22095,St. John the Baptist,Louisiana,2016,12661,7569,513,20743,0.6103745841970786,0.3648941811695512,0.024731234633370295,-518,189,-51,-380,-0.013542473039109493,0.009392504339377964,0.004149968699731554,5092,-467,0.24548040302752738,-0.017692441738841047
5659,22097,St. Landry,Louisiana,2000,18067,15449,635,34151,0.5290328248074727,0.45237328335919885,0.018593891833328453,0,0,0,0,0.0,0.0,0.0,2618,0,0.07665954144827386,0.0
5660,22097,St. Landry,Louisiana,2004,18166,18315,279,36760,0.4941784548422198,0.49823177366702937,0.007589771490750816,99,-356,2866,2609,-0.03485436996525293,-0.011004120342577636,0.04585849030783051,-149,-2767,-0.004053318824809582,-0.08071286027308344
5661,22097,St. Landry,Louisiana,2008,20268,21650,575,42493,0.4769726778528228,0.5094956816416821,0.013531640505495022,2102,296,3335,5733,-0.01720577698939696,0.005941869014744206,0.011263907974652765,-1382,-1233,-0.032523003788859306,-0.028469684964049724
5662,22097,St. Landry,Louisiana,2012,19668,21475,504,41647,0.4722549043148366,0.5156433836770956,0.012101712008067807,-600,-71,-175,-846,-0.004717773537986247,-0.0014299284974272145,0.006147702035413483,-1807,-425,-0.043388479362259036,-0.01086547557339973
5663,22097,St. Landry,Louisiana,2016,17209,21971,797,39977,0.43047252169997746,0.5495910148335292,0.019936463466493234,-2459,293,496,-1670,-0.041782382614859115,0.007834751458425427,0.03394763115643362,-4762,-2955,-0.11911849313355177,-0.07573001377129274
5664,22099,St. Martin,Louisiana,2000,9853,9961,964,20778,0.4742034844547117,0.4794012898257773,0.04639522571951102,0,0,0,0,0.0,0.0,0.0,-108,0,-0.005197805371065567,0.0
5665,22099,St. Martin,Louisiana,2004,10321,12095,408,22824,0.4521994391868209,0.5299246407290571,0.017875920084121977,468,-556,2134,2046,-0.022004045267890848,-0.02851930563538904,0.05052335090327981,-1774,-1666,-0.07772520154223622,-0.07252739617117065
5666,22099,St. Martin,Louisiana,2008,9419,14443,390,24252,0.3883803397657925,0.5955385122876464,0.016081147946561108,-902,-18,2348,1428,-0.06381909942102837,-0.001794772137560869,0.06561387155858933,-5024,-3250,-0.20715817252185392,-0.1294329709796177
5667,22099,St. Martin,Louisiana,2012,9422,15653,358,25433,0.3704635709511265,0.6154602288365509,0.014076200212322573,3,-32,1210,1181,-0.01791676881466603,-0.0020049477342385345,0.01992171654890451,-6231,-1207,-0.24499665788542446,-0.03783848536357054
5668,22099,St. Martin,Louisiana,2016,8266,16873,611,25750,0.32100970873786405,0.6552621359223301,0.023728155339805827,-1156,253,1220,317,-0.04945386221326242,0.009651955127483253,0.03980190708577913,-8607,-2376,-0.334252427184466,-0.08925576929904155
5669,22101,St. Mary,Louisiana,2000,9851,11325,634,21810,0.45167354424575884,0.5192572214580468,0.029069234296194405,0,0,0,0,0.0,0.0,0.0,-1474,0,-0.06758367721228792,0.0
5670,22101,St. Mary,Louisiana,2004,9547,12877,270,22694,0.42068388120207983,0.5674187009782321,0.011897417819688023,-304,-364,1552,884,-0.030989663043679005,-0.017171816476506382,0.048161479520185346,-3330,-1856,-0.14673481977615227,-0.07915114256386435
5671,22101,St. Mary,Louisiana,2008,9345,13183,375,22903,0.40802514954372787,0.5756014495917565,0.016373400864515567,-202,105,306,209,-0.012658731658351963,0.004475983044827544,0.008182748613524415,-3838,-508,-0.16757630004802865,-0.020841480271876378
5672,22101,St. Mary,Louisiana,2012,9450,13885,305,23640,0.399746192893401,0.5873519458544839,0.012901861252115059,105,-70,702,737,-0.008278956650326852,-0.003471539612400508,0.011750496262727395,-4435,-597,-0.1876057529610829,-0.020029452913054246
5673,22101,St. Mary,Louisiana,2016,8050,14359,468,22877,0.35188180268391833,0.6276609695327184,0.020457227783363202,-1400,163,474,-763,-0.04786439020948269,0.0075553665312481436,0.040309023678234523,-6309,-1874,-0.2757791668488001,-0.08817341388771721
5674,22103,St. Tammany,Louisiana,2000,22722,59193,1822,83737,0.2713495826217801,0.7068918160430873,0.02175860133513262,0,0,0,0,0.0,0.0,0.0,-36471,0,-0.43554223342130716,0.0
5675,22103,St. Tammany,Louisiana,2004,24665,75139,788,100592,0.2451984253220932,0.7469679497375536,0.00783362494035311,1943,-1034,15946,16855,-0.026151157299686895,-0.013924976394779508,0.04007613369446639,-50474,-14003,-0.5017695244154604,-0.06622729099415325
5676,22103,St. Tammany,Louisiana,2008,24596,83078,1868,109542,0.22453488159792592,0.7584122984791222,0.017052819922951927,-69,1080,7939,8950,-0.020663543724167288,0.009219194982598817,0.011444348741568522,-58482,-8008,-0.5338774168811963,-0.032107892465735866
5677,22103,St. Tammany,Louisiana,2012,25728,84723,2451,112902,0.22787904554392305,0.7504118616144976,0.021709092841579423,1132,583,1645,3360,0.003344163945997125,0.0046562729186274965,-0.008000436864624594,-58995,-513,-0.5225328160705746,0.011344600810621719
5678,22103,St. Tammany,Louisiana,2016,27717,90915,5760,124392,0.2228197954852402,0.7308749758826935,0.04630522863206637,1989,3309,6192,11490,-0.0050592500586828515,0.024596135790486945,-0.01953688573180412,-63198,-4203,-0.5080551803974532,0.014477635673121325
5679,22105,Tangipahoa,Louisiana,2000,15843,20421,891,37155,0.42640290674202663,0.549616471538151,0.023980621719822365,0,0,0,0,0.0,0.0,0.0,-4578,0,-0.12321356479612433,0.0
5680,22105,Tangipahoa,Louisiana,2004,15345,26181,609,42135,0.364186543253827,0.6213599145603418,0.014453542185831256,-498,-282,5760,4980,-0.062216363488199644,-0.009527079533991109,0.07174344302219082,-10836,-6258,-0.2571733713065148,-0.13395980651039047
5681,22105,Tangipahoa,Louisiana,2008,16438,31434,730,48602,0.33821653429900006,0.6467635076745812,0.015019958026418666,1093,121,5253,6467,-0.02597000895482693,0.0005664158405874094,0.025403593114239453,-14996,-4160,-0.3085469733755812,-0.05137360206906638
5682,22105,Tangipahoa,Louisiana,2012,17722,31590,787,50099,0.3537395956007106,0.6305515080141321,0.01570889638515739,1284,57,156,1497,0.01552306130171055,0.0006889383587387228,-0.016211999660449172,-13868,1128,-0.27681191241342146,0.03173506096215972
5683,22105,Tangipahoa,Louisiana,2016,16878,33959,1579,52416,0.3220009157509158,0.6478746947496947,0.0301243894993895,-844,792,2369,2317,-0.03173867984979484,0.014415493114232111,0.017323186735562657,-17081,-3213,-0.32587377899877895,-0.049061866585357494
5684,22107,Tensas,Louisiana,2000,1580,1330,100,3010,0.5249169435215947,0.4418604651162791,0.03322259136212625,0,0,0,0,0.0,0.0,0.0,250,0,0.0830564784053156,0.0
5685,22107,Tensas,Louisiana,2004,1469,1453,41,2963,0.49578130273371585,0.4903813702328721,0.013837327033412082,-111,-59,123,-47,-0.029135640787878836,-0.019385264328714166,0.048520905116593016,16,-234,0.0053999325008437515,-0.07765654590447185
5686,22107,Tensas,Louisiana,2008,1646,1367,27,3040,0.5414473684210527,0.44967105263157897,0.008881578947368421,177,-14,-86,77,0.04566606568733683,-0.004955748086043661,-0.04071031760129312,279,263,0.0917763157894737,0.08637638328862995
5687,22107,Tensas,Louisiana,2012,1564,1230,18,2812,0.5561877667140825,0.43741109530583216,0.006401137980085348,-82,-9,-137,-228,0.014740398293029866,-0.0024804409672830726,-0.012259957325746806,334,55,0.11877667140825038,0.027000355618776672
5688,22107,Tensas,Louisiana,2016,1332,1182,34,2548,0.5227629513343799,0.4638932496075353,0.013343799058084773,-232,16,-48,-264,-0.033424815379702655,0.006942661077999425,0.026482154301703142,150,-184,0.05886970172684458,-0.0599069696814058
5689,22109,Terrebonne,Louisiana,2000,14414,21314,947,36675,0.39301976823449214,0.5811588275391957,0.0258214042263122,0,0,0,0,0.0,0.0,0.0,-6900,0,-0.18813905930470354,0.0
5690,22109,Terrebonne,Louisiana,2004,13684,26358,532,40574,0.33726031448710997,0.6496278404889831,0.013111845023906936,-730,-415,5044,3899,-0.05575945374738217,-0.012709559202405265,0.06846901294978747,-12674,-5774,-0.3123675260018732,-0.12422846669716964
5691,22109,Terrebonne,Louisiana,2008,11581,28210,905,40696,0.2845734224493808,0.6931885197562414,0.022238057794377826,-2103,373,1852,122,-0.052686892037729194,0.00912621277047089,0.04356067926725826,-16629,-3955,-0.40861509730686063,-0.09624757130498746
5692,22109,Terrebonne,Louisiana,2012,12074,29503,764,42341,0.2851609551026192,0.6967950686096219,0.01804397628775891,493,-141,1293,1645,0.0005875326532384095,-0.004194081506618916,0.00360654885338052,-17429,-800,-0.41163411350700274,-0.0030190162001421106
5693,22109,Terrebonne,Louisiana,2016,10665,31902,1329,43896,0.2429606342263532,0.726763258611263,0.030276107162383815,-1409,565,2399,1555,-0.04220032087626599,0.012232130874624905,0.029968190001641082,-21237,-3808,-0.48380262438490984,-0.0721685108779071
5694,22111,Union,Louisiana,2000,3205,5772,366,9343,0.34303756823290166,0.6177887188269292,0.03917371294016911,0,0,0,0,0.0,0.0,0.0,-2567,0,-0.27475115059402755,0.0
5695,22111,Union,Louisiana,2004,3089,7457,172,10718,0.2882067549916029,0.695745474902034,0.016047770106363126,-116,-194,1685,1375,-0.05483081324129874,-0.023125942833805983,0.07795675607510477,-4368,-1801,-0.40753871991043106,-0.1327875693164035
5696,22111,Union,Louisiana,2008,3103,7619,146,10868,0.2855171144644829,0.701048951048951,0.013433934486566065,14,-26,162,150,-0.0026896405271200075,-0.002613835619797061,0.005303476146917063,-4516,-148,-0.41553183658446813,-0.00799311667403707
5697,22111,Union,Louisiana,2012,3075,7561,130,10766,0.28562140070592607,0.7023035482073193,0.012075051086754598,-28,-16,-58,-102,0.00010428624144315224,-0.0013588833998114669,0.0012545971583682869,-4486,30,-0.41668214750139326,-0.0011503109169251347
5698,22111,Union,Louisiana,2016,2691,7972,231,10894,0.24701670644391407,0.731778960895906,0.021204332660179917,-384,101,411,128,-0.03860469426201199,0.009129281573425319,0.029475412688586666,-5281,-795,-0.48476225445199195,-0.06808010695059868
5699,22113,Vermilion,Louisiana,2000,8704,12495,1036,22235,0.3914549134247807,0.5619518776703396,0.046593208904879696,0,0,0,0,0.0,0.0,0.0,-3791,0,-0.17049696424555888,0.0
5700,22113,Vermilion,Louisiana,2004,9085,15069,398,24552,0.37003095470837405,0.6137585532746823,0.01621049201694363,381,-638,2574,2317,-0.021423958716406677,-0.030382716887936066,0.05180667560434271,-5984,-2193,-0.24372759856630827,-0.07323063432074939
5701,22113,Vermilion,Louisiana,2008,6266,18069,498,24833,0.2523255345709338,0.7276205049732212,0.020053960455845045,-2819,100,3000,281,-0.11770542013744023,0.0038434684389014144,0.11386195169853885,-11803,-5819,-0.47529497040228735,-0.23156737183597909
5702,22113,Vermilion,Louisiana,2012,5720,18910,357,24987,0.22891903789970786,0.7567935326369712,0.014287429463320928,-546,-141,841,154,-0.023406496671225963,-0.005766530992524117,0.029173027663750073,-13190,-1387,-0.5278744947372633,-0.05257952433497598
5703,22113,Vermilion,Louisiana,2016,4857,20063,712,25632,0.18948970037453183,0.7827325218476904,0.027777777777777776,-863,355,1153,645,-0.03942933752517602,0.013490348314456849,0.025938989210719132,-15206,-2016,-0.5932428214731585,-0.06536832673589521
5704,22115,Vernon,Louisiana,2000,4655,8794,378,13827,0.3366601576625443,0.6360020250235048,0.027337817313950966,0,0,0,0,0.0,0.0,0.0,-4139,0,-0.29934186736096047,0.0
5705,22115,Vernon,Louisiana,2004,4035,11032,162,15229,0.264955020027579,0.7244073806553286,0.01063759931709239,-620,-216,2238,1402,-0.07170513763496533,-0.016700217996858578,0.08840535563182383,-6997,-2858,-0.45945236062774963,-0.16011049326678917
5706,22115,Vernon,Louisiana,2008,3534,11946,289,15769,0.2241105967404401,0.7575623057898409,0.01832709746971907,-501,127,914,540,-0.04084442328713889,0.00768949815262668,0.033154925134512236,-8412,-1415,-0.5334517090494008,-0.07399934842165112
5707,22115,Vernon,Louisiana,2012,3173,12150,287,15610,0.20326713645099295,0.7783472133247918,0.018385650224215247,-361,-2,204,-159,-0.02084346028944714,5.855275449617725e-05,0.02078490753495099,-8977,-565,-0.5750800768737989,-0.04162836782439816
5708,22115,Vernon,Louisiana,2016,2665,13471,497,16633,0.1602236517765887,0.8098959898995972,0.029880358323814103,-508,210,1321,1023,-0.04304348467440425,0.011494708099598856,0.03154877657480537,-10806,-1829,-0.6496723381230085,-0.07459226124920959
5709,22117,Washington,Louisiana,2000,7399,8983,505,16887,0.43814768757032035,0.5319476520400308,0.029904660389648844,0,0,0,0,0.0,0.0,0.0,-1584,0,-0.09379996446971045,0.0
5710,22117,Washington,Louisiana,2004,6554,11006,281,17841,0.36735608990527435,0.6168936718793789,0.015750238215346674,-845,-224,2023,954,-0.070791597665046,-0.01415442217430217,0.08494601983934813,-4452,-2868,-0.24953758197410458,-0.15573761750439413
5711,22117,Washington,Louisiana,2008,6122,12215,287,18624,0.3287156357388316,0.6558741408934707,0.015410223367697595,-432,6,1209,783,-0.03864045416644274,-0.000340014847649079,0.0389804690140918,-6093,-1641,-0.3271585051546391,-0.07762092318053454
5712,22117,Washington,Louisiana,2012,6466,11798,317,18581,0.3479898821376675,0.6349496797804208,0.01706043808191163,344,30,-417,-43,0.019274246398835904,0.0016502147142140357,-0.020924461113049908,-5332,761,-0.2869597976427533,0.04019870751188581
5713,22117,Washington,Louisiana,2016,5692,12556,380,18628,0.3055615202920335,0.6740390809534035,0.020399398754563022,-774,63,758,47,-0.04242836184563403,0.0033389606726513914,0.03908940117298265,-6864,-1532,-0.36847756066137,-0.08151776301861668
5714,22119,Webster,Louisiana,2000,7197,9420,473,17090,0.4211234640140433,0.5511995318899942,0.027677004095962552,0,0,0,0,0.0,0.0,0.0,-2223,0,-0.13007606787595083,0.0
5715,22119,Webster,Louisiana,2004,6833,11070,546,18449,0.3703723779066616,0.600032522087918,0.029595100005420347,-364,73,1650,1359,-0.050751086107381715,0.0019180959094577954,0.048832990197923865,-4237,-2014,-0.2296601441812564,-0.09958407630530558
5716,22119,Webster,Louisiana,2008,6610,11417,243,18270,0.36179529282977557,0.6249042145593869,0.013300492610837438,-223,-303,347,-179,-0.008577085076886037,-0.01629460739458291,0.02487169247146892,-4807,-570,-0.26310892172961137,-0.03344877754835496
5717,22119,Webster,Louisiana,2012,6802,11400,214,18416,0.3693527367506516,0.6190269331016507,0.011620330147697654,192,-29,-17,146,0.007557443920876039,-0.0016801624631397841,-0.00587728145773625,-4598,209,-0.24967419635099908,0.013434725378612289
5718,22119,Webster,Louisiana,2016,6260,11542,343,18145,0.3449986222099752,0.6360980986497657,0.018903279140259025,-542,129,142,-271,-0.02435411454067643,0.007282948992561371,0.017071165548115053,-5282,-684,-0.29109947643979056,-0.04142528008879148
5719,22121,West Baton Rouge,Louisiana,2000,5058,4924,187,10169,0.49739404071196774,0.4842167371422952,0.018389222145737044,0,0,0,0,0.0,0.0,0.0,134,0,0.01317730356967256,0.0
5720,22121,West Baton Rouge,Louisiana,2004,4932,5822,81,10835,0.4551915089986156,0.5373327180433779,0.007475772958006461,-126,-106,898,666,-0.04220253171335214,-0.010913449187730583,0.053115980901082716,-890,-1024,-0.0821412090447623,-0.09531851261443486
5721,22121,West Baton Rouge,Louisiana,2008,5043,6654,169,11866,0.4249957862801281,0.5607618405528401,0.014242373167031856,111,88,832,1031,-0.030195722718487528,0.006766600209025395,0.023429122509462164,-1611,-721,-0.135766054272712,-0.05362484522794969
5722,22121,West Baton Rouge,Louisiana,2012,5692,6922,160,12774,0.4455926099890402,0.5418819477062784,0.012525442304681384,649,-9,268,908,0.020596823708912138,-0.0017169308623504725,-0.018879892846561663,-1230,381,-0.09628933771723819,0.0394767165554738
5723,22121,West Baton Rouge,Louisiana,2016,5383,6927,402,12712,0.42345814977973567,0.544918187539333,0.031623662680931405,-309,242,5,-62,-0.02213446020930454,0.019098220376250023,0.003036239833054566,-1544,-314,-0.1214600377595973,-0.025170700042359107
5724,22123,West Carroll,Louisiana,2000,1319,3220,136,4675,0.2821390374331551,0.6887700534759358,0.02909090909090909,0,0,0,0,0.0,0.0,0.0,-1901,0,-0.4066310160427807,0.0
5725,22123,West Carroll,Louisiana,2004,1231,3740,62,5033,0.24458573415457976,0.7430955692429962,0.012318696602424002,-88,-74,520,358,-0.03755330327857534,-0.016772212488485087,0.05432551576706046,-2509,-608,-0.4985098350884165,-0.09187881904563583
5726,22123,West Carroll,Louisiana,2008,878,4045,64,4987,0.17605775015039102,0.8111088830960498,0.012833366753559254,-353,2,305,-46,-0.06852798400418875,0.0005146701511352519,0.06801331385305354,-3167,-658,-0.6350511329456587,-0.13654129785724223
5727,22123,West Carroll,Louisiana,2012,853,3628,67,4548,0.18755496921723835,0.7977132805628848,0.014731750219876869,-25,3,-417,-439,0.011497219066847336,0.0018983834663176147,-0.013395602533164963,-2775,392,-0.6101583113456465,0.02489282160001227
5728,22123,West Carroll,Louisiana,2016,715,3970,74,4759,0.150241647404917,0.8342088674091196,0.015549485185963437,-138,7,342,211,-0.03731332181232136,0.0008177349660865689,0.03649558684623477,-3255,-480,-0.6839672200042026,-0.07380890865855616
5729,22125,West Feliciana,Louisiana,2000,2187,2512,161,4860,0.45,0.516872427983539,0.0331275720164609,0,0,0,0,0.0,0.0,0.0,-325,0,-0.06687242798353904,0.0
5730,22125,West Feliciana,Louisiana,2004,2214,2932,72,5218,0.4243004982752012,0.5619011115369873,0.013798390187811422,27,-89,420,358,-0.02569950172479879,-0.019329181828649483,0.045028683553448245,-718,-393,-0.13760061326178608,-0.07072818527824704
5731,22125,West Feliciana,Louisiana,2008,2415,3150,55,5620,0.4297153024911032,0.5604982206405694,0.009786476868327402,201,-17,218,402,0.005414804215901958,-0.00401191331948402,-0.0014028908964178743,-735,-17,-0.13078291814946624,0.006817695112319833
5732,22125,West Feliciana,Louisiana,2012,2441,3257,79,5777,0.4225376492989441,0.5637874329236628,0.01367491777739311,26,24,107,157,-0.0071776531921590725,0.003888440909065708,0.0032892122830934234,-816,-81,-0.14124978362471874,-0.010466865475252496
5733,22125,West Feliciana,Louisiana,2016,2248,3390,161,5799,0.38765304362821174,0.5845835488877392,0.027763407484048975,-193,82,133,22,-0.03488460567073237,0.014088489706655865,0.020796115964076378,-1142,-326,-0.1969305052595275,-0.05568072163480875
5734,22127,Winn,Louisiana,2000,2167,4028,166,6361,0.3406697060210659,0.6332337682754284,0.02609652570350574,0,0,0,0,0.0,0.0,0.0,-1861,0,-0.29256406225436254,0.0
5735,22127,Winn,Louisiana,2004,2056,4366,85,6507,0.31596741970185954,0.6709697249116336,0.013062855386506839,-111,-81,338,146,-0.024702286319206346,-0.0130336703169989,0.037735956636205215,-2310,-449,-0.3550023052097741,-0.06243824295541156
5736,22127,Winn,Louisiana,2008,2047,4632,93,6772,0.3022740696987596,0.6839929119905493,0.01373301831069108,-9,8,266,265,-0.013693350003099958,0.0006701629241842415,0.013023187078915699,-2585,-275,-0.38171884229178976,-0.026716537082015657
5737,22127,Winn,Louisiana,2012,1919,4541,74,6534,0.29369452096724824,0.6949801040710132,0.011325374961738598,-128,-19,-91,-238,-0.008579548731511344,-0.0024076433489524825,0.010987192080463837,-2622,-37,-0.40128558310376494,-0.01956674081197518
5738,22127,Winn,Louisiana,2016,1644,4608,120,6372,0.2580037664783427,0.7231638418079096,0.018832391713747645,-275,46,67,-162,-0.03569075448890552,0.007507016752009047,0.02818373773689642,-2964,-342,-0.4651600753295669,-0.06387449222580194
5739,23001,Androscoggin,Maine,2000,26251,19948,3046,49245,0.5330693471418418,0.4050766575286831,0.061853995329475074,0,0,0,0,0.0,0.0,0.0,6303,0,0.12799268961315874,0.0
5740,23001,Androscoggin,Maine,2004,30503,24519,1045,56067,0.5440455169707671,0.43731606827545616,0.01863841475377673,4252,-2001,4571,6822,0.010976169828925242,-0.04321558057569834,0.032239410746773056,5984,-319,0.10672944869531092,-0.021263240917847814
5741,23001,Androscoggin,Maine,2008,31017,22671,1162,54850,0.5654876937101185,0.4133272561531449,0.021185050136736553,514,117,-1848,-1217,0.02144217673935145,0.002546635382959822,-0.023988812122311243,8346,2362,0.15216043755697362,0.04543098886166269
5742,23001,Androscoggin,Maine,2012,28989,22232,1641,52862,0.5483901479323522,0.4205667587302788,0.031043093337368998,-2028,479,-439,-1988,-0.017097545777766343,0.009858043200632445,0.007239502577133905,6757,-1589,0.12782338920207337,-0.024337048354900248
5743,23001,Androscoggin,Maine,2016,23009,28227,4365,55601,0.4138234923832305,0.5076707253466665,0.07850578227010306,-5980,2724,5995,2739,-0.13456665554912167,0.04746268893273406,0.08710396661638764,-5218,-11975,-0.09384723296343594,-0.2216706221655093
5744,23003,Aroostook,Maine,2000,17196,16555,1392,35143,0.48931508408502405,0.47107532083202913,0.03960959508294682,0,0,0,0,0.0,0.0,0.0,641,0,0.018239763252994923,0.0
5745,23003,Aroostook,Maine,2004,19569,17564,600,37733,0.5186176556330003,0.4654811438263589,0.015901200540640818,2373,-792,1009,2590,0.029302571547976275,-0.023708394542306003,-0.00559417700567022,2005,1364,0.05313651180664142,0.034896748553646495
5746,23003,Aroostook,Maine,2008,19345,15898,751,35994,0.537450686225482,0.4416847252319831,0.020864588542534868,-224,151,-1666,-1739,0.018833030592481648,0.00496338800189405,-0.023796418594375812,3447,1442,0.09576596099349888,0.04262944918685746
5747,23003,Aroostook,Maine,2012,17777,15196,887,33860,0.5250147666863556,0.44878913171884227,0.026196101594802127,-1568,136,-702,-2134,-0.012435919539126372,0.0053315130522672595,0.007104406486859172,2581,-866,0.07622563496751333,-0.019540326025985544
5748,23003,Aroostook,Maine,2016,13386,19419,2292,35097,0.38140011966834775,0.5532951534319173,0.06530472689973502,-4391,1405,4223,1237,-0.14361464701800786,0.03910862530493289,0.10450602171307499,-6033,-8614,-0.17189503376356952,-0.24812066873108285
5749,23005,Cumberland,Maine,2000,74203,58543,9874,142620,0.5202846725564437,0.4104824007853036,0.0692329266582527,0,0,0,0,0.0,0.0,0.0,15660,0,0.1098022717711401,0.0
5750,23005,Cumberland,Maine,2004,94846,65384,2732,162962,0.5820129846221819,0.40122237085946416,0.016764644518353973,20643,-7142,6841,20342,0.061728312065738145,-0.05246828213989873,-0.009260029925839464,29462,13802,0.1807906137627177,0.07098834199157761
5751,23005,Cumberland,Maine,2008,105218,56186,2747,164151,0.6409829973621848,0.3422824107072147,0.016734591930600482,10372,15,-9198,1189,0.05897001274000291,-3.0052587753490873e-05,-0.05893996015224945,49032,19570,0.29870058665497007,0.11790997289225236
5752,23005,Cumberland,Maine,2012,101950,57821,4015,163786,0.6224585739928932,0.3530277313079262,0.02451369469918064,-3268,1268,1635,-365,-0.01852442336929161,0.007779102768580157,0.010745320600711483,44129,-4903,0.269430842684967,-0.029269743970003093
5753,23005,Cumberland,Maine,2016,102981,57709,11128,171818,0.5993609517047108,0.3358728421934838,0.0647662061018054,1031,7113,-112,8032,-0.02309762228818235,0.040252511402624765,-0.017154889114442406,45272,1143,0.26348810951122703,-0.005942733173739945
5754,23007,Franklin,Maine,2000,7593,6459,1396,15448,0.49151993785603315,0.41811237700673226,0.09036768513723459,0,0,0,0,0.0,0.0,0.0,1134,0,0.07340756084930089,0.0
5755,23007,Franklin,Maine,2004,9465,7378,418,17261,0.5483459822721742,0.4274375760384682,0.02421644168935751,1872,-978,919,1813,0.056826044416141086,-0.06615124344787708,0.009325199031735953,2087,953,0.12090840623370602,0.04750084538440513
5756,23007,Franklin,Maine,2008,10113,6627,438,17178,0.5887181278379322,0.38578414250785886,0.02549772965420887,648,20,-751,-83,0.040372145565757966,0.001281287964851361,-0.04165343353060935,3486,1399,0.20293398533007334,0.08202557909636732
5757,23007,Franklin,Maine,2012,9367,6369,546,16282,0.5752978749539369,0.3911681611595627,0.03353396388650043,-746,108,-258,-896,-0.013420252883995287,0.008036234232291557,0.005384018651703848,2998,-488,0.1841297137943742,-0.018804271535699135
5758,23007,Franklin,Maine,2016,7016,7918,1554,16488,0.4255215914604561,0.480228044638525,0.09425036390101892,-2351,1008,1549,206,-0.14977628349348082,0.06071640001451849,0.08905988347896227,-902,-3900,-0.05470645317806888,-0.2388361669724431
5759,23009,Hancock,Maine,2000,12983,12732,2859,28574,0.45436410723034926,0.44557989780919716,0.10005599496045356,0,0,0,0,0.0,0.0,0.0,251,0,0.0087842094211521,0.0
5760,23009,Hancock,Maine,2004,18048,14405,669,33122,0.5448946319666687,0.43490731236036473,0.02019805567296661,5065,-2190,1673,4548,0.0905305247363194,-0.07985793928748695,-0.010672585448832428,3643,3392,0.10998731960630392,0.10120311018515182
5761,23009,Hancock,Maine,2008,18895,12686,584,32165,0.5874397637183274,0.394403855122027,0.018156381159645577,847,-85,-1719,-957,0.04254513175165875,-0.0020416745133210318,-0.0405034572383377,6209,2566,0.19303590859630038,0.08304858898999645
5762,23009,Hancock,Maine,2012,17569,12324,906,30799,0.5704405987207377,0.40014286178122666,0.02941653949803565,-1326,322,-362,-1366,-0.01699916499758969,0.011260158338390072,0.00573900665919963,5245,-964,0.17029773693951106,-0.02273817165678932
5763,23009,Hancock,Maine,2016,16117,13705,2308,32130,0.5016184251478369,0.42654839713663245,0.07183317771553066,-1452,1402,1381,1331,-0.06882217357290077,0.042416638217495015,0.026405535355405796,2412,-2833,0.07507002801120449,-0.09522770892830656
5764,23011,Kennebec,Maine,2000,31198,23967,3742,58907,0.529614477057056,0.40686166329977763,0.06352385964316634,0,0,0,0,0.0,0.0,0.0,7231,0,0.12275281375727837,0.0
5765,23011,Kennebec,Maine,2004,35616,29761,1395,66772,0.5333972323728509,0.44571077697238365,0.02089199065476547,4418,-2347,5794,7865,0.0037827553157948612,-0.04263186898840087,0.03884911367260602,5855,-1376,0.08768645540046721,-0.035066358356811156
5766,23011,Kennebec,Maine,2008,37238,27482,1266,65986,0.5643318279635074,0.4164822841208741,0.019185887915618465,1622,-129,-2279,-786,0.03093459559065659,-0.001706102739147005,-0.029228492851509524,9756,3901,0.14784954384263332,0.06016308844216611
5767,23011,Kennebec,Maine,2012,35068,26519,1910,63497,0.5522780603808054,0.41764177835173316,0.030080161267461453,-2170,644,-963,-2489,-0.012053767582702046,0.010894273351842988,0.0011594942308590372,8549,-1207,0.13463628202907224,-0.013213261813561084
5768,23011,Kennebec,Maine,2016,29302,31675,5231,66208,0.44257491541807636,0.4784165055582407,0.07900857902368294,-5766,3321,5156,2711,-0.10970314496272904,0.04892841775622149,0.06077472720650756,-2373,-10922,-0.03584159014016436,-0.1704778721692366
5769,23013,Knox,Maine,2000,9453,8968,2080,20501,0.46109945856299694,0.43744207599629287,0.10145846544071022,0,0,0,0,0.0,0.0,0.0,485,0,0.023657382566704077,0.0
5770,23013,Knox,Maine,2004,12690,10103,454,23247,0.5458768873403019,0.43459371101647526,0.019529401643222782,3237,-1626,1135,2746,0.08477742877730499,-0.08192906379748743,-0.002848364979817608,2587,2102,0.11128317632382667,0.0876257937571226
5771,23013,Knox,Maine,2008,13728,8816,436,22980,0.5973890339425587,0.3836379460400348,0.01897302001740644,1038,-18,-1287,-267,0.05151214660225678,-0.0005563816258163413,-0.05095576497644044,4912,2325,0.2137510879025239,0.10246791157869722
5772,23013,Knox,Maine,2012,13223,8248,596,22067,0.5992205555807314,0.37377078896089183,0.027008655458376763,-505,160,-568,-913,0.001831521638172684,0.008035635440970322,-0.009867157079142985,4975,63,0.22544976661983956,0.01169867871731567
5773,23013,Knox,Maine,2016,12443,9148,1556,23147,0.5375642631874541,0.3952132025748477,0.0672225342376982,-780,960,900,1080,-0.0616562923932773,0.040213878779321435,0.02144241361395588,3295,-1680,0.14235106061260638,-0.08309870600723318
5774,23015,Lincoln,Maine,2000,8634,9457,1580,19671,0.43892023791368,0.48075847694575774,0.08032128514056225,0,0,0,0,0.0,0.0,0.0,-823,0,-0.04183823903207773,0.0
5775,23015,Lincoln,Maine,2004,11351,10370,421,22142,0.5126456507993857,0.4683407099629663,0.01901363923764791,2717,-1159,913,2471,0.07372541288570572,-0.061307645902914334,-0.012417766982791456,981,1804,0.04430494083641945,0.08614317986849718
5776,23015,Lincoln,Maine,2008,11886,9287,411,21584,0.5506856931060045,0.430272424017791,0.019041882876204595,535,-10,-1083,-558,0.03804004230661873,2.8243638556683937e-05,-0.038068285945175306,2599,1618,0.12041326908821348,0.07610832825179403
5777,23015,Lincoln,Maine,2012,11315,8899,543,20757,0.5451173098231922,0.4287228404875464,0.026159849689261452,-571,132,-388,-827,-0.005568383282812284,0.007117966813056858,-0.0015495835302445915,2416,-183,0.11639446933564579,-0.004018799752567692
5778,23015,Lincoln,Maine,2016,10241,9727,1535,21503,0.476259126633493,0.45235548528112357,0.07138538808538343,-1074,992,828,746,-0.06885818318969916,0.04522553839612198,0.023632644793577184,514,-1902,0.023903641352369442,-0.09249082798327635
5779,23017,Oxford,Maine,2000,13649,11835,2009,27493,0.4964536427454261,0.43047321136289235,0.07307314589168151,0,0,0,0,0.0,0.0,0.0,1814,0,0.06598043138253373,0.0
5780,23017,Oxford,Maine,2004,16618,14196,732,31546,0.5267862803525011,0.45000950992201866,0.023204209725480252,2969,-1277,2361,4053,0.030332637607074997,-0.049868936166201264,0.01953629855912631,2422,608,0.07677677043048242,0.010796339047948689
5781,23017,Oxford,Maine,2008,17940,12863,847,31650,0.566824644549763,0.4064139020537125,0.026761453396524488,1322,115,-1333,104,0.04003836419726192,0.0035572436710442357,-0.043595607868306185,5077,2655,0.16041074249605053,0.08363397206556811
5782,23017,Oxford,Maine,2012,16330,11996,1094,29420,0.5550645819170632,0.4077498300475867,0.0371855880353501,-1610,247,-867,-2230,-0.011760062632699797,0.010424134638825616,0.0013359279938742197,4334,-743,0.1473147518694765,-0.013095990626574017
5783,23017,Oxford,Maine,2016,12172,16210,2819,31201,0.39011570141982627,0.5195346303003109,0.09034966827986282,-4158,1725,4214,1781,-0.16494888049723694,0.05316408024451272,0.11178480025272419,-4038,-8372,-0.12941892888048462,-0.27673368074996113
5784,23019,Penobscot,Maine,2000,32868,35620,4718,73206,0.4489795918367347,0.48657213889571893,0.06444826926754638,0,0,0,0,0.0,0.0,0.0,-2752,0,-0.03759254705898424,0.0
5785,23019,Penobscot,Maine,2004,40417,40318,1377,82112,0.49221794621979736,0.4910122759158223,0.01676977786438036,7549,-3341,4698,8906,0.04323835438306267,-0.04767849140316602,0.004440137020103374,99,2851,0.0012056703039750594,0.0387982173629593
5786,23019,Penobscot,Maine,2008,41614,37495,1358,80467,0.5171561012589012,0.46596741521369006,0.01687648352740875,1197,-19,-2823,-1645,0.02493815503910385,0.00010670566302839121,-0.025044860702132243,4119,4020,0.05118868604521115,0.04998301574123609
5787,23019,Penobscot,Maine,2012,38811,36547,1948,77306,0.5020438258349934,0.47275761260445504,0.025198561560551575,-2803,590,-948,-3161,-0.015112275423907806,0.008322078033142825,0.006790197390764974,2264,-1855,0.02928621323053837,-0.02190247281467278
5788,23019,Penobscot,Maine,2016,32838,41622,6080,80540,0.40772287062329277,0.516786689843556,0.07549043953315122,-5973,4132,5075,3234,-0.09432095521170064,0.05029187797259965,0.04402907723910099,-8784,-11048,-0.10906381922026326,-0.13835003245080163
5789,23021,Piscataquis,Maine,2000,3745,4845,666,9256,0.40460242005185826,0.5234442523768367,0.0719533275713051,0,0,0,0,0.0,0.0,0.0,-1100,0,-0.11884183232497841,0.0
5790,23021,Piscataquis,Maine,2004,4409,5299,232,9940,0.4435613682092555,0.5330985915492957,0.023340040241448694,664,-434,454,684,0.038958948157397255,-0.048613287329856404,0.009654339172459059,-890,210,-0.08953722334004022,0.029304608984938196
5791,23021,Piscataquis,Maine,2008,4430,4785,219,9434,0.46957812168751323,0.5072079711681153,0.023213907144371423,21,-13,-514,-506,0.026016753478257715,-0.00012613309707727033,-0.025890620381180396,-355,535,-0.03762984948060211,0.05190737385943811
5792,23021,Piscataquis,Maine,2012,4149,4530,276,8955,0.46331658291457284,0.5058626465661642,0.03082077051926298,-281,57,-255,-479,-0.006261538772940389,0.007606863374891557,-0.0013453246019511367,-381,-26,-0.04254606365159136,-0.004916214170989253
5793,23021,Piscataquis,Maine,2016,3098,5406,678,9182,0.33739925942060556,0.5887606186016119,0.07384012197778261,-1051,402,876,227,-0.12591732349396728,0.043019351458519636,0.08289797203544769,-2308,-1927,-0.2513613591810063,-0.20881529552941497
5794,23023,Sagadahoc,Maine,2000,8844,8052,1510,18406,0.48049549060089103,0.43746604368140823,0.08203846571770075,0,0,0,0,0.0,0.0,0.0,792,0,0.043029446919482794,0.0
5795,23023,Sagadahoc,Maine,2004,11107,9497,475,21079,0.5269225295317614,0.4505431946487025,0.022534275819536032,2263,-1035,1445,2673,0.04642703893087041,-0.05950418989816472,0.013077150967294282,1610,818,0.07637933488305892,0.03334988796357613
5796,23023,Sagadahoc,Maine,2008,12152,8721,428,21301,0.5704896483733158,0.40941739824421386,0.020092953382470306,1045,-47,-776,222,0.0435671188415544,-0.0024413224370657266,-0.04112579640448866,3431,1821,0.16107225012910198,0.08469291524604305
5797,23023,Sagadahoc,Maine,2012,11821,8429,544,20794,0.5684812926805809,0.40535731460998364,0.026161392709435415,-331,116,-292,-507,-0.002008355692734942,0.00606843932696511,-0.004060083634230216,3392,-39,0.16312397807059725,0.002051727941495274
5798,23023,Sagadahoc,Maine,2016,10664,9304,1648,21616,0.4933382679496669,0.4304219096965211,0.07623982235381199,-1157,1104,875,822,-0.075143024730914,0.050078429644376574,0.025064595086537467,1360,-2032,0.06291635825314579,-0.10020761981745147
5799,23025,Somerset,Maine,2000,11538,10684,1729,23951,0.4817335393094234,0.4460774080414179,0.0721890526491587,0,0,0,0,0.0,0.0,0.0,854,0,0.03565613126800554,0.0
5800,23025,Somerset,Maine,2004,13555,12953,600,27108,0.5000368894791205,0.47782942304854653,0.02213368747233289,2017,-1129,2269,3157,0.018303350169697086,-0.05005536517682581,0.03175201500712865,602,-252,0.022207466430573974,-0.013448664837431568
5801,23025,Somerset,Maine,2008,13335,11867,556,25758,0.5177032378290239,0.46071123534435904,0.021585526826616974,-220,-44,-1086,-1350,0.017666348349903438,-0.0005481606457159172,-0.017118187704187493,1468,866,0.056992002484664905,0.03478453605409093
5802,23025,Somerset,Maine,2012,12216,11800,771,24787,0.4928389881792875,0.47605599709525154,0.031105014725460928,-1119,215,-67,-971,-0.024864249649736436,0.009519487898843954,0.0153447617508925,416,-1052,0.01678299108403597,-0.040209011400628936
5803,23025,Somerset,Maine,2016,9092,15001,1971,26064,0.3488336402701044,0.5755448127685697,0.07562154696132596,-3124,1200,3201,1277,-0.14400534790918312,0.04451653223586503,0.09948881567331819,-5909,-6325,-0.22671117249846534,-0.2434941635825013
5804,23027,Waldo,Maine,2000,8477,8689,1972,19138,0.4429407461594733,0.45401818371825686,0.10304107012226983,0,0,0,0,0.0,0.0,0.0,-212,0,-0.011077437558783543,0.0
5805,23027,Waldo,Maine,2004,11555,10309,454,22318,0.5177435254055023,0.46191415001344205,0.02034232458105565,3078,-1518,1620,3180,0.07480277924602896,-0.08269874554121417,0.007895966295185186,1246,1458,0.05582937539206023,0.06690681295084377
5806,23027,Waldo,Maine,2008,11967,9423,460,21850,0.5476887871853547,0.43125858123569794,0.021052631578947368,412,6,-886,-468,0.02994526177985246,0.000710306997891718,-0.030655568777744113,2544,1298,0.1164302059496568,0.060600830557596574
5807,23027,Waldo,Maine,2012,11296,9058,707,21061,0.5363468021461469,0.4300840415934666,0.03356915626038649,-671,247,-365,-789,-0.011341985039207803,0.012516524681439125,-0.0011745396422313537,2238,-306,0.10626276055268036,-0.010167445396976449
5808,23027,Waldo,Maine,2016,10440,10378,1889,22707,0.45977011494252873,0.45703967939401946,0.0831902056634518,-856,1182,1320,1646,-0.07657668720361821,0.049621049403065304,0.02695563780055288,62,-2176,0.002730435548509269,-0.10353232500417109
5809,23029,Washington,Maine,2000,6701,7958,1049,15708,0.42659791189202956,0.506620830150242,0.06678125795772855,0,0,0,0,0.0,0.0,0.0,-1257,0,-0.0800229182582124,0.0
5810,23029,Washington,Maine,2004,8391,8619,300,17310,0.48474870017331023,0.49792027729636046,0.01733102253032929,1690,-749,661,1602,0.058150788281280674,-0.04945023542739926,-0.008700552853881494,-228,1029,-0.013171577123050227,0.06685134113516217
5811,23029,Washington,Maine,2008,8246,8077,331,16654,0.49513630359072897,0.48498859132941036,0.019875105079860695,-145,31,-542,-656,0.010387603417418734,0.002544082549531406,-0.012931685966950102,169,397,0.010147712261318609,0.023319289384368835
5812,23029,Washington,Maine,2012,7803,7550,483,15836,0.4927380651679717,0.4767618085375095,0.030500126294518818,-443,152,-527,-818,-0.0023982384227572706,0.010625021214658123,-0.008226782791900866,253,84,0.015976256630462204,0.005828544369143596
5813,23029,Washington,Maine,2016,6075,9093,1197,16365,0.3712190650779102,0.5556370302474793,0.07314390467461045,-1728,714,1543,529,-0.1215190000900615,0.04264377838009163,0.07887522170996986,-3018,-3271,-0.18441796516956915,-0.20039422180003136
5814,23031,York,Maine,2000,46618,42304,5628,94550,0.4930512956107879,0.44742464304600743,0.059524061343204655,0,0,0,0,0.0,0.0,0.0,4314,0,0.04562665256478049,0.0
5815,23031,York,Maine,2004,58702,49526,1805,110033,0.5334944971054139,0.45010133323639273,0.01640416965819345,12084,-3823,7222,15483,0.040443201494625935,-0.04311989168501121,0.0026766901903853,9176,4862,0.08339316386902113,0.037766511304240635
5816,23031,York,Maine,2008,64799,42389,1973,109161,0.5936094392686032,0.38831634008482885,0.018074220646567912,6097,168,-7137,-872,0.060114942163189355,0.0016700509883744614,-0.06178499315156388,22410,13234,0.20529309918377436,0.12189993531475324
5817,23031,York,Maine,2012,61551,43900,2606,108057,0.5696160359810101,0.40626706275391694,0.024116901265073064,-3248,633,1511,-1104,-0.02399340328759314,0.0060426806185051515,0.017950722669088093,17651,-4759,0.16334897322709313,-0.04194412595668123
5818,23031,York,Maine,2016,55844,50403,8027,114274,0.4886850902217477,0.44107145982463203,0.07024344995362025,-5707,5421,6503,6217,-0.08093094575926235,0.04612654868854719,0.03480439707071509,5441,-12210,0.04761363039711569,-0.11573534282997744
5819,24001,Allegany,Maryland,2000,10894,14656,821,26371,0.41310530506996324,0.555762011300292,0.031132683629744796,0,0,0,0,0.0,0.0,0.0,-3762,0,-0.14265670623032878,0.0
5820,24001,Allegany,Maryland,2004,10576,18980,299,29855,0.3542455200133981,0.6357394071344833,0.010015072852118573,-318,-522,4324,3484,-0.05885978505656514,-0.021117610777626222,0.07997739583419128,-8404,-4642,-0.2814938871210852,-0.13883718089075642
5821,24001,Allegany,Maryland,2008,10693,18405,644,29742,0.35952525048752604,0.6188218680653621,0.02165288144711183,117,345,-575,-113,0.005279730474127942,0.011637808594993256,-0.01691753906912119,-7712,692,-0.25929661757783606,0.022197269543249132
5822,24001,Allegany,Maryland,2012,9805,19230,811,29846,0.3285197346378074,0.6443074448837365,0.027172820478456074,-888,167,825,104,-0.031005515849718612,0.005519939031344245,0.025485576818374378,-9425,-1713,-0.31578771024592905,-0.05649109266809299
5823,24001,Allegany,Maryland,2016,7875,21270,1509,30654,0.2568995889606577,0.6938735564689763,0.04922685457036602,-1930,698,2040,808,-0.07162014567714975,0.022054034091909945,0.049566111585239825,-13395,-3970,-0.43697396750831863,-0.12118625726238957
5824,24003,Anne Arundel,Maryland,2000,89624,104209,6824,200657,0.446652745730276,0.5193389714786925,0.03400828279103146,0,0,0,0,0.0,0.0,0.0,-14585,0,-0.07268622574841643,0.0
5825,24003,Anne Arundel,Maryland,2004,103324,133231,3112,239667,0.43111483850509247,0.5559004785806974,0.012984682914210134,13700,-3712,29022,39010,-0.015537907225183556,-0.021023599876821328,0.0365615071020049,-29907,-15322,-0.12478564007560489,-0.052099414327188454
5826,24003,Anne Arundel,Maryland,2008,125015,129682,4922,259619,0.48153255347258866,0.4995088957279706,0.01895855079944072,21691,1810,-3549,19952,0.0504177149674962,0.005973867885230586,-0.056391582852726774,-4667,25240,-0.017976342255381916,0.10680929782022297
5827,24003,Anne Arundel,Maryland,2012,126635,126832,6677,260144,0.4867880865981918,0.48754535949320377,0.025666553908604464,1620,1755,-2850,525,0.005255533125603118,0.006708003109163745,-0.011963536234766814,-197,4470,-0.0007572728950119845,0.017219069360369932
5828,24003,Anne Arundel,Maryland,2016,128419,122403,19259,270081,0.47548328094164344,0.4532084818998745,0.07130823715848209,1784,12582,-4429,9937,-0.011304805656548345,0.04564168324987762,-0.03433687759332926,6016,6213,0.022274799041768933,0.023032071936780918
5829,24005,Baltimore,Maryland,2000,160635,133033,10416,304084,0.5282586390602597,0.4374876678812433,0.034253693058496994,0,0,0,0,0.0,0.0,0.0,27602,0,0.09077097117901639,0.0
5830,24005,Baltimore,Maryland,2004,182474,166051,4954,353479,0.5162230288079348,0.4697619943476133,0.014014976844451863,21839,-5462,33018,49395,-0.012035610252324913,-0.020238716214045133,0.03227432646636996,16423,-11179,0.046461034460321515,-0.044309936718694876
5831,24005,Baltimore,Maryland,2008,214151,158714,8073,380938,0.5621675968267802,0.41663997815917553,0.02119242501404428,31677,3119,-7337,27459,0.04594456801884539,0.007177448169592418,-0.05312201618843776,55437,39014,0.14552761866760466,0.09906658420728315
5832,24005,Baltimore,Maryland,2012,220322,154908,9541,384771,0.5726055238050685,0.4025979088860647,0.024796567308866833,6171,1468,-3806,3833,0.01043792697828827,0.003604142294822553,-0.014042069273110802,65414,9977,0.17000761491900374,0.024479996251399072
5833,24005,Baltimore,Maryland,2016,218412,149477,22793,390682,0.5590531429653784,0.3826052902360488,0.058341566798572754,-1910,13252,-5431,5911,-0.013552380839690015,0.03354499948970592,-0.019992618650015948,68935,3521,0.17644785272932967,0.006440237810325933
5834,24009,Calvert,Maryland,2000,12986,16004,816,29806,0.4356840904515869,0.5369388713681809,0.02737703818023217,0,0,0,0,0.0,0.0,0.0,-3018,0,-0.10125478091659396,0.0
5835,24009,Calvert,Maryland,2004,15967,23017,367,39351,0.4057584305354375,0.5849152499301161,0.009326319534446393,2981,-449,7013,9545,-0.029925659916149427,-0.018050718645785776,0.04797637856193526,-7050,-4032,-0.17915681939467865,-0.07790203847808469
5836,24009,Calvert,Maryland,2008,20299,23095,663,44057,0.4607440361350069,0.5242072769366957,0.015048686928297432,4332,296,78,4706,0.05498560559956944,0.005722367393851039,-0.060707972993420456,-2796,4254,-0.06346324080168875,0.1156935785929899
5837,24009,Calvert,Maryland,2012,20529,23952,1032,45513,0.4510579394898161,0.5262672203546239,0.02267484015555995,230,369,857,1456,-0.009686096645190823,0.007626153227262516,0.002059943417928256,-3423,-627,-0.07520928086480783,-0.011746040063119079
5838,24009,Calvert,Maryland,2016,18225,26176,3007,47408,0.3844287883901451,0.5521430982112724,0.06342811339858252,-2304,1975,2224,1895,-0.06662915109967099,0.040753273243022574,0.025875877856648466,-7951,-4528,-0.16771430982112728,-0.09250502895631946
5839,24011,Caroline,Maryland,2000,3396,5300,256,8952,0.37935656836461124,0.5920464700625558,0.028596961572832886,0,0,0,0,0.0,0.0,0.0,-1904,0,-0.2126899016979446,0.0
5840,24011,Caroline,Maryland,2004,3810,7396,150,11356,0.3355054596688975,0.6512856639661853,0.013208876364917225,414,-106,2096,2404,-0.043851108695713736,-0.015388085207915661,0.05923919390362942,-3586,-1682,-0.31578020429728776,-0.10309030259934315
5841,24011,Caroline,Maryland,2008,4971,8015,232,13218,0.376078075351793,0.6063701013769103,0.017551823271296715,1161,82,619,1862,0.040572615682895496,0.004342946906379491,-0.04491556258927498,-3044,542,-0.23029202602511728,0.08548817827217048
5842,24011,Caroline,Maryland,2012,4970,8098,289,13357,0.37208954106461034,0.6062738638915924,0.02163659504379726,-1,57,83,139,-0.003988534287182655,0.004084771772500544,-9.623748531784049e-05,-3128,-84,-0.2341843228269821,-0.003892296801864814
5843,24011,Caroline,Maryland,2016,4009,9368,736,14113,0.2840643378445405,0.6637851626160278,0.05215049953943173,-961,447,1270,756,-0.08802520322006985,0.030513904495634472,0.05751129872443539,-5359,-2231,-0.37972082477148733,-0.14553650194450524
5844,24013,Carroll,Maryland,2000,20146,41742,2139,64027,0.3146485076608306,0.6519437112468177,0.033407781092351665,0,0,0,0,0.0,0.0,0.0,-21596,0,-0.33729520358598714,0.0
5845,24013,Carroll,Maryland,2004,22974,55275,1100,79349,0.2895310589925519,0.6966061324024247,0.013862808605023378,2828,-1039,13533,15322,-0.025117448668278697,-0.01954497248732829,0.044662421155607035,-32301,-10705,-0.40707507340987287,-0.06977986982388573
5846,24013,Carroll,Maryland,2008,28060,54503,2197,84760,0.3310523831996225,0.6430273714016045,0.025920245398773006,5086,1097,-772,5411,0.04152132420707061,0.012057436793749628,-0.05357876100082026,-26443,5858,-0.311974988201982,0.09510008520789087
5847,24013,Carroll,Maryland,2012,27939,56761,2834,87534,0.3191788333676057,0.648445175588914,0.03237599104348025,-121,637,2258,2774,-0.011873549832016772,0.006455745644707241,0.005417804187309527,-28822,-2379,-0.3292663422213083,-0.0172913540193263
5848,24013,Carroll,Maryland,2016,26567,58215,7066,91848,0.28924962982318614,0.6338189182126992,0.07693145196411462,-1372,4232,1454,4314,-0.02992920354441958,0.04455546092063437,-0.014626257376214813,-31648,-2826,-0.34456928838951306,-0.015302946168204767
5849,24015,Cecil,Maryland,2000,12327,15494,1055,28876,0.4268943066906774,0.5365701620723092,0.03653553123701344,0,0,0,0,0.0,0.0,0.0,-3167,0,-0.10967585538163183,0.0
5850,24015,Cecil,Maryland,2004,14680,22556,438,37674,0.38965865052821574,0.5987152943674683,0.011626055104315974,2353,-617,7062,8798,-0.03723565616246166,-0.024909476132697464,0.062145132295159056,-7876,-4709,-0.20905664383925254,-0.09938078845762072
5851,24015,Cecil,Maryland,2008,17665,23855,974,42494,0.41570574669365085,0.5613733703581683,0.02292088294818092,2985,536,1299,4820,0.026047096165435102,0.011294827843864945,-0.03734192400930003,-6190,1686,-0.1456676236645174,0.06338902017473513
5852,24015,Cecil,Maryland,2012,16557,24806,1115,42478,0.3897782381468054,0.5839728800790998,0.026248881774094825,-1108,141,951,-16,-0.025927508546845446,0.0033279988259139054,0.0225995097209315,-8249,-2059,-0.19419464193229435,-0.048527018267776945
5853,24015,Cecil,Maryland,2016,13650,28868,2751,45269,0.3015308489253131,0.637699087675893,0.06077006339879388,-2907,1636,4062,2791,-0.08824738922149228,0.034521181624699054,0.05372620759679325,-15218,-6969,-0.3361682387505799,-0.14197359681828553
5854,24017,Charles,Maryland,2000,21873,21768,951,44592,0.49051399354144243,0.4881593110871905,0.021326695371367062,0,0,0,0,0.0,0.0,0.0,105,0,0.0023546824542519107,0.0
5855,24017,Charles,Maryland,2004,29354,28442,445,58241,0.5040092031386824,0.48835013135076666,0.0076406655105509865,7481,-506,6674,13649,0.013495209597239932,-0.013686029860816075,0.00019082026357614135,912,807,0.0156590717879157,0.01330438933366379
5856,24017,Charles,Maryland,2008,43635,25732,760,70127,0.6222282430447617,0.3669342763842742,0.010837480570964108,14281,315,-2710,11886,0.11821903990607929,0.003196815060413121,-0.12141585496649243,17903,16991,0.2552939666604874,0.23963489487257172
5857,24017,Charles,Maryland,2012,48774,25178,1267,75219,0.648426594344514,0.33472925723553887,0.016844148419947087,5139,507,-554,5092,0.026198351299752343,0.00600666784898298,-0.03220501914873536,23596,5693,0.3136973371089751,0.0584033704484877
5858,24017,Charles,Maryland,2016,49341,25614,3348,78303,0.6301291138270564,0.3271139036818513,0.0427569824910923,567,2081,436,3084,-0.01829748051745761,0.02591283407114521,-0.007615353553687587,23727,131,0.3030152101452051,-0.010682126963770022
5859,24019,Dorchester,Maryland,2000,5232,5847,313,11392,0.4592696629213483,0.5132549157303371,0.027475421348314606,0,0,0,0,0.0,0.0,0.0,-615,0,-0.053985252808988804,0.0
5860,24019,Dorchester,Maryland,2004,5411,7801,127,13339,0.4056525976460004,0.5848264487592774,0.009520953594722242,179,-186,1954,1947,-0.053617065275347875,-0.017954467753592364,0.07157153302894026,-2390,-1775,-0.17917385111327694,-0.12518859830428813
5861,24019,Dorchester,Maryland,2008,6912,8168,194,15274,0.45253371742830956,0.5347649600628519,0.012701322508838549,1501,67,367,1935,0.04688111978230913,0.0031803689141163063,-0.05006148869642546,-1256,1134,-0.08223124263454235,0.0969426084787346
5862,24019,Dorchester,Maryland,2012,7257,7976,211,15444,0.4698912198912199,0.5164465164465164,0.013662263662263661,345,17,-192,170,0.017357502462910346,0.0009609411534251128,-0.0183184436163355,-719,537,-0.0465552965552965,0.035675946079245846
5863,24019,Dorchester,Maryland,2016,6245,8413,567,15225,0.4101806239737274,0.5525779967159278,0.037241379310344824,-1012,356,437,-219,-0.059710595917492504,0.023579115648081163,0.036131480269411376,-2168,-1449,-0.14239737274220038,-0.09584207618690388
5864,24021,Frederick,Maryland,2000,30725,45350,2586,78661,0.3906001703512541,0.5765245801604353,0.032875249488310596,0,0,0,0,0.0,0.0,0.0,-14625,0,-0.18592440980918118,0.0
5865,24021,Frederick,Maryland,2004,39503,59934,1157,100594,0.3926973775771915,0.5958009424021313,0.011501680020677177,8778,-1429,14584,21933,0.0020972072259373697,-0.02137356946763342,0.019276362241696043,-20431,-5806,-0.20310356482493985,-0.017179155015758674
5866,24021,Frederick,Maryland,2008,54013,55170,2003,111186,0.48578957782454624,0.4961955641897361,0.018014857985717628,14510,846,-4764,10592,0.09309220024735476,0.0065131779650404505,-0.09960537821239523,-1157,19274,-0.010405986365189857,0.19269757845975
5867,24021,Frederick,Maryland,2012,55146,58798,3164,117108,0.4708986576493493,0.5020835468114903,0.027017795539160432,1133,1161,3628,5922,-0.014890920175196942,0.009002937553442805,0.005887982621754162,-3652,-2495,-0.03118488916214096,-0.020778902796951104
5868,24021,Frederick,Maryland,2016,56522,59522,9633,125677,0.4497402070386785,0.4736109232397336,0.07664886972158788,1376,6469,724,8569,-0.021158450610670787,0.049631074182427445,-0.028472623571756672,-3000,652,-0.023870716201055076,0.007314172961085885
5869,24023,Garrett,Maryland,2000,2872,7514,269,10655,0.2695448146410136,0.7052088221492258,0.025246363209760675,0,0,0,0,0.0,0.0,0.0,-4642,0,-0.43566400750821216,0.0
5870,24023,Garrett,Maryland,2004,3291,9085,108,12484,0.2636174303107978,0.7277314963152836,0.008651073373918615,419,-161,1571,1829,-0.005927384330215779,-0.01659528983584206,0.0225226741660578,-5794,-1152,-0.46411406600448574,-0.028450058496273578
5871,24023,Garrett,Maryland,2008,3736,8903,233,12872,0.29024238657551277,0.6916563082660038,0.01810130515848353,445,125,-182,388,0.02662495626471495,0.009450231784564915,-0.03607518804927978,-5167,627,-0.401413921690491,0.06270014431399473
5872,24023,Garrett,Maryland,2012,3124,9743,288,13155,0.23747624477385024,0.7406309388065374,0.021892816419612316,-612,55,840,283,-0.05276614180166253,0.003791511261128786,0.04897463054053364,-6619,-1452,-0.5031546940326872,-0.1017407723421962
5873,24023,Garrett,Maryland,2016,2567,10776,668,14011,0.183213189636714,0.7691099850117764,0.04767682535150953,-557,380,1033,856,-0.054263055137136224,0.025784008931897213,0.028479046205239,-8209,-1590,-0.5858967953750625,-0.08274210134237525
5874,24025,Harford,Maryland,2000,35665,52862,2897,91424,0.3901054427721386,0.5782070353517675,0.031687521876093805,0,0,0,0,0.0,0.0,0.0,-17197,0,-0.18810159257962894,0.0
5875,24025,Harford,Maryland,2004,39685,71565,1478,112728,0.35204208359946065,0.6348467106663828,0.013111205734156554,4020,-1419,18703,21304,-0.038063359172677946,-0.01857631614193725,0.05663967531461522,-31880,-14683,-0.2828046270669221,-0.09470303448729317
5876,24025,Harford,Maryland,2008,48552,71751,2992,123295,0.39378725820187355,0.5819457398921286,0.02426700190599781,8867,1514,186,10567,0.04174517460241289,0.011155796171841257,-0.05290097077425415,-23199,8681,-0.18815848169025506,0.09464614537666705
5877,24025,Harford,Maryland,2012,49729,72911,3314,125954,0.3948187433507471,0.5788700636740397,0.026311192975213175,1177,322,1160,2659,0.0010314851488735788,0.0020441910692153634,-0.0030756762180889075,-23182,17,-0.18405132032329258,0.004107161366962486
5878,24025,Harford,Maryland,2016,47077,77860,8735,133672,0.35218295529355437,0.5824705248668383,0.0653465198396074,-2652,5421,4949,7718,-0.04263578805719276,0.03903532686439423,0.003600461192798554,-30783,-7601,-0.2302875695732839,-0.04623624924999131
5879,24027,Howard,Maryland,2000,58556,49809,4414,112779,0.5192101366389132,0.4416513712659272,0.03913849209515956,0,0,0,0,0.0,0.0,0.0,8747,0,0.07755876537298606,0.0
5880,24027,Howard,Maryland,2004,72257,59724,1829,133810,0.5399970106867947,0.4463343546820118,0.013668634631193484,13701,-2585,9915,21031,0.020786874047881487,-0.025469857463966072,0.004682983416084641,12533,3786,0.09366265600478291,0.016103890631796847
5881,24027,Howard,Maryland,2008,87120,55393,2720,145233,0.59986366734833,0.38140780676568,0.0187285258859901,14863,891,-4331,11423,0.059866656661535234,0.0050598912547966165,-0.06492654791633184,31727,19194,0.21845586058264999,0.12479320457786708
5882,24027,Howard,Maryland,2012,91393,57758,3954,153105,0.5969302112929036,0.3772443747754809,0.025825413931615557,4273,1234,2365,7872,-0.0029334560554263867,0.007096888045625457,-0.004163431990199085,33635,1908,0.21968583651742268,0.001229975934772698
5883,24027,Howard,Maryland,2016,102597,47484,12112,162193,0.6325612079436227,0.29276232636426974,0.07467646569210755,11204,8158,-10274,9088,0.035630996650719116,0.048851051760491995,-0.08448204841121115,55113,21478,0.33979888157935295,0.12011304506193027
5884,24029,Kent,Maryland,2000,3627,4155,303,8085,0.44860853432282005,0.5139146567717996,0.037476808905380334,0,0,0,0,0.0,0.0,0.0,-528,0,-0.06530612244897954,0.0
5885,24029,Kent,Maryland,2004,4278,4900,107,9285,0.4607431340872375,0.5277329025309639,0.0115239633817986,651,-196,745,1200,0.012134599764417442,-0.025952845523581736,0.01381824575916435,-622,-94,-0.06698976844372645,-0.0016836459947469073
5886,24029,Kent,Maryland,2008,4953,4905,162,10020,0.494311377245509,0.48952095808383234,0.016167664670658683,675,55,5,735,0.033568243158271505,0.0046437012888600835,-0.03821194444713161,48,670,0.004790419161676662,0.07178018760540311
5887,24029,Kent,Maryland,2012,4842,4870,192,9904,0.4888933764135703,0.4917205169628433,0.01938610662358643,-111,30,-35,-116,-0.0054180008319387185,0.003218441952927746,0.0021995588790109655,-28,-76,-0.0028271405492730217,-0.007617559710949684
5888,24029,Kent,Maryland,2016,4575,4876,570,10021,0.45654126334697137,0.48657818580979945,0.05688055084322922,-267,378,6,117,-0.03235211306659891,0.03749444421964279,-0.005142331153043855,-301,-273,-0.030036922462828075,-0.027209781913555053
5889,24031,Montgomery,Maryland,2000,232453,124580,14655,371688,0.6253981834226555,0.3351735864488496,0.03942823012849487,0,0,0,0,0.0,0.0,0.0,107873,0,0.2902245969738059,0.0
5890,24031,Montgomery,Maryland,2004,273936,136334,4955,415225,0.6597290625564453,0.32833764826298995,0.011933289180564754,41483,-9700,11754,43537,0.03433087913378974,-0.027494940947930115,-0.006835938185859647,137602,29729,0.3313914142934553,0.041166817319649385
5891,24031,Montgomery,Maryland,2008,314444,118608,6209,439261,0.7158477533858002,0.2700171424278504,0.014135104186349346,40508,1254,-17726,24036,0.056118690829354945,0.0022018150057845926,-0.058320505835139536,195836,58234,0.4458306109579498,0.11443919666449448
5892,24031,Montgomery,Maryland,2012,323400,123353,9226,455979,0.7092431888310646,0.2705234232278241,0.020233387941111323,8956,3017,4745,16718,-0.00660456455473557,0.006098283754761976,0.0005062807999736685,200047,4211,0.43871976560324055,-0.007110845354709239
5893,24031,Montgomery,Maryland,2016,357837,92704,28332,478873,0.7472482265652898,0.1935878614998131,0.059163911934897145,34437,19106,-30649,22894,0.038005037734225144,0.038930523993785826,-0.07693556172801097,265133,65086,0.5536603650654767,0.11494059946223611
5894,24033,Prince George's,Maryland,2000,216119,49987,5803,271909,0.7948210614580613,0.18383723966474078,0.021341698877197886,0,0,0,0,0.0,0.0,0.0,166132,0,0.6109838217933206,0.0
5895,24033,Prince George's,Maryland,2004,260532,55532,2410,318474,0.8180636409879614,0.17436902227497378,0.007567336737064878,44413,-3393,5545,46565,0.023242579529900054,-0.013774362140133008,-0.009468217389766997,205000,38868,0.6436946187129876,0.03271079691966705
5896,24033,Prince George's,Maryland,2008,332396,38833,2797,374026,0.8886975771737794,0.10382433306775465,0.007478089758465989,71864,387,-16699,55552,0.07063393618581804,-8.924697859888885e-05,-0.07054468920721912,293563,88563,0.7848732441060248,0.14117862539303716
5897,24033,Prince George's,Maryland,2012,347938,35734,4065,387737,0.897355681815251,0.09216040769903311,0.010483910485715833,15542,1268,-3099,13711,0.008658104641471653,0.003005820727249844,-0.011663925368721545,312204,18641,0.8051952741162179,0.02032203001019317
5898,24033,Prince George's,Maryland,2016,344049,32811,13525,390385,0.8813069149685567,0.08404779896768574,0.03464528606375757,-3889,9460,-2923,2648,-0.016048766846694318,0.02416137557804174,-0.008112608731347365,311238,-966,0.797259116000871,-0.00793615811534698
5899,24035,Queen Anne's,Maryland,2000,6257,9970,534,16761,0.3733070819163534,0.5948332438398664,0.0318596742437802,0,0,0,0,0.0,0.0,0.0,-3713,0,-0.22152616192351293,0.0
5900,24035,Queen Anne's,Maryland,2004,7070,14489,235,21794,0.3244012113425713,0.6648160044048821,0.010782784252546572,813,-299,4519,5033,-0.048905870573782095,-0.02107688999123363,0.06998276056501573,-7419,-3706,-0.34041479306231076,-0.11888863113879783
5901,24035,Queen Anne's,Maryland,2008,8575,15087,383,24045,0.35662299854439594,0.6274485339987523,0.015928467456851735,1505,148,598,2251,0.032221787201824614,0.005145683204305163,-0.037367470406129755,-6512,907,-0.2708255354543564,0.06958925760795437
5902,24035,Queen Anne's,Maryland,2012,8556,15823,508,24887,0.3437939486478885,0.6357937879214047,0.020412263430706793,-19,125,736,842,-0.01282904989650746,0.004483795973855058,0.008345253922652396,-7267,-755,-0.29199983927351625,-0.021174303819159856
5903,24035,Queen Anne's,Maryland,2016,7973,16993,1557,26523,0.3006070203219847,0.640689213135769,0.05870376654224635,-583,1049,1170,1636,-0.04318692832590376,0.03829150311153956,0.004895425214364257,-9020,-1753,-0.34008219281378427,-0.04808235354026802
5904,24037,St. Mary's,Maryland,2000,11912,16856,733,29501,0.4037829226127928,0.5713704620182367,0.024846615368970544,0,0,0,0,0.0,0.0,0.0,-4944,0,-0.1675875394054439,0.0
5905,24037,St. Mary's,Maryland,2004,13776,23725,415,37916,0.3633294651334529,0.625725287477582,0.01094524738896508,1864,-318,6869,8415,-0.04045345747933993,-0.013901367980005463,0.054354825459345335,-9949,-5005,-0.26239582234412917,-0.09480828293868526
5906,24037,St. Mary's,Maryland,2008,19023,24705,681,44409,0.42835911639532526,0.5563061541579409,0.01533472944673377,5247,266,980,6493,0.06502965126187238,0.004389482057768689,-0.06941913331964111,-5682,4267,-0.12794703776261568,0.1344487845815135
5907,24037,St. Mary's,Maryland,2012,19711,26797,1316,47824,0.4121570759451322,0.5603253596520575,0.027517564402810304,688,635,2092,3415,-0.016202040450193078,0.012182834956076534,0.004019205494116607,-7086,-1404,-0.14816828370692536,-0.020221245944309685
5908,24037,St. Mary's,Maryland,2016,17534,28663,3645,49842,0.3517916616508166,0.5750772440913285,0.07313109425785481,-2177,2329,1866,2018,-0.06036541429431558,0.04561352985504451,0.014751884439271001,-11129,-4043,-0.22328558244051194,-0.07511729873358658
5909,24039,Somerset,Maryland,2000,3785,3609,210,7604,0.49776433456075747,0.47461862177801156,0.027617043661230932,0,0,0,0,0.0,0.0,0.0,176,0,0.02314571278274591,0.0
5910,24039,Somerset,Maryland,2004,4034,4884,76,8994,0.4485212363798088,0.543028685790527,0.008450077829664221,249,-134,1275,1390,-0.049243098180948686,-0.019166965831566712,0.06841006401251543,-850,-1026,-0.0945074494107182,-0.11765316219346411
5911,24039,Somerset,Maryland,2008,4779,5037,108,9924,0.48155985489721886,0.5075574365175333,0.010882708585247884,745,32,153,930,0.03303861851741008,0.002432630755583663,-0.03547124927299372,-258,592,-0.025997581620314403,0.0685098677904038
5912,24039,Somerset,Maryland,2012,5240,5042,117,10399,0.5038946052505049,0.4848543129147033,0.011251081834791806,461,9,5,475,0.022334750353286026,0.00036837324954392195,-0.022703123602829944,198,456,0.019040292335801567,0.04503787395611597
5913,24039,Somerset,Maryland,2016,4196,5341,363,9900,0.42383838383838385,0.5394949494949495,0.03666666666666667,-1044,246,299,-499,-0.08005622141212104,0.02541558483187486,0.05464063658024615,-1145,-1343,-0.11565656565656562,-0.1346968579923672
5914,24041,Talbot,Maryland,2000,5854,8874,506,15234,0.3842720231062098,0.5825128003150847,0.03321517657870553,0,0,0,0,0.0,0.0,0.0,-3020,0,-0.1982407772088749,0.0
5915,24041,Talbot,Maryland,2004,7367,11288,209,18864,0.3905322307039864,0.5983884648006785,0.01107930449533503,1513,-297,2414,3630,0.006260207597776624,-0.0221358720833705,0.015875664485593854,-3921,-901,-0.20785623409669213,-0.00961545688781723
5916,24041,Talbot,Maryland,2008,9035,10995,298,20328,0.44446084218811494,0.5408795749704841,0.014659582841401023,1668,89,-293,1464,0.05392861148412853,0.003580278346065993,-0.05750888983019442,-1960,1961,-0.09641873278236918,0.11143750131432295
5917,24041,Talbot,Maryland,2012,8808,11339,312,20459,0.4305195757368395,0.5542304120435994,0.015250012219561073,-227,14,344,131,-0.013941266451275414,0.0005904293781600501,0.01335083707311524,-2531,-571,-0.12371083630675983,-0.027292103524390654
5918,24041,Talbot,Maryland,2016,8653,10724,1176,20553,0.42100909842845324,0.5217729771809468,0.05721792439059991,-155,864,-615,94,-0.009510477308386278,0.04196791217103884,-0.03245743486265251,-2071,460,-0.1007638787524936,0.022946957554266234
5919,24043,Washington,Maryland,2000,18221,27948,1301,47470,0.38384242679587105,0.5887507899726143,0.02740678323151464,0,0,0,0,0.0,0.0,0.0,-9727,0,-0.20490836317674327,0.0
5920,24043,Washington,Maryland,2004,20387,36917,600,57904,0.35208275766786407,0.6375552638850511,0.01036197844708483,2166,-701,8969,10434,-0.031759669128006984,-0.01704480478442981,0.04880447391243681,-16530,-6803,-0.28547250621718706,-0.08056414304044379
5921,24043,Washington,Maryland,2008,26245,34169,1186,61600,0.4260551948051948,0.5546915584415585,0.019253246753246755,5858,586,-2748,3696,0.07397243713733076,0.008891268306161925,-0.08286370544349264,-7924,8606,-0.12863636363636366,0.1568361425808234
5922,24043,Washington,Maryland,2012,25042,36074,1635,62751,0.3990693375404376,0.5748753007920192,0.02605536166754315,-1203,449,1905,1151,-0.026985857264757218,0.0068021149142963935,0.02018374235046072,-11032,-3108,-0.1758059632515816,-0.04716959961521794
5923,24043,Washington,Maryland,2016,21129,40998,3864,65991,0.3201800245488021,0.6212665363458654,0.05855343910533255,-3913,2229,4924,3240,-0.07888931299163549,0.0324980774377894,0.046391235553846166,-19869,-8837,-0.30108651179706325,-0.12528054854548165
5924,24045,Wicomico,Maryland,2000,14469,16338,988,31795,0.45507155213083816,0.513854379619437,0.0310740682497248,0,0,0,0,0.0,0.0,0.0,-1869,0,-0.058782827488598866,0.0
5925,24045,Wicomico,Maryland,2004,15137,21998,368,37503,0.40362104364984136,0.5865664080206917,0.009812548329466975,668,-620,5660,5708,-0.051450508480996804,-0.021261519920257824,0.07271202840125468,-6861,-4992,-0.18294536437085035,-0.12416253688225148
5926,24045,Wicomico,Maryland,2008,19436,21849,569,41854,0.4643761647632245,0.5220289578057056,0.013594877431069909,4299,201,-149,4351,0.06075512111338316,0.0037823291016029336,-0.06453745021498614,-2413,4448,-0.057652793042481054,0.1252925713283693
5927,24045,Wicomico,Maryland,2012,19635,21764,858,42257,0.4646567432614715,0.5150389284615566,0.020304328276971862,199,289,-85,403,0.000280578498246975,0.006709450845901953,-0.00699002934414894,-2129,284,-0.05038218520008514,0.007270607842395915
5928,24045,Wicomico,Maryland,2016,18050,22198,2299,42547,0.42423672644369753,0.5217289115566315,0.05403436199967095,-1585,1441,434,290,-0.04042001681777396,0.03373003372269909,0.006689983095074847,-4148,-2019,-0.09749218511293395,-0.04710999991284881
5929,24047,Worcester,Maryland,2000,9389,10742,622,20753,0.4524165180937696,0.5176119115308631,0.029971570375367417,0,0,0,0,0.0,0.0,0.0,-1353,0,-0.06519539343709346,0.0
5930,24047,Worcester,Maryland,2004,9648,15349,232,25229,0.3824170597328471,0.608387173490824,0.009195766776328829,259,-390,4607,4476,-0.06999945836092247,-0.02077580359903859,0.090775261959961,-5701,-4348,-0.22597011375797693,-0.16077472032088347
5931,24047,Worcester,Maryland,2008,11374,15607,365,27346,0.415929203539823,0.5707233233379654,0.013347473122211658,1726,133,258,2117,0.03351214380697587,0.004151706345882829,-0.03766385015285867,-4233,1468,-0.1547941197981424,0.07117599395983454
5932,24047,Worcester,Maryland,2012,11014,15951,454,27419,0.4016922571939166,0.5817498814690543,0.016557861337029068,-360,89,344,73,-0.014236946345906387,0.00321038821481741,0.011026558131088882,-4937,-704,-0.18005762427513766,-0.02526350447699527
5933,24047,Worcester,Maryland,2016,9753,17210,1310,28273,0.3449580872210236,0.6087079545856471,0.046333958193329326,-1261,856,1259,854,-0.05673416997289299,0.02977609685630026,0.026958073116592818,-7457,-2520,-0.26374986736462347,-0.08369224308948581
5934,24510,Baltimore,Maryland,2000,158765,27150,6489,192404,0.8251647574894493,0.14110933244631088,0.03372591006423983,0,0,0,0,0.0,0.0,0.0,131615,0,0.6840554250431384,0.0
5935,24510,Baltimore,Maryland,2004,175022,36230,2311,213563,0.8195333461320548,0.16964549102606724,0.01082116284187804,16257,-4178,9080,21159,-0.0056314113573945335,-0.022904747222361785,0.02853615857975636,138792,7177,0.6498878551059875,-0.03416756993715098
5936,24510,Baltimore,Maryland,2008,214385,28681,2902,245968,0.8715971183243348,0.11660459897222403,0.011798282703441097,39363,591,-7549,32405,0.05206377219228009,0.0009771198615630573,-0.053040892053843214,185704,46912,0.7549925193521108,0.1051046642461233
5937,24510,Baltimore,Maryland,2012,221478,28171,4343,253992,0.8719880941132004,0.11091294213990992,0.017098963746889666,7093,1441,-510,8024,0.0003909757888655996,0.005300681043448569,-0.00569165683231411,193307,7603,0.7610751519732906,0.0060826326211798065
5938,24510,Baltimore,Maryland,2016,202673,25205,11524,239402,0.846580229070768,0.10528316388334266,0.04813660704588934,-18805,7181,-2966,-14590,-0.02540786504243242,0.031037643298999672,-0.0056297782565672555,177468,-15839,0.7412970651874253,-0.019778086785865234
5939,25001,Barnstable,Massachusetts,2000,62363,49686,9037,121086,0.5150306393802752,0.41033645508151234,0.07463290553821252,0,0,0,0,0.0,0.0,0.0,12677,0,0.10469418429876282,0.0
5940,25001,Barnstable,Massachusetts,2004,72156,58527,1465,132148,0.5460241547355995,0.44288979023519087,0.011086055029209674,9793,-7572,8841,11062,0.030993515355324353,-0.06354685050900284,0.03255333515367853,13629,952,0.10313436450040864,-0.0015598197983541784
5941,25001,Barnstable,Massachusetts,2008,74264,55694,2395,132353,0.5611055283975429,0.4207989240893671,0.018095547513089994,2108,930,-2833,205,0.015081373661943398,0.00700949248388032,-0.022090866145823784,18570,4941,0.14030660430817582,0.03717223980776718
5942,25001,Barnstable,Massachusetts,2012,70822,60446,1847,133115,0.5320362092927168,0.45408857003342973,0.013875220673853435,-3442,-548,4752,762,-0.02906931910482613,-0.004220326839236559,0.03328964594406264,10376,-8194,0.07794763925928705,-0.06235896504888877
5943,25001,Barnstable,Massachusetts,2016,72430,54099,9252,135781,0.5334325126490451,0.39842835153666567,0.06813913581428918,1608,7405,-6347,2666,0.0013963033563283433,0.05426391514043574,-0.05566021849676406,18331,7955,0.13500416111237945,0.0570565218530924
5944,25003,Berkshire,Massachusetts,2000,37934,15805,5672,59411,0.638501287640336,0.2660281766002929,0.09547053575937116,0,0,0,0,0.0,0.0,0.0,22129,0,0.3724731110400431,0.0
5945,25003,Berkshire,Massachusetts,2004,47743,16806,742,65291,0.7312340138763382,0.25740147953010367,0.01136450659355807,9809,-4930,1001,5880,0.09273272623600226,-0.08410602916581308,-0.008626697070189204,30937,8808,0.47383253434623457,0.10135942330619147
5946,25003,Berkshire,Massachusetts,2008,49558,14876,1696,66130,0.7494026916679268,0.22495085437774082,0.025646453954332377,1815,954,-1930,839,0.018168677791588594,0.014281947360774306,-0.032450625152362855,34682,3745,0.5244518372901861,0.050619302943951505
5947,25003,Berkshire,Massachusetts,2012,48843,14252,1391,64486,0.7574202152405173,0.2210092113016779,0.021570573457804793,-715,-305,-624,-1644,0.008017523572590446,-0.004075880496527583,-0.003941643076062928,34591,-91,0.5364110039388394,0.011959166648653374
5948,25003,Berkshire,Massachusetts,2016,43714,16839,5064,65617,0.666199308106131,0.2566255695932457,0.07717512230062332,-5129,3673,2587,1131,-0.09122090713438624,0.05560454884281853,0.035616358291567785,26875,-7716,0.40957373851288537,-0.12683726542595408
5949,25005,Bristol,Massachusetts,2000,136325,62848,12164,211337,0.645059786028949,0.29738285297889155,0.05755736099215944,0,0,0,0,0.0,0.0,0.0,73477,0,0.3476769330500574,0.0
5950,25005,Bristol,Massachusetts,2004,147854,82524,2500,232878,0.6348989599704566,0.3543658052714297,0.01073523475811369,11529,-9664,19676,21541,-0.010160826058492334,-0.04682212623404575,0.056982952292538136,65330,-8147,0.28053315469902695,-0.06714377835103047
5951,25005,Bristol,Massachusetts,2008,146861,90531,5728,243120,0.6040679499835472,0.37237166831194474,0.02356038170450806,-993,3228,8007,10242,-0.030831009986909463,0.012825146946394372,0.018005863040515047,56330,-9000,0.23169628167160244,-0.04883687302742451
5952,25005,Bristol,Massachusetts,2012,143433,93898,4178,241509,0.5939033327950511,0.3887971048697978,0.01729956233515107,-3428,-1550,3367,-1611,-0.010164617188496039,-0.00626081936935699,0.016425436557853057,49535,-6795,0.20510622792525335,-0.026590053746349096
5953,25005,Bristol,Massachusetts,2016,129540,105443,17157,252140,0.513762195605616,0.4181922741334179,0.06804553026096613,-13893,12979,11545,10631,-0.08014113718943516,0.05074596792581506,0.029395169263620125,24097,-25438,0.09556992147219806,-0.10953630645305529
5954,25007,Dukes,Massachusetts,2000,5474,2315,1067,8856,0.6181120144534779,0.26140469738030714,0.120483288166215,0,0,0,0,0.0,0.0,0.0,3159,0,0.3567073170731707,0.0
5955,25007,Dukes,Massachusetts,2004,7265,2602,130,9997,0.7267180154046213,0.2602780834250275,0.013003901170351105,1791,-937,287,1141,0.10860600095114348,-0.10747938699586389,-0.0011266139552796317,4663,1504,0.4664399319795938,0.10973261490642311
5956,25007,Dukes,Massachusetts,2008,7913,2442,198,10553,0.7498341703780915,0.23140339240026533,0.018762437221643134,648,68,-160,556,0.023116154973470193,0.0057585360512920295,-0.028874691024762172,5471,808,0.5184307779778262,0.05199084599823239
5957,25007,Dukes,Massachusetts,2012,7978,2792,198,10968,0.7273887673231219,0.25455871626549964,0.018052516411378557,65,0,350,415,-0.02244540305496967,-0.000709920810264577,0.023155323865234306,5186,-285,0.4728300510576222,-0.045600726920204004
5958,25007,Dukes,Massachusetts,2016,8400,2477,797,11674,0.7195477128661983,0.21218091485352064,0.06827137228028096,422,599,-315,706,-0.007841054456923513,0.0502188558689024,-0.042377801411979,5923,737,0.5073667980126777,0.034536746955055486
5959,25009,Essex,Massachusetts,2000,178400,110010,21923,310333,0.5748663532399068,0.35449017668117794,0.07064347007891524,0,0,0,0,0.0,0.0,0.0,68390,0,0.22037617655872882,0.0
5960,25009,Essex,Massachusetts,2004,194068,135114,4051,333233,0.5823792961681467,0.4054640446774479,0.012156659154405476,15668,-17872,25104,22900,0.007512942928239896,-0.05848681092450976,0.05097386799626996,58954,-9436,0.17691525149069875,-0.043460925068030065
5961,25009,Essex,Massachusetts,2008,208976,137129,7357,353462,0.5912262138504281,0.3879596675173003,0.020814118632271644,14908,3306,2015,20229,0.008846917682281408,0.008657459477866168,-0.017504377160147577,71847,12893,0.20326654633312774,0.026351294842428985
5962,25009,Essex,Massachusetts,2012,210302,150480,5575,366357,0.5740357083391336,0.41074689442265333,0.015217397238213,1326,-1782,13351,12895,-0.01719050551129442,-0.005596721394058644,0.02278722690535301,59822,-12025,0.1632888139164803,-0.03997773241664743
5963,25009,Essex,Massachusetts,2016,222310,136316,26744,385370,0.5768741728728235,0.35372758647533536,0.06939824065184108,12008,21169,-14164,19013,0.002838464533689855,0.05418084341362808,-0.057019307947317965,85994,26172,0.22314658639748813,0.05985777248100782
5964,25011,Franklin,Massachusetts,2000,17945,10176,5245,33366,0.5378229335251453,0.3049811185038662,0.15719594797098843,0,0,0,0,0.0,0.0,0.0,7769,0,0.2328418150212791,0.0
5965,25011,Franklin,Massachusetts,2004,25550,11058,773,37381,0.6835023140097911,0.29581873144110643,0.020678954549102485,7605,-4472,882,4015,0.1456793804846458,-0.13651699342188595,-0.009162387062759791,14492,6723,0.3876835825686847,0.15484176754740558
5966,25011,Franklin,Massachusetts,2008,27919,9545,1065,38529,0.7246230112382881,0.24773547198214332,0.027641516779568637,2369,292,-1513,1148,0.04112069722849698,0.006962562230466152,-0.04808325945896311,18374,3882,0.4768875392561448,0.08920395668746012
5967,25011,Franklin,Massachusetts,2012,27072,9344,1342,37758,0.7169871285555379,0.2474707346787436,0.035542136765718525,-847,277,-201,-771,-0.0076358826827501725,0.007900619986149889,-0.0002647373033997369,17728,-646,0.46951639387679434,-0.007371145379350463
5968,25011,Franklin,Massachusetts,2016,24478,10364,3979,38821,0.6305350197058294,0.2669689085804075,0.10249607171376317,-2594,2637,1020,1063,-0.08645210884970855,0.06695393494804464,0.019498173901663918,14114,-3614,0.36356611112542186,-0.10595028275137247
5969,25013,Hampden,Massachusetts,2000,100103,59558,12432,172093,0.5816796731999558,0.34608031703788067,0.07224000976216348,0,0,0,0,0.0,0.0,0.0,40545,0,0.23559935616207517,0.0
5970,25013,Hampden,Massachusetts,2004,113710,70925,2004,186639,0.6092510139895735,0.3800116803026163,0.010737305707810264,13607,-10428,11367,14546,0.02757134078961765,-0.061502704054353215,0.033931363264735614,42785,2240,0.2292393336869572,-0.006360022475117966
5971,25013,Hampden,Massachusetts,2008,121454,71350,4916,197720,0.6142727088812462,0.3608638478656686,0.02486344325308517,7744,2912,425,11081,0.005021694891672701,0.014126137545274906,-0.019147832436947676,50104,7319,0.2534088610155776,0.024169527328620377
5972,25013,Hampden,Massachusetts,2012,123619,73392,3388,200399,0.616864355610557,0.3662293724020579,0.016906271987385167,2165,-1528,2042,2679,0.0025916467293107814,-0.007957171265700003,0.005365524536389277,50227,123,0.2506349832084991,-0.0027738778070784953
5973,25013,Hampden,Massachusetts,2016,112590,78685,14826,206101,0.5462855590220329,0.3817788365898273,0.0719356043881398,-11029,11438,5293,5702,-0.07057879658852406,0.05502933240075463,0.015549464187769424,33905,-16322,0.1645067224322056,-0.08612826077629349
5974,25015,Hampshire,Massachusetts,2000,38543,19202,10881,68626,0.5616384460700026,0.27980648733716085,0.15855506659283652,0,0,0,0,0.0,0.0,0.0,19341,0,0.2818319587328417,0.0
5975,25015,Hampshire,Massachusetts,2004,51680,21315,1427,74422,0.6944183171642794,0.28640724516943916,0.019174437666281477,13137,-9454,2113,5796,0.1327798710942768,-0.13938062892655506,0.0066007578322783145,30365,11024,0.4080110719948402,0.1261791132619985
5976,25015,Hampshire,Massachusetts,2008,56869,20618,2083,79570,0.7147040341837376,0.25911775794897574,0.026178207867286665,5189,656,-697,5148,0.02028571701945825,0.007003770201005188,-0.027289487220463426,36251,5886,0.4555862762347619,0.047575204239921676
5977,25015,Hampshire,Massachusetts,2012,57359,21480,2782,81621,0.7027480672866052,0.26316756717021356,0.03408436554318129,490,699,862,2051,-0.011955966897132408,0.007906157675894625,0.004049809221237821,35879,-372,0.43958050011639166,-0.01600577611837023
5978,25015,Hampshire,Massachusetts,2016,55367,21790,7036,84193,0.6576199921608685,0.2588101148551542,0.0835698929839773,-1992,4254,310,2572,-0.04512807512573669,0.049485527440796005,-0.004357452315059351,33577,-2302,0.3988098773057143,-0.04077062281067734
5979,25017,Middlesex,Massachusetts,2000,404043,198914,54091,657048,0.6149368082697154,0.30273891709585904,0.08232427463442549,0,0,0,0,0.0,0.0,0.0,205129,0,0.3121978911738564,0.0
5980,25017,Middlesex,Massachusetts,2004,440862,237815,10283,688960,0.639894914073386,0.3451796911286577,0.01492539479795634,36819,-43808,38901,31912,0.024958105803670527,-0.06739887983646915,0.04244077403279867,203047,-2082,0.29471522294472824,-0.01748266822912814
5981,25017,Middlesex,Massachusetts,2008,464484,245766,15781,726031,0.639757806484847,0.33850620703523676,0.021735986479916147,23622,5498,7951,37071,-0.00013710758853890948,0.006810591681959808,-0.006673484093420945,218718,15671,0.3012515994496103,0.0065363765048820355
5982,25017,Middlesex,Massachusetts,2012,471804,267321,15045,754170,0.6255936990333745,0.3544572178686503,0.01994908309797526,7320,-736,21555,28139,-0.014164107451472563,-0.001786903381940888,0.015951010833413548,204483,-14235,0.27113648116472416,-0.03011511828488611
5983,25017,Middlesex,Massachusetts,2016,520360,219793,56582,796735,0.6531155277476199,0.27586713273547664,0.07101733951690337,48556,41537,-47528,42565,0.027521828714245467,0.05106825641892811,-0.07859008513317367,300567,96084,0.3772483950121433,0.10611191384741914
5984,25019,Nantucket,Massachusetts,2000,2874,1624,428,4926,0.5834348355663824,0.32967925294356476,0.08688591149005279,0,0,0,0,0.0,0.0,0.0,1250,0,0.25375558262281767,0.0
5985,25019,Nantucket,Massachusetts,2004,3608,2040,76,5724,0.6303284416491963,0.35639412997903563,0.013277428371767994,734,-352,416,798,0.0468936060828139,-0.07360848311828479,0.026714877035470874,1568,318,0.2739343116701607,0.020178729047343025
5986,25019,Nantucket,Massachusetts,2008,4073,1863,116,6052,0.6730006609385327,0.30783212161269,0.019167217448777262,465,40,-177,328,0.0426722192893364,0.005889789077009268,-0.04856200836634561,2210,642,0.3651685393258427,0.09123422765568201
5987,25019,Nantucket,Massachusetts,2012,3830,2187,103,6120,0.6258169934640523,0.3573529411764706,0.016830065359477123,-243,-13,324,68,-0.04718366747448044,-0.002337152089300139,0.04952081956378057,1643,-567,0.2684640522875817,-0.09670448703826101
5988,25019,Nantucket,Massachusetts,2016,4146,1892,470,6508,0.6370620774431469,0.29071911493546404,0.07221880762138906,316,367,-295,388,0.011245083979094628,0.05538874226191194,-0.06663382624100656,2254,611,0.34634296250768287,0.07787891022010118
5989,25021,Norfolk,Massachusetts,2000,188450,107033,21694,317177,0.5941477471569502,0.3374551118145389,0.0683971410285109,0,0,0,0,0.0,0.0,0.0,81417,0,0.25669263534241127,0.0
5990,25021,Norfolk,Massachusetts,2004,199392,127763,3982,331137,0.6021435236775111,0.3858312420538931,0.012025234268595777,10942,-17712,20730,13960,0.007995776520560938,-0.056371906759915116,0.048376130239354165,71629,-9788,0.21631228162361804,-0.04038035371879323
5991,25021,Norfolk,Massachusetts,2008,200675,136841,7400,344916,0.5818083243456378,0.39673717658792285,0.021454499066439366,1283,3418,9078,13779,-0.020335199331873333,0.00942926479784359,0.01090593453402977,63834,-7795,0.18507114775771494,-0.031241133865903103
5992,25021,Norfolk,Massachusetts,2012,202714,148393,5416,356523,0.5685860379274268,0.4162227962852327,0.015191165787340508,2039,-1984,11552,11607,-0.013222286418210993,-0.006263333279098858,0.01948561969730983,54321,-9513,0.1523632416421941,-0.032707906115520824
5993,25021,Norfolk,Massachusetts,2016,221819,119723,26153,367695,0.6032690137206108,0.3256041012252002,0.07112688505418893,19105,20737,-28670,11172,0.03468297579318402,0.05593571926684843,-0.09061869506003245,102096,47775,0.2776649124954106,0.12530167085321647
5994,25023,Plymouth,Massachusetts,2000,115376,82751,13450,211577,0.5453144717998648,0.39111529135964684,0.06357023684048833,0,0,0,0,0.0,0.0,0.0,32625,0,0.15419918044021796,0.0
5995,25023,Plymouth,Massachusetts,2004,125178,105603,2516,233297,0.5365606930221992,0.45265477052855374,0.010784536449247097,9802,-10934,22852,21720,-0.008753778777665588,-0.05278570039124124,0.061539479168906897,19575,-13050,0.08390592249364548,-0.07029325794657248
5996,25023,Plymouth,Massachusetts,2008,131817,112904,5096,249817,0.5276542429058071,0.4519468250759556,0.02039893201823735,6639,2580,7301,16520,-0.008906450116392128,0.009614395568990254,-0.0007079454525981133,18913,-662,0.07570741782985146,-0.008198504663794015
5997,25023,Plymouth,Massachusetts,2012,131845,121086,3600,256531,0.5139534793065945,0.47201312901754566,0.014033391675859838,28,-1496,8182,6714,-0.013700763599212573,-0.006365540342377513,0.020066303941590036,10759,-8154,0.041940350289048856,-0.03376706754080261
5998,25023,Plymouth,Massachusetts,2016,135513,115369,20295,271177,0.499721584057645,0.42543799806030747,0.07484041788204752,3668,16695,-5717,14646,-0.014231895248949522,0.060807026206187685,-0.0465751309572382,20144,9385,0.07428358599733753,0.032343235708288676
5999,25025,Suffolk,Massachusetts,2000,154888,44441,17671,217000,0.7137695852534562,0.20479723502304148,0.08143317972350231,0,0,0,0,0.0,0.0,0.0,110447,0,0.5089723502304148,0.0
6000,25025,Suffolk,Massachusetts,2004,182592,54923,3130,240645,0.758760830268653,0.22823245860084357,0.013006711130503439,27704,-14541,10482,23645,0.0449912450151968,-0.06842646859299886,0.02343522357780209,127669,17222,0.5305283716678095,0.021556021437394768
6001,25025,Suffolk,Massachusetts,2008,207128,57194,4900,269222,0.7693576305056793,0.2124417766750117,0.018200592819308973,24536,1770,2271,28577,0.01059680023702625,0.005193881688805534,-0.015790681925831856,149934,22265,0.5569158538306676,0.026387482162858023
6002,25025,Suffolk,Massachusetts,2012,223896,59999,5203,289098,0.7744640225805782,0.2075386201218964,0.017997357297525406,16768,303,2805,19876,0.0051063920748989355,-0.00020323552178356727,-0.004903156553115323,163897,13963,0.5669254024586818,0.010009548628014286
6003,25025,Suffolk,Massachusetts,2016,245751,50421,17111,313283,0.7844377128666413,0.1609439388667754,0.054618348266583246,21855,11908,-9578,24185,0.009973690286063097,0.03662099096905784,-0.04659468125512098,195330,31433,0.6234937739998659,0.056568371541184104
6004,25027,Worcester,Massachusetts,2000,173769,114139,22240,310148,0.560277673884726,0.36801462527567486,0.07170770083959915,0,0,0,0,0.0,0.0,0.0,59630,0,0.1922630486090512,0.0
6005,25027,Worcester,Massachusetts,2004,192142,144094,4400,340636,0.5640683897180568,0.42301459622588333,0.012917014056059842,18373,-17840,29955,30488,0.0037907158333307933,-0.05879068678353931,0.05499997095020848,48048,-11582,0.1410537934921735,-0.05120925511687768
6006,25027,Worcester,Massachusetts,2008,202107,152101,9386,363594,0.5558590075743824,0.4183264850355066,0.025814507390110947,9965,4986,8007,22958,-0.008209382143674393,0.012897493334051106,-0.004688111190376709,50006,1958,0.13753252253887582,-0.003521270953297684
6007,25027,Worcester,Massachusetts,2012,198244,163390,7478,369112,0.5370835952231301,0.44265697132577647,0.020259433451093434,-3863,-1908,11289,5518,-0.018775412351252352,-0.005555073939017514,0.024330486290269848,34854,-15152,0.09442662389735362,-0.0431058986415222
6008,25027,Worcester,Massachusetts,2016,198778,157682,33491,389951,0.5097512251539296,0.4043636251734192,0.08588514967265118,534,26013,-5708,20839,-0.02733237006920053,0.06562571622155774,-0.038293346152357244,41096,6242,0.10538759998051034,0.010960976083156715
6009,26001,Alcona,Michigan,2000,2696,3152,149,5997,0.4495581123895281,0.5255961313990328,0.024845756211439054,0,0,0,0,0.0,0.0,0.0,-456,0,-0.07603801900950474,0.0
6010,26001,Alcona,Michigan,2004,2871,3592,68,6531,0.4395957740009187,0.5499923442045629,0.01041188179451845,175,-81,440,534,-0.009962338388609382,-0.014433874416920603,0.02439621280553006,-721,-265,-0.11039657020364418,-0.03435855119413944
6011,26001,Alcona,Michigan,2008,2896,3404,120,6420,0.45109034267912773,0.5302180685358255,0.018691588785046728,25,52,-188,-111,0.011494568678209027,0.008279706990528277,-0.01977427566873735,-508,213,-0.0791277258566978,0.03126884434694638
6012,26001,Alcona,Michigan,2012,2472,3571,53,6096,0.40551181102362205,0.5857939632545932,0.008694225721784778,-424,-67,167,-324,-0.04557853165550568,-0.00999736306326195,0.05557589471876767,-1099,-591,-0.18028215223097116,-0.10115442637427335
6013,26001,Alcona,Michigan,2016,1732,4201,265,6198,0.2794449822523395,0.6777992900935785,0.04275572765408196,-740,212,630,102,-0.12606682877128256,0.034061501932297185,0.09200532683898532,-2469,-1370,-0.39835430784123904,-0.21807215561026788
6014,26003,Alger,Michigan,2000,2071,2142,153,4366,0.4743472285845167,0.4906092533211177,0.03504351809436555,0,0,0,0,0.0,0.0,0.0,-71,0,-0.01626202473660099,0.0
6015,26003,Alger,Michigan,2004,2395,2318,52,4765,0.5026232948583421,0.4864637985309549,0.010912906610703044,324,-101,176,399,0.028276066273825395,-0.02413061148366251,-0.004145454790162817,77,148,0.016159496327387224,0.03242152106398821
6016,26003,Alger,Michigan,2008,2472,2188,90,4750,0.5204210526315789,0.46063157894736845,0.018947368421052633,77,38,-130,-15,0.017797757773236778,0.00803446181034959,-0.025832219583586447,284,207,0.05978947368421045,0.043629977356823224
6017,26003,Alger,Michigan,2012,2212,2330,62,4604,0.48045178105994785,0.5060816681146829,0.013466550825369244,-260,-28,142,-146,-0.03996927157163105,-0.005480817595683389,0.04545008916731447,-118,-402,-0.025629887054735068,-0.08541936073894552
6018,26003,Alger,Michigan,2016,1663,2585,270,4518,0.36808322266489596,0.5721558211598052,0.05976095617529881,-549,208,255,-86,-0.11236855839505189,0.04629440534992956,0.06607415304512232,-922,-804,-0.20407259849490927,-0.1784427114401742
6019,26005,Allegan,Michigan,2000,15495,28197,1199,44891,0.34516941034951326,0.6281214497337997,0.026709139916687087,0,0,0,0,0.0,0.0,0.0,-12702,0,-0.2829520393842864,0.0
6020,26005,Allegan,Michigan,2004,19355,34022,530,53907,0.3590442799636411,0.6311239727679151,0.009831747268443802,3860,-669,5825,9016,0.013874869614127816,-0.016877392648243283,0.003002523034115412,-14667,-1965,-0.272079692804274,0.010872346580012404
6021,26005,Allegan,Michigan,2008,24165,30061,1154,55380,0.43634886240520043,0.5428132899963886,0.02083784759841098,4810,624,-3961,1473,0.07730458244155936,0.011006100329967178,-0.08831068277152654,-5896,8771,-0.10646442759118813,0.1656152652130859
6022,26005,Allegan,Michigan,2012,20806,31123,766,52695,0.3948382199449663,0.5906252965176961,0.014536483537337509,-3359,-388,1062,-2685,-0.041510642460234115,-0.006301364061073471,0.04781200652130757,-10317,-4421,-0.1957870765727298,-0.08932264898154169
6023,26005,Allegan,Michigan,2016,18050,34183,3887,56120,0.32163221667854597,0.6091054882394868,0.06926229508196721,-2756,3121,3060,3425,-0.07320600326642035,0.0547258115446297,0.018480191721790717,-16133,-5816,-0.2874732715609409,-0.09168619498821107
6024,26007,Alpena,Michigan,2000,7053,6769,310,14132,0.49908010189640534,0.4789838664024908,0.021936031701103878,0,0,0,0,0.0,0.0,0.0,284,0,0.020096235493914538,0.0
6025,26007,Alpena,Michigan,2004,7407,7665,139,15211,0.48695023338373544,0.5039116428900138,0.00913812372625074,354,-171,896,1079,-0.012129868512669895,-0.012797907974853138,0.02492777648752298,-258,-542,-0.016961409506278335,-0.037057645000192874
6026,26007,Alpena,Michigan,2008,7705,7125,294,15124,0.5094551705897911,0.47110552763819097,0.019439301772017983,298,155,-540,-87,0.02250493720605562,0.010301178045767244,-0.03280611525182281,580,838,0.038349642951600094,0.05531105245787843
6027,26007,Alpena,Michigan,2012,6549,7298,244,14091,0.46476474345326807,0.5179192392307146,0.017316017316017316,-1156,-50,173,-1033,-0.04469042713652299,-0.0021232844560006674,0.04681371159252362,-749,-1329,-0.05315449577744652,-0.09150413872904661
6028,26007,Alpena,Michigan,2016,4877,9090,801,14768,0.3302410617551463,0.6155200433369448,0.054238894907908994,-1672,557,1792,677,-0.1345236816981218,0.03692287759189168,0.09760080410623018,-4213,-3464,-0.2852789815817985,-0.23212448580435197
6029,26009,Antrim,Michigan,2000,4329,6780,398,11507,0.3762057877813505,0.5892065699139654,0.034587642304684106,0,0,0,0,0.0,0.0,0.0,-2451,0,-0.21300078213261486,0.0
6030,26009,Antrim,Michigan,2004,5072,8379,168,13619,0.37242088259049855,0.6152434099419928,0.012335707467508627,743,-230,1599,2112,-0.0037849051908519504,-0.02225193483717548,0.02603684002802742,-3307,-856,-0.24282252735149423,-0.02982174521887937
6031,26009,Antrim,Michigan,2008,6079,7506,267,13852,0.43885359514871497,0.5418712099335836,0.019275194917701414,1007,99,-873,233,0.06643271255821642,0.006939487450192787,-0.07337220000840916,-1427,1880,-0.10301761478486865,0.13980491256662558
6032,26009,Antrim,Michigan,2012,5107,7917,160,13184,0.3873634708737864,0.6005006067961165,0.012135922330097087,-972,-107,411,-668,-0.05149012427492855,-0.007139272587604327,0.05862939686253288,-2810,-1383,-0.21313713592233008,-0.11011952113746143
6033,26009,Antrim,Michigan,2016,4448,8469,750,13667,0.32545547669569036,0.6196678129801713,0.054876710324138434,-659,590,552,483,-0.06190799417809606,0.042740787994041345,0.019167206184054764,-4021,-1211,-0.2942123362844809,-0.08107520036215082
6034,26011,Arenac,Michigan,2000,3685,3421,161,7267,0.5070868308793175,0.4707582220999037,0.022154947020778862,0,0,0,0,0.0,0.0,0.0,264,0,0.036328608779413796,0.0
6035,26011,Arenac,Michigan,2004,4076,4071,69,8216,0.4961051606621227,0.4954965920155794,0.008398247322297955,391,-92,650,949,-0.010981670217194817,-0.013756699698480907,0.024738369915675684,5,-259,0.0006085686465432949,-0.0357200401328705
6036,26011,Arenac,Michigan,2008,4155,3807,166,8128,0.5111958661417323,0.468380905511811,0.02042322834645669,79,97,-264,-88,0.015090705479609612,0.012024981024158736,-0.027115686503768388,348,343,0.042814960629921295,0.042206391983378
6037,26011,Arenac,Michigan,2012,3669,4057,103,7829,0.4686422276152765,0.5182015583088517,0.01315621407587176,-486,-63,250,-299,-0.04255363852645577,-0.007267014270584932,0.04982065279704073,-388,-736,-0.04955933069357521,-0.0923742913234965
6038,26011,Arenac,Michigan,2016,2384,4950,395,7729,0.30844869970241945,0.6404450769827921,0.05110622331478846,-1285,292,893,-100,-0.16019352791285707,0.0379500092389167,0.12224351867394034,-2566,-2178,-0.3319963772803726,-0.2824370465867974
6039,26013,Baraga,Michigan,2000,1400,1836,157,3393,0.412614205717654,0.5411140583554377,0.04627173592690834,0,0,0,0,0.0,0.0,0.0,-436,0,-0.12849985263778368,0.0
6040,26013,Baraga,Michigan,2004,1660,1977,47,3684,0.4505971769815418,0.5366449511400652,0.012757871878393051,260,-110,141,291,0.03798297126388778,-0.03351386404851529,-0.004469107215372525,-317,119,-0.08604777415852338,0.0424520784792603
6041,26013,Baraga,Michigan,2008,1725,1846,82,3653,0.4722146181220914,0.505338078291815,0.022447303586093623,65,35,-131,-31,0.021617441140549642,0.009689431707700572,-0.03130687284825018,-121,196,-0.03312346016972356,0.05292431398879982
6042,26013,Baraga,Michigan,2012,1574,1866,50,3490,0.4510028653295129,0.5346704871060172,0.014326647564469915,-151,-32,20,-163,-0.02121175279257853,-0.008120656021623708,0.029332408814202182,-292,-171,-0.08366762177650428,-0.05054416160678071
6043,26013,Baraga,Michigan,2016,1156,2158,204,3518,0.328595793064241,0.6134167140420693,0.057987492893689596,-418,154,292,28,-0.12240707226527187,0.04366084532921968,0.07874622693605215,-1002,-710,-0.2848209209778283,-0.20115329920132402
6044,26015,Barry,Michigan,2000,9769,15716,759,26244,0.37223746380124983,0.5988416399939034,0.02892089620484682,0,0,0,0,0.0,0.0,0.0,-5947,0,-0.22660417619265355,0.0
6045,26015,Barry,Michigan,2004,11312,18638,322,30272,0.3736786469344609,0.6156844608879493,0.010636892177589853,1543,-437,2922,4028,0.0014411831332110658,-0.018284004027256967,0.016842820894045873,-7326,-1379,-0.24200581395348836,-0.015401637760834808
6046,26015,Barry,Michigan,2008,13449,16431,749,30629,0.43909366939828265,0.5364523817297333,0.024453948871984068,2137,427,-2207,357,0.06541502246382175,0.013817056694394215,-0.07923207915821595,-2982,4344,-0.09735871233145066,0.1446471016220377
6047,26015,Barry,Michigan,2012,11491,16655,441,28587,0.40196592856892993,0.5826074789239865,0.01542659250708364,-1958,-308,224,-2042,-0.03712774082935272,-0.009027356364900428,0.04615509719425315,-5164,-2182,-0.18064155035505652,-0.08328283802360587
6048,26015,Barry,Michigan,2016,9114,19202,2201,30517,0.2986532096864043,0.6292230560015729,0.0721237343120228,-2377,1760,2547,1930,-0.10331271888252563,0.05669714180493916,0.046615577077586456,-10088,-4924,-0.3305698463151686,-0.1499282959601121
6049,26017,Bay,Michigan,2000,28251,22150,1235,51636,0.5471182895654195,0.4289642884809048,0.02391742195367573,0,0,0,0,0.0,0.0,0.0,6101,0,0.11815400108451474,0.0
6050,26017,Bay,Michigan,2004,31049,25448,562,57059,0.5441560490019103,0.4459944969242363,0.00984945407385338,2798,-673,3298,5423,-0.002962240563509244,-0.01406796787982235,0.01703020844333153,5601,-500,0.09816155207767396,-0.019992449006840773
6051,26017,Bay,Michigan,2008,32589,23795,1204,57588,0.5658991456553448,0.4131937209140793,0.020907133430575816,1540,642,-1653,529,0.021743096653434546,0.011057679356722435,-0.03280077601015702,8794,3193,0.15270542474126553,0.054543872663591564
6052,26017,Bay,Michigan,2012,27877,24911,763,53551,0.5205691770461803,0.4651827230117085,0.014248099942111259,-4712,-441,1116,-4037,-0.045329968609164495,-0.006659033488464557,0.05198900209762919,2966,-5828,0.055386454034471844,-0.09731897070679368
6053,26017,Bay,Michigan,2016,21642,28328,3304,53274,0.40623944137853363,0.5317415624882682,0.06201899613319818,-6235,2541,3417,-277,-0.1143297356676467,0.047770896191086924,0.06655883947655972,-6686,-9652,-0.12550212110973458,-0.18088857514420642
6054,26019,Benzie,Michigan,2000,3546,4172,354,8072,0.4392963330029732,0.5168483647175421,0.043855302279484636,0,0,0,0,0.0,0.0,0.0,-626,0,-0.07755203171456893,0.0
6055,26019,Benzie,Michigan,2004,4383,5284,111,9778,0.4482511761096339,0.5403968091634281,0.011352014726938024,837,-243,1112,1706,0.00895484310666067,-0.03250328755254661,0.023548444445885997,-901,-275,-0.09214563305379425,-0.014593601339225326
6056,26019,Benzie,Michigan,2008,5451,4687,171,10309,0.5287612765544669,0.4546512755844408,0.016587447861092248,1068,60,-597,531,0.08051010044483303,0.005235433134154224,-0.08574553357898734,764,1665,0.07411000097002612,0.16625563402382038
6057,26019,Benzie,Michigan,2012,4685,5075,93,9853,0.4754896985689638,0.515071551811631,0.009438749619405258,-766,-78,388,-456,-0.05327157798550314,-0.00714869824168699,0.060420276227190206,-390,-1154,-0.03958185324266722,-0.11369185421269334
6058,26019,Benzie,Michigan,2016,4108,5539,581,10228,0.40164254986312087,0.54155260070395,0.05680484943292921,-577,488,464,375,-0.07384714870584291,0.04736609981352395,0.026481048892318948,-1431,-1041,-0.13991005084082908,-0.10032819759816186
6059,26021,Berrien,Michigan,2000,28152,35689,1400,65241,0.4315077941785074,0.5470333072760993,0.021458898545393235,0,0,0,0,0.0,0.0,0.0,-7537,0,-0.11552551309759196,0.0
6060,26021,Berrien,Michigan,2004,32846,41076,749,74671,0.43987625718150286,0.5500930749554713,0.010030667863025807,4694,-651,5387,9430,0.008368463002995485,-0.011428230682367427,0.003059767679371994,-8230,-693,-0.11021681777396847,0.005308695323623491
6061,26021,Berrien,Michigan,2008,40381,36130,1323,77834,0.5188092607343834,0.4641930261839299,0.016997713081686665,7535,574,-4946,3163,0.07893300355288052,0.006967045218660858,-0.08590004877154145,4251,12481,0.0546162345504535,0.16483305232442197
6062,26021,Berrien,Michigan,2012,33465,38209,913,72587,0.46103296733574883,0.5263890228277791,0.012578009836472096,-6916,-410,2079,-5247,-0.05777629339863455,-0.00441970324521457,0.06219599664384923,-4744,-8995,-0.06535605549203027,-0.11997229004248378
6063,26021,Berrien,Michigan,2016,29495,38647,3889,72031,0.40947647540642224,0.536532881675945,0.053990642917632684,-3970,2976,438,-556,-0.0515564919293266,0.04141263308116059,0.010143858848165932,-9152,-4408,-0.1270564062695228,-0.06170035077749253
6064,26023,Branch,Michigan,2000,6691,8743,349,15783,0.4239371475638345,0.5539504530190712,0.022112399417094343,0,0,0,0,0.0,0.0,0.0,-2052,0,-0.1300133054552367,0.0
6065,26023,Branch,Michigan,2004,7004,10784,179,17967,0.38982579172928145,0.6002114988590194,0.009962709411699227,313,-170,2041,2184,-0.03411135583455305,-0.012149690005395116,0.04626104583994817,-3780,-1728,-0.21038570712973792,-0.08037240167450121
6066,26023,Branch,Michigan,2008,8413,9534,338,18285,0.46010391030899644,0.521410992616899,0.018485097074104458,1409,159,-1250,318,0.070278118579715,0.00852238766240523,-0.07880050624212032,-1121,2659,-0.061307082307902605,0.14907862482183531
6067,26023,Branch,Michigan,2012,6913,10035,182,17130,0.4035610040863981,0.5858143607705779,0.010624635143023935,-1500,-156,501,-1155,-0.05654290622259833,-0.007860461931080523,0.06440336815367886,-3122,-2001,-0.1822533566841798,-0.1209462743762772
6068,26023,Branch,Michigan,2016,5061,11786,816,17663,0.28653116684594915,0.6672705655890845,0.04619826756496631,-1852,634,1751,533,-0.11702983724044896,0.03557363242194238,0.08145620481850657,-6725,-3603,-0.38073939874313534,-0.19848604205895554
6069,26025,Calhoun,Michigan,2000,27312,26291,1477,55080,0.4958605664488017,0.4773238925199709,0.026815541031227307,0,0,0,0,0.0,0.0,0.0,1021,0,0.018536673928830794,0.0
6070,26025,Calhoun,Michigan,2004,29891,32093,683,62667,0.4769815054175244,0.5121196163850192,0.010898878197456396,2579,-794,5802,7587,-0.018879061031277344,-0.01591666283377091,0.03479572386504831,-2202,-3223,-0.03513811096749486,-0.053674784896325656
6071,26025,Calhoun,Michigan,2008,34561,28553,1082,64196,0.5383668764408998,0.4447784908717054,0.016854632687394854,4670,399,-3540,1529,0.06138537102337538,0.0059557544899384585,-0.06734112551331384,6008,8210,0.09358838556919435,0.12872649653668922
6072,26025,Calhoun,Michigan,2012,29267,28333,624,58224,0.5026621324539708,0.4866206375377851,0.010717230008244023,-5294,-458,-220,-5972,-0.03570474398692891,-0.006137402679150831,0.041842146666079716,934,-5074,0.016041494916185728,-0.07754689065300863
6073,26025,Calhoun,Michigan,2016,24157,31494,3251,58902,0.4101218973888832,0.5346847305694203,0.05519337204169638,-5110,2627,3161,678,-0.09254023506508763,0.044476142033452355,0.048064093031635224,-7337,-8271,-0.12456283318053712,-0.14060432809672285
6074,26027,Cass,Michigan,2000,8808,10545,472,19825,0.4442875157629256,0.5319041614123581,0.023808322824716267,0,0,0,0,0.0,0.0,0.0,-1737,0,-0.0876166456494325,0.0
6075,26027,Cass,Michigan,2004,9537,12964,196,22697,0.4201876900030841,0.5711768075076001,0.008635502489315768,729,-276,2419,2872,-0.024099825759841487,-0.015172820335400499,0.03927264609524206,-3427,-1690,-0.15098911750451605,-0.06337247185508355
6076,26027,Cass,Michigan,2008,12083,11114,379,23576,0.5125127248048863,0.4714116050220563,0.016075670173057346,2546,183,-1850,879,0.09232503480180221,0.007440167683741578,-0.09976520248554382,969,4396,0.04110111978282999,0.19209023728734603
6077,26027,Cass,Michigan,2012,9591,12659,213,22463,0.4269687931264746,0.563548947157548,0.009482259715977385,-2492,-166,1545,-1113,-0.08554393167841168,-0.006593410457079962,0.09213734213549168,-3068,-4037,-0.13658015403107338,-0.17768127381390336
6078,26027,Cass,Michigan,2016,7270,14243,1082,22595,0.32175260013277274,0.6303606992697499,0.047886700597477315,-2321,869,1584,132,-0.10521619299370188,0.03840444088149993,0.06681175211220192,-6973,-3905,-0.3086080991369772,-0.1720279451059038
6079,26029,Charlevoix,Michigan,2000,4958,7018,511,12487,0.39705293505245454,0.5620245054857052,0.04092255946184031,0,0,0,0,0.0,0.0,0.0,-2060,0,-0.1649715704332506,0.0
6080,26029,Charlevoix,Michigan,2004,5729,8214,196,14139,0.4051913148030271,0.5809463186929769,0.013862366503996039,771,-315,1196,1652,0.008138379750572577,-0.027060192957844273,0.01892181320727171,-2485,-425,-0.17575500388994975,-0.010783433456699132
6081,26029,Charlevoix,Michigan,2008,6817,7306,275,14398,0.4734685372968468,0.5074315877205168,0.01909987498263648,1088,79,-908,259,0.06827722249381968,0.00523750847864044,-0.07351473097246009,-489,1996,-0.03396305042366998,0.14179195346627976
6082,26029,Charlevoix,Michigan,2012,5939,8000,166,14105,0.42105636299184684,0.5671747607231479,0.011768876285005317,-878,-109,694,-293,-0.05241217430499995,-0.007330998697631161,0.0597431730026311,-2061,-1572,-0.14611839773130103,-0.11215534730763105
6083,26029,Charlevoix,Michigan,2016,5137,8674,843,14654,0.35055275010236114,0.5919202948000546,0.05752695509758428,-802,677,674,549,-0.0705036128894857,0.04575807881257896,0.024745534076906717,-3537,-1476,-0.24136754469769345,-0.09524914696639242
6084,26031,Cheboygan,Michigan,2000,5484,6815,318,12617,0.43465166045811204,0.5401442498216692,0.02520408972021875,0,0,0,0,0.0,0.0,0.0,-1331,0,-0.10549258936355715,0.0
6085,26031,Cheboygan,Michigan,2004,5941,7798,148,13887,0.4278101821847771,0.5615323684021026,0.010657449413120185,457,-170,983,1270,-0.006841478273334922,-0.014546640307098567,0.021388118580433435,-1857,-526,-0.1337221862173255,-0.028229596853768357
6086,26031,Cheboygan,Michigan,2008,6720,6920,261,13901,0.4834184591036616,0.49780591324365153,0.018775627652686856,779,113,-878,14,0.05560827691888448,0.00811817823956667,-0.0637264551584511,-200,1657,-0.01438745413998993,0.11933473207733558
6087,26031,Cheboygan,Michigan,2012,5831,7286,214,13331,0.4374015452704223,0.5465456454879604,0.016052809241617283,-889,-47,366,-570,-0.046016913833239304,-0.0027228184110695726,0.04873973224430883,-1455,-1255,-0.10914410021753806,-0.09475664607754813
6088,26031,Cheboygan,Michigan,2016,4302,8683,687,13672,0.3146576945582212,0.6350936220011703,0.050248683440608545,-1529,473,1397,341,-0.12274385071220112,0.03419587419899126,0.08854797651320989,-4381,-2926,-0.3204359274429491,-0.211291827225411
6089,26033,Chippewa,Michigan,2000,6370,7526,458,14354,0.44377873763410897,0.524313780130974,0.031907482234917094,0,0,0,0,0.0,0.0,0.0,-1156,0,-0.080535042496865,0.0
6090,26033,Chippewa,Michigan,2004,7203,9122,163,16488,0.436863173216885,0.5532508491023775,0.009885977680737505,833,-295,1596,2134,-0.006915564417223963,-0.02202150455417959,0.02893706897140358,-1919,-763,-0.11638767588549254,-0.03585263338862754
6091,26033,Chippewa,Michigan,2008,8184,8267,257,16708,0.4898252334211156,0.49479291357433564,0.01538185300454872,981,94,-855,220,0.05296206020423061,0.005495875323811215,-0.058457935528041904,-83,1836,-0.004967680153220022,0.11141999573227251
6092,26033,Chippewa,Michigan,2012,7100,8278,282,15660,0.45338441890166026,0.5286079182630907,0.01800766283524904,-1084,25,11,-1048,-0.036440814519455356,0.002625809830700321,0.03381500468875509,-1178,-1095,-0.07522349936143047,-0.07025581920821045
6093,26033,Chippewa,Michigan,2016,5379,9122,1051,15552,0.34587191358024694,0.586548353909465,0.06757973251028807,-1721,769,844,-108,-0.10751250532141332,0.04957206967503902,0.0579404356463743,-3743,-2565,-0.2406764403292181,-0.16545294096778762
6094,26035,Clare,Michigan,2000,6287,5937,383,12607,0.4986912032997541,0.4709288490521139,0.03037994764813199,0,0,0,0,0.0,0.0,0.0,350,0,0.027762354247640175,0.0
6095,26035,Clare,Michigan,2004,6984,7088,154,14226,0.490932096161957,0.4982426542949529,0.010825249543090117,697,-229,1151,1619,-0.007759107137797094,-0.019554698105041873,0.027313805242838995,-104,-454,-0.007310558132995915,-0.03507291238063609
6096,26035,Clare,Michigan,2008,7496,6793,316,14605,0.51324888736734,0.4651146867511126,0.021636425881547416,512,162,-295,379,0.02231679120538299,0.010811176338457299,-0.033127967543840287,703,807,0.04813420061622736,0.05544475874922328
6097,26035,Clare,Michigan,2012,6338,6988,198,13524,0.4686483288967761,0.5167110322389825,0.014640638864241348,-1158,-118,195,-1081,-0.04460055847056388,-0.006995787017306068,0.0515963454878699,-650,-1353,-0.048062703342206414,-0.09619690395843378
6098,26035,Clare,Michigan,2016,4249,8505,695,13449,0.31593427020596326,0.632389025206335,0.05167670458770169,-2089,497,1517,-75,-0.15271405869081284,0.03703606572346034,0.11567799296735248,-4256,-3606,-0.31645475500037173,-0.2683920516581653
6099,26037,Clinton,Michigan,2000,13394,18054,751,32199,0.4159756514177459,0.560700642877108,0.023323705705146122,0,0,0,0,0.0,0.0,0.0,-4660,0,-0.14472499145936207,0.0
6100,26037,Clinton,Michigan,2004,15483,21989,335,37807,0.4095273362075806,0.5816118708175735,0.008860792974845927,2089,-416,3935,5608,-0.006448315210165312,-0.014462912730300195,0.020911227940465515,-6506,-1846,-0.1720845346099929,-0.027359543150630827
6101,26037,Clinton,Michigan,2008,20005,19726,650,40381,0.4954062554171516,0.4884970654515738,0.01609667913127461,4522,315,-2263,2574,0.08587891920957103,0.007235886156428681,-0.0931148053659997,279,6785,0.006909189965577822,0.17899372457557072
6102,26037,Clinton,Michigan,2012,18191,20650,308,39149,0.4646606554445835,0.5274719660783161,0.007867378477100308,-1814,-342,924,-1232,-0.030745599972568094,-0.0082293006541743,0.03897490062674236,-2459,-2738,-0.06281131063373263,-0.06972050059931045
6103,26037,Clinton,Michigan,2016,16492,21636,2809,40937,0.40286293573051274,0.5285194322984097,0.06861763197107751,-1699,2501,986,1788,-0.061797719714070776,0.0607502534939772,0.0010474662200935514,-5144,-2685,-0.12565649656789696,-0.06284518593416433
6104,26039,Crawford,Michigan,2000,2790,3345,229,6364,0.43840351979886866,0.52561282212445,0.03598365807668133,0,0,0,0,0.0,0.0,0.0,-555,0,-0.08720930232558138,0.0
6105,26039,Crawford,Michigan,2004,3126,4017,92,7235,0.43206634416033174,0.5552176917760885,0.01271596406357982,336,-137,672,871,-0.006337175638536918,-0.02326769401310151,0.029604869651638444,-891,-336,-0.12315134761575675,-0.03594204529017536
6106,26039,Crawford,Michigan,2008,3441,3561,176,7178,0.4793814432989691,0.49609919197548064,0.024519364725550292,315,84,-456,-57,0.04731509913863735,0.011803400661970472,-0.05911849980060785,-120,771,-0.016717748676511546,0.1064335989392452
6107,26039,Crawford,Michigan,2012,2994,3744,76,6814,0.4393894922218961,0.5494570002935134,0.011153507484590548,-447,-100,183,-364,-0.039991951077072985,-0.013365857240959744,0.05335780831803277,-750,-630,-0.1100675080716173,-0.09334975939510576
6108,26039,Crawford,Michigan,2016,2110,4354,380,6844,0.3082992402104033,0.636177673874927,0.055523085914669784,-884,304,610,30,-0.13109025201149282,0.044369578430079236,0.08672067358141355,-2244,-1494,-0.3278784336645237,-0.21781092559290638
6109,26041,Delta,Michigan,2000,7970,8871,475,17316,0.46026796026796024,0.5123007623007623,0.02743127743127743,0,0,0,0,0.0,0.0,0.0,-901,0,-0.05203280203280203,0.0
6110,26041,Delta,Michigan,2004,9381,9680,177,19238,0.48762865162698826,0.5031708077762761,0.009200540596735628,1411,-298,809,1922,0.027360691359028022,-0.0182307368345418,-0.009129954524486172,-299,602,-0.015542156149287834,0.036490645883514194
6111,26041,Delta,Michigan,2008,9974,8763,327,19064,0.523185060847671,0.4596621905161561,0.01715274863617289,593,150,-917,-174,0.03555640922068276,0.007952208039437263,-0.04350861726012001,1211,1510,0.06352287033151494,0.07906502648080277
6112,26041,Delta,Michigan,2012,8330,9534,260,18124,0.45961156477598764,0.5260428161553741,0.014345619068638269,-1644,-67,771,-940,-0.06357349607168339,-0.002807129567534622,0.06638062563921798,-1204,-2415,-0.06643125137938644,-0.12995412171090137
6113,26041,Delta,Michigan,2016,6436,11121,1037,18594,0.3461331612348069,0.5980961600516296,0.05577067871356352,-1894,777,1587,470,-0.11347840354118072,0.04142505964492525,0.0720533438962555,-4685,-3481,-0.25196299881682266,-0.18553174743743622
6114,26043,Dickinson,Michigan,2000,5533,6932,367,12832,0.43118765586034913,0.5402119700748129,0.028600374064837904,0,0,0,0,0.0,0.0,0.0,-1399,0,-0.10902431421446379,0.0
6115,26043,Dickinson,Michigan,2004,5650,7734,165,13549,0.4170049450143922,0.5708170344674883,0.012178020518119418,117,-202,802,717,-0.014182710845956903,-0.016422353546718484,0.030605064392675407,-2084,-685,-0.1538120894530961,-0.04478777523863231
6116,26043,Dickinson,Michigan,2008,5995,7049,267,13311,0.45037938547066336,0.5295620163774322,0.02005859815190444,345,102,-685,-238,0.03337444045627114,0.007880577633785022,-0.04125501809005616,-1054,1030,-0.0791826309067688,0.0746294585463273
6117,26043,Dickinson,Michigan,2012,4952,7688,186,12826,0.3860907531576485,0.599407453609855,0.014501793232496491,-1043,-81,639,-485,-0.06428863231301485,-0.005556804919407949,0.06984543723242287,-2736,-1682,-0.21331670045220652,-0.13413406954543772
6118,26043,Dickinson,Michigan,2016,3923,8580,729,13232,0.2964782345828295,0.648428053204353,0.05509371221281741,-1029,543,892,406,-0.089612518574819,0.04059191898032092,0.049020599594498004,-4657,-1921,-0.3519498186215235,-0.138633118169317
6119,26045,Eaton,Michigan,2000,23211,24803,1258,49272,0.47107890891378473,0.5033893489202793,0.02553174216593603,0,0,0,0,0.0,0.0,0.0,-1592,0,-0.03231044000649458,0.0
6120,26045,Eaton,Michigan,2004,25411,29781,563,55755,0.455761815083849,0.5341404358353511,0.010097749080799929,2200,-695,4978,6483,-0.015317093829935735,-0.0154339930851361,0.03075108691507178,-4370,-2778,-0.07837862075150209,-0.046068180745007514
6121,26045,Eaton,Michigan,2008,30742,25900,974,57616,0.5335670647042489,0.4495279089141905,0.01690502638156068,5331,411,-3881,1861,0.07780524962039986,0.00680727730076075,-0.08461252692116061,4842,9212,0.08403915579005838,0.16241777654156048
6122,26045,Eaton,Michigan,2012,27913,26197,602,54712,0.5101805819564263,0.47881634741921336,0.011003070624360286,-2829,-372,297,-2904,-0.023386482747822512,-0.005901955757200393,0.029288438505022885,1716,-3126,0.03136423453721299,-0.0526749212528454
6123,26045,Eaton,Michigan,2016,24938,27609,4028,56575,0.4407954043305347,0.4880070702607159,0.07119752540874945,-2975,3426,1412,1863,-0.06938517762589164,0.06019445478438916,0.009190722841502519,-2671,-4387,-0.04721166593018117,-0.07857590046739416
6124,26047,Emmet,Michigan,2000,5451,8602,658,14711,0.3705390524097614,0.5847325130854463,0.04472843450479233,0,0,0,0,0.0,0.0,0.0,-3151,0,-0.21419346067568484,0.0
6125,26047,Emmet,Michigan,2004,6846,10332,194,17372,0.3940824314989638,0.5947501726916877,0.011167395809348377,1395,-464,1730,2661,0.0235433790892024,-0.033561038695443954,0.010017659606241458,-3486,-335,-0.2006677411927239,0.01352571948296094
6126,26047,Emmet,Michigan,2008,8515,9314,320,18149,0.4691718551986335,0.5131963193564384,0.017631825444928095,1669,126,-1018,777,0.0750894236996697,0.006464429635579718,-0.08155385333524934,-799,2687,-0.044024464157804866,0.15664327703491904
6127,26047,Emmet,Michigan,2012,7225,10253,250,17728,0.40754738267148016,0.5783506317689531,0.014101985559566786,-1290,-70,939,-421,-0.06162447252715336,-0.0035298398853613085,0.06515431241251468,-3028,-2229,-0.1708032490974729,-0.12677878493966804
6128,26047,Emmet,Michigan,2016,6972,10616,1406,18994,0.36706328314204484,0.5589133410550701,0.07402337580288512,-253,1156,363,1266,-0.040484099529435325,0.059921390243318336,-0.019437290713883004,-3644,-616,-0.19185005791302523,-0.02104680881555232
6129,26049,Genesee,Michigan,2000,119833,66641,4391,190865,0.6278416681947974,0.34915254237288135,0.023005789432321275,0,0,0,0,0.0,0.0,0.0,53192,0,0.278689125821916,0.0
6130,26049,Genesee,Michigan,2004,128334,83870,1571,213775,0.6003227692667524,0.3923283826453046,0.0073488480879429306,8501,-2820,17229,22910,-0.027518898928044933,-0.015656941344378346,0.04317584027242327,44464,-8728,0.2079943866214478,-0.0706947392004682
6131,26049,Genesee,Michigan,2008,143927,72451,4117,220495,0.6527449602031792,0.3285834145899,0.01867162520692079,15593,2546,-11419,6720,0.05242219093642675,0.01132277711897786,-0.06374496805540464,71476,27012,0.3241615456132792,0.11616715899183139
6132,26049,Genesee,Michigan,2012,128978,71808,2733,203519,0.6337393560306409,0.3528319223266624,0.013428721642696751,-14949,-1384,-643,-16976,-0.01900560417253827,-0.005242903564224039,0.024248507736762404,57170,-14306,0.2809074337039785,-0.043254111909300674
6133,26049,Genesee,Michigan,2016,102751,84175,10715,197641,0.5198870679666668,0.4258984724829362,0.05421445955039693,-26227,7982,12367,-5878,-0.11385228806397407,0.04078573790770018,0.07306655015627384,18576,-38594,0.09398859548373062,-0.1869188382202479
6134,26051,Gladwin,Michigan,2000,5573,5743,313,11629,0.4792329521025024,0.49385157795167256,0.026915469945825093,0,0,0,0,0.0,0.0,0.0,-170,0,-0.014618625849170175,0.0
6135,26051,Gladwin,Michigan,2004,6343,6770,114,13227,0.47954940651697286,0.5118318590761322,0.008618734406894988,770,-199,1027,1598,0.0003164544144704795,-0.018296735538930103,0.017980281124459596,-427,-257,-0.03228245255915929,-0.017663826709989117
6136,26051,Gladwin,Michigan,2008,6590,6391,260,13241,0.4976965485990484,0.4826674722452987,0.019635979155652895,247,146,-379,14,0.018147142082075518,0.011017244748757907,-0.029164386830833444,199,626,0.01502907635374967,0.04731152891290896
6137,26051,Gladwin,Michigan,2012,5760,6661,131,12552,0.4588910133843212,0.5306724028043339,0.010436583811344805,-830,-129,270,-689,-0.03880553521472718,-0.00919939534430809,0.04800493055903521,-901,-1100,-0.07178138942001272,-0.08681046577376239
6138,26051,Gladwin,Michigan,2016,3794,8124,624,12542,0.30250358794450644,0.6477435815659385,0.049752830489555096,-1966,493,1463,-10,-0.15638742543981476,0.03931624667821029,0.11707117876160456,-4330,-3429,-0.34523999362143204,-0.2734586042014193
6139,26053,Gogebic,Michigan,2000,4066,3929,344,8339,0.4875884398608946,0.4711596114642043,0.04125194867490107,0,0,0,0,0.0,0.0,0.0,137,0,0.016428828396690298,0.0
6140,26053,Gogebic,Michigan,2004,4421,3935,96,8452,0.5230714623757691,0.46557027922385236,0.011358258400378608,355,-248,6,113,0.03548302251487445,-0.02989369027452246,-0.005589332240351963,486,349,0.05750118315191671,0.041072354755226415
6141,26053,Gogebic,Michigan,2008,4757,3330,194,8281,0.5744475304914866,0.40212534718029225,0.02342712232822123,336,98,-605,-171,0.05137606811571749,0.012068863927842621,-0.06344493204356011,1427,941,0.1723221833111943,0.1148210001592776
6142,26053,Gogebic,Michigan,2012,4058,3444,111,7613,0.5330355970051228,0.4523840798633916,0.014580323131485617,-699,-83,114,-668,-0.04141193348636374,-0.008846799196735613,0.05025873268309933,614,-813,0.08065151714173124,-0.09167066616946307
6143,26053,Gogebic,Michigan,2016,2925,4018,440,7383,0.3961804144656644,0.5442232154950563,0.05959637003927942,-1133,329,574,-230,-0.13685518253945844,0.0450160469077938,0.09183913563166468,-1093,-1707,-0.14804280102939188,-0.22869431817112312
6144,26055,Grand Traverse,Michigan,2000,14371,22358,1500,38229,0.37591880509560804,0.5848439666221978,0.03923722828219415,0,0,0,0,0.0,0.0,0.0,-7987,0,-0.2089251615265898,0.0
6145,26055,Grand Traverse,Michigan,2004,18256,27446,489,46191,0.3952285077179537,0.594185014396744,0.010586477885302332,3885,-1011,5088,7962,0.01930970262234566,-0.028650750396891817,0.00934104777454614,-9190,-1203,-0.19895650667879028,0.009968654847799518
6146,26055,Grand Traverse,Michigan,2008,23258,24716,869,48843,0.47617877689740595,0.5060295231660626,0.017791699936531336,5002,380,-2730,2652,0.08095026917945225,0.007205222051229004,-0.08815549123068134,-1458,7732,-0.02985074626865669,0.1691057604101336
6147,26055,Grand Traverse,Michigan,2012,20875,26534,692,48101,0.43398266148312925,0.5516309432236336,0.014386395293237146,-2383,-177,1818,-742,-0.0421961154142767,-0.00340530464329419,0.04560142005757095,-5659,-4201,-0.11764828174050435,-0.08779753547184765
6148,26055,Grand Traverse,Michigan,2016,20965,27413,3607,51985,0.4032894104068481,0.527325189958642,0.06938539963450996,90,2915,879,3884,-0.030693251076281125,0.05499900434127281,-0.024305753264991625,-6448,-789,-0.12403577955179385,-0.0063874978112895
6149,26057,Gratiot,Michigan,2000,6538,8312,329,15179,0.4307266618354305,0.5475986560379472,0.021674682126622307,0,0,0,0,0.0,0.0,0.0,-1774,0,-0.1168719942025167,0.0
6150,26057,Gratiot,Michigan,2004,7377,9834,168,17379,0.4244778180562748,0.5658553426549283,0.009666839288796823,839,-161,1522,2200,-0.006248843779155688,-0.012007842837825484,0.0182566866169811,-2457,-683,-0.1413775245986535,-0.024505530396136788
6151,26057,Gratiot,Michigan,2008,9105,8322,311,17738,0.5133047694215808,0.46916225053557337,0.01753298004284587,1728,143,-1512,359,0.08882695136530594,0.007866140754049046,-0.09669309211935495,783,3240,0.0441425188860074,0.1855200434846609
6152,26057,Gratiot,Michigan,2012,7610,8241,169,16020,0.47503121098626716,0.5144194756554307,0.010549313358302122,-1495,-142,-81,-1718,-0.038273558435313604,-0.0069836666845437476,0.0452572251198573,-631,-1414,-0.03938826466916351,-0.0835307835551709
6153,26057,Gratiot,Michigan,2016,5666,9880,919,16465,0.34412389918007896,0.6000607348921956,0.05581536592772548,-1944,750,1639,445,-0.1309073118061882,0.04526605256942336,0.08564125923676491,-4214,-3583,-0.2559368357121166,-0.2165485710429531
6154,26059,Hillsdale,Michigan,2000,6495,10483,495,17473,0.37171636238768385,0.5999542150746867,0.028329422537629486,0,0,0,0,0.0,0.0,0.0,-3988,0,-0.22823785268700286,0.0
6155,26059,Hillsdale,Michigan,2004,7123,12804,289,20216,0.35234467748318166,0.6333597150771666,0.014295607439651761,628,-206,2321,2743,-0.019371684904502195,-0.014033815097977725,0.03340550000247988,-5681,-1693,-0.28101503759398494,-0.05277718490698208
6156,26059,Hillsdale,Michigan,2008,8765,11221,463,20449,0.42862731673920484,0.5487309892904298,0.0226416939703653,1642,174,-1583,233,0.07628263925602319,0.008346086530713538,-0.08462872578673675,-2456,3225,-0.120103672551225,0.16091136504275994
6157,26059,Hillsdale,Michigan,2012,7106,11727,248,19081,0.3724123473612494,0.6145904302709502,0.01299722236780043,-1659,-215,506,-1368,-0.05621496937795545,-0.00964447160256487,0.06585944098052032,-4621,-2165,-0.24217808290970078,-0.12207441035847577
6158,26059,Hillsdale,Michigan,2016,4799,14095,1046,19940,0.24067201604814442,0.7068706118355065,0.05245737211634905,-2307,798,2368,859,-0.13174033131310497,0.03946014974854862,0.09228018156455631,-9296,-4675,-0.46619859578736206,-0.22402051287766128
6159,26061,Houghton,Michigan,2000,5688,7895,633,14216,0.4001125492402926,0.5553601575689364,0.044527293190770964,0,0,0,0,0.0,0.0,0.0,-2207,0,-0.15524760832864382,0.0
6160,26061,Houghton,Michigan,2004,6731,8889,231,15851,0.4246419784240742,0.5607848085294304,0.01457321304649549,1043,-402,994,1635,0.024529429183781593,-0.029954080144275474,0.0054246509604939375,-2158,49,-0.13614283010535616,0.019104778223287655
6161,26061,Houghton,Michigan,2008,7476,8101,395,15972,0.46806912096168296,0.5072001001753068,0.02473077886301027,745,164,-788,121,0.043427142537608765,0.01015756581651478,-0.053584708354123545,-625,1533,-0.03913097921362385,0.09701185089173231
6162,26061,Houghton,Michigan,2012,6801,8196,319,15316,0.4440454426743275,0.535126664925568,0.020827892400104468,-675,-76,95,-656,-0.024023678287355466,-0.0039028864629058017,0.02792656475026123,-1395,-770,-0.09108122225124055,-0.051950243037616695
6163,26061,Houghton,Michigan,2016,6018,8475,1268,15761,0.3818285641773999,0.5377196878370661,0.08045174798553391,-783,949,279,445,-0.062216878496927586,0.059623855585429444,0.0025930229114980996,-2457,-1062,-0.15589112365966623,-0.06480990140842569
6164,26063,Huron,Michigan,2000,6899,8911,285,16095,0.4286424355389873,0.553650201926064,0.017707362534948742,0,0,0,0,0.0,0.0,0.0,-2012,0,-0.12500776638707667,0.0
6165,26063,Huron,Michigan,2004,7629,9671,166,17466,0.43679148059086226,0.5537043398603,0.009504179548837742,730,-119,760,1371,0.00814904505187497,-0.008203182986111,5.4137934236031526e-05,-2042,-30,-0.11691285926943773,0.008094907117638939
6166,26063,Huron,Michigan,2008,8367,8434,334,17135,0.48829880361832506,0.49220892909250075,0.019492267289174206,738,168,-1237,-331,0.051507323027462804,0.009988087740336464,-0.06149541076779924,-67,1975,-0.003910125474175685,0.11300273379526204
6167,26063,Huron,Michigan,2012,6518,8806,154,15478,0.4211138389972865,0.5689365551104794,0.00994960589223414,-1849,-180,372,-1657,-0.06718496462103857,-0.009542661396940067,0.07672762601797861,-2288,-2221,-0.14782271611319286,-0.14391259063901718
6168,26063,Huron,Michigan,2016,4579,10692,673,15944,0.2871926743602609,0.6705970898143502,0.04221023582538886,-1939,519,1886,466,-0.13392116463702558,0.03226062993315472,0.10166053470387082,-6113,-3825,-0.38340441545408926,-0.2355816993408964
6169,26065,Ingham,Michigan,2000,69231,47314,4050,120595,0.5740785273021269,0.3923379907956383,0.03358348190223475,0,0,0,0,0.0,0.0,0.0,21917,0,0.18174053650648864,0.0
6170,26065,Ingham,Michigan,2004,76877,54734,1442,133053,0.5777923083282601,0.41136990522573713,0.010837786446002721,7646,-2608,7420,12458,0.0037137810261331783,-0.022745695456232028,0.01903191443009883,22143,226,0.166422403102523,-0.01531813340396565
6171,26065,Ingham,Michigan,2008,93994,46483,2549,143026,0.6571812118076433,0.32499685371890424,0.01782193447345238,17117,1107,-8251,9973,0.07938890347938321,0.006984148027449658,-0.08637305150683289,47511,25368,0.3321843580887391,0.1657619549862161
6172,26065,Ingham,Michigan,2012,80847,45306,1710,127863,0.6322939396072359,0.3543323713662279,0.013373689026536215,-13147,-839,-1177,-15163,-0.02488727220040743,-0.004448245446916164,0.029335517647323672,35541,-11970,0.277961568241008,-0.0542227898477311
6173,26065,Ingham,Michigan,2016,79110,43868,9157,132135,0.598705868997616,0.3319937942256026,0.06930033677678132,-1737,7447,-1438,4272,-0.03358807060961988,0.05592664775024511,-0.022338577140625315,35242,-299,0.2667120747720134,-0.011249493468994565
6174,26067,Ionia,Michigan,2000,9481,13915,574,23970,0.3955360867751356,0.580517313308302,0.02394659991656237,0,0,0,0,0.0,0.0,0.0,-4434,0,-0.18498122653316645,0.0
6175,26067,Ionia,Michigan,2004,10647,16621,350,27618,0.38550945035846185,0.6018176551524368,0.01267289448910131,1166,-224,2706,3648,-0.010026636416673729,-0.01127370542746106,0.021300341844134763,-5974,-1540,-0.21630820479397495,-0.03132697826080849
6176,26067,Ionia,Michigan,2008,12565,14156,638,27359,0.45926386198325964,0.5174165722431375,0.023319565773602835,1918,288,-2465,-259,0.07375441162479779,0.010646671284501525,-0.08440108290929926,-1591,4383,-0.05815271025987789,0.15815549453409705
6177,26067,Ionia,Michigan,2012,11018,14315,490,25823,0.42667389536459743,0.5543507725670913,0.018975332068311195,-1547,-148,159,-1536,-0.0325899666186622,-0.0043442337052916405,0.03693420032395378,-3297,-1706,-0.12767687720249388,-0.06952416694261598
6178,26067,Ionia,Michigan,2016,8352,16635,2052,27039,0.30888716298679686,0.6152224564517919,0.0758903805614113,-2666,1562,2320,1216,-0.11778673237780057,0.056915048493100105,0.060871683884700545,-8283,-4986,-0.306335293464995,-0.17865841626250112
6179,26069,Iosco,Michigan,2000,6505,6345,372,13222,0.491983058538799,0.47988201482377857,0.028134926637422477,0,0,0,0,0.0,0.0,0.0,160,0,0.01210104371502041,0.0
6180,26069,Iosco,Michigan,2004,6557,7301,148,14006,0.46815650435527634,0.5212765957446809,0.010566899900042838,52,-224,956,784,-0.02382655418352264,-0.017568026737379637,0.04139458092090231,-744,-904,-0.053120091389404545,-0.06522113510442495
6181,26069,Iosco,Michigan,2008,7309,6583,333,14225,0.5138137082601054,0.4627768014059754,0.023409490333919158,752,185,-718,219,0.04565720390482908,0.01284259043387632,-0.0584997943387055,726,1470,0.05103690685413004,0.10415699824353458
6182,26069,Iosco,Michigan,2012,6242,6909,223,13374,0.46672648422311946,0.5165993719156572,0.01667414386122327,-1067,-110,326,-851,-0.04708722403698595,-0.006735346472695889,0.05382257050968181,-667,-1393,-0.049872887692537726,-0.10090979454666776
6183,26069,Iosco,Michigan,2016,4345,8345,739,13429,0.32355350361158686,0.621416337776454,0.055030158611959194,-1897,516,1436,55,-0.1431729806115326,0.038356014750735926,0.1048169658607968,-4000,-3333,-0.29786283416486714,-0.24798994647232941
6184,26071,Iron,Michigan,2000,3014,2967,207,6188,0.4870717517776341,0.4794764059469942,0.033451842275371686,0,0,0,0,0.0,0.0,0.0,47,0,0.007595345830639921,0.0
6185,26071,Iron,Michigan,2004,3215,3224,72,6511,0.4937797573337429,0.49516203348180005,0.011058209184457072,201,-135,257,323,0.006708005556108787,-0.022393633090914612,0.015685627534805846,-9,-56,-0.0013822761480571377,-0.008977621978697059
6186,26071,Iron,Michigan,2008,3080,2947,135,6162,0.49983771502758845,0.47825381369685166,0.021908471275559883,-135,63,-277,-349,0.006057957693845539,0.01085026209110281,-0.016908219784948386,133,142,0.021583901330736788,0.022966177478793925
6187,26071,Iron,Michigan,2012,2687,3224,100,6011,0.4470138080186325,0.5363500249542505,0.01663616702711695,-393,-35,277,-151,-0.05282390700895595,-0.005272304248442931,0.05809621125739889,-537,-670,-0.08933621693561805,-0.11092011826635484
6188,26071,Iron,Michigan,2016,2004,3675,281,5960,0.33624161073825504,0.6166107382550335,0.04714765100671141,-683,181,451,-51,-0.11077219728037746,0.030511483979594457,0.080260713300783,-1671,-1134,-0.2803691275167785,-0.19103291058116045
6189,26073,Isabella,Michigan,2000,10228,10053,788,21069,0.48545256063410697,0.4771465185818026,0.03740092078409037,0,0,0,0,0.0,0.0,0.0,175,0,0.008306042052304341,0.0
6190,26073,Isabella,Michigan,2004,12334,11754,302,24390,0.5056990569905699,0.4819188191881919,0.012382123821238213,2106,-486,1701,3321,0.020246496356462973,-0.025018796962852162,0.004772300606389279,580,405,0.023780237802378035,0.015474195750073694
6191,26073,Isabella,Michigan,2008,16679,11220,511,28410,0.587082013375572,0.39493136219640973,0.017986624428018304,4345,209,-534,4020,0.08138295638500204,0.0056045006067800916,-0.08698745699178217,5459,4879,0.19215065117916225,0.1683704133767842
6192,26073,Isabella,Michigan,2012,13038,10800,422,24260,0.5374278647980214,0.4451772464962902,0.017394888705688377,-3641,-89,-420,-4150,-0.04965414857755057,-0.000591735722329928,0.05024588429988047,2238,-3221,0.0922506183017312,-0.09990003287743104
6193,26073,Isabella,Michigan,2016,11404,12338,1798,25540,0.4465152701644479,0.48308535630383714,0.07039937353171495,-1634,1376,1538,1280,-0.09091259463357348,0.05300448482602657,0.03790810980754694,-934,-3172,-0.036570086139389224,-0.12882070444112043
6194,26075,Jackson,Michigan,2000,28160,32066,1720,61946,0.4545894811610112,0.5176443999612566,0.02776611887773222,0,0,0,0,0.0,0.0,0.0,-3906,0,-0.06305491880024533,0.0
6195,26075,Jackson,Michigan,2004,31025,40029,741,71795,0.432133156905077,0.5575457900968034,0.010321052998119647,2865,-979,7963,9849,-0.022456324255934246,-0.017445065879612573,0.03990139013554683,-9004,-5098,-0.1254126331917264,-0.06235771439148108
6196,26075,Jackson,Michigan,2008,37480,35692,1507,74679,0.5018813856639751,0.47793891187616333,0.020179702459861542,6455,766,-4337,2884,0.06974822875889813,0.009858649461741895,-0.07960687822064005,1788,10792,0.02394247378781178,0.1493551069795382
6197,26075,Jackson,Michigan,2012,32301,36298,963,69562,0.4643483511112389,0.5218078836146172,0.013843765274143929,-5179,-544,606,-5117,-0.03753303455273621,-0.006335937185717613,0.04386897173845383,-3997,-5785,-0.05745953250337826,-0.08140200629119004
6198,26075,Jackson,Michigan,2016,25795,39793,4537,70125,0.367843137254902,0.5674581105169341,0.06469875222816399,-6506,3574,3495,563,-0.09650521385633692,0.050854986954020055,0.045650226902316904,-13998,-10001,-0.1996149732620321,-0.14215544075865383
6199,26077,Kalamazoo,Michigan,2000,48807,48254,3595,100656,0.48488912732474965,0.4793951676998887,0.035715704975361626,0,0,0,0,0.0,0.0,0.0,553,0,0.0054939596248609335,0.0
6200,26077,Kalamazoo,Michigan,2004,61462,57147,1174,119783,0.5131112094370653,0.4770877336516868,0.00980105691124784,12655,-2421,8893,19127,0.028222082112315694,-0.025914648064113786,-0.0023074340482019395,4315,3762,0.03602347578537857,0.030529516160517634
6201,26077,Kalamazoo,Michigan,2008,77051,51554,2456,131061,0.5879018167113024,0.39335881764979663,0.01873936563890097,15589,1282,-5593,11278,0.07479060727423703,0.008938308727653131,-0.08372891600189014,25497,21182,0.19454299906150574,0.15851952327612717
6202,26077,Kalamazoo,Michigan,2012,69051,52662,1687,123400,0.5595705024311183,0.4267585089141005,0.0136709886547812,-8000,-769,1108,-7661,-0.028331314280184094,-0.005068376984119771,0.033399691264303866,16389,-9108,0.13281199351701778,-0.06173100554448796
6203,26077,Kalamazoo,Michigan,2016,67148,51034,8117,126299,0.5316589996753736,0.4040728746862604,0.0642681256383661,-1903,6430,-1628,2899,-0.02791150275574472,0.05059713698358491,-0.02268563422784009,16114,-275,0.12758612498911315,-0.005225868527904631
6204,26079,Kalkaska,Michigan,2000,2774,3842,233,6849,0.40502263104102787,0.5609578040589868,0.0340195648999854,0,0,0,0,0.0,0.0,0.0,-1068,0,-0.1559351730179589,0.0
6205,26079,Kalkaska,Michigan,2004,3189,5084,107,8380,0.38054892601431983,0.6066825775656325,0.012768496420047733,415,-126,1242,1531,-0.024473705026708037,-0.021251068479937667,0.04572477350664572,-1895,-827,-0.22613365155131265,-0.07019847853335376
6206,26079,Kalkaska,Michigan,2008,3780,4527,192,8499,0.44475820684786443,0.5326509001058948,0.022590893046240734,591,85,-557,119,0.0642092808335446,0.009822396626193,-0.07403167745973771,-747,1148,-0.08789269325803034,0.1382409582932823
6207,26079,Kalkaska,Michigan,2012,3272,4901,117,8290,0.39469240048250903,0.5911942098914355,0.01411338962605549,-508,-75,374,-209,-0.0500658063653554,-0.008477503420185245,0.058543309785540676,-1629,-882,-0.19650180940892642,-0.10860911615089608
6208,26079,Kalkaska,Michigan,2016,2280,6116,437,8833,0.25812294803577496,0.6924034869240349,0.049473565040190196,-992,320,1215,543,-0.13656945244673407,0.035360175414134706,0.10120927703259941,-3836,-2207,-0.4342805388882599,-0.23777872947933348
6209,26081,Kent,Michigan,2000,95442,148602,6274,250318,0.38128300801380643,0.593652873544851,0.02506411844134261,0,0,0,0,0.0,0.0,0.0,-53160,0,-0.21236986553104453,0.0
6210,26081,Kent,Michigan,2004,116909,171201,2781,290891,0.4018996806363896,0.5885400373335716,0.009560282030038744,21467,-3493,22599,40573,0.020616672622583154,-0.015503836411303868,-0.005112836211279337,-54292,-1132,-0.18664035669718204,0.02572950883386249
6211,26081,Kent,Michigan,2008,149909,148336,5554,303799,0.49344797053314854,0.48827020497104995,0.0182818244958015,33000,2773,-22865,12908,0.09154828989675895,0.008721542465762755,-0.10026983236252168,1573,55865,0.005177765562098591,0.19181812225928063
6212,26081,Kent,Michigan,2012,133408,155925,4247,293580,0.45441787587710336,0.5311158798283262,0.014466244294570475,-16501,-1307,7589,-10219,-0.03903009465604518,-0.003815580201231024,0.04284567485727625,-22517,-24090,-0.07669800395122284,-0.08187576951332143
6213,26081,Kent,Michigan,2016,138683,148180,24031,310894,0.44607808449182035,0.47662547363410035,0.07729644187407927,5275,19784,-7745,17314,-0.008339791385283013,0.0628301975795088,-0.05449040619422585,-9497,13020,-0.03054738914228,0.046150614808942836
6214,26083,Keweenaw,Michigan,2000,540,740,63,1343,0.40208488458674607,0.5510052122114668,0.04690990320178704,0,0,0,0,0.0,0.0,0.0,-200,0,-0.14892032762472074,0.0
6215,26083,Keweenaw,Michigan,2004,630,781,28,1439,0.43780403057678946,0.5427380125086866,0.019457956914523976,90,-35,41,96,0.03571914599004339,-0.027451946287263065,-0.008267199702780226,-151,49,-0.10493398193189712,0.043986345692823614
6216,26083,Keweenaw,Michigan,2008,610,756,44,1410,0.4326241134751773,0.5361702127659574,0.031205673758865248,-20,16,-25,-29,-0.0051799171016121415,0.011747716844341272,-0.006567799742729141,-146,5,-0.10354609929078012,0.0013878826411169998
6217,26083,Keweenaw,Michigan,2012,582,774,32,1388,0.41930835734870314,0.5576368876080692,0.023054755043227664,-28,-12,18,-22,-0.013315756126474176,-0.008150918715637584,0.021466674842111733,-192,-46,-0.13832853025936603,-0.03478243096858591
6218,26083,Keweenaw,Michigan,2016,527,814,93,1434,0.36750348675034866,0.5676429567642957,0.06485355648535565,-55,61,40,46,-0.05180487059835448,0.041798801442127984,0.010006069156226483,-287,-95,-0.200139470013947,-0.06181093975458096
6219,26085,Lake,Michigan,2000,2584,1961,148,4693,0.5506072874493927,0.4178563818453015,0.03153633070530577,0,0,0,0,0.0,0.0,0.0,623,0,0.1327509056040912,0.0
6220,26085,Lake,Michigan,2004,2675,2503,68,5246,0.5099123141441098,0.47712542889820814,0.012962256957682043,91,-80,542,553,-0.04069497330528293,-0.01857407374762373,0.05926904705290664,172,-451,0.03278688524590162,-0.09996402035818958
6221,26085,Lake,Michigan,2008,2919,2269,104,5292,0.5515873015873016,0.42876039304610736,0.019652305366591082,244,36,-234,46,0.04167498744319187,0.006690048408909039,-0.04836503585210078,650,478,0.12282690854119427,0.09004002329529265
6222,26085,Lake,Michigan,2012,2752,2487,71,5310,0.5182674199623352,0.46836158192090394,0.013370998116760829,-167,-33,218,18,-0.03331988162496646,-0.006281307249830254,0.03960118887479658,265,-385,0.04990583804143123,-0.07292107049976304
6223,26085,Lake,Michigan,2016,1939,3159,260,5358,0.36188876446435236,0.589585666293393,0.048525569242254575,-813,189,672,48,-0.1563786554979828,0.03515457112549375,0.1212240843724891,-1220,-1485,-0.22769690182904068,-0.2776027398704719
6224,26087,Lapeer,Michigan,2000,15749,20351,1134,37234,0.4229736262555729,0.5465703389375303,0.03045603480689692,0,0,0,0,0.0,0.0,0.0,-4602,0,-0.12359671268195738,0.0
6225,26087,Lapeer,Michigan,2004,18086,25556,505,44147,0.4096767617278637,0.5788841823906494,0.01143905588148685,2337,-629,5205,6913,-0.013296864527709173,-0.019016978925410072,0.03231384345311916,-7470,-2868,-0.1692074206627857,-0.045610707980828336
6226,26087,Lapeer,Michigan,2008,21457,22831,1074,45362,0.4730170627397381,0.503306732507385,0.023676204752876857,3371,569,-2725,1215,0.06334030101187438,0.012237148871390007,-0.07557744988326442,-1374,6096,-0.03028966976764691,0.1389177508951388
6227,26087,Lapeer,Michigan,2012,18796,23734,513,43043,0.43667959947029716,0.5514020862858072,0.011918314243895639,-2661,-561,903,-2319,-0.03633746326944093,-0.011757890508981218,0.04809535377842222,-4938,-3564,-0.11472248681551006,-0.08443281704786315
6228,26087,Lapeer,Michigan,2016,12734,30037,2412,45183,0.2818316623508842,0.6647854281477547,0.05338290950136113,-6062,1899,6303,2140,-0.15484793711941297,0.04146459525746549,0.11338334186194743,-17303,-12365,-0.38295376579687046,-0.2682312789813604
6229,26089,Leelanau,Michigan,2000,4635,6840,534,12009,0.3859605296027979,0.5695728203847115,0.04446665001249063,0,0,0,0,0.0,0.0,0.0,-2205,0,-0.18361229078191355,0.0
6230,26089,Leelanau,Michigan,2004,6048,7733,136,13917,0.4345764173313214,0.5556513616440325,0.009772221024646116,1413,-398,893,1908,0.04861588772852349,-0.034694428987844514,-0.01392145874067896,-1685,520,-0.1210749443127111,0.06253734646920245
6231,26089,Leelanau,Michigan,2008,7355,6938,171,14464,0.508503871681416,0.47967367256637167,0.011822455752212389,1307,35,-795,547,0.07392745435009457,0.0020502347275662726,-0.07597768907766084,417,2102,0.028830199115044308,0.1499051434277554
6232,26089,Leelanau,Michigan,2012,6576,7483,148,14207,0.46287041599211654,0.5267121841345815,0.010417399873301893,-779,-23,545,-257,-0.04563345568929944,-0.0014050558789104953,0.04703851156820987,-907,-1324,-0.063841768142465,-0.09267196725750931
6233,26089,Leelanau,Michigan,2016,6774,7239,879,14892,0.4548751007252216,0.4860999194198227,0.05902497985495568,198,731,-244,685,-0.007995315266894953,0.048607579981653784,-0.04061226471475882,-465,442,-0.031224818694601142,0.03261694944786386
6234,26091,Lenawee,Michigan,2000,18365,20681,1047,40093,0.45806001047564415,0.5158257052353279,0.02611428428902801,0,0,0,0,0.0,0.0,0.0,-2316,0,-0.05776569475968374,0.0
6235,26091,Lenawee,Michigan,2004,20787,25675,550,47012,0.44216370288436996,0.5461371564706884,0.011699140644941717,2422,-497,4994,6919,-0.015896307591274195,-0.014415143644086295,0.030311451235360498,-4888,-2572,-0.10397345358631843,-0.04620775882663469
6236,26091,Lenawee,Michigan,2008,24640,22225,1000,47865,0.5147811553327065,0.46432675232424525,0.020892092343048157,3853,450,-3450,853,0.07261745244833656,0.00919295169810644,-0.08181040414644314,2415,7303,0.05045440300846127,0.1544278565947797
6237,26091,Lenawee,Michigan,2012,21776,22351,698,44825,0.48580033463469047,0.49862799776910205,0.015571667596207473,-2864,-302,126,-3040,-0.028980820698016052,-0.005320424746840684,0.0343012454448568,-575,-2990,-0.012827663134411582,-0.06328206614287285
6238,26091,Lenawee,Michigan,2016,16750,26430,3118,46298,0.361786686249946,0.5708669920946909,0.06734632165536308,-5026,2420,4079,1473,-0.12401364838474449,0.051774654059155614,0.07223899432558889,-9680,-9105,-0.20908030584474496,-0.19625264271033338
6239,26093,Livingston,Michigan,2000,28780,44637,2058,75475,0.3813183173236171,0.5914143756210666,0.02726730705531633,0,0,0,0,0.0,0.0,0.0,-15857,0,-0.21009605829744948,0.0
6240,26093,Livingston,Michigan,2004,33991,58860,891,93742,0.36260160867060653,0.6278935802521816,0.009504811077211923,5211,-1167,14223,18267,-0.01871670865301056,-0.017762495978104406,0.03647920463111498,-24869,-9012,-0.265291971581575,-0.05519591328412554
6241,26093,Livingston,Michigan,2008,42349,55592,1965,99906,0.42388845514783896,0.5564430564730847,0.01966848837907633,8358,1074,-3268,6164,0.061286846477232426,0.010163677301864408,-0.07145052377909689,-13243,11626,-0.1325546013252457,0.1327373702563293
6242,26093,Livingston,Michigan,2012,37216,60083,1076,98375,0.37830749682337994,0.6107547649301144,0.010937738246505718,-5133,-889,4491,-1531,-0.04558095832445902,-0.008730750132570613,0.054311708457029706,-22867,-9624,-0.23244726810673444,-0.09989266678148873
6243,26093,Livingston,Michigan,2016,34384,65680,6425,106489,0.3228878100085455,0.6167773197231639,0.060334870268290625,-2832,5349,5597,8114,-0.055419686814834446,0.049397132021784904,0.006022554793049473,-31296,-8429,-0.29388950971461836,-0.06144224160788392
6244,26095,Luce,Michigan,2000,956,1480,100,2536,0.37697160883280756,0.583596214511041,0.03943217665615142,0,0,0,0,0.0,0.0,0.0,-524,0,-0.20662460567823349,0.0
6245,26095,Luce,Michigan,2004,1045,1749,35,2829,0.36938847649346057,0.6182396606574762,0.012371862849063274,89,-65,269,293,-0.007583132339346987,-0.027060313807088142,0.03464344614643511,-704,-180,-0.24885118416401558,-0.042226578485782096
6246,26095,Luce,Michigan,2008,1191,1490,59,2740,0.43467153284671534,0.5437956204379562,0.021532846715328468,146,24,-259,-89,0.06528305635325476,0.009160983866265194,-0.07444404021952,-299,405,-0.10912408759124081,0.13972709657277477
6247,26095,Luce,Michigan,2012,991,1580,25,2596,0.3817411402157165,0.6086286594761171,0.00963020030816641,-200,-34,90,-144,-0.05293039263099886,-0.011902646407162059,0.06483303903816096,-589,-290,-0.22688751926040063,-0.11776343166915981
6248,26095,Luce,Michigan,2016,681,1756,154,2591,0.26283288305673486,0.6777306059436511,0.05943651099961405,-310,129,176,-5,-0.11890825715898162,0.04980631069144764,0.06910194646753398,-1075,-486,-0.41489772288691623,-0.1880102036265156
6249,26097,Mackinac,Michigan,2000,2533,3272,165,5970,0.42428810720268006,0.5480737018425461,0.02763819095477387,0,0,0,0,0.0,0.0,0.0,-739,0,-0.12378559463986605,0.0
6250,26097,Mackinac,Michigan,2004,2819,3706,74,6599,0.4271859372632217,0.561600242460979,0.011213820275799364,286,-91,434,629,0.0028978300605416174,-0.01642437067897451,0.013526540618432836,-887,-148,-0.13441430519775727,-0.010628710557891219
6251,26097,Mackinac,Michigan,2008,3027,3268,114,6409,0.47230457169605244,0.5099079419566235,0.017787486347324074,208,40,-438,-190,0.04511863443283076,0.00657366607152471,-0.05169230050435547,-241,646,-0.037603370260571034,0.09681093493718623
6252,26097,Mackinac,Michigan,2012,2652,3397,67,6116,0.43361674296926095,0.5554283845650753,0.010954872465663833,-375,-47,129,-293,-0.038687828726791496,-0.006832613881660241,0.04552044260845178,-745,-504,-0.12181164159581431,-0.08420827133524328
6253,26097,Mackinac,Michigan,2016,2085,3744,315,6144,0.33935546875,0.609375,0.05126953125,-567,248,347,28,-0.09426127421926095,0.04031465878433617,0.05394661543492474,-1659,-914,-0.27001953125,-0.1482078896541857
6254,26099,Macomb,Michigan,2000,172625,164265,8669,345559,0.49955289834731553,0.47536021345124857,0.025086888201435936,0,0,0,0,0.0,0.0,0.0,8360,0,0.024192684896066963,0.0
6255,26099,Macomb,Michigan,2004,196160,202166,4084,402410,0.4874630352128426,0.5023881116274447,0.01014885315971273,23535,-4585,37901,56851,-0.012089863134472911,-0.014938035041723205,0.027027898176196108,-6006,-14366,-0.014925076414602056,-0.03911776131066902
6256,26099,Macomb,Michigan,2008,223784,187663,8729,420176,0.5325958645900766,0.44662950763489584,0.02077462777502761,27624,4645,-14503,17766,0.04513282937723395,0.010625774615314878,-0.05575860399254884,36121,42127,0.08596635695518073,0.10089143336978279
6257,26099,Macomb,Michigan,2012,208016,191913,4929,404858,0.5137999002119261,0.474025460778841,0.012174639009232867,-15768,-3800,4250,-15318,-0.018795964378150454,-0.008599988765794741,0.027395953143945162,16103,-20018,0.03977443943308512,-0.046191917522095616
6258,26099,Macomb,Michigan,2016,176317,224665,18330,419312,0.42049118556110965,0.5357943488380967,0.04371446560079368,-31699,13401,32752,14454,-0.09330871465081647,0.031539826591560814,0.06176888805925573,-48348,-64451,-0.11530316327698709,-0.1550776027100722
6259,26101,Manistee,Michigan,2000,5639,5401,388,11428,0.4934371718585929,0.4726111305565278,0.033951697584879245,0,0,0,0,0.0,0.0,0.0,238,0,0.020826041302065113,0.0
6260,26101,Manistee,Michigan,2004,6272,6295,173,12740,0.49230769230769234,0.49411302982731553,0.013579277864992152,633,-215,894,1312,-0.0011294795509005917,-0.020372419719887094,0.021501899270787717,-23,-261,-0.0018053375196231958,-0.02263137882168831
6261,26101,Manistee,Michigan,2008,7235,5510,264,13009,0.556153432239219,0.42355292489814744,0.020293642862633562,963,91,-785,269,0.06384573993152665,0.006714364997641411,-0.07056010492916809,1725,1748,0.13260050734107154,0.13440584486069473
6262,26101,Manistee,Michigan,2012,6473,5737,182,12392,0.5223531310522918,0.46295997417688833,0.014686894770819884,-762,-82,227,-617,-0.03380030118692723,-0.005606748091813678,0.03940704927874089,736,-989,0.05939315687540342,-0.07320735046566812
6263,26101,Manistee,Michigan,2016,4979,6915,766,12660,0.39328593996840444,0.5462085308056872,0.06050552922590837,-1494,584,1178,268,-0.1290671910838873,0.045818634455088485,0.08324855662879888,-1936,-2672,-0.15292259083728277,-0.2123157477126862
6264,26103,Marquette,Michigan,2000,15503,12577,1099,29179,0.5313067617121903,0.4310291648103088,0.03766407347750094,0,0,0,0,0.0,0.0,0.0,2926,0,0.10027759690188148,0.0
6265,26103,Marquette,Michigan,2004,17412,14690,386,32488,0.5359517360256094,0.4521669539522285,0.011881310022162028,1909,-713,2113,3309,0.004644974313419148,-0.025782763455338913,0.021137789141919716,2722,-204,0.08378478207338091,-0.016492814828500568
6266,26103,Marquette,Michigan,2008,19635,12906,719,33260,0.5903487672880336,0.38803367408298256,0.021617558628983763,2223,333,-1784,772,0.054397031262424234,0.009736248606821735,-0.06413327986924594,6729,4007,0.2023150932050511,0.11853031113167017
6267,26103,Marquette,Michigan,2012,18115,13606,561,32282,0.561148627718233,0.42147326683600767,0.017378105445759247,-1520,-158,700,-978,-0.02920013956980061,-0.004239453183224516,0.033439592753025105,4509,-2220,0.13967536088222537,-0.06263973232282571
6268,26103,Marquette,Michigan,2016,16042,14646,2530,33218,0.48293094105605394,0.4409055331446806,0.07616352579926546,-2073,1969,1040,936,-0.0782176866621791,0.05878542035350621,0.019432266308672952,1396,-3113,0.042025407911373325,-0.09764995297085205
6269,26105,Mason,Michigan,2000,5579,7066,371,13016,0.42862630608481866,0.5428703134603565,0.028503380454824832,0,0,0,0,0.0,0.0,0.0,-1487,0,-0.11424400737553786,0.0
6270,26105,Mason,Michigan,2004,6333,8124,154,14611,0.43344055848333446,0.5560194374101705,0.010540004106495107,754,-217,1058,1595,0.004814252398515795,-0.017963376348329726,0.013149123949813935,-1791,-304,-0.122578878926836,-0.00833487155129814
6271,26105,Mason,Michigan,2008,7817,7147,277,15241,0.5128928547995538,0.46893248474509547,0.0181746604553507,1484,123,-977,630,0.07945229631621936,0.007634656348855594,-0.08708695266507499,670,2461,0.04396037005445835,0.16653924898129435
6272,26105,Mason,Michigan,2012,6856,7580,213,14649,0.46801829476414775,0.5174414635811319,0.014540241654720459,-961,-64,433,-592,-0.044874560035406075,-0.0036344188006302413,0.04850897883603639,-724,-1394,-0.04942316881698411,-0.09338353887144246
6273,26105,Mason,Michigan,2016,5281,8505,1006,14792,0.35701730665224446,0.574972958355868,0.0680097349918875,-1575,793,925,143,-0.11100098811190329,0.053469493337167044,0.05753149477473618,-3224,-2500,-0.21795565170362358,-0.16853248288663947
6274,26107,Mecosta,Michigan,2000,6300,8072,382,14754,0.4270028466856446,0.5471058695946862,0.025891283719669242,0,0,0,0,0.0,0.0,0.0,-1772,0,-0.12010302290904162,0.0
6275,26107,Mecosta,Michigan,2004,7730,9710,141,17581,0.4396791991354303,0.5523007792503271,0.008020021614242649,1430,-241,1638,2827,0.01267635244978571,-0.017871262105426593,0.005194909655640845,-1980,-208,-0.11262158011489676,0.007481442794144866
6276,26107,Mecosta,Michigan,2008,9101,9238,358,18697,0.48676258223244373,0.49408996095630314,0.01914745681125314,1371,217,-472,1116,0.04708338309701343,0.011127435197010493,-0.058210818294023914,-137,1843,-0.007327378723859412,0.10529420139103735
6277,26107,Mecosta,Michigan,2012,7515,9176,256,16947,0.443441317047265,0.5414527645010916,0.01510591845164336,-1586,-102,-62,-1750,-0.0433212651851787,-0.004041538359609782,0.047362803544788445,-1661,-1524,-0.09801144745382656,-0.09068406872996715
6278,26107,Mecosta,Michigan,2016,5827,10305,1127,17259,0.3376209513876818,0.5970797844602815,0.06529926415203662,-1688,871,1129,312,-0.10582036565958325,0.05019334570039326,0.05562701995918995,-4478,-2817,-0.25945883307259976,-0.1614473856187732
6279,26109,Menominee,Michigan,2000,4597,5529,308,10434,0.4405788767490895,0.5299022426682001,0.02951888058271037,0,0,0,0,0.0,0.0,0.0,-932,0,-0.08932336591911055,0.0
6280,26109,Menominee,Michigan,2004,5326,5942,151,11419,0.46641562308433315,0.5203608021718189,0.013223574743847973,729,-157,413,985,0.025836746335243632,-0.0162953058388624,-0.00954144049638117,-616,316,-0.05394517908748575,0.0353781868316248
6281,26109,Menominee,Michigan,2008,5981,4855,236,11072,0.5401914739884393,0.4384934971098266,0.021315028901734104,655,85,-1087,-347,0.0737758509041061,0.008091454157886131,-0.0818673050619923,1126,1742,0.10169797687861265,0.1556431559660984
6282,26109,Menominee,Michigan,2012,5242,5564,157,10963,0.4781537900209797,0.5075253124144851,0.014320897564535254,-739,-79,709,-109,-0.06203768396745957,-0.006994131337198849,0.06903181530465846,-322,-1448,-0.029371522393505378,-0.13106949927211803
6283,26109,Menominee,Michigan,2016,3539,6702,583,10824,0.32695861049519587,0.6191796008869179,0.05386178861788618,-1703,426,1138,-139,-0.15119517952578382,0.03954089105335093,0.11165428847243286,-3163,-2841,-0.29222099039172206,-0.2628494679982167
6284,26111,Midland,Michigan,2000,15959,21887,1042,38888,0.4103836659123637,0.5628214359185353,0.02679489816910101,0,0,0,0,0.0,0.0,0.0,-5928,0,-0.1524377700061716,0.0
6285,26111,Midland,Michigan,2004,18355,24369,551,43275,0.42414789139225884,0.5631195840554593,0.012732524552281918,2396,-491,2482,4387,0.013764225479895142,-0.01406237361681909,0.00029814813692397024,-6014,-86,-0.13897169266320042,0.013466077342971172
6286,26111,Midland,Michigan,2008,20701,22263,834,43798,0.47264715283802916,0.5083108817754235,0.01904196538654733,2346,283,-2106,523,0.048499261445770325,0.0063094408342654115,-0.05480870228003576,-1562,4452,-0.035663728937394334,0.10330796372580608
6287,26111,Midland,Michigan,2012,17450,23919,610,41979,0.4156840324924367,0.5697848924462231,0.014531075061340194,-3251,-224,1656,-1819,-0.05696312034559248,-0.0045108903252071356,0.061474010670799606,-6469,-4907,-0.15410085995378642,-0.11843713101639208
6288,26111,Midland,Michigan,2016,15635,23846,3295,42776,0.36550869646530765,0.5574621282962409,0.07702917523845147,-1815,2685,-73,797,-0.050175336027129036,0.06249810017711128,-0.012322764149982235,-8211,-1742,-0.19195343183093322,-0.0378525718771468
6289,26113,Missaukee,Michigan,2000,2062,4274,160,6496,0.31742610837438423,0.6579433497536946,0.024630541871921183,0,0,0,0,0.0,0.0,0.0,-2212,0,-0.3405172413793104,0.0
6290,26113,Missaukee,Michigan,2004,2319,5055,47,7421,0.3124915779544536,0.6811750437946369,0.006333378250909581,257,-113,781,925,-0.004934530419930638,-0.0182971636210116,0.023231694040942275,-2736,-524,-0.3686834658401833,-0.028166224460872913
6291,26113,Missaukee,Michigan,2008,2898,4469,125,7492,0.3868126001067806,0.5965029364655633,0.016684463427656167,579,78,-586,71,0.074321022152327,0.010351085176746586,-0.0846721073290736,-1571,1165,-0.2096903363587827,0.1589931294814006
6292,26113,Missaukee,Michigan,2012,2274,4665,85,7024,0.32374715261959,0.6641514806378133,0.012101366742596811,-624,-40,196,-468,-0.06306544748719062,-0.0045830966850593565,0.06764854417224997,-2391,-820,-0.3404043280182233,-0.1307139916594406
6293,26113,Missaukee,Michigan,2016,1565,5386,366,7317,0.2138854721880552,0.7360940276069428,0.05002050020500205,-709,281,721,293,-0.10986168043153477,0.03791913346240524,0.0719425469691295,-3821,-1430,-0.5222085554188876,-0.18180422740066426
6294,26115,Monroe,Michigan,2000,31555,28940,1300,61795,0.5106400194190468,0.4683226798284651,0.021037300752488067,0,0,0,0,0.0,0.0,0.0,2615,0,0.042317339590581704,0.0
6295,26115,Monroe,Michigan,2004,36089,37470,573,74132,0.48682080612960665,0.5054497383046458,0.007729455565747586,4534,-727,8530,12337,-0.023819213289440144,-0.013307845186740481,0.0371270584761807,-1381,-3996,-0.018628932175039137,-0.06094627176562084
6296,26115,Monroe,Michigan,2008,39180,35858,1593,76631,0.5112813352298679,0.46793073299317506,0.020787931776957105,3091,1020,-1612,2499,0.024460529100261197,0.01305847621120952,-0.03751900531147073,3322,4703,0.04335060223669279,0.06197953441173193
6297,26115,Monroe,Michigan,2012,36310,35593,1021,72924,0.49791563819867257,0.4880834841753058,0.014000877626021611,-2870,-572,-265,-3707,-0.013365697031195278,-0.006787054150935494,0.020152751182130724,717,-2605,0.00983215402336679,-0.033518448213326
6298,26115,Monroe,Michigan,2016,26863,43261,4531,74655,0.3598285446386712,0.5794789364409617,0.06069251892036702,-9447,3510,7668,1731,-0.13808709356000137,0.04669164129434541,0.09139545226565593,-16398,-17115,-0.2196503918022905,-0.2294825458256573
6299,26117,Montcalm,Michigan,2000,9627,12696,581,22904,0.4203195948305973,0.5543136570031435,0.025366748166259168,0,0,0,0,0.0,0.0,0.0,-3069,0,-0.13399406217254622,0.0
6300,26117,Montcalm,Michigan,2004,11471,14968,295,26734,0.4290790753347797,0.5598862871250093,0.011034637540210968,1844,-286,2272,3830,0.008759480504182404,-0.0143321106260482,0.005572630121865818,-3497,-428,-0.13080721179022964,0.003186850382316586
6301,26117,Montcalm,Michigan,2008,13208,13291,597,27096,0.48745202243873637,0.49051520519633895,0.02203277236492471,1737,302,-1677,362,0.058372947103956685,0.010998134824713743,-0.06937108192867036,-83,3414,-0.0030631827576025894,0.12774402903262705
6302,26117,Montcalm,Michigan,2012,11430,13621,445,25496,0.44830561656730467,0.5342406652023847,0.01745371823031064,-1778,-152,330,-1600,-0.0391464058714317,-0.004579054134614072,0.04372546000604571,-2191,-2108,-0.08593504863508,-0.08287186587747741
6303,26117,Montcalm,Michigan,2016,7874,16907,1979,26760,0.2942451420029895,0.6318011958146488,0.07395366218236174,-3556,1534,3286,1264,-0.15406047456431515,0.0564999439520511,0.09756053061226411,-9033,-6842,-0.33755605381165926,-0.25162100517657926
6304,26119,Montmorency,Michigan,2000,2139,2750,120,5009,0.4270313435815532,0.5490117787981633,0.02395687762028349,0,0,0,0,0.0,0.0,0.0,-611,0,-0.12198043521661012,0.0
6305,26119,Montmorency,Michigan,2004,2196,3300,67,5563,0.39475103361495595,0.5932051051590869,0.012043861225957218,57,-53,550,554,-0.032280309966597254,-0.011913016394326272,0.044193326360923546,-1104,-493,-0.19845407154413092,-0.0764736363275208
6306,26119,Montmorency,Michigan,2008,2403,2841,116,5360,0.4483208955223881,0.5300373134328358,0.02164179104477612,207,49,-459,-203,0.053569861907432126,0.009597929818818903,-0.06316779172625109,-438,666,-0.0817164179104477,0.11673765363368321
6307,26119,Montmorency,Michigan,2012,2049,2928,74,5051,0.4056622450999802,0.5796871906553158,0.014650564244704019,-354,-42,87,-309,-0.04265865042240785,-0.006991226800072102,0.04964987722248004,-879,-441,-0.1740249455553356,-0.0923085276448879
6308,26119,Montmorency,Michigan,2016,1287,3498,247,5032,0.25576311605723373,0.6951510333863276,0.04908585055643879,-762,173,570,-19,-0.1498991290427465,0.03443528631173477,0.11546384273101173,-2211,-1332,-0.4393879173290938,-0.2653629717737582
6309,26121,Muskegon,Michigan,2000,37865,30028,1377,69270,0.5466291323805399,0.4334921322361773,0.019878735383282806,0,0,0,0,0.0,0.0,0.0,7837,0,0.11313700014436262,0.0
6310,26121,Muskegon,Michigan,2004,44282,35302,729,80313,0.5513677735858454,0.43955524012301866,0.00907698629113593,6417,-648,5274,11043,0.004738641205305538,-0.010801749092146876,0.00606310788684139,8980,1143,0.11181253346282677,-0.001324466681535852
6311,26121,Muskegon,Michigan,2008,53821,29145,1490,84456,0.6372667424457705,0.3450909349246945,0.017642322629534905,9539,761,-6157,4143,0.0858989688599251,0.008565336338398975,-0.09446430519832416,24676,15696,0.292175807521076,0.18036327405824926
6312,26121,Muskegon,Michigan,2012,44436,30884,970,76290,0.5824616594573339,0.40482369904312493,0.012714641499541225,-9385,-520,1739,-8166,-0.05480508298843667,-0.0049276811299936805,0.059732764118430426,13552,-11124,0.17763796041420893,-0.1145378471068671
6313,26121,Muskegon,Michigan,2016,37304,36127,5292,78723,0.4738640549775796,0.4589128971202825,0.06722304790213787,-7132,4322,5243,2433,-0.10859760447975425,0.054508406402596646,0.05408919807715756,1177,-12375,0.014951157857297115,-0.1626868025569118
6314,26123,Newaygo,Michigan,2000,7677,11399,481,19557,0.39254486884491485,0.5828603569054559,0.02459477424962929,0,0,0,0,0.0,0.0,0.0,-3722,0,-0.19031548806054105,0.0
6315,26123,Newaygo,Michigan,2004,9057,13608,208,22873,0.39596904647400866,0.5949372622742972,0.009093691251694137,1380,-273,2209,3316,0.0034241776290938053,-0.015501082997935152,0.012076905368841317,-4551,-829,-0.19896821580028856,-0.008652727739747512
6316,26123,Newaygo,Michigan,2008,10790,11862,544,23196,0.46516640800137954,0.5113812726332126,0.023452319365407828,1733,336,-1746,323,0.06919736152737088,0.014358628113713691,-0.08355598964108457,-1072,3479,-0.04621486463183311,0.15275335116845545
6317,26123,Newaygo,Michigan,2012,8728,12457,244,21429,0.4072985206962527,0.5813150403658593,0.011386438937887908,-2062,-300,595,-1767,-0.05786788730512682,-0.01206588042751992,0.0699337677326467,-3729,-2657,-0.17401651966960663,-0.12780165503777352
6318,26123,Newaygo,Michigan,2016,6212,15173,1397,22782,0.27267140725133876,0.6660082521288737,0.06132034061978755,-2516,1153,2716,1353,-0.13462711344491396,0.04993390168189964,0.08469321176301436,-8961,-5232,-0.39333684487753495,-0.21932032520792832
6319,26125,Oakland,Michigan,2000,281201,274319,14745,570265,0.4931058367601028,0.4810377631452044,0.025856400094692818,0,0,0,0,0.0,0.0,0.0,6882,0,0.012068073614898367,0.0
6320,26125,Oakland,Michigan,2004,319387,316633,5957,641977,0.4975053623416415,0.49321548902842316,0.009279148629935341,38186,-8788,42314,71712,0.004399525581538721,-0.016577251464757477,0.012177725883218748,2754,-4128,0.00428987331321834,-0.007778200301680027
6321,26125,Oakland,Michigan,2008,372566,276956,10873,660395,0.5641563003959751,0.4193793108669811,0.01646438873704374,53179,4916,-39677,18418,0.06665093805433359,0.0071852401071083975,-0.07383617816144206,95610,92856,0.14477698952899398,0.14048711621577564
6322,26125,Oakland,Michigan,2012,349002,296514,6686,652202,0.535113354451535,0.4546352203765091,0.010251425171955928,-23564,-4187,19558,-8193,-0.029042945944440124,-0.00621296356508781,0.035255909509528005,52488,-43122,0.08047813407502585,-0.06429885545396813
6323,26125,Oakland,Michigan,2016,343070,289203,36652,668925,0.5128676607990432,0.4323399484247113,0.05479239077624547,-5932,29966,-7311,16723,-0.022245693652491738,0.04454096560428954,-0.022295271951797813,53867,1379,0.08052771237433193,4.957829930607449e-05
6324,26127,Oceana,Michigan,2000,4597,5913,262,10772,0.4267545488303008,0.5489231340512439,0.024322317118455256,0,0,0,0,0.0,0.0,0.0,-1316,0,-0.12216858522094315,0.0
6325,26127,Oceana,Michigan,2004,5441,6677,179,12297,0.4424656420265105,0.5429779621045784,0.014556395868911116,844,-83,764,1525,0.015711093196209724,-0.00976592124954414,-0.005945171946665551,-1236,80,-0.10051232007806787,0.021656265142875275
6326,26127,Oceana,Michigan,2008,6405,5860,244,12509,0.5120313374370453,0.4684627068510672,0.01950595571188744,964,65,-817,212,0.06956569541053481,0.004949559842976323,-0.07451525525351116,545,1781,0.043568630585978096,0.14408095066404597
6327,26127,Oceana,Michigan,2012,5063,6239,136,11438,0.44264731596432944,0.5454624934429096,0.011890190592760972,-1342,-108,379,-1071,-0.06938402147271588,-0.007615765119126467,0.07699978659184242,-1176,-1721,-0.10281517747858021,-0.1463838080645583
6328,26127,Oceana,Michigan,2016,3973,7228,729,11930,0.3330259849119866,0.6058675607711651,0.06110645431684828,-1090,593,989,492,-0.10962133105234284,0.04921626372408731,0.06040506732825546,-3255,-2079,-0.2728415758591785,-0.1700263983805983
6329,26129,Ogemaw,Michigan,2000,4896,4706,253,9855,0.4968036529680365,0.47752409944190766,0.02567224759005581,0,0,0,0,0.0,0.0,0.0,190,0,0.019279553526128868,0.0
6330,26129,Ogemaw,Michigan,2004,5215,5454,127,10796,0.48304927751018895,0.5051871063356799,0.01176361615413116,319,-126,748,941,-0.013754375457847579,-0.013908631435924648,0.027663006893772213,-239,-429,-0.022137828825490924,-0.04141738235161979
6331,26129,Ogemaw,Michigan,2008,5391,5133,274,10798,0.4992591220596407,0.47536580848305243,0.025375069457306908,176,147,-321,2,0.016209844549451735,0.013611453303175747,-0.029821297852627437,258,497,0.02389331357658825,0.04603114240207917
6332,26129,Ogemaw,Michigan,2012,4791,5437,166,10394,0.460939003271118,0.5230902443717529,0.015970752357129112,-600,-108,304,-404,-0.038320118788522706,-0.009404317100177795,0.047724435888700456,-646,-904,-0.06215124110063491,-0.08604455467722316
6333,26129,Ogemaw,Michigan,2016,3030,6827,583,10440,0.29022988505747127,0.6539272030651341,0.05584291187739464,-1761,417,1390,46,-0.1707091182136467,0.03987215952026553,0.1308369586933812,-3797,-3151,-0.3636973180076628,-0.3015460769070279
6334,26131,Ontonagon,Michigan,2000,1514,2472,165,4151,0.3647313900264996,0.5955191520115635,0.03974945796193688,0,0,0,0,0.0,0.0,0.0,-958,0,-0.23078776198506384,0.0
6335,26131,Ontonagon,Michigan,2004,1863,2262,67,4192,0.4444179389312977,0.5395992366412213,0.015982824427480915,349,-98,-210,41,0.0796865489047981,-0.023766633534455964,-0.05591991537034213,-399,559,-0.09518129770992362,0.13560646427514023
6336,26131,Ontonagon,Michigan,2008,1966,1823,96,3885,0.5060489060489061,0.46924066924066926,0.02471042471042471,103,29,-439,-307,0.06163096711760835,0.008727600282943795,-0.07035856740055207,143,542,0.036808236808236805,0.13198953451816042
6337,26131,Ontonagon,Michigan,2012,1586,1906,44,3536,0.4485294117647059,0.5390271493212669,0.012443438914027148,-380,-52,83,-349,-0.05751949428420017,-0.012266985796397562,0.06978648008059768,-320,-463,-0.09049773755656104,-0.12730597436479785
6338,26131,Ontonagon,Michigan,2016,1176,2066,191,3433,0.3425575298572677,0.6018060005825808,0.05563646956015147,-410,147,160,-103,-0.10597188190743823,0.04319303064612432,0.06277885126131388,-890,-570,-0.25924847072531315,-0.1687507331687521
6339,26133,Osceola,Michigan,2000,4006,5680,244,9930,0.40342396777442097,0.5720040281973817,0.024572004028197383,0,0,0,0,0.0,0.0,0.0,-1674,0,-0.16858006042296075,0.0
6340,26133,Osceola,Michigan,2004,4467,6599,122,11188,0.39926707186271004,0.589828387558098,0.010904540579191992,461,-122,919,1258,-0.004156895911710923,-0.013667463449005391,0.017824359360716246,-2132,-458,-0.19056131569538792,-0.02198125527242717
6341,26133,Osceola,Michigan,2008,4855,5973,198,11026,0.4403228732087793,0.5417195719209142,0.01795755487030655,388,76,-626,-162,0.04105580134606923,0.007053014291114558,-0.04810881563718372,-1118,1014,-0.10139669871213497,0.08916461698325295
6342,26133,Osceola,Michigan,2012,3981,6141,144,10266,0.38778492109877266,0.5981881940385739,0.014026884862653419,-874,-54,168,-760,-0.052537952110006614,-0.0039306700076531306,0.056468622117659684,-2160,-1042,-0.21040327293980127,-0.1090065742276663
6343,26133,Osceola,Michigan,2016,2705,7336,568,10609,0.25497219342068056,0.6914883589405222,0.05353944763879725,-1276,424,1195,343,-0.1328127276780921,0.03951256277614383,0.09330016490194826,-4631,-2471,-0.4365161655198416,-0.22611289258004036
6344,26135,Oscoda,Michigan,2000,1677,2207,108,3992,0.42009018036072143,0.5528557114228457,0.027054108216432865,0,0,0,0,0.0,0.0,0.0,-530,0,-0.1327655310621243,0.0
6345,26135,Oscoda,Michigan,2004,1792,2570,47,4409,0.4064413699251531,0.5828986164663189,0.01066001360852801,115,-61,363,417,-0.013648810435568315,-0.016394094607904856,0.030042905043473178,-778,-248,-0.1764572465411658,-0.04369171547904149
6346,26135,Oscoda,Michigan,2008,1887,2320,139,4346,0.43419236079153245,0.53382420616659,0.03198343304187759,95,92,-250,-63,0.027750990866379333,0.02132341943334958,-0.04907441029972892,-433,345,-0.09963184537505754,0.07682540116610825
6347,26135,Oscoda,Michigan,2012,1657,2308,76,4041,0.41004701806483546,0.5711457560009898,0.01880722593417471,-230,-63,-12,-305,-0.024145342726696994,-0.01317620710770288,0.037321549834399836,-651,-218,-0.16109873793615437,-0.06146689256109683
6348,26135,Oscoda,Michigan,2016,1044,2843,205,4092,0.25513196480938416,0.694770283479961,0.050097751710654934,-613,129,535,51,-0.1549150532554513,0.03129052577648023,0.12362452747897112,-1799,-1148,-0.4396383186705768,-0.2785395807344224
6349,26137,Otsego,Michigan,2000,4034,6108,363,10505,0.38400761542122797,0.5814374107567825,0.03455497382198953,0,0,0,0,0.0,0.0,0.0,-2074,0,-0.1974297953355545,0.0
6350,26137,Otsego,Michigan,2004,4674,7470,163,12307,0.3797838628422849,0.6069716421548712,0.01324449500284391,640,-200,1362,1802,-0.004223752578943085,-0.02131047881914562,0.025534231398088747,-2796,-722,-0.22718777931258632,-0.029757983977031832
6351,26137,Otsego,Michigan,2008,5634,6752,261,12647,0.44548114177275244,0.5338815529374555,0.020637305289792046,960,98,-718,340,0.06569727893046756,0.007392810286948137,-0.07309008921741567,-1118,1678,-0.0884004111647031,0.13878736814788323
6352,26137,Otsego,Michigan,2012,4681,7011,176,11868,0.39442197505898213,0.5907482305358949,0.01482979440512302,-953,-85,259,-779,-0.05105916671377031,-0.005807510884669026,0.05686667759843933,-2330,-1212,-0.19632625547691274,-0.10792584431220964
6353,26137,Otsego,Michigan,2016,3556,8266,788,12610,0.28199841395717684,0.6555114988104679,0.062490087232355274,-1125,612,1255,742,-0.11242356110180529,0.047660292827232255,0.06476326827457302,-4710,-2380,-0.37351308485329104,-0.1771868293763783
6354,26139,Ottawa,Michigan,2000,29600,78703,2296,110599,0.2676335229070787,0.7116067957214803,0.02075968137144097,0,0,0,0,0.0,0.0,0.0,-49103,0,-0.44397327281440163,0.0
6355,26139,Ottawa,Michigan,2004,35552,92048,1043,128643,0.27636171420131683,0.7155305768677658,0.008107708930917345,5952,-1253,13345,18044,0.00872819129423813,-0.012651972440523625,0.003923781146285443,-56496,-7393,-0.43916886266644894,0.004804410147952687
6356,26139,Ottawa,Michigan,2008,50828,83330,2381,136539,0.3722599403833337,0.6103018185280396,0.017438241088626693,15276,1338,-8718,7896,0.09589822618201688,0.009330532157709348,-0.10522875833972622,-32502,23994,-0.23804187814470584,0.2011269845217431
6357,26139,Ottawa,Michigan,2012,42737,88166,1552,132455,0.322652976482579,0.6656298365482617,0.011717186969159337,-8091,-829,4836,-4084,-0.0496069639007547,-0.005721054119467356,0.055328018020222136,-45429,-12927,-0.3429768600656827,-0.10493498192097683
6358,26139,Ottawa,Michigan,2016,44973,88467,10408,143848,0.31264251153995887,0.6150033368555697,0.07235415160447138,2236,8856,301,11393,-0.010010464942620145,0.06063696463531204,-0.05062649969269195,-43494,1935,-0.30236082531561087,0.040616034750071806
6359,26141,Presque Isle,Michigan,2000,3242,3660,178,7080,0.457909604519774,0.5169491525423728,0.02514124293785311,0,0,0,0,0.0,0.0,0.0,-418,0,-0.05903954802259881,0.0
6360,26141,Presque Isle,Michigan,2004,3432,3982,102,7516,0.4566258648217137,0.5298030867482704,0.013571048430015966,190,-76,322,436,-0.0012837396980603377,-0.011570194507837143,0.012853934205897533,-550,-132,-0.07317722192655668,-0.01413767390395787
6361,26141,Presque Isle,Michigan,2008,3722,3606,183,7511,0.49553987485021966,0.48009585940620425,0.02436426574357609,290,81,-376,-5,0.038914010028505974,0.010793217313560123,-0.04970722734206612,116,666,0.015444015444015413,0.08862123737057209
6362,26141,Presque Isle,Michigan,2012,3192,3794,109,7095,0.44989429175475687,0.5347427766032418,0.01536293164200141,-530,-74,188,-416,-0.045645583095462794,-0.009001334101574679,0.054646917197037514,-602,-718,-0.0848484848484849,-0.10029250029250031
6363,26141,Presque Isle,Michigan,2016,2400,4488,369,7257,0.3307151715584952,0.6184373708143861,0.05084745762711865,-792,260,694,162,-0.11917912019626165,0.03548452598511724,0.08369459421114434,-2088,-1486,-0.2877221992558909,-0.20287371440740598
6364,26143,Roscommon,Michigan,2000,6433,6190,305,12928,0.49760210396039606,0.4788056930693069,0.02359220297029703,0,0,0,0,0.0,0.0,0.0,243,0,0.018796410891089133,0.0
6365,26143,Roscommon,Michigan,2004,6810,7364,185,14359,0.47426701023748175,0.512849084198064,0.012883905564454349,377,-120,1174,1431,-0.023335093722914313,-0.010708297405842681,0.03404339112875704,-554,-797,-0.03858207396058222,-0.05737848485167135
6366,26143,Roscommon,Michigan,2008,7082,6727,287,14096,0.5024120317820658,0.47722758229284906,0.02036038592508513,272,102,-637,-263,0.028145021544584092,0.007476480360630783,-0.0356215019052149,355,909,0.025184449489216776,0.063766523449799
6367,26143,Roscommon,Michigan,2012,6198,6701,178,13077,0.47396191787107134,0.5124263974917794,0.013611684637149193,-884,-109,-26,-1019,-0.0284501139109945,-0.006748701287935938,0.03519881519893037,-503,-858,-0.03846447962070809,-0.06364892910992487
6368,26143,Roscommon,Michigan,2016,4287,8141,668,13096,0.32735186316432496,0.6216401954795358,0.05100794135613928,-1911,490,1440,19,-0.14661005470674637,0.037396256718990085,0.10921379798775632,-3854,-3351,-0.2942883323152108,-0.2558238526945027
6369,26145,Saginaw,Michigan,2000,50825,41152,1779,93756,0.542098639020436,0.43892657536584323,0.01897478561372072,0,0,0,0,0.0,0.0,0.0,9673,0,0.10317206365459275,0.0
6370,26145,Saginaw,Michigan,2004,54887,47165,800,102852,0.5336502936257924,0.4585715396880955,0.007778166686112083,4062,-979,6013,9096,-0.008448345394643564,-0.011196618927608638,0.019644964322252267,7722,-1951,0.07507875393769692,-0.02809330971689583
6371,26145,Saginaw,Michigan,2008,60276,42225,1782,104283,0.5780040850378297,0.4049077989701102,0.017088115992060067,5389,982,-4940,1431,0.044353791412037324,0.009309949305947984,-0.0536637407179853,18051,10329,0.17309628606771954,0.09801753213002262
6372,26145,Saginaw,Michigan,2012,54381,42720,1045,98146,0.5540826931306421,0.43526990402054083,0.010647402848817069,-5895,-737,495,-6137,-0.023921391907187672,-0.006440713143242998,0.030362105050430632,11661,-6390,0.11881278911010124,-0.054283496957618305
6373,26145,Saginaw,Michigan,2016,44396,45469,4915,94780,0.46841105718506015,0.47973201097277907,0.051856931842160794,-9985,3870,2749,-3366,-0.08567163594558191,0.04120952899334372,0.044462106952238234,-1073,-12734,-0.011320953787718913,-0.13013374289782015
6374,26147,St. Clair,Michigan,2000,33002,33571,1943,68516,0.48166851538326816,0.48997314495884176,0.028358339657890128,0,0,0,0,0.0,0.0,0.0,-569,0,-0.008304629575573597,0.0
6375,26147,St. Clair,Michigan,2004,36174,42740,829,79743,0.4536322937436515,0.535971809437819,0.010395896818529525,3172,-1114,9169,11227,-0.028036221639616665,-0.017962442839360604,0.045998664478977214,-6566,-5997,-0.08233951569416748,-0.07403488611859388
6376,26147,St. Clair,Michigan,2008,40677,38536,1687,80900,0.502805933250927,0.47634116192830656,0.020852904820766377,4503,858,-4204,1157,0.049173639507275546,0.010457008002236852,-0.05963064750951241,2141,8707,0.026464771322620484,0.10880428701678796
6377,26147,St. Clair,Michigan,2012,33983,39271,821,74075,0.458764765440432,0.5301518731015862,0.011083361457981776,-6694,-866,735,-6825,-0.04404116781049505,-0.009769543362784601,0.053810711173279624,-5288,-7429,-0.07138710766115419,-0.09785187898377468
6378,26147,St. Clair,Michigan,2016,24553,49051,4399,78003,0.3147699447457149,0.6288347884055742,0.05639526684871095,-9430,3578,9780,3928,-0.14399482069471709,0.04531190539072917,0.09868291530398798,-24498,-19210,-0.31406484365985926,-0.24267773599870507
6379,26149,St. Joseph,Michigan,2000,8574,12906,544,22024,0.38930257900472215,0.5859970940791863,0.024700326916091538,0,0,0,0,0.0,0.0,0.0,-4332,0,-0.19669451507446417,0.0
6380,26149,St. Joseph,Michigan,2004,9648,15340,251,25239,0.38226554142398667,0.6077895320733785,0.009944926502634812,1074,-293,2434,3215,-0.0070370375807354835,-0.014755400413456726,0.02179243799419217,-5692,-1360,-0.22552399064939183,-0.028829475574927654
6381,26149,St. Joseph,Michigan,2008,12322,12886,563,25771,0.4781343370455163,0.5000194016530208,0.021846261301462885,2674,312,-2454,532,0.09586879562152961,0.011901334798828073,-0.10777013042035766,-564,5128,-0.021885064607504556,0.20363892604188727
6382,26149,St. Joseph,Michigan,2012,10112,12978,337,23427,0.4316387074742818,0.5539761813292355,0.01438511119648269,-2210,-226,92,-2344,-0.04649562957123449,-0.007461150104980194,0.053956779676214706,-2866,-2302,-0.12233747385495375,-0.10045240924744919
6383,26149,St. Joseph,Michigan,2016,7526,14884,1557,23967,0.3140151041014729,0.6210205699503484,0.06496432594817875,-2586,1220,1906,540,-0.11762360337280892,0.05057921475169606,0.06704438862111284,-7358,-4492,-0.3070054658488755,-0.18466799199392175
6384,26151,Sanilac,Michigan,2000,7153,10966,447,18566,0.38527415706129486,0.5906495744910051,0.024076268447700097,0,0,0,0,0.0,0.0,0.0,-3813,0,-0.20537541742971022,0.0
6385,26151,Sanilac,Michigan,2004,7883,12632,248,20763,0.3796657515773251,0.6083899243847228,0.011944324037952127,730,-199,1666,2197,-0.005608405483969792,-0.01213194440974797,0.017740349893717755,-4749,-936,-0.22872417280739776,-0.023348755377687547
6386,26151,Sanilac,Michigan,2008,9047,10679,443,20169,0.448559670781893,0.5294759284049779,0.02196440081312906,1164,195,-1953,-594,0.06889391920456794,0.010020076775176932,-0.07891399597974491,-1632,3117,-0.08091625762308491,0.14780791518431285
6387,26151,Sanilac,Michigan,2012,7212,10963,267,18442,0.3910638759353649,0.5944583017026353,0.014477822361999784,-1835,-176,284,-1727,-0.057495794846528114,-0.007486578451129275,0.06498237329765733,-3751,-2119,-0.20339442576727035,-0.12247816814418544
6388,26151,Sanilac,Michigan,2016,4873,13446,930,19249,0.2531560081043171,0.6985297937555197,0.04831419814016313,-2339,663,2483,807,-0.1379078678310478,0.03383637577816334,0.10407149205288446,-8573,-4822,-0.4453737856512026,-0.24197935988393227
6389,26153,Schoolcraft,Michigan,2000,2036,2088,74,4198,0.4849928537398761,0.4973797046212482,0.017627441638875654,0,0,0,0,0.0,0.0,0.0,-52,0,-0.012386850881372091,0.0
6390,26153,Schoolcraft,Michigan,2004,2137,2267,37,4441,0.48119792839450576,0.510470614726413,0.008331456879081288,101,-37,179,243,-0.003794925345370348,-0.009295984759794367,0.013090910105164777,-130,-78,-0.029272686331907216,-0.016885835450535125
6391,26153,Schoolcraft,Michigan,2008,2184,2058,93,4335,0.5038062283737024,0.47474048442906575,0.021453287197231833,47,56,-209,-106,0.02260829997919661,0.013121830318150545,-0.03573013029734723,126,256,0.029065743944636624,0.05833843027654384
6392,26153,Schoolcraft,Michigan,2012,1865,2142,52,4059,0.45947277654594726,0.5277161862527716,0.012811037201281104,-319,-41,84,-276,-0.04433345182775511,-0.00864224999595073,0.05297570182370587,-277,-403,-0.06824340970682435,-0.09730915365146098
6393,26153,Schoolcraft,Michigan,2016,1369,2556,252,4177,0.3277471869762988,0.611922432367728,0.06033038065597319,-496,200,414,118,-0.13172558956964847,0.04751934345469208,0.08420624611495642,-1187,-910,-0.28417524539142924,-0.2159318356846049
6394,26155,Shiawassee,Michigan,2000,15520,15816,882,32218,0.48171829412129863,0.49090570488546775,0.027376000993233597,0,0,0,0,0.0,0.0,0.0,-296,0,-0.009187410764169124,0.0
6395,26155,Shiawassee,Michigan,2004,16881,19407,363,36651,0.46058770565605306,0.5295080625358107,0.009904231808136203,1361,-519,3591,4433,-0.02113058846524557,-0.017471769185097394,0.03860235765034298,-2526,-2230,-0.06892035687975767,-0.05973294611558855
6396,26155,Shiawassee,Michigan,2008,19397,16268,750,36415,0.5326651105313744,0.44673898118907046,0.02059590827955513,2516,387,-3139,-236,0.07207740487532138,0.010691676471418925,-0.08276908134674027,3129,5655,0.08592612934230398,0.15484648622206165
6397,26155,Shiawassee,Michigan,2012,17197,15962,431,33590,0.5119678475736826,0.4752009526644835,0.012831199761833879,-2200,-319,-306,-2825,-0.02069726295769181,-0.00776470851772125,0.028461971475413017,1235,-1894,0.036766894909199155,-0.049159234433104826
6398,26155,Shiawassee,Michigan,2016,12546,19230,2335,34111,0.3677992436457448,0.5637477646506992,0.06845299170355604,-4651,1904,3268,521,-0.14416860392793784,0.05562179194172216,0.08854681198621572,-6684,-7919,-0.1959485210049544,-0.23271541591415357
6399,26157,Tuscola,Michigan,2000,10845,13213,594,24652,0.4399237384390719,0.5359808534804479,0.024095408080480284,0,0,0,0,0.0,0.0,0.0,-2368,0,-0.09605711504137598,0.0
6400,26157,Tuscola,Michigan,2004,12631,15389,318,28338,0.44572658620933026,0.5430517326557979,0.011221681134871904,1786,-276,2176,3686,0.005802847770258357,-0.01287372694560838,0.007070879175349987,-2758,-390,-0.09732514644646761,-0.0012680314050916297
6401,26157,Tuscola,Michigan,2008,13503,13740,611,27854,0.4847777697996697,0.4932864220578732,0.0219358081424571,872,293,-1649,-484,0.03905118359033943,0.010714127007585195,-0.04976531059792466,-237,2521,-0.00850865225820352,0.0888164941882641
6402,26157,Tuscola,Michigan,2012,11425,14240,421,26086,0.4379743923943878,0.5458866825116921,0.01613892509392011,-2078,-190,500,-1768,-0.0468033774052819,-0.00579688304853699,0.05260026045381894,-2815,-2578,-0.10791229011730435,-0.09940363785910084
6403,26157,Tuscola,Michigan,2016,7429,17102,1397,25928,0.2865242209194693,0.6595958037642703,0.05387997531626041,-3996,976,2862,-158,-0.15145017147491852,0.0377410502223403,0.11370912125257815,-9673,-6858,-0.373071582844801,-0.26515929272749666
6404,26159,Van Buren,Michigan,2000,13796,14792,894,29482,0.4679465436537548,0.5017298690726545,0.030323587273590667,0,0,0,0,0.0,0.0,0.0,-996,0,-0.03378332541889967,0.0
6405,26159,Van Buren,Michigan,2004,16151,17634,389,34174,0.47261075671563174,0.516006320594604,0.011382922689764149,2355,-505,2842,4692,0.004664213061876921,-0.018940664583826518,0.014276451521949562,-1483,-487,-0.04339556387897231,-0.009612238460072642
6406,26159,Van Buren,Michigan,2008,18588,15534,644,34766,0.5346603002933901,0.44681585457055745,0.018523845136052465,2437,255,-2100,592,0.062049543577758326,0.007140922446288316,-0.0691904660240466,3054,4537,0.08784444572283262,0.13124000960180493
6407,26159,Van Buren,Michigan,2012,16290,16141,370,32801,0.4966312002682845,0.4920886558336636,0.01128014389805189,-2298,-274,607,-1965,-0.03802910002510557,-0.007243701238000576,0.04527280126310618,149,-2905,0.0045425444346208765,-0.08330190128821174
6408,26159,Van Buren,Michigan,2016,13258,17890,2126,33274,0.3984492396465709,0.5376570295125324,0.06389373084089679,-3032,1756,1749,473,-0.09818196062171358,0.0526135869428449,0.045568373678868734,-4632,-4781,-0.13920778986596144,-0.14375033430058232
6409,26161,Washtenaw,Michigan,2000,86647,52459,5834,144940,0.5978128880916241,0.3619359735062785,0.04025113840209742,0,0,0,0,0.0,0.0,0.0,34188,0,0.23587691458534565,0.0
6410,26161,Washtenaw,Michigan,2004,109953,61455,1856,173264,0.6345980699972297,0.3546899529042386,0.01071197709853172,23306,-3978,8996,28324,0.036785181905605535,-0.029539161303565695,-0.007246020602039882,48498,14310,0.27990811709299107,0.04403120250764542
6411,26161,Washtenaw,Michigan,2008,130578,53946,3024,187548,0.6962377631326381,0.28763836457866787,0.016123872288694094,20625,1168,-7509,14284,0.0616396931354084,0.005411895190162374,-0.06705158832557073,76632,28134,0.4085993985539702,0.12869128146097913
6412,26161,Washtenaw,Michigan,2012,120890,56412,2568,179870,0.6720965141491076,0.31362650803357983,0.014276977817312504,-9688,-456,2466,-7678,-0.024141248983530428,-0.00184689447138159,0.02598814345491196,64478,-12154,0.3584700061155278,-0.05012939243844239
6413,26161,Washtenaw,Michigan,2016,128483,50631,10965,190079,0.6759452648635568,0.26636819427711633,0.05768654085932691,7593,8397,-5781,10209,0.003848750714449123,0.043409563042014404,-0.0472583137564635,77852,13374,0.40957707058644044,0.05110706447091262
6414,26163,Wayne,Michigan,2000,530414,223021,15192,768627,0.690079843669296,0.29015504269300973,0.019765113637694225,0,0,0,0,0.0,0.0,0.0,307393,0,0.39992480097628624,0.0
6415,26163,Wayne,Michigan,2004,600047,257750,6931,864728,0.693914155665134,0.29807060717358524,0.008015237161280773,69633,-8261,34729,96101,0.003834311995838058,-0.011749876476413451,0.00791556448057551,342297,34904,0.3958435484915488,-0.004081252484737452
6416,26163,Wayne,Michigan,2008,660085,219582,12064,891731,0.7402288358260507,0.24624242064030522,0.013528743533644114,60038,5133,-38168,27003,0.046314680160916666,0.005513506372363341,-0.05182818653328003,440503,98206,0.4939864151857455,0.0981428666941967
6417,26163,Wayne,Michigan,2012,595846,213814,7585,817245,0.7290910314532362,0.26162778603723486,0.009281182509528967,-64239,-4479,-5768,-74486,-0.01113780437281453,-0.004247561024115148,0.01538536539692964,382032,-58471,0.4674632454160013,-0.02652316976974417
6418,26163,Wayne,Michigan,2016,519444,228993,34282,782719,0.6636404635635522,0.29256093182866394,0.04379860460778389,-76402,26697,15179,-34526,-0.06545056788968395,0.034517422098254924,0.030933145791429084,290451,-91581,0.3710795317348883,-0.09638371368111304
6419,26165,Wexford,Michigan,2000,5326,7215,441,12982,0.41026036049915265,0.5557695270374364,0.033970112463410876,0,0,0,0,0.0,0.0,0.0,-1889,0,-0.14550916653828377,0.0
6420,26165,Wexford,Michigan,2004,6034,8966,160,15160,0.39802110817941955,0.5914248021108179,0.010554089709762533,708,-281,1751,2178,-0.012239252319733107,-0.023416022753648343,0.03565527507338151,-2932,-1043,-0.1934036939313984,-0.047894527393114616
6421,26165,Wexford,Michigan,2008,7379,8044,318,15741,0.4687758083984499,0.5110221713995299,0.020202020202020204,1345,158,-922,581,0.07075470021903035,0.009647930492257671,-0.08040263071128806,-665,2267,-0.04224636300107998,0.1511573309303184
6422,26165,Wexford,Michigan,2012,6184,8450,229,14863,0.4160667429186571,0.5685258696090965,0.015407387472246518,-1195,-89,406,-878,-0.052709065479792816,-0.004794632729773686,0.05750369820956658,-2266,-1601,-0.15245912669043937,-0.1102127636893594
6423,26165,Wexford,Michigan,2016,4436,10000,934,15370,0.28861418347430057,0.6506180871828237,0.060767729342875734,-1748,705,1550,507,-0.12745255944435652,0.04536034187062922,0.0820922175737272,-5564,-3298,-0.3620039037085231,-0.20954477701808372
6424,27001,Aitkin,Minnesota,2000,3830,3755,675,8260,0.463680387409201,0.45460048426150124,0.08171912832929783,0,0,0,0,0.0,0.0,0.0,75,0,0.009079903147699742,0.0
6425,27001,Aitkin,Minnesota,2004,4539,4768,145,9452,0.4802158273381295,0.5044435040203131,0.015340668641557342,709,-530,1013,1192,0.01653543992892853,-0.06637845968774049,0.04984301975881189,-229,-304,-0.02422767668218362,-0.03330757982988336
6426,27001,Aitkin,Minnesota,2008,4595,4589,226,9410,0.48831030818278426,0.48767268862911795,0.02401700318809777,56,81,-179,-42,0.00809448084465475,0.008676334546540427,-0.016770815391195182,6,235,0.0006376195536663132,0.024865296235849932
6427,27001,Aitkin,Minnesota,2012,4412,4533,196,9141,0.4826605404222733,0.4958976042008533,0.021441855376873428,-183,-30,-56,-269,-0.00564976776051096,-0.002575147811224341,0.00822491557173538,-121,-127,-0.013237063778580027,-0.01387468333224634
6428,27001,Aitkin,Minnesota,2016,3134,5516,581,9231,0.3395081789621926,0.5975517278734699,0.06294009316433756,-1278,385,983,90,-0.1431523614600807,0.04149823778746413,0.10165412367261656,-2382,-2261,-0.2580435489112773,-0.24480648513269726
6429,27003,Anoka,Minnesota,2000,68008,69256,8355,145619,0.467026967634718,0.475597277827756,0.05737575453752601,0,0,0,0,0.0,0.0,0.0,-1248,0,-0.008570310193038,0.0
6430,27003,Anoka,Minnesota,2004,80226,91853,1987,174066,0.4608941436007032,0.5276906460767755,0.011415210322521343,12218,-6368,22597,28447,-0.006132824034014828,-0.045960544215004666,0.0520933682490195,-11627,-10379,-0.06679650247607233,-0.05822619228303433
6431,27003,Anoka,Minnesota,2008,86976,91357,3891,182224,0.47730266046184916,0.5013444990780578,0.021352840460093073,6750,1904,-496,8158,0.016408516861145972,0.00993763013757173,-0.026346146998717734,-4381,7246,-0.02404183861620862,0.042754663859863706
6432,27003,Anoka,Minnesota,2012,88614,93430,4421,186465,0.47523127664709197,0.5010591800069718,0.023709543345936234,1638,530,2073,4241,-0.0020713838147571884,0.0023567028858431614,-0.00028531907108597654,-4816,-435,-0.025827903359879834,-0.0017860647436712118
6433,27003,Anoka,Minnesota,2016,75500,93339,16919,185758,0.4064427911583889,0.5024763401845411,0.09108086865706995,-13114,12498,-91,-707,-0.06878848548870309,0.06737132531113371,0.001417160177569321,-17839,-13023,-0.09603354902615224,-0.07020564566627241
6434,27005,Becker,Minnesota,2000,5253,8152,928,14333,0.3664968952766343,0.5687574129630921,0.06474569176027349,0,0,0,0,0.0,0.0,0.0,-2899,0,-0.2022605176864578,0.0
6435,27005,Becker,Minnesota,2004,6756,9795,250,16801,0.4021189214927683,0.583001011844533,0.014880066662698649,1503,-678,1643,2468,0.03562202621613397,-0.04986562509757484,0.014243598881440889,-3039,-140,-0.18088209035176472,0.021378427334693084
6436,27005,Becker,Minnesota,2008,7687,8851,427,16965,0.4531093427645152,0.521721190686708,0.025169466548776893,931,177,-944,164,0.05099042127174691,0.010289399886078245,-0.06127982115782504,-1164,1875,-0.06861184792219277,0.11227024242957195
6437,27005,Becker,Minnesota,2012,6829,9204,349,16382,0.416859968257844,0.5618361616408253,0.021303870101330728,-858,-78,353,-583,-0.036249374506671206,-0.003865596447446166,0.04011497095411731,-2375,-1211,-0.1449761933829813,-0.07636434546078852
6438,27005,Becker,Minnesota,2016,5208,10880,1134,17222,0.30240390198583206,0.631750087097898,0.06584601091626989,-1621,785,1676,840,-0.11445606627201194,0.044542140814939166,0.06991392545707276,-5672,-3297,-0.329346185112066,-0.1843699917290847
6439,27007,Beltrami,Minnesota,2000,7301,8346,1570,17217,0.42405761747110415,0.48475344136609166,0.09118894116280421,0,0,0,0,0.0,0.0,0.0,-1045,0,-0.06069582389498751,0.0
6440,27007,Beltrami,Minnesota,2004,10592,10237,302,21131,0.5012540816809427,0.48445411954001233,0.014291798779045005,3291,-1268,1891,3914,0.0771964642098385,-0.0768971423837592,-0.0002993218260793351,355,1400,0.016799962140930325,0.07749578603591784
6441,27007,Beltrami,Minnesota,2008,12019,9762,455,22236,0.540519877675841,0.4390178089584458,0.020462313365713258,1427,153,-475,1105,0.03926579599489832,0.006170514586668252,-0.04543631058156655,2257,1902,0.1015020687173952,0.08470210657646488
6442,27007,Beltrami,Minnesota,2012,11818,9637,596,22051,0.5359394131785407,0.4370323341345064,0.027028252686952973,-201,141,-125,-185,-0.004580464497300318,0.006565939321239715,-0.0019854748239394038,2181,-76,0.09890707904403429,-0.0025949896733609146
6443,27007,Beltrami,Minnesota,2016,8688,10783,2093,21564,0.4028937117417919,0.5000463735856057,0.09705991467260248,-3130,1497,1146,-487,-0.13304570143674876,0.07003166198564952,0.06301403945109929,-2095,-4276,-0.09715266184381377,-0.19605974088784806
6444,27009,Benton,Minnesota,2000,6009,7663,1236,14908,0.403072176012879,0.5140193184867186,0.08290850550040246,0,0,0,0,0.0,0.0,0.0,-1654,0,-0.11094714247383958,0.0
6445,27009,Benton,Minnesota,2004,8059,10043,282,18384,0.4383703220191471,0.5462902523933856,0.015339425587467363,2050,-954,2380,3476,0.03529814600626813,-0.06756907991293509,0.03227093390666702,-1984,-330,-0.10791993037423847,0.0030272120996011065
6446,27009,Benton,Minnesota,2008,8454,10338,547,19339,0.43714773256114586,0.5345674543668235,0.028284813072030613,395,265,295,955,-0.0012225894580012442,0.01294538748456325,-0.011722798026562065,-1884,100,-0.09741972180567765,0.01050020856856082
6447,27009,Benton,Minnesota,2012,8173,10849,593,19615,0.41667091511598264,0.5530971195513638,0.03023196533265358,-281,46,511,276,-0.02047681744516322,0.0019471522606229683,0.018529665184540245,-2676,-792,-0.13642620443538112,-0.039006482629703465
6448,27009,Benton,Minnesota,2016,5640,12872,1546,20058,0.28118456476218967,0.6417389570246286,0.07707647821318177,-2533,953,2023,443,-0.13548635035379297,0.04684451288052818,0.08864183747326482,-7232,-4556,-0.3605543922624389,-0.2241281878270578
6449,27011,Big Stone,Minnesota,2000,1430,1370,180,2980,0.4798657718120805,0.4597315436241611,0.06040268456375839,0,0,0,0,0.0,0.0,0.0,60,0,0.020134228187919434,0.0
6450,27011,Big Stone,Minnesota,2004,1536,1483,48,3067,0.5008151287903488,0.4835343984349527,0.0156504727746984,106,-132,113,87,0.02094935697826833,-0.04475221178905999,0.02380285481079164,53,-7,0.017280730355396123,-0.0028534978325233107
6451,27011,Big Stone,Minnesota,2008,1552,1362,76,2990,0.5190635451505017,0.45551839464882943,0.025418060200668897,16,28,-121,-77,0.01824841636015284,0.009767587425970496,-0.02801600378612329,190,137,0.06354515050167225,0.04626442014627613
6452,27011,Big Stone,Minnesota,2012,1345,1385,59,2789,0.48225170311939763,0.49659376120473286,0.021154535675869487,-207,-17,23,-201,-0.03681184203110405,-0.00426352452479941,0.041075366555903436,-40,-230,-0.01434205808533523,-0.07788720858700748
6453,27011,Big Stone,Minnesota,2016,921,1608,226,2755,0.33430127041742286,0.5836660617059891,0.08203266787658803,-424,167,223,-34,-0.14795043270197478,0.06087813220071854,0.08707230050125625,-687,-647,-0.24936479128856626,-0.23502273320323103
6454,27013,Blue Earth,Minnesota,2000,12329,12942,2131,27402,0.44993066199547477,0.4723012918765054,0.07776804612801985,0,0,0,0,0.0,0.0,0.0,-613,0,-0.022370629881030613,0.0
6455,27013,Blue Earth,Minnesota,2004,16865,15737,517,33119,0.5092243123282708,0.4751653129623479,0.015610374709381323,4536,-1614,2795,5717,0.059293650332796044,-0.06215767141863853,0.002864021085842494,1128,1741,0.03405899936592294,0.05642962924695355
6456,27013,Blue Earth,Minnesota,2008,19325,14782,963,35070,0.5510407755916737,0.42149985742800117,0.027459366980325063,2460,446,-955,1951,0.041816463263402937,0.01184899227094374,-0.05366545553434671,4543,3415,0.12954091816367258,0.09548191879774964
6457,27013,Blue Earth,Minnesota,2012,18164,14916,1194,34274,0.5299644045048725,0.4351986928867363,0.0348369026083912,-1161,231,134,-796,-0.02107637108680127,0.007377535628066138,0.013698835458735126,3248,-1295,0.09476571161813618,-0.0347752065455364
6458,27013,Blue Earth,Minnesota,2016,14428,15667,3498,33593,0.4294942398714018,0.4663769237638794,0.10412883636471884,-3736,2304,751,-681,-0.1004701646334707,0.06929193375632764,0.03117823087714311,-1239,-4487,-0.03688268389247762,-0.1316483955106138
6459,27015,Brown,Minnesota,2000,4650,7370,814,12834,0.36231884057971014,0.5742558828112825,0.06342527660900732,0,0,0,0,0.0,0.0,0.0,-2720,0,-0.21193704223157234,0.0
6460,27015,Brown,Minnesota,2004,5158,8395,225,13778,0.37436492959790973,0.6093046886340543,0.016330381768036,508,-589,1025,944,0.01204608901819959,-0.04709489484097132,0.03504880582277181,-3237,-517,-0.23493975903614456,-0.02300271680457222
6461,27015,Brown,Minnesota,2008,5809,7456,355,13620,0.4265051395007342,0.5474302496328928,0.026064610866372982,651,130,-939,-158,0.052140209902824475,0.009734229098336981,-0.06187443900116152,-1647,1590,-0.12092511013215856,0.114014648903986
6462,27015,Brown,Minnesota,2012,5630,7938,361,13929,0.404192691506928,0.5698901572259315,0.025917151267140497,-179,6,482,309,-0.022312447993806217,-0.00014745959923248564,0.02245990759303873,-2308,-661,-0.1656974657190035,-0.04477235558684495
6463,27015,Brown,Minnesota,2016,3763,8708,1308,13779,0.27309674141810003,0.6319761956600625,0.09492706292183758,-1867,947,770,-150,-0.13109595008882796,0.06900991165469708,0.06208603843413096,-4945,-2637,-0.35887945424196244,-0.19318198852295893
6464,27017,Carlton,Minnesota,2000,8620,5578,883,15081,0.5715801339433725,0.3698693720575559,0.05855049399907168,0,0,0,0,0.0,0.0,0.0,3042,0,0.2017107618858166,0.0
6465,27017,Carlton,Minnesota,2004,11462,6642,230,18334,0.6251772662812262,0.362277735355078,0.012544998363695865,2842,-653,1064,3253,0.05359713233785368,-0.046005495635375815,-0.007591636702477866,4820,1778,0.26289953092614815,0.06118876904033155
6466,27017,Carlton,Minnesota,2008,11501,6549,399,18449,0.6233942219090466,0.354978589625454,0.021627188465499485,39,169,-93,115,-0.0017830443721795763,0.00908219010180362,-0.007299145729624035,4952,132,0.2684156322835926,0.005516101357444458
6467,27017,Carlton,Minnesota,2012,11389,6586,461,18436,0.6177587329138642,0.35723584291603383,0.025005424170101976,-112,62,37,-13,-0.005635488995182403,0.003378235704602491,0.0022572532905798526,4803,-149,0.26052288999783035,-0.007892742285762255
6468,27017,Carlton,Minnesota,2016,8460,8160,1591,18211,0.464554390203723,0.4480808302674208,0.08736477952885618,-2929,1130,1574,-225,-0.15320434271014116,0.06235935535875421,0.09084498735138696,300,-4503,0.01647355993630223,-0.24404933006152812
6469,27019,Carver,Minnesota,2000,12462,20790,1769,35021,0.3558436366751378,0.5936438137117729,0.05051254961308929,0,0,0,0,0.0,0.0,0.0,-8328,0,-0.23780017703663509,0.0
6470,27019,Carver,Minnesota,2004,16456,28510,445,45411,0.3623791592345467,0.6278214529519279,0.009799387813525358,3994,-1324,7720,10390,0.006535522559408924,-0.040713161799563934,0.034177639240155044,-12054,-3726,-0.2654422937173812,-0.02764211668074612
6471,27019,Carver,Minnesota,2008,20654,28156,873,49683,0.4157156371394642,0.5667129601674618,0.01757140269307409,4198,428,-354,4272,0.05333647790491747,0.007772014879548733,-0.06110849278446617,-7502,4552,-0.15099732302799757,0.11444497068938364
6472,27019,Carver,Minnesota,2012,20745,31155,999,52899,0.3921624227301083,0.5889525321839733,0.01888504508591845,91,126,2999,3216,-0.02355321440935587,0.001313642392844358,0.0222395720165115,-10410,-2908,-0.19679010945386494,-0.04579278642586737
6473,27019,Carver,Minnesota,2016,21508,29056,5132,55696,0.3861677678827923,0.5216891697787992,0.09214306233840851,763,4133,-2099,2797,-0.005994654847316039,0.07325801725249007,-0.06726336240517405,-7548,2862,-0.13552140189600692,0.061268707557858015
6474,27021,Cass,Minnesota,2000,5534,7134,925,13593,0.4071213124402266,0.5248289560803354,0.06804973147943795,0,0,0,0,0.0,0.0,0.0,-1600,0,-0.11770764364010883,0.0
6475,27021,Cass,Minnesota,2004,6835,8875,200,15910,0.4296040226272784,0.5578252671275927,0.01257071024512885,1301,-725,1741,2317,0.022482710187051835,-0.0554790212343091,0.03299631104725731,-2040,-440,-0.1282212445003143,-0.010513600860205474
6476,27021,Cass,Minnesota,2008,7276,8660,371,16307,0.4461887532961305,0.5310602808609799,0.022750965842889558,441,171,-215,397,0.016584730668852077,0.010180255597760708,-0.026764986266612834,-1384,656,-0.08487152756484939,0.04334971693546491
6477,27021,Cass,Minnesota,2012,6858,8957,326,16141,0.4248807384920389,0.5549222476922124,0.020197013815748715,-418,-45,297,-166,-0.021308014804091613,-0.0025539520271408434,0.02386196683123254,-2099,-715,-0.13004150920017354,-0.04516998163532415
6478,27021,Cass,Minnesota,2016,4949,9982,1068,15999,0.30933183323957747,0.623913994624664,0.06675417213575849,-1909,742,1025,-142,-0.11554890525246142,0.04655715832000977,0.06899174693245158,-5033,-2934,-0.31458216138508655,-0.184540652184913
6479,27023,Chippewa,Minnesota,2000,2952,2977,423,6352,0.464735516372796,0.4686712846347607,0.06659319899244333,0,0,0,0,0.0,0.0,0.0,-25,0,-0.003935768261964734,0.0
6480,27023,Chippewa,Minnesota,2004,3424,3089,93,6606,0.5183166818044203,0.4676052073872237,0.01407811080835604,472,-330,112,254,0.05358116543162428,-0.05251508818408729,-0.0010660772475369895,335,360,0.050711474417196534,0.05464724267916127
6481,27023,Chippewa,Minnesota,2008,3280,2907,169,6356,0.5160478288231592,0.45736312146003777,0.02658904971680302,-144,76,-182,-250,-0.0022688529812610048,0.01251093890844698,-0.010242085927185951,373,38,0.05868470736312148,0.007973232945924946
6482,27023,Chippewa,Minnesota,2012,3083,2967,151,6201,0.4971778745363651,0.4784712143202709,0.024350911143363973,-197,-18,60,-155,-0.018869954286794166,-0.002238138573439047,0.02110809286023313,116,-257,0.018706660216094184,-0.039978047147027296
6483,27023,Chippewa,Minnesota,2016,1978,3764,480,6222,0.31790421086467374,0.6049501767920283,0.07714561234329798,-1105,329,797,21,-0.17927366367169134,0.052794701199934,0.12647896247175744,-1786,-1902,-0.2870459659273546,-0.3057526261434488
6484,27025,Chisago,Minnesota,2000,9593,10937,1457,21987,0.43630327011415837,0.4974302997225633,0.0662664301632783,0,0,0,0,0.0,0.0,0.0,-1344,0,-0.06112702960840494,0.0
6485,27025,Chisago,Minnesota,2004,12219,15705,336,28260,0.4323779193205945,0.5557324840764332,0.0118895966029724,2626,-1121,4768,6273,-0.003925350793563875,-0.0543768335603059,0.05830218435386986,-3486,-2142,-0.12335456475583867,-0.06222753514743373
6486,27025,Chisago,Minnesota,2008,12783,15789,733,29305,0.4362054256952738,0.5387817778536086,0.025012796451117557,564,397,84,1045,0.0038275063746793236,0.013123199848145157,-0.016950706222824574,-3006,480,-0.10257635215833477,0.020778212597503898
6487,27025,Chisago,Minnesota,2012,12524,16227,690,29441,0.42539315919975546,0.5511701368839373,0.02343670391630719,-259,-43,438,136,-0.010812266495518363,-0.0015760925348103673,0.012388359030328755,-3703,-697,-0.1257769776841819,-0.02320062552584712
6488,27025,Chisago,Minnesota,2016,9278,18441,2509,30228,0.3069339685060209,0.6100635172687574,0.08300251422522165,-3246,1819,2214,787,-0.11845919069373456,0.05956581030891446,0.05889338038482006,-9163,-5460,-0.3031295487627365,-0.17735257107855462
6489,27027,Clay,Minnesota,2000,10128,11712,1518,23358,0.4335987670177241,0.5014127921911122,0.06498844079116363,0,0,0,0,0.0,0.0,0.0,-1584,0,-0.06781402517338814,0.0
6490,27027,Clay,Minnesota,2004,12989,14365,383,27737,0.4682914518513177,0.5179002776075279,0.013808270541154414,2861,-1135,2653,4379,0.03469268483359361,-0.05118017025000922,0.016487485416415648,-1376,208,-0.04960882575621017,0.018205199417177964
6491,27027,Clay,Minnesota,2008,16666,11978,615,29259,0.5696025154653269,0.409378310947059,0.021019173587614067,3677,232,-2387,1522,0.10131106361400921,0.007210903046459653,-0.10852196666046887,4688,6064,0.1602242045182679,0.20983303027447808
6492,27027,Clay,Minnesota,2012,15208,12920,758,28886,0.5264834175725265,0.44727549678044726,0.026241085647026242,-1458,143,942,-373,-0.04311909789280044,0.005221912059412175,0.03789718583338825,2288,-2400,0.07920792079207922,-0.08101628372618869
6493,27027,Clay,Minnesota,2016,12971,13543,2884,29398,0.4412204911898769,0.46067759711545003,0.09810191169467311,-2237,2126,623,512,-0.0852629263826496,0.07186082604764688,0.013402100335002776,-572,-2860,-0.019457105925573148,-0.09866502671765237
6494,27029,Clearwater,Minnesota,2000,1466,2137,221,3824,0.3833682008368201,0.5588389121338913,0.057792887029288705,0,0,0,0,0.0,0.0,0.0,-671,0,-0.17547071129707115,0.0
6495,27029,Clearwater,Minnesota,2004,1871,2438,52,4361,0.4290300389818849,0.5590460903462509,0.011923870671864251,405,-169,301,537,0.045661838145064804,-0.04586901635742445,0.00020717821235960443,-567,104,-0.13001605136436595,0.0454546599327052
6496,27029,Clearwater,Minnesota,2008,1877,2291,93,4261,0.4405069232574513,0.5376672142689509,0.021825862473597746,6,41,-147,-100,0.011476884275566368,0.009901991801733494,-0.021378876077299935,-414,153,-0.09716029101149964,0.0328557603528663
6497,27029,Clearwater,Minnesota,2012,1753,2359,85,4197,0.4176792947343341,0.5620681439123183,0.020252561353347628,-124,-8,68,-64,-0.022827628523117205,-0.001573301120250118,0.024400929643367375,-606,-192,-0.14438884917798422,-0.04722855816648458
6498,27029,Clearwater,Minnesota,2016,1100,2925,220,4245,0.2591283863368669,0.6890459363957597,0.05182567726737338,-653,135,566,48,-0.15855090839746716,0.03157311591402576,0.12697779248344143,-1825,-1219,-0.4299175500588928,-0.2855287008809086
6499,27031,Cook,Minnesota,2000,1171,1295,354,2820,0.4152482269503546,0.4592198581560284,0.125531914893617,0,0,0,0,0.0,0.0,0.0,-124,0,-0.04397163120567377,0.0
6500,27031,Cook,Minnesota,2004,1733,1489,81,3303,0.5246745382985165,0.45080230093854073,0.02452316076294278,562,-273,194,483,0.10942631134816189,-0.10100875413067423,-0.008417557217487659,244,368,0.07387223735997578,0.11784386856564955
6501,27031,Cook,Minnesota,2008,2019,1240,89,3348,0.6030465949820788,0.37037037037037035,0.026583034647550775,286,8,-249,45,0.07837205668356229,0.0020598738846079948,-0.08043193056817038,779,535,0.23267622461170845,0.15880398725173267
6502,27031,Cook,Minnesota,2012,1993,1221,108,3322,0.5999397953040337,0.3675496688741722,0.0325105358217941,-26,19,-19,-26,-0.003106799678045058,0.005927501174243323,-0.0028207014961981747,772,-7,0.23239012642986157,-0.0002860981818468833
6503,27031,Cook,Minnesota,2016,1912,1156,327,3395,0.563181148748159,0.34050073637702505,0.09631811487481591,-81,219,-65,73,-0.036758646555874686,0.06380757905302181,-0.027048932497147127,756,-16,0.222680412371134,-0.009709714058727559
6504,27033,Cottonwood,Minnesota,2000,2503,3369,309,6181,0.40495065523378093,0.5450574340721566,0.04999191069406245,0,0,0,0,0.0,0.0,0.0,-866,0,-0.14010677883837563,0.0
6505,27033,Cottonwood,Minnesota,2004,2726,3557,86,6369,0.42801067671533993,0.5584864185900456,0.013502904694614539,223,-223,188,188,0.023060021481559,-0.036489005999447904,0.013428984517888987,-831,35,-0.13047574187470562,0.009631036963670014
6506,27033,Cottonwood,Minnesota,2008,2759,3157,120,6036,0.457090788601723,0.5230284956925116,0.019880715705765408,33,34,-400,-333,0.029080111886383042,0.006377811011150869,-0.03545792289753391,-398,433,-0.06593770709078867,0.06453803478391695
6507,27033,Cottonwood,Minnesota,2012,2433,3316,113,5862,0.4150460593654043,0.5656772432616854,0.01927669737291027,-326,-7,159,-174,-0.04204472923631869,-0.0006040183328551371,0.042648747569173806,-883,-485,-0.15063118389628116,-0.0846934768054925
6508,27033,Cottonwood,Minnesota,2016,1678,3679,364,5721,0.2933053661947212,0.6430693934626813,0.06362524034259745,-755,251,363,-141,-0.12174069317068309,0.04434854296968718,0.07739215020099588,-2001,-1118,-0.34976402726796013,-0.19913284337167897
6509,27035,Crow Wing,Minnesota,2000,11255,15035,1838,28128,0.40013509670079633,0.5345207622298066,0.06534414106939704,0,0,0,0,0.0,0.0,0.0,-3780,0,-0.13438566552901027,0.0
6510,27035,Crow Wing,Minnesota,2004,14005,19106,434,33545,0.4174988820986734,0.5695632732150843,0.01293784468624236,2750,-1404,4071,5417,0.017363785397877085,-0.05240629638315468,0.035042510985277664,-5101,-1321,-0.15206439111641085,-0.01767872558740058
6511,27035,Crow Wing,Minnesota,2008,15859,18567,739,35165,0.45098819849281957,0.527996587515996,0.021015213991184417,1854,305,-539,1620,0.03348931639414615,0.008077369304942057,-0.04156668569908828,-2708,2393,-0.07700838902317642,0.07505600209323443
6512,27035,Crow Wing,Minnesota,2012,14760,19415,744,34919,0.4226925169678399,0.5560010309573584,0.021306452074801682,-1099,5,848,-246,-0.028295681524979688,0.0002912380836172651,0.028004443441362437,-4655,-1947,-0.13330851398951854,-0.056300124966342124
6513,27035,Crow Wing,Minnesota,2016,10982,22287,2573,35842,0.30640031248256233,0.6218123988616706,0.07178728865576697,-3778,1829,2872,923,-0.11629220448527755,0.05048083658096529,0.06581136790431219,-11305,-6650,-0.3154120863791083,-0.18210357238958974
6514,27037,Dakota,Minnesota,2000,85446,87250,9553,182249,0.4688420786945333,0.47874062409121587,0.052417297214250834,0,0,0,0,0.0,0.0,0.0,-1804,0,-0.009898545396682557,0.0
6515,27037,Dakota,Minnesota,2004,104635,108959,2252,215846,0.48476691715389675,0.5047997183176894,0.010433364528413777,19189,-7301,21709,33597,0.015924838459363433,-0.041983932685837055,0.026059094226473567,-4324,-2520,-0.02003280116379269,-0.010134255767110134
6516,27037,Dakota,Minnesota,2008,116778,104364,4330,225472,0.5179268379222254,0.4628690036900369,0.019204158387737723,12143,2078,-4595,9626,0.03315992076832863,0.008770793859323946,-0.04193071462765252,12414,16738,0.05505783423218846,0.07509063539598115
6517,27037,Dakota,Minnesota,2012,116255,109516,5046,230817,0.5036674075133114,0.4744711178119463,0.021861474674742327,-523,716,5152,5345,-0.014259430408913976,0.002657316287004604,0.011602114121909368,6739,-5675,0.02919628970136512,-0.025861544530823344
6518,27037,Dakota,Minnesota,2016,110592,99864,21404,231860,0.4769774864142155,0.43070818597429483,0.0923143276114897,-5663,16358,-9652,1043,-0.026689921099095903,0.07045285293674737,-0.04376293183765145,10728,3989,0.04626930043992067,0.01707301073855555
6519,27039,Dodge,Minnesota,2000,3370,4213,467,8050,0.4186335403726708,0.5233540372670807,0.05801242236024845,0,0,0,0,0.0,0.0,0.0,-843,0,-0.10472049689440993,0.0
6520,27039,Dodge,Minnesota,2004,4117,5593,158,9868,0.417207134171058,0.5667815160113499,0.016011349817592217,747,-309,1380,1818,-0.0014264062016128287,-0.04200107254265623,0.04342747874426911,-1476,-633,-0.14957438184029187,-0.04485388494588194
6521,27039,Dodge,Minnesota,2008,4463,5468,282,10213,0.43699206893175363,0.5353960638402037,0.02761186722804269,346,124,-125,345,0.01978493476069565,0.011600517410450473,-0.03138545217114619,-1005,471,-0.09840399490845003,0.05117038693184184
6522,27039,Dodge,Minnesota,2012,4487,5522,318,10327,0.4344921080662341,0.5347148252154547,0.030793066718311224,24,36,54,114,-0.0024999608655195127,0.0031811994902685332,-0.0006812386247490032,-1035,-30,-0.10022271714922054,-0.0018187222407705095
6523,27039,Dodge,Minnesota,2016,3102,6527,1025,10654,0.2911582504223766,0.6126337525811901,0.09620799699643326,-1385,707,1005,327,-0.14333385764385753,0.06541493027812204,0.07791892736573547,-3425,-2390,-0.32147550215881354,-0.221252785009593
6524,27041,Douglas,Minnesota,2000,6352,9811,1042,17205,0.369195001453066,0.5702412089508864,0.06056378959604766,0,0,0,0,0.0,0.0,0.0,-3459,0,-0.20104620749782037,0.0
6525,27041,Douglas,Minnesota,2004,8219,11793,297,20309,0.40469742478704024,0.5806785169136836,0.014624058299276183,1867,-745,1982,3104,0.03550242333397424,-0.04593973129677148,0.010437307962797182,-3574,-115,-0.1759810921266433,0.02506511537117706
6526,27041,Douglas,Minnesota,2008,9256,11241,421,20918,0.44248972177072377,0.5373840711349077,0.020126207094368485,1037,124,-552,609,0.037792296983683527,0.005502148795092303,-0.043294445778775836,-1985,1589,-0.09489434936418395,0.08108674276245936
6527,27041,Douglas,Minnesota,2012,8653,11884,414,20951,0.4130113121092072,0.5672282945921435,0.019760393298649228,-603,-7,643,33,-0.029478409661516547,-0.0003658137957192574,0.029844223457235808,-3231,-1246,-0.1542169824829363,-0.059322633118752355
6528,27041,Douglas,Minnesota,2016,6227,13966,1592,21785,0.2858388799632775,0.6410833142070231,0.07307780582969933,-2426,1178,2082,834,-0.12717243214592971,0.0533174125310501,0.07385501961487961,-7739,-4508,-0.35524443424374563,-0.20102745176080933
6529,27043,Faribault,Minnesota,2000,3624,4336,464,8424,0.4301994301994302,0.5147198480531814,0.055080721747388414,0,0,0,0,0.0,0.0,0.0,-712,0,-0.0845204178537512,0.0
6530,27043,Faribault,Minnesota,2004,3767,4794,120,8681,0.4339361824674577,0.5522405252851054,0.013823292247436931,143,-344,458,257,0.003736752268027499,-0.04125742949995148,0.03752067723192398,-1027,-315,-0.11830434281764768,-0.03378392496389648
6531,27043,Faribault,Minnesota,2008,3736,4196,220,8152,0.45829244357212956,0.514720314033366,0.026987242394504417,-31,100,-598,-529,0.024356261104671872,0.013163950147067486,-0.03752021125173932,-460,567,-0.056427870461236485,0.061876472356411194
6532,27043,Faribault,Minnesota,2012,3407,4104,202,7713,0.44172176844288863,0.5320886814469078,0.026189550110203554,-329,-18,-92,-439,-0.01657067512924093,-0.0007976922843008633,0.017368367413541752,-697,-237,-0.09036691300401917,-0.03393904254278268
6533,27043,Faribault,Minnesota,2016,2153,4659,600,7412,0.2904749055585537,0.6285752833243389,0.08094981111710739,-1254,398,555,-301,-0.15124686288433492,0.054760261006903836,0.09648660187743108,-2506,-1809,-0.33810037776578516,-0.247733464761766
6534,27045,Fillmore,Minnesota,2000,5020,4646,557,10223,0.49104959405262644,0.4544654211092634,0.054484984838110144,0,0,0,0,0.0,0.0,0.0,374,0,0.036584172943363025,0.0
6535,27045,Fillmore,Minnesota,2004,5825,5694,179,11698,0.49794836724226366,0.48674987177295265,0.015301760984783724,805,-378,1048,1475,0.0068987731896372195,-0.03918322385332642,0.032284450663689235,131,-243,0.01119849546931101,-0.025385677474052015
6536,27045,Fillmore,Minnesota,2008,5921,4993,320,11234,0.52706070856329,0.44445433505429943,0.02848495638241054,96,141,-701,-464,0.029112341321026358,0.013183195397626815,-0.042295536718653215,928,797,0.08260637350899058,0.07140787803967957
6537,27045,Fillmore,Minnesota,2012,5713,4913,266,10892,0.5245134043334557,0.45106500183621007,0.02442159383033419,-208,-54,-80,-342,-0.0025473042298342907,-0.004063362552076351,0.006610666781910635,800,-128,0.07344840249724566,-0.009157971011744925
6538,27045,Fillmore,Minnesota,2016,3872,6271,912,11055,0.3502487562189055,0.5672546359113523,0.0824966078697422,-1841,646,1358,163,-0.17426464811455022,0.058075014039408006,0.11618963407514221,-2399,-3199,-0.21700587969244678,-0.29045428218969244
6539,27047,Freeborn,Minnesota,2000,8514,6843,782,16139,0.5275419790569428,0.42400396554929054,0.048454055393766654,0,0,0,0,0.0,0.0,0.0,1671,0,0.10353801350765224,0.0
6540,27047,Freeborn,Minnesota,2004,9733,7681,252,17666,0.5509453186912714,0.43478999207517266,0.014264689233555982,1219,-530,838,1527,0.023403339634328613,-0.03418936616021067,0.01078602652588212,2052,381,0.11615532661609873,0.012617313108446493
6541,27047,Freeborn,Minnesota,2008,9915,6955,410,17280,0.5737847222222222,0.40248842592592593,0.023726851851851853,182,158,-726,-386,0.02283940353095082,0.00946216261829587,-0.03230156614924673,2960,908,0.17129629629629628,0.05514096968019755
6542,27047,Freeborn,Minnesota,2012,9326,6969,410,16705,0.5582759652798563,0.41718048488476506,0.02454354983537863,-589,0,14,-575,-0.015508756942365864,0.0008166979835267756,0.014692058958839127,2357,-603,0.1410954803950913,-0.03020081590120499
6543,27047,Freeborn,Minnesota,2016,6041,8808,1202,16051,0.376362843436546,0.5487508566444458,0.07488629991900816,-3285,792,1839,-654,-0.18191312184331032,0.05034275008362954,0.13157037175968073,-2767,-5124,-0.17238801320789976,-0.31348349360299105
6544,27049,Goodhue,Minnesota,2000,9981,10852,1424,22257,0.44844318641326325,0.48757694208563596,0.06397987150110078,0,0,0,0,0.0,0.0,0.0,-871,0,-0.039133755672372705,0.0
6545,27049,Goodhue,Minnesota,2004,12103,13134,371,25608,0.4726257419556389,0.5128865979381443,0.014487660106216807,2122,-1053,2282,3351,0.02418255554237564,-0.049492211394883974,0.025309655852508328,-1031,-160,-0.040260855982505395,-0.0011271003101326893
6546,27049,Goodhue,Minnesota,2008,12420,12775,600,25795,0.4814886605931382,0.49525101763907736,0.023260321767784455,317,229,-359,187,0.008862918637499329,0.008772661661567647,-0.017635580299066922,-355,676,-0.013762357045939144,0.02649849893656625
6547,27049,Goodhue,Minnesota,2012,12212,12986,603,25801,0.47331498779117087,0.5033138250455409,0.023371187163288246,-208,3,211,6,-0.008173672801967347,0.0001108653955037911,0.008062807406463535,-774,-419,-0.029998837254370025,-0.01623648020843088
6548,27049,Goodhue,Minnesota,2016,9446,14041,2230,25717,0.3673056732900416,0.545981257533927,0.08671306917603142,-2766,1627,1055,-84,-0.10600931450112927,0.06334188201274317,0.042667432488386114,-4595,-3821,-0.1786755842438854,-0.14867674698951538
6549,27051,Grant,Minnesota,2000,1507,1804,313,3624,0.41583885209713023,0.4977924944812362,0.08636865342163355,0,0,0,0,0.0,0.0,0.0,-297,0,-0.08195364238410596,0.0
6550,27051,Grant,Minnesota,2004,1856,1893,70,3819,0.4859910971458497,0.4956794972505892,0.018329405603561142,349,-243,89,195,0.07015224504871947,-0.06803924781807241,-0.002112997230647007,-37,260,-0.00968840010473948,0.07226524227936648
6551,27051,Grant,Minnesota,2008,1850,1646,109,3605,0.5131761442441054,0.4565880721220527,0.030235783633841887,-6,39,-247,-214,0.0271850470982557,0.011906378030280745,-0.03909142512853647,204,241,0.05658807212205269,0.06627647222679217
6552,27051,Grant,Minnesota,2012,1647,1748,92,3487,0.47232578147404647,0.5012905075996559,0.02638371092629768,-203,-17,102,-118,-0.040850362770058934,-0.0038520727075442088,0.044702435477603164,-101,-305,-0.028964726125609408,-0.0855527982476621
6553,27051,Grant,Minnesota,2016,1105,2063,305,3473,0.3181687302044342,0.594010941549093,0.08782032824647279,-542,213,315,-14,-0.15415705126961227,0.06143661732017511,0.09272043394943708,-958,-857,-0.27584221134465875,-0.24687748521904934
6554,27053,Hennepin,Minnesota,2000,307599,225657,40590,573846,0.5360305726623519,0.3932361644064784,0.07073326293116969,0,0,0,0,0.0,0.0,0.0,81942,0,0.14279440825587347,0.0
6555,27053,Hennepin,Minnesota,2004,383841,255133,8007,646981,0.5932801736063347,0.39434388335978954,0.012375943033875802,76242,-32583,29476,73135,0.05724960094398279,-0.05835731989729388,0.001107718953311132,128708,46766,0.19893629024654513,0.05614188199067166
6556,27053,Hennepin,Minnesota,2008,420958,231054,11768,663780,0.634183012443882,0.3480882220012655,0.01772876555485251,37117,3761,-24079,16799,0.040902838837547306,0.00535282252097671,-0.04625566135852405,189904,61196,0.2860947904426165,0.08715850019607135
6557,27053,Hennepin,Minnesota,2012,423982,240073,15983,680038,0.6234681003120414,0.3530288013316903,0.023503098356268327,3024,4215,9019,16258,-0.010714912131840615,0.005774332801415816,0.004940579330424799,183909,-5995,0.2704392989803511,-0.015655491462265414
6558,27053,Hennepin,Minnesota,2016,429288,191770,58919,679977,0.6313272360682788,0.2820242449376964,0.0866485189940248,5306,42936,-48303,-61,0.007859135756237423,0.06314542063775647,-0.07100455639399389,237518,53609,0.3493029911305824,0.07886369215023131
6559,27055,Houston,Minnesota,2000,4502,5077,588,10167,0.44280515392937936,0.4993606766991246,0.05783416937149602,0,0,0,0,0.0,0.0,0.0,-575,0,-0.05655552276974524,0.0
6560,27055,Houston,Minnesota,2004,5276,5631,175,11082,0.47608734885399745,0.508121277747699,0.015791373398303554,774,-413,554,915,0.03328219492461809,-0.042042795973192465,0.008760601048574401,-355,220,-0.032033928893701547,0.02452159387604369
6561,27055,Houston,Minnesota,2008,5906,4743,234,10883,0.5426812459799688,0.43581732978039145,0.021501424239639806,630,59,-888,-199,0.06659389712597136,0.005710050841336252,-0.07230394796730755,1163,1518,0.10686391619957736,0.1388978450932789
6562,27055,Houston,Minnesota,2012,5281,4951,214,10446,0.5055523645414512,0.4739613249090561,0.02048631054949263,-625,-20,208,-437,-0.03712888143851756,-0.001015113690147177,0.038143995128664676,330,-833,0.031591039632395124,-0.07527287656718223
6563,27055,Houston,Minnesota,2016,4145,5616,843,10604,0.39089023010184837,0.5296114673708034,0.07949830252734817,-1136,629,665,158,-0.11466213443960288,0.059011991977855546,0.05565014246174732,-1471,-1801,-0.13872123726895508,-0.1703122769013502
6564,27057,Hubbard,Minnesota,2000,3632,5307,674,9613,0.37782169978154584,0.5520649120982003,0.07011338812025382,0,0,0,0,0.0,0.0,0.0,-1675,0,-0.17424321231665446,0.0
6565,27057,Hubbard,Minnesota,2004,4741,6444,155,11340,0.41807760141093475,0.5682539682539682,0.013668430335097001,1109,-519,1137,1727,0.04025590162938891,-0.05644495778515682,0.016189056155767934,-1703,-28,-0.15017636684303348,0.02406684547362098
6566,27057,Hubbard,Minnesota,2008,4872,6558,208,11638,0.41862863034885717,0.5634988829695824,0.017872486681560405,131,53,114,298,0.0005510289379224154,0.004204056346463404,-0.0047550852843858404,-1686,17,-0.14487025262072523,0.005306114222308256
6567,27057,Hubbard,Minnesota,2012,4676,6622,222,11520,0.4059027777777778,0.5748263888888889,0.019270833333333334,-196,14,64,-118,-0.012725852571079388,0.001398346651772929,0.011327505919306535,-1946,-260,-0.16892361111111115,-0.024053358490385923
6568,27057,Hubbard,Minnesota,2016,3423,7261,821,11505,0.297522816166884,0.6311169056931769,0.07136027813993916,-1253,599,639,-15,-0.1083799616108938,0.05208944480660582,0.05629051680428798,-3838,-1892,-0.33359408952629294,-0.1646704784151818
6569,27059,Isanti,Minnesota,2000,6247,7668,1014,14929,0.41844731730189566,0.513631187621408,0.06792149507669636,0,0,0,0,0.0,0.0,0.0,-1421,0,-0.09518387031951236,0.0
6570,27059,Isanti,Minnesota,2004,7883,11190,240,19313,0.40817066224822657,0.5794024750168281,0.012426862734945374,1636,-774,3522,4384,-0.010276655053669093,-0.055494632341750984,0.06577128739542004,-3307,-1886,-0.1712318127686015,-0.07604794244908913
6571,27059,Isanti,Minnesota,2008,8248,11324,481,20053,0.4113100284246746,0.564703535630579,0.02398643594474642,365,241,134,740,0.003139366176448055,0.011559573209801046,-0.01469893938624911,-3076,231,-0.15339350720590433,0.017838305562697165
6572,27059,Isanti,Minnesota,2012,8024,11675,516,20215,0.3969329705664111,0.5775414296314618,0.02552559980212713,-224,35,351,162,-0.014377057858263542,0.0015391638573807112,0.012837894000882866,-3651,-575,-0.18060845906505074,-0.027214951859146408
6573,27059,Isanti,Minnesota,2016,5657,13635,1724,21016,0.26917586600685195,0.6487913970308337,0.08203273696231443,-2367,1208,1960,801,-0.12775710455955913,0.0565071371601873,0.07124996739937184,-7978,-4327,-0.3796155310239817,-0.19900707195893097
6574,27061,Itasca,Minnesota,2000,10583,9545,1586,21714,0.4873814129133278,0.4395781523441098,0.0730404347425624,0,0,0,0,0.0,0.0,0.0,1038,0,0.04780326056921802,0.0
6575,27061,Itasca,Minnesota,2004,13290,10705,372,24367,0.5454097755160668,0.43932367546271595,0.01526654902121722,2707,-1214,1160,2653,0.058028362602739025,-0.05777388572134518,-0.0002544768813938503,2585,1547,0.1060861000533509,0.058282839484132876
6576,27061,Itasca,Minnesota,2008,13460,10309,626,24395,0.5517524082803853,0.4225865956138553,0.025660996105759375,170,254,-396,28,0.006342632764318457,0.010394447084542156,-0.016737079848860636,3151,566,0.12916581266653,0.023079712613179093
6577,27061,Itasca,Minnesota,2012,12852,10501,566,23919,0.5373134328358209,0.43902337054224677,0.023663196621932354,-608,-60,192,-476,-0.014438975444564406,-0.0019977994838270216,0.016436774928391462,2351,-800,0.09829006229357412,-0.030875750372955868
6578,27061,Itasca,Minnesota,2016,9015,12920,1945,23880,0.37751256281407036,0.541038525963149,0.08144891122278057,-3837,1379,2419,-39,-0.15980087002175053,0.05778571460084822,0.10201515542090228,-3905,-6256,-0.1635259631490787,-0.2618160254426528
6579,27063,Jackson,Minnesota,2000,2364,2773,301,5438,0.43471864656123577,0.5099301213681501,0.055351232070614195,0,0,0,0,0.0,0.0,0.0,-409,0,-0.07521147480691431,0.0
6580,27063,Jackson,Minnesota,2004,2652,3024,103,5779,0.45890292438138086,0.523273922824018,0.017823152794601144,288,-198,251,341,0.024184277820145095,-0.03752807927601305,0.013343801455867887,-372,37,-0.0643709984426371,0.010840476364277207
6581,27063,Jackson,Minnesota,2008,2618,2858,147,5623,0.4655877645385026,0.5082696069713676,0.026142628490129823,-34,44,-166,-156,0.00668484015712173,0.00831947569552868,-0.015004315852650385,-240,132,-0.04268184243286499,0.021689156009772115
6582,27063,Jackson,Minnesota,2012,2268,3044,118,5430,0.4176795580110497,0.5605893186003683,0.021731123388581953,-350,-29,186,-193,-0.04790820652745287,-0.00441150510154787,0.05231971162900073,-776,-536,-0.1429097605893186,-0.1002279181564536
6583,27063,Jackson,Minnesota,2016,1492,3609,383,5484,0.27206418672501825,0.6580962800875274,0.06983953318745441,-776,265,565,54,-0.14561537128603147,0.04810840979887246,0.0975069614871591,-2117,-1341,-0.38603209336250915,-0.24312233277319056
6584,27065,Kanabec,Minnesota,2000,2831,3480,500,6811,0.41565115254734986,0.5109381882249303,0.07341065922771986,0,0,0,0,0.0,0.0,0.0,-649,0,-0.09528703567758046,0.0
6585,27065,Kanabec,Minnesota,2004,3592,4527,129,8248,0.4354995150339476,0.5488603297769156,0.01564015518913676,761,-371,1047,1437,0.01984836248659777,-0.057770504038583095,0.037922141551985256,-935,-286,-0.11336081474296794,-0.018073779065387485
6586,27065,Kanabec,Minnesota,2008,3743,4479,277,8499,0.4404047535004118,0.5270031768443346,0.03259206965525356,151,148,-48,251,0.004905238466464179,0.0169519144661168,-0.021857152932580948,-736,199,-0.08659842334392281,0.026762391399045127
6587,27065,Kanabec,Minnesota,2012,3593,4328,229,8150,0.44085889570552145,0.531042944785276,0.028098159509202456,-150,-48,-151,-349,0.0004541422051096422,-0.0044939101460511055,0.004039767940941408,-735,1,-0.09018404907975458,-0.0035856257358317656
6588,27065,Kanabec,Minnesota,2016,2327,5230,620,8177,0.2845786963434022,0.6395988748929925,0.07582242876360523,-1266,391,902,27,-0.15628019936211923,0.047724269254402776,0.10855593010771647,-2903,-2168,-0.3550201785495903,-0.2648361294698357
6589,27067,Kandiyohi,Minnesota,2000,8220,10026,1039,19285,0.4262380088151413,0.5198859217008037,0.05387606948405497,0,0,0,0,0.0,0.0,0.0,-1806,0,-0.09364791288566243,0.0
6590,27067,Kandiyohi,Minnesota,2004,9337,11704,308,21349,0.43735069558293127,0.5482223991756054,0.014426905241463301,1117,-731,1678,2064,0.011112686767789981,-0.039449164242591664,0.028336477474801725,-2367,-561,-0.11087170359267418,-0.017223790707011744
6591,27067,Kandiyohi,Minnesota,2008,10125,11319,451,21895,0.46243434574103676,0.5169673441424983,0.020598310116464947,788,143,-385,546,0.025083650158105486,0.006171404875001646,-0.031255055033107104,-1194,1173,-0.054532998401461585,0.05633870519121259
6592,27067,Kandiyohi,Minnesota,2012,9805,11240,419,21464,0.4568114051434961,0.523667536339918,0.01952105851658591,-320,-32,-79,-431,-0.005622940597540649,-0.0010772515998790366,0.006700192197419685,-1435,-241,-0.06685613119642192,-0.012323132794960334
6593,27067,Kandiyohi,Minnesota,2016,7266,12785,1721,21772,0.3337313981260334,0.5872221201543266,0.0790464817196399,-2539,1302,1545,308,-0.12308000701746269,0.059525423203054,0.0635545838144086,-5519,-4084,-0.2534907220282932,-0.18663459083187128
6594,27069,Kittson,Minnesota,2000,1107,1353,177,2637,0.4197952218430034,0.5130830489192264,0.0671217292377702,0,0,0,0,0.0,0.0,0.0,-246,0,-0.09328782707622302,0.0
6595,27069,Kittson,Minnesota,2004,1333,1307,42,2682,0.4970171513795675,0.4873228933631618,0.015659955257270694,226,-135,-46,45,0.0772219295365641,-0.0514617739804995,-0.02576015555606459,26,272,0.009694258016405666,0.10298208509262868
6596,27069,Kittson,Minnesota,2008,1492,1016,60,2568,0.5809968847352025,0.3956386292834891,0.02336448598130841,159,18,-291,-114,0.08397973335563502,0.007704530724037716,-0.09168426407967273,476,450,0.18535825545171342,0.17566399743530775
6597,27069,Kittson,Minnesota,2012,1241,1095,84,2420,0.5128099173553718,0.4524793388429752,0.03471074380165289,-251,24,79,-148,-0.06818696737983065,0.011346257820344482,0.05684070955948611,146,-330,0.06033057851239665,-0.12502767693931677
6598,27069,Kittson,Minnesota,2016,823,1349,213,2385,0.3450733752620545,0.5656184486373166,0.08930817610062892,-418,129,254,-35,-0.16773654209331734,0.05459743229897603,0.11313910979434139,-526,-672,-0.22054507337526208,-0.28087565188765873
6599,27071,Koochiching,Minnesota,2000,2903,3523,453,6879,0.42200901293792703,0.5121383922081698,0.06585259485390318,0,0,0,0,0.0,0.0,0.0,-620,0,-0.09012937927024278,0.0
6600,27071,Koochiching,Minnesota,2004,3662,3539,108,7309,0.5010261321658229,0.48419756464632646,0.014776303187850596,759,-345,16,430,0.0790171192278959,-0.05107629166605259,-0.02794082756184335,123,743,0.016828567519496462,0.10695794678973924
6601,27071,Koochiching,Minnesota,2008,3649,2962,191,6802,0.5364598647456631,0.43546015877683036,0.028079976477506617,-13,83,-577,-507,0.03543373257984017,0.013303673289656022,-0.0487374058694961,687,564,0.10099970596883273,0.08417113844933627
6602,27071,Koochiching,Minnesota,2012,3451,2841,166,6458,0.534375967791886,0.43991947971508205,0.0257045524930319,-198,-25,-121,-344,-0.002083896953777087,-0.0023754239844747185,0.004459320938251687,610,-77,0.09445648807680396,-0.006543217892028774
6603,27071,Koochiching,Minnesota,2016,2306,3569,488,6363,0.3624076693383624,0.5608989470375609,0.0766933836240767,-1145,322,728,-95,-0.17196829845352363,0.0509888311310448,0.12097946732247888,-1263,-1873,-0.19849127769919855,-0.2929477657760025
6604,27073,Lac Qui Parle,Minnesota,2000,2244,1941,268,4453,0.503929934875365,0.43588591960476086,0.06018414551987424,0,0,0,0,0.0,0.0,0.0,303,0,0.06804401527060411,0.0
6605,27073,Lac Qui Parle,Minnesota,2004,2390,2093,58,4541,0.5263157894736842,0.4609116934595904,0.012772517066725391,146,-210,152,88,0.02238585459831921,-0.04741162845314885,0.025025773854829514,297,-6,0.0654040960140938,-0.0026399192565103036
6606,27073,Lac Qui Parle,Minnesota,2008,2160,1912,120,4192,0.5152671755725191,0.45610687022900764,0.02862595419847328,-230,62,-181,-349,-0.011048613901165072,0.01585343713174789,-0.004804823230582733,248,-49,0.059160305343511466,-0.006243790670582339
6607,27073,Lac Qui Parle,Minnesota,2012,1974,1938,72,3984,0.4954819277108434,0.4864457831325301,0.018072289156626505,-186,-48,26,-208,-0.019785247861675737,-0.010553665041846776,0.030338912903522475,36,-212,0.009036144578313254,-0.05012416076519821
6608,27073,Lac Qui Parle,Minnesota,2016,1305,2293,262,3860,0.3380829015544041,0.594041450777202,0.06787564766839378,-669,190,355,-124,-0.15739902615643925,0.04980335851176727,0.10759566764467193,-988,-1024,-0.2559585492227979,-0.2649946938011112
6609,27075,Lake,Minnesota,2000,3579,2465,519,6563,0.5453298796282188,0.3755904312052415,0.0790796891665397,0,0,0,0,0.0,0.0,0.0,1114,0,0.16973944842297728,0.0
6610,27075,Lake,Minnesota,2004,4212,2769,90,7071,0.5956724649978786,0.39159949087823503,0.012728044123886296,633,-429,304,508,0.050342585369659854,-0.0663516450426534,0.016009059672993542,1443,329,0.2040729741196436,0.03433352569666631
6611,27075,Lake,Minnesota,2008,4174,2636,159,6969,0.5989381546850338,0.37824652030420436,0.022815325010761944,-38,69,-133,-102,0.0032656896871551266,0.010087280886875648,-0.013352970574030676,1538,95,0.2206916343808294,0.016618660261185803
6612,27075,Lake,Minnesota,2012,4043,2610,167,6820,0.5928152492668621,0.38269794721407624,0.024486803519061583,-131,8,-26,-149,-0.00612290541817162,0.001671478508299639,0.004451426909871881,1433,-105,0.2101173020527859,-0.010574332328043501
6613,27075,Lake,Minnesota,2016,3077,2932,512,6521,0.4718601441496703,0.449624290752952,0.0785155650973777,-966,345,322,-299,-0.12095510511719182,0.05402876157831611,0.06692634353887578,145,-1288,0.022235853396718297,-0.1878814486560676
6614,27077,Lake of the Woods,Minnesota,2000,848,1216,123,2187,0.38774577046181985,0.5560128029263832,0.056241426611796985,0,0,0,0,0.0,0.0,0.0,-368,0,-0.16826703246456337,0.0
6615,27077,Lake of the Woods,Minnesota,2004,921,1428,51,2400,0.38375,0.595,0.02125,73,-72,212,213,-0.00399577046181987,-0.03499142661179698,0.03898719707361675,-507,-139,-0.21125,-0.04298296753543662
6616,27077,Lake of the Woods,Minnesota,2008,971,1278,64,2313,0.41980112408127973,0.5525291828793775,0.027669693039342844,50,13,-150,-87,0.03605112408127975,0.006419693039342842,-0.042470817120622506,-307,200,-0.13272805879809774,0.07852194120190226
6617,27077,Lake of the Woods,Minnesota,2012,859,1306,69,2234,0.3845120859444942,0.5846016114592659,0.03088630259623993,-112,5,28,-79,-0.03528903813678552,0.0032166095568970862,0.03207242857988846,-447,-140,-0.20008952551477172,-0.06736146671667398
6618,27077,Lake of the Woods,Minnesota,2016,553,1540,149,2242,0.24665477252453166,0.6868867082961642,0.06645851917930419,-306,80,234,8,-0.13785731341996255,0.03557221658306426,0.10228509683689824,-987,-540,-0.4402319357716325,-0.24014241025686078
6619,27079,Le Sueur,Minnesota,2000,5361,6138,832,12331,0.43475792717541156,0.4977698483496878,0.06747222447490066,0,0,0,0,0.0,0.0,0.0,-777,0,-0.06301192117427623,0.0
6620,27079,Le Sueur,Minnesota,2004,6466,7746,212,14424,0.4482806433721575,0.5370216306156406,0.014697726012201887,1105,-620,1608,2093,0.013522716196745943,-0.05277449846269877,0.03925178226595277,-1280,-503,-0.08874098724348306,-0.02572906606920683
6621,27079,Le Sueur,Minnesota,2008,6994,7636,379,15009,0.4659870744220135,0.5087614098207742,0.02525151575721234,528,167,-110,585,0.017706431049855975,0.010553789745010454,-0.028260220794866342,-642,638,-0.04277433539876074,0.04596665184472232
6622,27079,Le Sueur,Minnesota,2012,6753,7715,327,14795,0.4564379858060155,0.5214599526867185,0.022102061507265968,-241,-52,79,-214,-0.009549088615997958,-0.003149454249946372,0.012698542865944296,-962,-320,-0.065021966880703,-0.022247631481942254
6623,27079,Le Sueur,Minnesota,2016,4623,9182,1166,14971,0.308797007547926,0.6133190835615523,0.07788390889052167,-2130,839,1467,176,-0.14764097825808953,0.0557818473832557,0.09185913087483377,-4559,-3597,-0.3045220760136263,-0.2395001091329233
6624,27081,Lincoln,Minnesota,2000,1590,1513,181,3284,0.48416565164433617,0.46071863580998784,0.055115712545676,0,0,0,0,0.0,0.0,0.0,77,0,0.023447015834348328,0.0
6625,27081,Lincoln,Minnesota,2004,1558,1736,48,3342,0.46618791143028127,0.5194494314781568,0.01436265709156194,-32,-133,223,58,-0.017977740214054905,-0.04075305545411406,0.05873079566816897,-178,-255,-0.053261520047875544,-0.07670853588222387
6626,27081,Lincoln,Minnesota,2008,1517,1491,118,3126,0.48528470889315417,0.47696737044145876,0.037747920665387076,-41,70,-245,-216,0.019096797462872905,0.023385263573825137,-0.04248206103669805,26,204,0.00831733845169541,0.061578858499570954
6627,27081,Lincoln,Minnesota,2012,1429,1595,96,3120,0.4580128205128205,0.5112179487179487,0.03076923076923077,-88,-22,104,-6,-0.027271888380333675,-0.006978689896156305,0.03425057827648992,-166,-192,-0.05320512820512818,-0.06152246665682359
6628,27081,Lincoln,Minnesota,2016,860,1931,228,3019,0.2848625372639947,0.639615766810202,0.07552169592580324,-569,132,336,-101,-0.1731502832488258,0.04475246515657247,0.12839781809225337,-1071,-905,-0.35475322954620736,-0.3015481013410792
6629,27083,Lyon,Minnesota,2000,4737,6087,665,11489,0.4123074244929933,0.5298111236835233,0.05788145182348333,0,0,0,0,0.0,0.0,0.0,-1350,0,-0.11750369919053005,0.0
6630,27083,Lyon,Minnesota,2004,5292,7203,178,12673,0.4175806833425393,0.5683737078829006,0.014045608774560089,555,-487,1116,1184,0.005273258849545992,-0.04383584304892324,0.0385625841993773,-1911,-561,-0.15079302454036136,-0.03328932534983131
6631,27083,Lyon,Minnesota,2008,6110,6315,283,12708,0.48079949638023295,0.4969310670443815,0.022269436575385583,818,105,-888,35,0.06321881303769367,0.008223827800825494,-0.07144264083851914,-205,1706,-0.016131570664148553,0.1346614538762128
6632,27083,Lyon,Minnesota,2012,5465,6594,329,12388,0.4411527284468841,0.5322893122376493,0.02655795931546658,-645,46,279,-320,-0.03964676793334887,0.004288522740080996,0.0353582451932678,-1129,-924,-0.09113658379076522,-0.07500501312661667
6633,27083,Lyon,Minnesota,2016,3825,7256,1134,12215,0.3131395824805567,0.5940237413016782,0.09283667621776505,-1640,805,662,-173,-0.1280131459663274,0.06627871690229847,0.06173442906402893,-3431,-2302,-0.28088415882112155,-0.18974757503035633
6634,27085,McLeod,Minnesota,2000,5609,8782,1003,15394,0.3643627387293751,0.5704820059763545,0.06515525529427049,0,0,0,0,0.0,0.0,0.0,-3173,0,-0.20611926724697938,0.0
6635,27085,McLeod,Minnesota,2004,6712,11407,293,18412,0.3645448620464914,0.6195416033021942,0.01591353465131436,1103,-710,2625,3018,0.0001821233171163117,-0.049241720642956135,0.049059597325839754,-4695,-1522,-0.2549967412557028,-0.04887747400872344
6636,27085,McLeod,Minnesota,2008,7505,10993,531,19029,0.394398024068527,0.5776971990120343,0.02790477691943875,793,238,-414,617,0.029853162022035584,0.01199124226812439,-0.0418444042901599,-3488,1207,-0.18329917494350734,0.07169756631219548
6637,27085,McLeod,Minnesota,2012,6968,11069,516,18553,0.37557268366301944,0.596615102678812,0.02781221365816849,-537,-15,76,-476,-0.01882534040550754,-9.256326127025927e-05,0.018917903666777702,-4101,-613,-0.22104241901579258,-0.03774324407228524
6638,27085,McLeod,Minnesota,2016,4978,12155,1674,18807,0.26468867974690274,0.646301908863721,0.08900941138937629,-1990,1158,1086,254,-0.11088400391611669,0.0611971977312078,0.04968680618490895,-7177,-3076,-0.3816132291168182,-0.16057081010102564
6639,27087,Mahnomen,Minnesota,2000,921,1122,181,2224,0.4141187050359712,0.5044964028776978,0.08138489208633093,0,0,0,0,0.0,0.0,0.0,-201,0,-0.09037769784172661,0.0
6640,27087,Mahnomen,Minnesota,2004,1339,1132,37,2508,0.5338915470494418,0.4513556618819777,0.014752791068580542,418,-144,10,284,0.11977284201347055,-0.06663210101775038,-0.05314074099572014,207,408,0.08253588516746407,0.17291358300919069
6641,27087,Mahnomen,Minnesota,2008,1436,843,64,2343,0.6128894579598805,0.35979513444302175,0.02731540759709774,97,27,-289,-165,0.07899791091043873,0.012562616528517197,-0.09156052743895593,593,386,0.25309432351685873,0.17055843834939466
6642,27087,Mahnomen,Minnesota,2012,1276,871,35,2182,0.5847846012832264,0.39917506874427133,0.016040329972502293,-160,-29,28,-161,-0.028104856676654077,-0.011275077624595446,0.039379934301249586,405,-188,0.18560953253895507,-0.06748479097790366
6643,27087,Mahnomen,Minnesota,2016,930,991,167,2088,0.4454022988505747,0.4746168582375479,0.07998084291187739,-346,132,120,-94,-0.1393823024326517,0.0639405129393751,0.07544178949327657,-61,-466,-0.029214559386973205,-0.21482409192592827
6644,27089,Marshall,Minnesota,2000,1910,2912,377,5199,0.367378341988844,0.5601077130217349,0.07251394498942104,0,0,0,0,0.0,0.0,0.0,-1002,0,-0.1927293710328909,0.0
6645,27089,Marshall,Minnesota,2004,2308,3187,67,5562,0.4149586479683567,0.5729953254225099,0.012046026609133405,398,-310,275,363,0.04758030597951268,-0.06046791838028764,0.012887612400774962,-879,123,-0.15803667745415317,0.03469269357873772
6646,27089,Marshall,Minnesota,2008,2311,2285,143,4739,0.487655623549272,0.4821692340156151,0.030175142435112892,3,76,-902,-823,0.07269697558091531,0.018129115825979487,-0.09082609140689474,26,905,0.005486389533656877,0.16352306698781005
6647,27089,Marshall,Minnesota,2012,1998,2569,131,4698,0.42528735632183906,0.5468284376330353,0.027884206045125585,-313,-12,284,-41,-0.06236826722743294,-0.0022909363899873067,0.06465920361742022,-571,-597,-0.12154108131119629,-0.12702747084485316
6648,27089,Marshall,Minnesota,2016,1225,3208,384,4817,0.2543076603695246,0.6659746730330081,0.0797176665974673,-773,253,639,119,-0.17097969595231444,0.05183346055234172,0.11914623539997271,-1983,-1412,-0.41166701266348343,-0.29012593135228715
6649,27091,Martin,Minnesota,2000,4166,5686,519,10371,0.4016970398225822,0.5482595699546813,0.050043390222736475,0,0,0,0,0.0,0.0,0.0,-1520,0,-0.14656253013209908,0.0
6650,27091,Martin,Minnesota,2004,4590,6311,146,11047,0.4154974201140581,0.5712863220783924,0.01321625780754956,424,-373,625,676,0.0138003802914759,-0.03682713241518691,0.02302675212371108,-1721,-201,-0.15578890196433426,-0.00922637183223518
6651,27091,Martin,Minnesota,2008,4413,6053,288,10754,0.4103589362097824,0.5628603310396132,0.026780732750604427,-177,142,-258,-293,-0.005138483904275681,0.013564474943054867,-0.008425991038779168,-1640,81,-0.15250139482983077,0.0032875071345034867
6652,27091,Martin,Minnesota,2012,4054,6657,257,10968,0.36962071480671044,0.6069474835886215,0.023431801604668127,-359,-31,604,214,-0.040738221403071984,-0.0033489311459363007,0.0440871525490083,-2603,-963,-0.23732676878191106,-0.08482537395208029
6653,27091,Martin,Minnesota,2016,2733,7062,736,10531,0.25951951381635174,0.670591586743899,0.06988889943974931,-1321,479,405,-437,-0.1101012009903587,0.04645709783508119,0.06364410315527746,-4329,-1726,-0.4110720729275472,-0.17374530414563616
6654,27093,Meeker,Minnesota,2000,4402,5520,750,10672,0.4124812593703148,0.5172413793103449,0.07027736131934033,0,0,0,0,0.0,0.0,0.0,-1118,0,-0.10476011994003004,0.0
6655,27093,Meeker,Minnesota,2004,5292,6854,188,12334,0.42905788876276957,0.5556996919085455,0.015242419328684935,890,-562,1334,1662,0.016576629392454745,-0.055034941990655395,0.03845831259820065,-1562,-444,-0.12664180314577594,-0.021881683205745905
6656,27093,Meeker,Minnesota,2008,5380,6737,428,12545,0.42885611797528894,0.5370267038660821,0.034117178158628934,88,240,-117,211,-0.00020177078748062627,0.018874758829944,-0.018672988042463423,-1357,205,-0.10817058589079315,0.018471217254982797
6657,27093,Meeker,Minnesota,2012,4969,6913,332,12214,0.40682822990011464,0.565989847715736,0.027181922384149338,-411,-96,176,-331,-0.022027888075174307,-0.006935255774479596,0.028963143849653927,-1944,-587,-0.15916161781562138,-0.050991031924828234
6658,27093,Meeker,Minnesota,2016,3191,8104,987,12282,0.2598111056831135,0.6598273896759486,0.08036150464093796,-1778,655,1191,68,-0.14701712421700114,0.05317958225678862,0.09383754196021254,-4913,-2969,-0.40001628399283506,-0.24085466617721368
6659,27095,Mille Lacs,Minnesota,2000,4376,5223,654,10253,0.42680191163561887,0.5094118794499171,0.06378620891446406,0,0,0,0,0.0,0.0,0.0,-847,0,-0.08260996781429819,0.0
6660,27095,Mille Lacs,Minnesota,2004,5677,7194,194,13065,0.43451970914657484,0.5506314580941447,0.01484883275928052,1301,-460,1971,2812,0.0077177975109559704,-0.04893737615518354,0.04121957864422765,-1517,-670,-0.11611174894756987,-0.03350178113327168
6661,27095,Mille Lacs,Minnesota,2008,6072,7049,423,13544,0.4483165977554637,0.5204518606024808,0.03123154164205552,395,229,-145,479,0.013796888608888835,0.016382708882775,-0.03017959749166388,-977,540,-0.07213526284701716,0.043976486100552714
6662,27095,Mille Lacs,Minnesota,2012,5829,6951,311,13091,0.4452677411962417,0.530975479336949,0.023756779466809257,-243,-112,-98,-453,-0.0030488565592219907,-0.007474762175246265,0.010523618734468165,-1122,-145,-0.08570773814070731,-0.013572475293690156
6663,27095,Mille Lacs,Minnesota,2016,3710,8340,967,13017,0.28501190750556965,0.6407006222631942,0.07428747023123608,-2119,656,1389,-74,-0.16025583369067203,0.050530690764426824,0.10972514292624524,-4630,-3508,-0.3556887147576246,-0.2699809766169173
6664,27097,Morrison,Minnesota,2000,5274,8197,1206,14677,0.35933773932002455,0.5584928800163521,0.08216938066362335,0,0,0,0,0.0,0.0,0.0,-2923,0,-0.19915514069632756,0.0
6665,27097,Morrison,Minnesota,2004,6794,9698,266,16758,0.40541830767394677,0.5787086764530374,0.015873015873015872,1520,-940,1501,2081,0.04608056835392221,-0.06629636479060748,0.02021579643668525,-2904,19,-0.1732903687790906,0.02586477191723696
6666,27097,Morrison,Minnesota,2008,6547,9735,461,16743,0.391029086782536,0.5814370184554739,0.027533894761990085,-247,195,37,-15,-0.014389220891410759,0.011660878888974213,0.0027283420024365457,-3188,-284,-0.1904079316729379,-0.017117562893847305
6667,27097,Morrison,Minnesota,2012,6153,10159,399,16711,0.3682005864400694,0.6079229250194482,0.023876488540482316,-394,-62,424,-32,-0.022828500342466584,-0.003657406221507769,0.026485906563974315,-4006,-818,-0.2397223385793788,-0.0493144069064409
6668,27097,Morrison,Minnesota,2016,3637,12925,1052,17614,0.2064834790507551,0.7337913023731123,0.059725218576132624,-2516,653,2766,903,-0.16171710738931433,0.03584873003565031,0.12586837735366407,-9288,-5282,-0.5273078233223571,-0.28758548474297835
6669,27099,Mower,Minnesota,2000,10693,6873,914,18480,0.5786255411255411,0.3719155844155844,0.04945887445887446,0,0,0,0,0.0,0.0,0.0,3820,0,0.20670995670995668,0.0
6670,27099,Mower,Minnesota,2004,12334,7591,297,20222,0.6099297794481258,0.37538324596973593,0.014686974582138265,1641,-617,718,1742,0.031304238322584665,-0.03477189987673619,0.0034676615541515132,4743,923,0.23454653347838983,0.027836576768433152
6671,27099,Mower,Minnesota,2008,11605,7075,507,19187,0.6048366081200813,0.36873925053421586,0.02642414134570282,-729,210,-516,-1035,-0.005093171328044432,0.011737166763564554,-0.006643995435520078,4530,-213,0.23609735758586547,0.0015508241074756457
6672,27099,Mower,Minnesota,2012,11129,6938,471,18538,0.6003344481605352,0.3742582802891358,0.025407271550329055,-476,-36,-137,-649,-0.00450215995954617,-0.0010168697953737635,0.0055190297549199685,4191,-339,0.22607616787139934,-0.010021189714466139
6673,27099,Mower,Minnesota,2016,7437,8823,1455,17715,0.41981371718882304,0.49805249788314987,0.0821337849280271,-3692,984,1885,-823,-0.18052073097171212,0.056726513377698046,0.12379421759401404,-1386,-5577,-0.07823878069432683,-0.30431494856572616
6674,27101,Murray,Minnesota,2000,2093,2407,253,4753,0.44035346097201766,0.5064169997896065,0.05322953923837576,0,0,0,0,0.0,0.0,0.0,-314,0,-0.06606353881758886,0.0
6675,27101,Murray,Minnesota,2004,2218,2719,61,4998,0.44377751100440177,0.5440176070428171,0.012204881952781112,125,-192,312,245,0.003424050032384107,-0.04102465728559465,0.03760060725321057,-501,-187,-0.10024009603841533,-0.034176557220826465
6676,27101,Murray,Minnesota,2008,2345,2320,148,4813,0.48722210679409933,0.4820278412632454,0.03075005194265531,127,87,-399,-185,0.04344459578969756,0.018545169989874197,-0.061989765779571715,25,526,0.005194265530853948,0.10543436156926927
6677,27101,Murray,Minnesota,2012,2160,2504,103,4767,0.45311516677155445,0.525277952590728,0.02160688063771764,-185,-45,184,-46,-0.034106940022544885,-0.009143171304937667,0.04325011132748258,-344,-369,-0.07216278581917351,-0.07735705135002746
6678,27101,Murray,Minnesota,2016,1295,2974,399,4668,0.27742073693230507,0.6371036846615252,0.08547557840616966,-865,296,470,-99,-0.17569442983924938,0.06386869776845203,0.11182573207079727,-1679,-1335,-0.35968294772922016,-0.28752016191004665
6679,27103,Nicollet,Minnesota,2000,7041,7221,1065,15327,0.459385398316696,0.4711293795263261,0.06948522215697789,0,0,0,0,0.0,0.0,0.0,-180,0,-0.011743981209630105,0.0
6680,27103,Nicollet,Minnesota,2004,8797,8689,255,17741,0.49585705428104393,0.4897694605715574,0.014373485147398682,1756,-810,1468,2414,0.03647165596434793,-0.055111737009579206,0.018640081045231294,108,288,0.006087593709486527,0.017831574919116633
6681,27103,Nicollet,Minnesota,2008,9887,7968,390,18245,0.5419018909290216,0.43672238969580707,0.02137571937517128,1090,135,-721,504,0.046044836647977705,0.007002234227772599,-0.053047070875750335,1919,1811,0.10517950123321457,0.09909190752372804
6682,27103,Nicollet,Minnesota,2012,9652,8214,488,18354,0.525879917184265,0.4475318731611638,0.02658820965457121,-235,98,246,109,-0.016021973744756668,0.0052124902793999305,0.010809483465356706,1438,-481,0.0783480440231012,-0.026831457210113374
6683,27103,Nicollet,Minnesota,2016,7886,8437,1774,18097,0.43576283361883184,0.46620986903906725,0.0980272973421009,-1766,1286,223,-257,-0.09011708356543313,0.07143908768752968,0.018677995877903475,-551,-1989,-0.030447035420235413,-0.1087950794433366
6684,27105,Nobles,Minnesota,2000,3760,4766,346,8872,0.4238052299368801,0.5371956717763751,0.03899909828674482,0,0,0,0,0.0,0.0,0.0,-1006,0,-0.11339044183949498,0.0
6685,27105,Nobles,Minnesota,2004,3898,5159,147,9204,0.4235115167318557,0.5605171664493699,0.015971316818774447,138,-199,393,332,-0.0002937132050243596,-0.02302778146797037,0.023321494672994825,-1261,-255,-0.13700564971751417,-0.023615207878019184
6686,27105,Nobles,Minnesota,2008,4244,4368,201,8813,0.4815613298536253,0.49563145353455124,0.022807216611823444,346,54,-791,-391,0.0580498131217696,0.0068358997930489974,-0.06488571291481865,-124,1137,-0.014070123680925917,0.12293552603658825
6687,27105,Nobles,Minnesota,2012,3793,4581,146,8520,0.44518779342723,0.5376760563380282,0.017136150234741784,-451,-55,213,-293,-0.03637353642639529,-0.00567106637708166,0.04204460280347694,-788,-664,-0.09248826291079815,-0.07841813922987223
6688,27105,Nobles,Minnesota,2016,2733,5299,600,8632,0.3166126042632067,0.6138785912882299,0.06950880444856349,-1060,454,718,112,-0.12857518916402333,0.0523726542138217,0.07620253495020168,-2566,-1778,-0.29726598702502316,-0.204777724114225
6689,27107,Norman,Minnesota,2000,1575,1808,258,3641,0.4325734688272453,0.4965668772315298,0.07085965394122494,0,0,0,0,0.0,0.0,0.0,-233,0,-0.06399340840428452,0.0
6690,27107,Norman,Minnesota,2004,1954,1794,62,3810,0.5128608923884515,0.47086614173228347,0.01627296587926509,379,-196,-14,169,0.08028742356120616,-0.05458668806195985,-0.02570073549924634,160,393,0.04199475065616798,0.1059881590604525
6691,27107,Norman,Minnesota,2008,2129,1204,101,3434,0.6199767035527082,0.3506115317414094,0.029411764705882353,175,39,-590,-376,0.10711581116425672,0.013138798826617261,-0.12025460999087406,925,765,0.26936517181129876,0.2273704211551308
6692,27107,Norman,Minnesota,2012,1730,1384,93,3207,0.5394449641409417,0.43155597131275336,0.028999064546304958,-399,-8,180,-227,-0.0805317394117665,-0.0004127001595773949,0.08094443957134395,346,-579,0.10788899282818831,-0.16147617898311045
6693,27107,Norman,Minnesota,2016,1264,1699,298,3261,0.3876111622201779,0.5210058264336094,0.09138301134621282,-466,205,315,54,-0.1518338019207638,0.062383946799907865,0.08944985512085601,-435,-781,-0.1333946642134315,-0.2412836570416198
6694,27109,Olmsted,Minnesota,2000,25822,30641,2929,59392,0.4347723599137931,0.5159112338362069,0.04931640625,0,0,0,0,0.0,0.0,0.0,-4819,0,-0.08113887392241376,0.0
6695,27109,Olmsted,Minnesota,2004,33285,37371,919,71575,0.4650366748166259,0.5221236465246245,0.012839678658749564,7463,-2010,6730,12183,0.030264314902832823,-0.03647672759125044,0.006212412688417657,-4086,733,-0.05708697170799859,0.024051902214415166
6696,27109,Olmsted,Minnesota,2008,38711,36202,1557,76470,0.5062246632666405,0.4734144108800837,0.020360925853275796,5426,638,-1169,4895,0.04118798845001459,0.007521247194526232,-0.04870923564454083,2509,6595,0.032810252386556826,0.08989722409455542
6697,27109,Olmsted,Minnesota,2012,39338,36832,2143,78313,0.5023176228723201,0.47031782718067244,0.02736454994700752,627,586,630,1843,-0.003907040394320438,0.007003624093731724,-0.0030965836994112372,2506,-3,0.031999795691647626,-0.0008104566949092007
6698,27109,Olmsted,Minnesota,2016,36268,35668,8193,80129,0.4526201500081119,0.44513222428833504,0.10224762570355302,-3070,6050,-1164,1816,-0.04969747286420817,0.0748830757565455,-0.0251856028923374,600,-1906,0.007487925719776856,-0.02451186997187077
6699,27111,Otter Tail,Minnesota,2000,9844,16963,1704,28511,0.34527024657149874,0.5949633474799201,0.05976640594858125,0,0,0,0,0.0,0.0,0.0,-7119,0,-0.24969310090842134,0.0
6700,27111,Otter Tail,Minnesota,2004,12038,19734,406,32178,0.3741065324134502,0.6132761514077941,0.012617316178755672,2194,-1298,2771,3667,0.02883628584195147,-0.047149089769825576,0.018312803927874044,-7696,-577,-0.2391696189943439,0.010523481914077426
6701,27111,Otter Tail,Minnesota,2008,13856,18077,754,32687,0.4238994095511977,0.5530333159971854,0.02306727445161685,1818,348,-1657,509,0.04979287713774749,0.010449958272861179,-0.06024283541060871,-4221,3475,-0.1291339064459877,0.1100357125483562
6702,27111,Otter Tail,Minnesota,2012,12165,18860,643,31668,0.3841417203486169,0.5955538714159404,0.020304408235442717,-1691,-111,783,-1019,-0.039757689202580826,-0.0027628662161741334,0.04252055541875499,-6695,-2474,-0.21141215106732353,-0.08227824462133582
6703,27111,Otter Tail,Minnesota,2016,9340,20939,2221,32500,0.2873846153846154,0.6442769230769231,0.06833846153846154,-2825,1578,2079,832,-0.09675710496400147,0.048034053303018825,0.048723051660982675,-11599,-4904,-0.3568923076923077,-0.14548015662498415
6704,27113,Pennington,Minnesota,2000,2458,3380,482,6320,0.3889240506329114,0.5348101265822784,0.07626582278481013,0,0,0,0,0.0,0.0,0.0,-922,0,-0.14588607594936703,0.0
6705,27113,Pennington,Minnesota,2004,3117,3767,133,7017,0.44420692603676787,0.5368391050306399,0.018953968932592276,659,-349,387,697,0.05528287540385646,-0.057311853852217855,0.0020289784483614737,-650,272,-0.09263217899387205,0.053253896955494984
6706,27113,Pennington,Minnesota,2008,3394,3248,180,6822,0.4975080621518616,0.476106713573732,0.026385224274406333,277,47,-519,-195,0.05330113611509374,0.007431255341814057,-0.0607323914569079,146,796,0.021401348578129586,0.11403352757200164
6707,27113,Pennington,Minnesota,2012,3024,3305,188,6517,0.4640171858216971,0.507135184901028,0.02884762927727482,-370,8,57,-305,-0.03349087633016451,0.0024624050028684875,0.031028471327296026,-281,-427,-0.04311799907933095,-0.06451934765746054
6708,27113,Pennington,Minnesota,2016,2147,4000,568,6715,0.3197319434102755,0.5956813104988831,0.0845867460908414,-877,380,695,198,-0.1442852424114216,0.055739116813566573,0.08854612559785502,-1853,-1572,-0.27594936708860757,-0.23283136800927662
6709,27115,Pine,Minnesota,2000,6148,5854,1066,13068,0.470462197734925,0.4479644934190389,0.08157330884603611,0,0,0,0,0.0,0.0,0.0,294,0,0.022497704315886102,0.0
6710,27115,Pine,Minnesota,2004,7228,7033,257,14518,0.49786471965835516,0.4844331175092988,0.017702162832346054,1080,-809,1179,1450,0.02740252192343018,-0.06387114601369007,0.036468624090259916,195,-99,0.013431602149056365,-0.009066102166829737
6711,27115,Pine,Minnesota,2008,7084,6862,437,14383,0.4925258986303275,0.47709101022039907,0.03038309114927345,-144,180,-171,-135,-0.005338821028027685,0.012680928316927395,-0.007342107288899724,222,27,0.015434888409928404,0.002003286260872039
6712,27115,Pine,Minnesota,2012,6750,6845,370,13965,0.4833512352309345,0.49015395631936987,0.026494808449695668,-334,-67,-17,-418,-0.00917466339939299,-0.003888282699577781,0.013062946098970796,-95,-317,-0.006802721088435382,-0.022237609498363786
6713,27115,Pine,Minnesota,2016,4580,8191,1040,13811,0.33161972340887697,0.5930779813192383,0.07530229527188473,-2170,670,1346,-154,-0.15173151182205752,0.048807486822189064,0.10292402499986841,-3611,-3516,-0.2614582579103613,-0.25465553682192593
6714,27117,Pipestone,Minnesota,2000,1970,2693,231,4894,0.40253371475275845,0.5502656313853699,0.04720065386187168,0,0,0,0,0.0,0.0,0.0,-723,0,-0.14773191663261143,0.0
6715,27117,Pipestone,Minnesota,2004,1900,3066,66,5032,0.37758346581875996,0.6093004769475358,0.013116057233704292,-70,-165,373,138,-0.024950248933998498,-0.03408459662816739,0.05903484556216587,-1166,-443,-0.2317170111287758,-0.08398509449616437
6716,27117,Pipestone,Minnesota,2008,2023,2652,126,4801,0.42137054780254113,0.5523849198083732,0.02624453238908561,123,60,-414,-231,0.04378708198378117,0.013128475155381316,-0.05691555713916252,-629,537,-0.1310143720058321,0.1007026391229437
6717,27117,Pipestone,Minnesota,2012,1725,2826,95,4646,0.3712871287128713,0.6082651743435213,0.020447696943607405,-298,-31,174,-155,-0.050083419089669845,-0.005796835445478203,0.05588025453514811,-1101,-472,-0.23697804563065006,-0.10596367362481796
6718,27117,Pipestone,Minnesota,2016,1127,3338,343,4808,0.2344009983361065,0.6942595673876872,0.07133943427620633,-598,248,512,162,-0.13688613037676478,0.05089173733259893,0.0859943930441659,-2211,-1110,-0.45985856905158073,-0.22288052342093068
6719,27119,Polk,Minnesota,2000,5764,7609,767,14140,0.40763790664780764,0.5381188118811882,0.05424328147100424,0,0,0,0,0.0,0.0,0.0,-1845,0,-0.13048090523338052,0.0
6720,27119,Polk,Minnesota,2004,6729,8724,215,15668,0.42947408731171816,0.5568036762828695,0.013722236405412305,965,-552,1115,1528,0.02183618066391052,-0.04052104506559193,0.018684864401681378,-1995,-150,-0.12732958897115138,0.0031513162622291424
6721,27119,Polk,Minnesota,2008,7850,7148,336,15334,0.511934263727664,0.46615364549367416,0.021912090778661797,1121,121,-1576,-334,0.08246017641594588,0.008189854373249492,-0.09065003078919537,702,2697,0.04578061823398988,0.17311020720514125
6722,27119,Polk,Minnesota,2012,6773,7615,305,14693,0.4609678077996325,0.5182740080310352,0.020758184169332335,-1077,-31,467,-641,-0.05096645592803156,-0.0011539066093294616,0.05212036253736102,-842,-1544,-0.057306200231402704,-0.10308681846539258
6723,27119,Polk,Minnesota,2016,4712,8979,1105,14796,0.31846444985131117,0.606853203568532,0.0746823465801568,-2061,800,1364,103,-0.1425033579483213,0.053924162410824455,0.08857919553749682,-4267,-3425,-0.28838875371722084,-0.23108255348581813
6724,27121,Pope,Minnesota,2000,2771,2808,408,5987,0.46283614498079173,0.46901620177050274,0.06814765324870553,0,0,0,0,0.0,0.0,0.0,-37,0,-0.006180056789711008,0.0
6725,27121,Pope,Minnesota,2004,3301,3303,96,6700,0.4926865671641791,0.4929850746268657,0.014328358208955224,530,-312,495,713,0.02985042218338735,-0.0538192950397503,0.023968872856362955,-2,35,-0.00029850746268661466,0.0058815493270243935
6726,27121,Pope,Minnesota,2008,3317,3069,150,6536,0.5074969400244798,0.4695532435740514,0.022949816401468787,16,54,-234,-164,0.01481037286030068,0.008621458192513563,-0.023431831052814267,248,250,0.03794369645042833,0.03824220391311495
6727,27121,Pope,Minnesota,2012,2981,3142,123,6246,0.4772654498879283,0.5030419468459815,0.0196926032660903,-336,-27,73,-290,-0.030231490136551464,-0.003257213135378488,0.03348870327193004,-161,-409,-0.025776496958053174,-0.0637201934084815
6728,27121,Pope,Minnesota,2016,2106,3793,420,6319,0.33328058237062824,0.6002532046209843,0.0664662130083874,-875,297,651,73,-0.14398486751730005,0.0467736097422971,0.09721125777500284,-1687,-1526,-0.26697262225035606,-0.2411961252923029
6729,27123,Ramsey,Minnesota,2000,138470,87669,18139,244278,0.5668541579675616,0.3588902807457078,0.07425556128673069,0,0,0,0,0.0,0.0,0.0,50801,0,0.20796387722185378,0.0
6730,27123,Ramsey,Minnesota,2004,171846,97096,3635,272577,0.6304493776070615,0.3562149410992123,0.013335681293726176,33376,-14504,9427,28299,0.06359521963949999,-0.060919879993004515,-0.002675339646495467,74750,23949,0.27423443650784923,0.06627055928599546
6731,27123,Ramsey,Minnesota,2008,182974,88942,5470,277386,0.6596367516745618,0.3206434355014312,0.01971981282400698,11128,1835,-8154,4809,0.02918737406750027,0.006384131530280805,-0.035571505597781106,94032,19282,0.3389933161731306,0.06475887966528138
6732,27123,Ramsey,Minnesota,2012,184938,86800,7076,278814,0.6633024166648733,0.31131865688236604,0.02537892645276062,1964,1606,-2142,1428,0.0036656649903115124,0.00565911362875364,-0.009324778619065166,98138,4106,0.3519837597825073,0.012990443609376678
6733,27123,Ramsey,Minnesota,2016,177738,70894,24511,273143,0.6507140948148039,0.259549027432517,0.089736877752679,-7200,17435,-15906,-5671,-0.012588321850069417,0.06435795129991838,-0.05176962944984903,106844,8706,0.3911650673822869,0.03918130759977961
6734,27125,Red Lake,Minnesota,2000,830,1090,170,2090,0.39712918660287083,0.5215311004784688,0.08133971291866028,0,0,0,0,0.0,0.0,0.0,-260,0,-0.12440191387559801,0.0
6735,27125,Red Lake,Minnesota,2004,963,1164,50,2177,0.4423518603582912,0.534680753330271,0.022967386311437757,133,-120,74,87,0.045222673755420384,-0.058372326607222524,0.01314965285180214,-201,59,-0.09232889297197977,0.03207302090361824
6736,27125,Red Lake,Minnesota,2008,1120,983,88,2191,0.5111821086261981,0.44865358283888634,0.040164308534915566,157,38,-181,14,0.06883024826790685,0.01719692222347781,-0.08602717049138464,137,338,0.06252852578731172,0.1548574187592915
6737,27125,Red Lake,Minnesota,2012,928,978,69,1975,0.46987341772151897,0.4951898734177215,0.034936708860759495,-192,-19,-5,-216,-0.04130869090467909,-0.005227599674156071,0.04653629057883518,-50,-187,-0.025316455696202556,-0.08784498148351427
6738,27125,Red Lake,Minnesota,2016,540,1141,200,1881,0.28708133971291866,0.6065922381711856,0.1063264221158958,-388,131,163,-94,-0.1827920780086003,0.0713897132551363,0.11140236475346404,-601,-551,-0.3195108984582669,-0.29419444276206436
6739,27127,Redwood,Minnesota,2000,2681,4589,478,7748,0.34602478058853897,0.5922818791946308,0.06169334021683015,0,0,0,0,0.0,0.0,0.0,-1908,0,-0.24625709860609185,0.0
6740,27127,Redwood,Minnesota,2004,3104,4898,137,8139,0.3813736331244625,0.6017938321661138,0.016832534709423762,423,-341,309,391,0.035348852535923514,-0.044860805507406384,0.009511952971482995,-1794,114,-0.22042019904165133,0.02583689956444052
6741,27127,Redwood,Minnesota,2008,3250,4308,248,7806,0.41634640020497055,0.5518831667947732,0.03177043300025621,146,111,-590,-333,0.03497276708050806,0.01493789829083245,-0.04991066537134059,-1058,736,-0.13553676658980268,0.08488343245184865
6742,27127,Redwood,Minnesota,2012,3008,4570,212,7790,0.38613607188703464,0.5866495507060334,0.027214377406931965,-242,-36,262,-16,-0.03021032831793591,-0.004556055593324247,0.03476638391126019,-1562,-504,-0.20051347881899878,-0.0649767122291961
6743,27127,Redwood,Minnesota,2016,1887,5137,587,7611,0.24793062672447774,0.6749441597687558,0.07712521350676652,-1121,375,567,-179,-0.1382054451625569,0.04991083609983455,0.08829460906272235,-3250,-1688,-0.427013533044278,-0.22650005422527925
6744,27129,Renville,Minnesota,2000,3533,4036,553,8122,0.43499138143314453,0.4969219404087663,0.06808667815808914,0,0,0,0,0.0,0.0,0.0,-503,0,-0.061930558975621774,0.0
6745,27129,Renville,Minnesota,2004,3787,4430,132,8349,0.45358725595879745,0.5306024673613606,0.015810276679841896,254,-421,394,227,0.018595874525652922,-0.05227640147824724,0.033680526952594325,-643,-140,-0.07701521140256318,-0.015084652426941403
6746,27129,Renville,Minnesota,2008,3904,3956,275,8135,0.47990165949600494,0.4862937922556853,0.03380454824830977,117,143,-474,-214,0.026314403537207487,0.017994271568467876,-0.04430867510567532,-52,591,-0.006392132759680369,0.07062307864288281
6747,27129,Renville,Minnesota,2012,3394,4149,167,7710,0.44020752269779506,0.5381322957198443,0.02166018158236057,-510,-108,193,-425,-0.03969413679820988,-0.012144366665949202,0.051838503464159025,-755,-703,-0.09792477302204927,-0.0915326402623689
6748,27129,Renville,Minnesota,2016,2117,4890,599,7606,0.2783328950828293,0.6429134893505127,0.0787536155666579,-1277,432,741,-104,-0.16187462761496574,0.05709343398429733,0.1047811936306684,-2773,-2018,-0.3645805942676834,-0.26665582124563414
6749,27131,Rice,Minnesota,2000,13140,10876,2005,26021,0.5049767495484416,0.4179701010722109,0.07705314937934744,0,0,0,0,0.0,0.0,0.0,2264,0,0.08700664847623074,0.0
6750,27131,Rice,Minnesota,2004,16425,13881,439,30745,0.5342332086518133,0.45148804683688404,0.01427874451130265,3285,-1566,3005,4724,0.029256459103371713,-0.0627744048680448,0.03351794576467315,2544,280,0.0827451618149293,-0.004261486661301439
6751,27131,Rice,Minnesota,2008,17381,13723,695,31799,0.5465895153935658,0.4315544513978427,0.021856033208591464,956,256,-158,1054,0.012356306741752476,0.007577288697288813,-0.01993359543904133,3658,1114,0.11503506399572311,0.032289902180793806
6752,27131,Rice,Minnesota,2012,17054,14384,829,32267,0.528527597855394,0.44578051879629343,0.025691883348312516,-327,134,661,468,-0.018061917538171768,0.0038358501397210525,0.014226067398450726,2670,-988,0.08274707905910061,-0.032287984936622494
6753,27131,Rice,Minnesota,2016,14437,15429,2577,32443,0.4449958388558395,0.47557254261319853,0.07943161853096199,-2617,1748,1045,176,-0.08353175899955456,0.053739735182649476,0.0297920238169051,-992,-3662,-0.030576703757359047,-0.11332378281645966
6754,27133,Rock,Minnesota,2000,2081,2772,157,5010,0.4153692614770459,0.5532934131736527,0.0313373253493014,0,0,0,0,0.0,0.0,0.0,-691,0,-0.13792415169660677,0.0
6755,27133,Rock,Minnesota,2004,2000,3111,80,5191,0.38528221922558276,0.599306492005394,0.015411288769023309,-81,-77,339,181,-0.030087042251463136,-0.01592603658027809,0.04601307883174133,-1111,-420,-0.21402427277981123,-0.07610012108320446
6756,27133,Rock,Minnesota,2008,2079,2775,121,4975,0.4178894472361809,0.5577889447236181,0.024321608040201004,79,41,-336,-216,0.03260722801059812,0.008910319271177695,-0.041517547281775924,-696,415,-0.13989949748743719,0.07412477529237405
6757,27133,Rock,Minnesota,2012,1946,2810,90,4846,0.40156830375567476,0.5798596780850186,0.018572018159306643,-133,-31,35,-129,-0.016321143480506117,-0.00574958988089436,0.02207073336140053,-864,-168,-0.17829137432934383,-0.03839187684190665
6758,27133,Rock,Minnesota,2016,1373,3091,375,4839,0.28373630915478404,0.6387683405662327,0.07749535027898326,-573,285,281,-7,-0.11783199460089072,0.05892333211967661,0.05890866248121407,-1718,-854,-0.3550320314114486,-0.1767406570821048
6759,27135,Roseau,Minnesota,2000,2128,4695,343,7166,0.29695785654479484,0.6551772257884454,0.047864917666759696,0,0,0,0,0.0,0.0,0.0,-2567,0,-0.35821936924365055,0.0
6760,27135,Roseau,Minnesota,2004,2442,5355,114,7911,0.3086841107318923,0.676905574516496,0.01441031475161168,314,-229,660,745,0.01172625418709744,-0.03345460291514801,0.021728348728050628,-2913,-346,-0.36822146378460374,-0.010002094540953188
6761,27135,Roseau,Minnesota,2008,3097,4438,165,7700,0.4022077922077922,0.5763636363636364,0.02142857142857143,655,51,-917,-211,0.0935236814758999,0.007018256676959749,-0.10054193815285961,-1341,1572,-0.17415584415584423,0.1940656196287595
6762,27135,Roseau,Minnesota,2012,2772,4409,171,7352,0.37704026115342765,0.5997007616974973,0.023258977149075082,-325,6,-29,-348,-0.025167531054364534,0.0018304057205036535,0.023337125333860897,-1637,-296,-0.22266050054406966,-0.04850465638822543
6763,27135,Roseau,Minnesota,2016,1856,5451,497,7804,0.23782675550999488,0.6984879548949257,0.06368528959507945,-916,326,1042,452,-0.13921350564343277,0.040426312446004364,0.09878719319742835,-3595,-1958,-0.4606611993849308,-0.2380006988408611
6764,27137,St. Louis,Minnesota,2000,64237,35420,7807,107464,0.597753666344078,0.32959874934861905,0.0726475843073029,0,0,0,0,0.0,0.0,0.0,28817,0,0.26815491699545896,0.0
6765,27137,St. Louis,Minnesota,2004,77958,40112,1495,119565,0.6520135491155439,0.33548279178689416,0.012503659097561995,13721,-6312,4692,12101,0.05425988277146587,-0.06014392520974091,0.005884042438275117,37846,9029,0.3165307573286497,0.048375840333190756
6766,27137,St. Louis,Minnesota,2008,77351,38742,2721,118814,0.6510259733701416,0.32607268503711684,0.022901341592741598,-607,1226,-1370,-751,-0.0009875757454023137,0.010397682495179602,-0.009410106749777325,38609,763,0.3249532883330247,0.008422531004375011
6767,27137,St. Louis,Minnesota,2012,73378,39131,3084,115593,0.6347962246848857,0.3385239590632651,0.02667981625184916,-3973,363,389,-3221,-0.01622974868525584,0.003778474659107564,0.012451274026148262,34247,-4362,0.2962722656216206,-0.028681022711404103
6768,27137,St. Louis,Minnesota,2016,57771,44630,10021,112422,0.5138762875593745,0.39698635498389995,0.08913735745672555,-15607,6937,5499,-3171,-0.12091993712551119,0.062457541204876385,0.058462395920634846,13141,-21106,0.11688993257547459,-0.17938233304614604
6769,27139,Scott,Minnesota,2000,17503,23954,2336,43793,0.3996757472655447,0.546982394446601,0.053341858287854226,0,0,0,0,0.0,0.0,0.0,-6451,0,-0.1473066471810563,0.0
6770,27139,Scott,Minnesota,2004,23958,36055,626,60639,0.3950922673526938,0.5945843434093571,0.010323389237949175,6455,-1710,12101,16846,-0.004583479912850907,-0.04301846904990505,0.04760194896275605,-12097,-5646,-0.19949207605666325,-0.052185428875606954
6771,27139,Scott,Minnesota,2008,29208,36724,1200,67132,0.43508311982363107,0.5470416492879699,0.017875230888398975,5250,574,669,6493,0.039990852470937255,0.0075518416504498,-0.04754269412138712,-7516,4581,-0.11195852946433887,0.08753354659232437
6772,27139,Scott,Minnesota,2012,29712,40323,1612,71647,0.4146998478652281,0.5628009546805868,0.0224991974541851,504,412,3599,4515,-0.02038327195840295,0.0046239665657861265,0.01575930539261683,-10611,-3095,-0.14810110681535865,-0.03614257735101978
6773,27139,Scott,Minnesota,2016,28502,39948,6579,75029,0.3798797798184702,0.5324341254714844,0.08768609471004545,-1210,4967,-375,3382,-0.03482006804675791,0.06518689725586034,-0.030366829209102386,-11446,-835,-0.15255434565301418,-0.0044532388376555265
6774,27141,Sherburne,Minnesota,2000,12109,16813,1913,30835,0.3927030971298849,0.5452570131344252,0.06203988973568996,0,0,0,0,0.0,0.0,0.0,-4704,0,-0.15255391600454032,0.0
6775,27141,Sherburne,Minnesota,2004,15816,25182,456,41454,0.38153133593863076,0.6074685193226227,0.011000144738746562,3707,-1457,8369,10619,-0.011171761191254126,-0.0510397449969434,0.062211506188197485,-9366,-4662,-0.22593718338399194,-0.07338326737945161
6776,27141,Sherburne,Minnesota,2008,17957,26140,893,44990,0.3991331406979329,0.5810180040008891,0.01984885530117804,2141,437,958,3536,0.01760180475930212,0.008848710562431477,-0.026450515321733592,-8183,1183,-0.18188486330295622,0.04405232008103571
6777,27141,Sherburne,Minnesota,2012,17597,27848,1064,46509,0.37835687716355976,0.5987658302694102,0.022877292567030038,-360,171,1708,1519,-0.02077626353437312,0.0030284372658519985,0.017747826268521116,-10251,-2068,-0.22040895310585046,-0.038524089802894235
6778,27141,Sherburne,Minnesota,2016,13293,31053,3937,48283,0.2753142928152766,0.6431456206118096,0.08154008657291387,-4304,2873,3205,1774,-0.10304258434828317,0.058662794005883825,0.04437979034239936,-17760,-7509,-0.367831327796533,-0.14742237469068253
6779,27143,Sibley,Minnesota,2000,2687,4087,561,7335,0.3663258350374915,0.5571915473755965,0.07648261758691206,0,0,0,0,0.0,0.0,0.0,-1400,0,-0.190865712338105,0.0
6780,27143,Sibley,Minnesota,2004,3109,4669,171,7949,0.3911183796703988,0.5873694804377909,0.021512139891810292,422,-390,582,614,0.02479254463290731,-0.05497047769510177,0.030177933062194406,-1560,-160,-0.1962511007673921,-0.005385388429287097
6781,27143,Sibley,Minnesota,2008,2998,4492,239,7729,0.38788976581705265,0.5811877345064045,0.03092249967654289,-111,68,-177,-220,-0.003228613853346163,0.009410359784732598,-0.006181745931386429,-1494,66,-0.19329796868935184,0.002953132078040266
6782,27143,Sibley,Minnesota,2012,2916,4693,206,7815,0.3731285988483685,0.600511836212412,0.02635956493921945,-82,-33,201,86,-0.014761166968684125,-0.0045629347373234395,0.019324101706007513,-1777,-283,-0.22738323736404348,-0.03408526867469164
6783,27143,Sibley,Minnesota,2016,1954,5193,627,7774,0.2513506560329303,0.6679958837149472,0.08065346025212246,-962,421,500,-41,-0.12177794281543824,0.054293895312903004,0.06748404750253523,-3239,-1462,-0.41664522768201695,-0.18926199031797347
6784,27145,Stearns,Minnesota,2000,24800,32402,5274,62476,0.3969524297330175,0.5186311543632754,0.08441641590370702,0,0,0,0,0.0,0.0,0.0,-7602,0,-0.12167872463025797,0.0
6785,27145,Stearns,Minnesota,2004,32659,41726,1192,75577,0.4321288222607407,0.5520991836140625,0.01577199412519682,7859,-4082,9324,13101,0.0351763925277232,-0.0686444217785102,0.03346802925078707,-9067,-1465,-0.11997036135332184,0.0017083632769361312
6786,27145,Stearns,Minnesota,2008,35690,41194,1872,78756,0.45317182182944793,0.5230585606176037,0.023769617552948347,3031,680,-532,3179,0.021042999568707255,0.007997623427751527,-0.02904062299645882,-5504,3563,-0.06988673878815577,0.050083622565166075
6787,27145,Stearns,Minnesota,2012,33551,43015,1909,78475,0.4275374323032813,0.5481363491557821,0.024326218540936605,-2139,37,1821,-281,-0.025634389526166645,0.000556600987988258,0.025077788538178436,-9464,-3960,-0.12059891685250085,-0.05071217806434508
6788,27145,Stearns,Minnesota,2016,25576,47617,6399,79592,0.32133882802291686,0.5982636445873957,0.0803975273896874,-7975,4490,4602,1117,-0.10619860428036443,0.0560713088487508,0.05012729543161354,-22041,-12577,-0.2769248165644788,-0.15632589971197797
6789,27147,Steele,Minnesota,2000,6900,8223,943,16066,0.4294784015934271,0.5118262168554711,0.058695381551101704,0,0,0,0,0.0,0.0,0.0,-1323,0,-0.08234781526204404,0.0
6790,27147,Steele,Minnesota,2004,7994,10389,312,18695,0.42760096282428456,0.5557100829098689,0.016688954265846483,1094,-631,2166,2629,-0.0018774387691425365,-0.04200642728525522,0.04388386605439776,-2395,-1072,-0.12810912008558434,-0.045761304823540294
6791,27147,Steele,Minnesota,2008,9016,10068,572,19656,0.4586894586894587,0.5122100122100122,0.0291005291005291,1022,260,-321,961,0.03108849586517415,0.012411574834682616,-0.04350007069985673,-1052,1343,-0.05352055352055346,0.07458856656503088
6792,27147,Steele,Minnesota,2012,8706,9903,514,19123,0.45526329550802697,0.5178580766616117,0.026878627830361344,-310,-58,-165,-533,-0.0034261631814317406,-0.0022219012701677546,0.005648064451599488,-1197,-145,-0.06259478115358469,-0.009074227633031229
6793,27147,Steele,Minnesota,2016,6241,11198,1740,19179,0.3254079983315084,0.583867772042338,0.0907242296261536,-2465,1226,1295,56,-0.12985529717651856,0.06384560179579227,0.06600969538072632,-4957,-3760,-0.25845977371082957,-0.19586499255724488
6794,27149,Stevens,Minnesota,2000,2434,2831,487,5752,0.42315716272600834,0.4921766342141864,0.08466620305980528,0,0,0,0,0.0,0.0,0.0,-397,0,-0.06901947148817805,0.0
6795,27149,Stevens,Minnesota,2004,2821,3030,98,5949,0.47419734409144393,0.5093292990418558,0.016473356866700286,387,-389,199,197,0.05104018136543559,-0.06819284619310499,0.01715266482766936,-209,188,-0.035131954950411826,0.03388751653776623
6796,27149,Stevens,Minnesota,2008,2781,2710,143,5634,0.4936102236421725,0.481008164714235,0.025381611643592473,-40,45,-320,-315,0.019412879550728568,0.008908254776892187,-0.028321134327620734,71,280,0.012602058927937476,0.0477340138783493
6797,27149,Stevens,Minnesota,2012,2742,2766,144,5652,0.4851380042462845,0.4893842887473461,0.025477707006369428,-39,1,56,18,-0.008472219395887992,9.609536277695521e-05,0.008376124033111054,-24,-95,-0.00424628450106157,-0.016848343428999046
6798,27149,Stevens,Minnesota,2016,2116,2799,483,5398,0.39199703593923674,0.5185253797702853,0.08947758429047796,-626,339,33,-254,-0.09314096830704777,0.06399987728410853,0.02914109102293927,-683,-659,-0.1265283438310486,-0.12228205932998704
6799,27151,Swift,Minnesota,2000,2698,2376,363,5437,0.49622953834835387,0.4370057016737171,0.06676475997792901,0,0,0,0,0.0,0.0,0.0,322,0,0.059223836674636765,0.0
6800,27151,Swift,Minnesota,2004,3165,2481,89,5735,0.5518744551002616,0.43260680034873583,0.015518744551002616,467,-274,105,298,0.05564491675190769,-0.05124601542692639,-0.004398901324981275,684,362,0.11926765475152573,0.060043818076888966
6801,27151,Swift,Minnesota,2008,2907,2184,153,5244,0.5543478260869565,0.41647597254004576,0.02917620137299771,-258,64,-297,-491,0.0024733709866949782,0.013657456821995095,-0.016130827808690074,723,39,0.13787185354691078,0.018604198795385052
6802,27151,Swift,Minnesota,2012,2751,2248,120,5119,0.5374096503223286,0.43914827114670835,0.023442078530963077,-156,-33,64,-125,-0.016938175764627972,-0.005734122842034634,0.02267229860666259,503,-220,0.09826137917562022,-0.03961047437129056
6803,27151,Swift,Minnesota,2016,1686,2963,345,4994,0.33760512615138166,0.5933119743692431,0.06908289947937525,-1065,225,715,-125,-0.1998045241709469,0.045640820948412174,0.15416370322253475,-1277,-1780,-0.25570684821786144,-0.35396822739348166
6804,27153,Todd,Minnesota,2000,4132,6031,929,11092,0.3725207356653444,0.5437252073566534,0.08375405697800216,0,0,0,0,0.0,0.0,0.0,-1899,0,-0.17120447169130903,0.0
6805,27153,Todd,Minnesota,2004,5034,6945,235,12214,0.412149991812674,0.5686097920419191,0.01924021614540691,902,-694,914,1122,0.039629256147329595,-0.06451384083259525,0.024884584685265665,-1911,-12,-0.1564598002292451,0.01474467146206393
6806,27153,Todd,Minnesota,2008,5277,6637,343,12257,0.43052949335073837,0.541486497511626,0.027984009137635636,243,108,-308,43,0.01837950153806439,0.008743792992228726,-0.02712329453029305,-1360,551,-0.11095700416088766,0.04550279606835744
6807,27153,Todd,Minnesota,2012,4819,6719,265,11803,0.40828602897568417,0.5692620520206727,0.022451919003643142,-458,-78,82,-454,-0.0222434643750542,-0.005532090133992494,0.027775554509046674,-1900,-540,-0.16097602304498854,-0.050019018884100874
6808,27153,Todd,Minnesota,2016,2783,8485,725,11993,0.2320520303510381,0.7074960393562911,0.06045193029267072,-2036,460,1766,190,-0.17623399862464606,0.03800001128902758,0.13823398733561842,-5702,-3802,-0.475444009005253,-0.3144679859602645
6809,27155,Traverse,Minnesota,2000,884,1074,148,2106,0.41975308641975306,0.50997150997151,0.07027540360873694,0,0,0,0,0.0,0.0,0.0,-190,0,-0.09021842355175691,0.0
6810,27155,Traverse,Minnesota,2004,1026,1076,39,2141,0.47921531994395145,0.5025688930406352,0.01821578701541336,142,-109,2,35,0.05946223352419838,-0.052059616593323574,-0.007402616930874739,-50,140,-0.02335357309668379,0.06686485045507312
6811,27155,Traverse,Minnesota,2008,1043,933,59,2035,0.5125307125307126,0.45847665847665847,0.028992628992628992,17,20,-143,-106,0.03331539258676114,0.010776841977215634,-0.04409223456397676,110,160,0.05405405405405411,0.0774076271507379
6812,27155,Traverse,Minnesota,2012,943,861,43,1847,0.5105576610720086,0.466161342717921,0.023280996210070383,-100,-16,-72,-188,-0.001973051458703967,-0.005711632782558609,0.007684684241262507,82,-28,0.04439631835408764,-0.009657735699966474
6813,27155,Traverse,Minnesota,2016,630,1049,119,1798,0.3503893214682981,0.5834260289210234,0.06618464961067853,-313,76,188,-49,-0.16016833960371052,0.04290365340060815,0.11726468620310238,-419,-501,-0.23303670745272526,-0.2774330258068129
6814,27157,Wabasha,Minnesota,2000,4522,5245,764,10531,0.42939891748172065,0.49805336625201785,0.07254771626626151,0,0,0,0,0.0,0.0,0.0,-723,0,-0.0686544487702972,0.0
6815,27157,Wabasha,Minnesota,2004,5548,6120,167,11835,0.4687790452049007,0.5171102661596958,0.014110688635403464,1026,-597,875,1304,0.03938012772318006,-0.05843702763085805,0.01905689990767795,-572,151,-0.048331220954795084,0.02032322781550211
6816,27157,Wabasha,Minnesota,2008,5646,5935,312,11893,0.47473303623980495,0.4990330446481123,0.026233919112082737,98,145,-185,58,0.005953991034904238,0.012123230476679273,-0.018077221511583474,-289,283,-0.024300008408307372,0.024031212546487712
6817,27157,Wabasha,Minnesota,2012,5415,6049,298,11762,0.46038088760414897,0.5142832851555857,0.02533582724026526,-231,-14,114,-131,-0.014352148635655981,-0.000898091871817476,0.015250240507473423,-634,-345,-0.053902397551436776,-0.029602389143129404
6818,27157,Wabasha,Minnesota,2016,3866,6989,977,11832,0.3267410412440838,0.5906862745098039,0.08257268424611224,-1549,679,940,70,-0.13363984636006515,0.05723685700584698,0.07640298935421819,-3123,-2489,-0.2639452332657201,-0.21004283571428334
6819,27159,Wadena,Minnesota,2000,2251,3733,398,6382,0.3527107489815105,0.5849263553744908,0.062362895643998745,0,0,0,0,0.0,0.0,0.0,-1482,0,-0.23221560639298028,0.0
6820,27159,Wadena,Minnesota,2004,2791,4214,88,7093,0.3934865360214296,0.5941068659241505,0.01240659805441985,540,-310,481,711,0.040775787039919076,-0.049956297589578896,0.009180510549659737,-1423,59,-0.20062032990272094,0.03159527649025934
6821,27159,Wadena,Minnesota,2008,2882,4128,159,7169,0.4020086483470498,0.5758125261542754,0.02217882549867485,91,71,-86,76,0.008522112325620224,0.009772227444255,-0.018294339769875156,-1246,177,-0.17380387780722556,0.02681645209549538
6822,27159,Wadena,Minnesota,2012,2492,4143,156,6791,0.36695626564570755,0.6100721543218967,0.022971580032395817,-390,-3,15,-378,-0.035052382701342255,0.0007927545337209664,0.03425962816762129,-1651,-405,-0.2431158886761891,-0.06931201086896355
6823,27159,Wadena,Minnesota,2016,1684,4837,413,6934,0.24286126334006344,0.6975771560426882,0.05956158061724834,-808,257,694,143,-0.1240950023056441,0.036590000584852525,0.08750500172079156,-3153,-1502,-0.4547158927026248,-0.2116000040264357
6824,27161,Waseca,Minnesota,2000,3694,4608,562,8864,0.41674187725631767,0.51985559566787,0.06340252707581227,0,0,0,0,0.0,0.0,0.0,-914,0,-0.10311371841155231,0.0
6825,27161,Waseca,Minnesota,2004,4179,5457,164,9800,0.42642857142857143,0.5568367346938775,0.01673469387755102,485,-398,849,936,0.009686694172253763,-0.046667833198261253,0.036981139026007526,-1278,-364,-0.13040816326530608,-0.027294444853753763
6826,27161,Waseca,Minnesota,2008,4401,5211,276,9888,0.44508495145631066,0.527002427184466,0.027912621359223302,222,112,-246,88,0.018656380027739228,0.011177927481672283,-0.029834307509411517,-810,468,-0.08191747572815533,0.048490687537150745
6827,27161,Waseca,Minnesota,2012,4370,5116,261,9747,0.44834307992202727,0.5248794500872063,0.02677746999076639,-31,-15,-95,-141,0.003258128465716603,-0.0011351513684569117,-0.002122977097259726,-746,64,-0.076536370165179,0.005381105562976329
6828,27161,Waseca,Minnesota,2016,2838,5967,848,9653,0.29400186470527295,0.618149797990262,0.08784833730446494,-1532,587,851,-94,-0.1543412152167543,0.06107086731369855,0.09327034790305577,-3129,-2383,-0.3241479332849891,-0.24761156311981009
6829,27163,Washington,Minnesota,2000,49637,51502,5870,107009,0.46385818015307123,0.48128662075152556,0.05485519909540319,0,0,0,0,0.0,0.0,0.0,-1865,0,-0.01742844059845433,0.0
6830,27163,Washington,Minnesota,2004,61395,65751,1303,128449,0.47797180203816303,0.5118840940762481,0.010144103885588833,11758,-4567,14249,21440,0.014113621885091798,-0.04471109520981436,0.03059747332472257,-4356,-2491,-0.0339122920380851,-0.01648385143963077
6831,27163,Washington,Minnesota,2008,70277,64334,2448,137059,0.5127499835837122,0.46938909520717353,0.01786092120911432,8882,1145,-1417,8610,0.034778181545549125,0.0077168173235254885,-0.042494998869074596,5943,10299,0.04336088837653862,0.07727318041462372
6832,27163,Washington,Minnesota,2012,70203,69137,2793,142133,0.49392470432622965,0.48642468673707023,0.019650608936700134,-74,345,4803,5074,-0.018825279257482508,0.0017896877275858127,0.0170355915298967,1066,-4877,0.007500017589159413,-0.035860870787379207
6833,27163,Washington,Minnesota,2016,67086,64428,12721,144235,0.46511595659860644,0.4466876971608833,0.08819634624051027,-3117,9928,-4709,2102,-0.028808747727623207,0.06854573730381014,-0.03973698957618693,2658,1592,0.018428259437723138,0.010928241848563724
6834,27165,Watonwan,Minnesota,2000,2258,2562,314,5134,0.4398130112972341,0.49902610050642776,0.06116088819633814,0,0,0,0,0.0,0.0,0.0,-304,0,-0.05921308920919366,0.0
6835,27165,Watonwan,Minnesota,2004,2514,2970,99,5583,0.4502955400322407,0.5319720580333154,0.017732401934443847,256,-215,408,449,0.010482528735006602,-0.043428486261894286,0.032945957526887615,-456,-152,-0.08167651800107467,-0.022463428791881013
6836,27165,Watonwan,Minnesota,2008,2562,2526,170,5258,0.4872575123621149,0.4804108025865348,0.032331685051350326,48,71,-444,-325,0.03696197232987419,0.014599283116906479,-0.051561255446780585,36,492,0.0068467097755801065,0.08852322777665478
6837,27165,Watonwan,Minnesota,2012,2494,2517,133,5144,0.4848367029548989,0.4893079315707621,0.025855365474339035,-68,-37,-9,-114,-0.002420809407216007,-0.006476319577011291,0.008897128984227287,-23,-59,-0.0044712286158631875,-0.011317938391443294
6838,27165,Watonwan,Minnesota,2016,1814,2768,416,4998,0.3629451780712285,0.5538215286114446,0.08323329331732693,-680,283,251,-146,-0.12189152488367039,0.0573779278429879,0.06451359704068255,-954,-931,-0.19087635054021612,-0.18640512192435293
6839,27167,Wilkin,Minnesota,2000,1046,2032,227,3305,0.31649016641452343,0.6148260211800303,0.0686838124054463,0,0,0,0,0.0,0.0,0.0,-986,0,-0.29833585476550684,0.0
6840,27167,Wilkin,Minnesota,2004,1169,2303,55,3527,0.33144315282109443,0.6529628579529345,0.01559398922597108,123,-172,271,222,0.014952986406571,-0.05308982317947522,0.03813683677290425,-1134,-148,-0.3215197051318401,-0.023183850366333247
6841,27167,Wilkin,Minnesota,2008,1550,1786,78,3414,0.45401288810779145,0.5231400117164616,0.022847100175746926,381,23,-517,-113,0.12256973528669701,0.007253110949775847,-0.1298228462364729,-236,898,-0.06912712360867018,0.2523925815231699
6842,27167,Wilkin,Minnesota,2012,1258,1884,79,3221,0.39056193728655697,0.5849115181620614,0.02452654455138156,-292,1,98,-193,-0.06345095082123448,0.0016794443756346332,0.06177150644559981,-626,-390,-0.19434958087550447,-0.1252224572668343
6843,27167,Wilkin,Minnesota,2016,893,2129,280,3302,0.2704421562689279,0.6447607510599637,0.08479709267110842,-365,201,245,81,-0.12011978101762905,0.06027054811972686,0.05984923289790223,-1236,-610,-0.37431859479103574,-0.17996901391553127
6844,27169,Winona,Minnesota,2000,11069,10773,2076,23918,0.46278953089723224,0.4504139142068735,0.0867965548958943,0,0,0,0,0.0,0.0,0.0,296,0,0.012375616690358748,0.0
6845,27169,Winona,Minnesota,2004,14231,12686,505,27422,0.5189628765225002,0.4626212530085333,0.018415870468966523,3162,-1571,1913,3504,0.056173345625267934,-0.06838068442692778,0.012207338801659806,1545,1249,0.056341623513966876,0.04396600682360813
6846,27169,Winona,Minnesota,2008,16308,10975,652,27935,0.5837837837837838,0.3928763200286379,0.023339896187578306,2077,147,-1711,513,0.06482090726128364,0.004924025718611783,-0.06974493297989537,5333,3788,0.1909074637551459,0.134565840241179
6847,27169,Winona,Minnesota,2012,14980,11480,772,27232,0.5500881316098707,0.4215628672150411,0.02834900117508813,-1328,120,505,-703,-0.033695652173913127,0.005009104987509824,0.028686547186403177,3500,-1833,0.12852526439482959,-0.062382199360316304
6848,27169,Winona,Minnesota,2016,11366,12122,2586,26074,0.4359131702078699,0.4649075707601442,0.09917925903198589,-3614,1814,642,-1158,-0.11417496140200079,0.07083025785689775,0.043344703545103114,-756,-4256,-0.028994400552274313,-0.1575196649471039
6849,27171,Wright,Minnesota,2000,16762,23861,2743,43366,0.3865240049808606,0.5502236775353964,0.06325231748374302,0,0,0,0,0.0,0.0,0.0,-7099,0,-0.16369967255453577,0.0
6850,27171,Wright,Minnesota,2004,22618,36176,740,59534,0.37991735814828503,0.6076527698458024,0.012429872005912588,5856,-2003,12315,16168,-0.006606646832575558,-0.050822445477830436,0.05742909231040605,-13558,-6459,-0.22773541169751738,-0.06403573914298161
6851,27171,Wright,Minnesota,2008,26343,37779,1456,65578,0.40170484003781753,0.5760925920278142,0.02220256793436823,3725,716,1603,6044,0.0217874818895325,0.009772695928455644,-0.031560177817988255,-11436,2122,-0.17438775198999662,0.053347659707520756
6852,27171,Wright,Minnesota,2012,25741,40466,1605,67812,0.3795935822568277,0.5967380404648145,0.023668377278357813,-602,149,2687,2234,-0.022111257780989824,0.0014658093439895818,0.020645448437000335,-14725,-3289,-0.21714445820798678,-0.04275670621799016
6853,27171,Wright,Minnesota,2016,20334,43274,6010,69618,0.2920796345772645,0.6215921169812405,0.08632824844149502,-5407,4405,2808,1806,-0.08751394767956322,0.0626598711631372,0.024854076516426016,-22940,-8215,-0.329512482403976,-0.11236802419598924
6854,27173,Yellow Medicine,Minnesota,2000,2528,2598,389,5515,0.45838621940163193,0.47107887579329105,0.07053490480507706,0,0,0,0,0.0,0.0,0.0,-70,0,-0.012692656391659118,0.0
6855,27173,Yellow Medicine,Minnesota,2004,2799,2878,81,5758,0.48610628690517543,0.4998263285863147,0.0140673845085099,271,-308,280,243,0.0277200675035435,-0.05646752029656715,0.028747452793023653,-79,-9,-0.013720041681139272,-0.0010273852894801538
6856,27173,Yellow Medicine,Minnesota,2008,2816,2579,174,5569,0.505656311725624,0.46309929969473873,0.031244388579637277,17,93,-299,-189,0.01955002482044854,0.017177004071127377,-0.036727028891575975,237,316,0.042557012030885244,0.056277053712024516
6857,27173,Yellow Medicine,Minnesota,2012,2465,2806,143,5414,0.4553010712966383,0.5182859253786479,0.026413003324713705,-351,-31,227,-155,-0.05035524042898565,-0.004831385254923572,0.055186625683909196,-341,-578,-0.0629848540820096,-0.10554186611289484
6858,27173,Yellow Medicine,Minnesota,2016,1524,3382,370,5276,0.288855193328279,0.6410159211523881,0.07012888551933283,-941,227,576,-138,-0.1664458779683593,0.043715882194619124,0.12272999577374022,-1858,-1517,-0.3521607278241091,-0.2891758737420995
6859,28001,Adams,Mississippi,2000,8065,6691,123,14879,0.5420391155319578,0.44969419987902415,0.008266684589018079,0,0,0,0,0.0,0.0,0.0,1374,0,0.09234491565293368,0.0
6860,28001,Adams,Mississippi,2004,8423,6996,60,15479,0.5441565992635183,0.451967181342464,0.0038762193940177015,358,-63,305,600,0.00211748373156051,-0.0043904651950003775,0.0022729814634398493,1427,53,0.09218941792105434,-0.00015549773187933935
6861,28001,Adams,Mississippi,2008,9021,6566,109,15696,0.5747324159021406,0.4183231396534149,0.006944444444444444,598,49,-430,217,0.0305758166386223,0.0030682250504267426,-0.03364404168904911,2455,1028,0.15640927624872575,0.06421985832767141
6862,28001,Adams,Mississippi,2012,9061,6293,93,15447,0.5865863921797113,0.40739302129863403,0.0060205865216546904,40,-16,-273,-249,0.011853976277570677,-0.0009238579227897536,-0.01093011835478086,2768,313,0.17919337088107729,0.022784094632351537
6863,28001,Adams,Mississippi,2016,7757,5874,205,13836,0.5606389129806303,0.42454466608846486,0.014816420930904886,-1304,112,-419,-1611,-0.025947479199081025,0.008795834409250195,0.017151644789830833,1883,-885,0.13609424689216543,-0.04309912398891186
6864,28003,Alcorn,Mississippi,2000,5059,7254,325,12638,0.4003006804874189,0.5739832251938598,0.025716094318721315,0,0,0,0,0.0,0.0,0.0,-2195,0,-0.1736825447064409,0.0
6865,28003,Alcorn,Mississippi,2004,5454,8634,151,14239,0.38303251632839386,0.6063628063768524,0.010604677294753844,395,-174,1380,1601,-0.017268164159025046,-0.01511141702396747,0.032379581182992556,-3180,-985,-0.2233302900484585,-0.0496477453420176
6866,28003,Alcorn,Mississippi,2008,4130,10805,247,15182,0.27203267026742195,0.7116980634962455,0.0162692662363325,-1324,96,2171,943,-0.11099984606097191,0.005664588941578655,0.10533525711939318,-6675,-3495,-0.4396653932288236,-0.21633510318036508
6867,28003,Alcorn,Mississippi,2012,3511,11111,208,14830,0.23674983142279163,0.7492245448415374,0.014025623735670937,-619,-39,306,-352,-0.03528283884463032,-0.002243642500661563,0.03752648134529191,-7600,-925,-0.5124747134187458,-0.07280932018992226
6868,28003,Alcorn,Mississippi,2016,2684,11819,280,14783,0.18155989988500304,0.7994994250152202,0.01894067509977677,-827,72,708,-47,-0.05518993153778859,0.004915051364105834,0.05027488017368276,-9135,-1535,-0.6179395251302171,-0.10546481171147126
6869,28005,Amite,Mississippi,2000,2673,3677,58,6408,0.41713483146067415,0.5738139825218477,0.009051186017478152,0,0,0,0,0.0,0.0,0.0,-1004,0,-0.15667915106117353,0.0
6870,28005,Amite,Mississippi,2004,3012,4147,38,7197,0.4185077115464777,0.5762123106850077,0.005279977768514659,339,-20,470,789,0.0013728800858035517,-0.003771208248963493,0.0023983281631599906,-1135,-131,-0.15770459913852997,-0.001025448077356439
6871,28005,Amite,Mississippi,2008,3348,4245,57,7650,0.4376470588235294,0.5549019607843138,0.007450980392156863,336,19,98,453,0.019139347277051688,0.002171002623642204,-0.021310349900693915,-897,238,-0.11725490196078436,0.0404496971777456
6872,28005,Amite,Mississippi,2012,3242,4414,50,7706,0.4207111341811575,0.5728004152608357,0.006488450558006748,-106,-7,169,56,-0.01693592464237187,-0.0009625298341501146,0.01789845447652194,-1172,-275,-0.15208928107967817,-0.03483437911889381
6873,28005,Amite,Mississippi,2016,2697,4289,64,7050,0.3825531914893617,0.6083687943262411,0.009078014184397163,-545,14,-125,-656,-0.03815794269179584,0.002589563626390415,0.03556837906540544,-1592,-420,-0.22581560283687946,-0.07372632175720129
6874,28007,Attala,Mississippi,2000,2922,4206,45,7173,0.40736093684650776,0.5863655374320368,0.006273525721455458,0,0,0,0,0.0,0.0,0.0,-1284,0,-0.17900460058552903,0.0
6875,28007,Attala,Mississippi,2004,3145,5014,48,8207,0.3832094553429999,0.6109418788838796,0.005848665773120507,223,3,808,1034,-0.024151481503507877,-0.000424859948334951,0.024576341451842842,-1869,-585,-0.22773242354087975,-0.04872782295535072
6876,28007,Attala,Mississippi,2008,3849,5273,61,9183,0.4191440705651748,0.5742132200805837,0.006642709354241533,704,13,259,976,0.03593461522217489,0.0007940435811210258,-0.0367286588032959,-1424,445,-0.15506914951540895,0.07266327402547079
6877,28007,Attala,Mississippi,2012,3927,5126,39,9092,0.43191816981962167,0.5637923449186097,0.004289485261768588,78,-22,-147,-91,0.012774099254446891,-0.002353224092472945,-0.010420875161973986,-1199,225,-0.13187417509898808,0.023194974416420877
6878,28007,Attala,Mississippi,2016,3242,4897,117,8256,0.39268410852713176,0.5931443798449613,0.014171511627906976,-685,78,-229,-836,-0.03923406129248991,0.009882026366138389,0.029352034926351522,-1655,-456,-0.2004602713178295,-0.06858609621884143
6879,28009,Benton,Mississippi,2000,1886,1561,34,3481,0.541798333812123,0.4484343579431198,0.009767308244757253,0,0,0,0,0.0,0.0,0.0,325,0,0.09336397586900314,0.0
6880,28009,Benton,Mississippi,2004,2245,1969,33,4247,0.5286084294796327,0.4636213797975041,0.007770190722863198,359,-1,408,766,-0.013189904332490232,-0.0019971175218940554,0.015187021854384308,276,-49,0.0649870496821286,-0.02837692618687454
6881,28009,Benton,Mississippi,2008,2227,2329,82,4638,0.48016386373436826,0.5021561017680034,0.017680034497628287,-18,49,360,391,-0.048444565745264456,0.009909843774765089,0.038534721970499286,-102,-378,-0.021992238033635148,-0.08697928771576374
6882,28009,Benton,Mississippi,2012,2051,2041,24,4116,0.49829931972789115,0.4958697764820214,0.0058309037900874635,-176,-58,-288,-522,0.018135455993522898,-0.011849130707540824,-0.006286325285981997,10,112,0.0024295432458697475,0.024421781279504895
6883,28009,Benton,Mississippi,2016,1719,2251,52,4022,0.4273993038289408,0.5596718050721035,0.012928891098955743,-332,28,210,-94,-0.07090001589895034,0.007097987308868279,0.06380202859008205,-532,-542,-0.13227250124316264,-0.1347020444890324
6884,28011,Bolivar,Mississippi,2000,8436,4847,255,13538,0.6231348795981682,0.35802925099719307,0.018835869404638793,0,0,0,0,0.0,0.0,0.0,3589,0,0.2651056286009751,0.0
6885,28011,Bolivar,Mississippi,2004,9631,5535,141,15307,0.6291892598157706,0.361599268308617,0.009211471875612465,1195,-114,688,1769,0.006054380217602406,-0.009624397529026328,0.003570017311423923,4096,507,0.26758999150715357,0.0024843629061784833
6886,28011,Bolivar,Mississippi,2008,10334,4891,156,15381,0.6718678889539041,0.3179897275859827,0.010142383460113126,703,15,-644,74,0.042678629138133584,0.000930911584500661,-0.04360954072263429,5443,1347,0.35387816136792144,0.08628816986076787
6887,28011,Bolivar,Mississippi,2012,10582,4701,145,15428,0.6858957739175525,0.304705729841846,0.009398496240601503,248,-11,-190,47,0.014027884963648374,-0.0007438872195116228,-0.013283997744136689,5881,438,0.3811900440757065,0.027311882707785062
6888,28011,Bolivar,Mississippi,2016,9046,4590,188,13824,0.6543692129629629,0.33203125,0.013599537037037037,-1536,43,-111,-1604,-0.03152656095458961,0.0042010407964355335,0.027325520158153982,4456,-1425,0.3223379629629629,-0.05885208111274359
6889,28013,Calhoun,Mississippi,2000,2251,3448,59,5758,0.39093435220562694,0.59881903438694,0.010246613407433136,0,0,0,0,0.0,0.0,0.0,-1197,0,-0.207884682181313,0.0
6890,28013,Calhoun,Mississippi,2004,2234,4131,27,6392,0.3494993742177722,0.6462765957446809,0.004224030037546934,-17,-32,683,634,-0.041434977987854726,-0.006022583369886202,0.04745756135774093,-1897,-700,-0.29677722152690866,-0.08889253934559566
6891,28013,Calhoun,Mississippi,2008,2522,4467,45,7034,0.3585442138185954,0.6350582883139039,0.00639749786750071,288,18,336,642,0.009044839600823196,0.002173467829953777,-0.011218307430777008,-1945,-48,-0.27651407449530846,0.020263147031600204
6892,28013,Calhoun,Mississippi,2012,2586,4412,70,7068,0.36587436332767403,0.624221844934918,0.009903791737408036,64,25,-55,34,0.007330149509078621,0.0035062938699073256,-0.010836443378985927,-1826,119,-0.2583474816072439,0.018166592888064548
6893,28013,Calhoun,Mississippi,2016,1910,4390,96,6396,0.2986241400875547,0.6863664790494058,0.0150093808630394,-676,26,-22,-672,-0.06725022324011931,0.005105589125631364,0.062144634114487896,-2480,-654,-0.3877423389618511,-0.1293948573546072
6894,28015,Carroll,Mississippi,2000,1726,3165,33,4924,0.3505280259951259,0.642770105605199,0.006701868399675061,0,0,0,0,0.0,0.0,0.0,-1439,0,-0.2922420796100731,0.0
6895,28015,Carroll,Mississippi,2004,1900,3664,28,5592,0.3397711015736767,0.6552217453505007,0.005007153075822604,174,-5,499,668,-0.01075692442144921,-0.0016947153238524573,0.012451639745301724,-1764,-325,-0.315450643776824,-0.023208564166750933
6896,28015,Carroll,Mississippi,2008,2037,3902,26,5965,0.34149203688181057,0.6541492036881811,0.0043587594300083824,137,-2,238,373,0.0017209353081338863,-0.0006483936458142213,-0.001072541662319626,-1865,-101,-0.3126571668063705,0.0027934769704535123
6897,28015,Carroll,Mississippi,2012,2007,3960,25,5992,0.33494659546061417,0.6608811748998665,0.004172229639519359,-30,-1,58,27,-0.006545441421196396,-0.00018652979048902358,0.00673197121168545,-1953,-88,-0.32593457943925236,-0.013277412632881846
6898,28015,Carroll,Mississippi,2016,1680,3799,49,5528,0.30390738060781475,0.6872286541244573,0.00886396526772793,-327,24,-161,-464,-0.031039214852799424,0.004691735628208571,0.026347479224590797,-2119,-166,-0.3833212735166426,-0.05738669407739022
6899,28017,Chickasaw,Mississippi,2000,3519,3549,107,7175,0.4904529616724739,0.4946341463414634,0.014912891986062719,0,0,0,0,0.0,0.0,0.0,-30,0,-0.004181184668989535,0.0
6900,28017,Chickasaw,Mississippi,2004,4078,4193,79,8350,0.4883832335329341,0.5021556886227545,0.009461077844311378,559,-28,644,1175,-0.0020697281395397615,-0.005451814141751341,0.007521542281291094,-115,-85,-0.01377245508982039,-0.009591270420830855
6901,28017,Chickasaw,Mississippi,2008,4588,4395,75,9058,0.5065135791565467,0.4852064473393685,0.008279973504084787,510,-4,202,708,0.018130345623612598,-0.0011811043402265905,-0.016949241283385985,193,308,0.021307131817178193,0.03507958690699858
6902,28017,Chickasaw,Mississippi,2012,4378,3994,131,8503,0.5148771021992238,0.46971657062213334,0.015406327178642832,-210,56,-401,-555,0.008363523042677068,0.007126353674558045,-0.015489876717235174,384,191,0.045160531577090435,0.02385339975991224
6903,28017,Chickasaw,Mississippi,2016,3649,4127,114,7890,0.46248415716096325,0.5230671736375159,0.014448669201520912,-729,-17,133,-613,-0.05239294503826053,-0.0009576579771219205,0.053350603015382525,-478,-862,-0.06058301647655262,-0.10574354805364305
6904,28019,Choctaw,Mississippi,2000,1278,2398,43,3719,0.34364076364614143,0.6447969884377521,0.01156224791610648,0,0,0,0,0.0,0.0,0.0,-1120,0,-0.3011562247916107,0.0
6905,28019,Choctaw,Mississippi,2004,1366,2694,22,4082,0.33463988241058307,0.6599706026457619,0.005389514943655071,88,-21,296,363,-0.009000881235558367,-0.006172732972451409,0.015173614208009778,-1328,-208,-0.32533072023517884,-0.024174495443568145
6906,28019,Choctaw,Mississippi,2008,1459,2624,45,4128,0.3534399224806202,0.6356589147286822,0.010901162790697675,93,23,-70,46,0.018800040070037105,0.005511647847042603,-0.024311687917079716,-1165,163,-0.282218992248062,0.04311172798711682
6907,28019,Choctaw,Mississippi,2012,1428,2812,33,4273,0.3341914345892815,0.6580856541071847,0.007722911303533817,-31,-12,188,145,-0.01924848789133865,-0.003178251487163858,0.02242673937850248,-1384,-219,-0.32389421951790315,-0.04167522726984113
6908,28019,Choctaw,Mississippi,2016,1218,2788,59,4065,0.2996309963099631,0.6858548585485855,0.014514145141451414,-210,26,-24,-208,-0.03456043827931843,0.006791233837917597,0.027769204441400852,-1570,-186,-0.38622386223862243,-0.06232964272071928
6909,28021,Claiborne,Mississippi,2000,3670,883,62,4615,0.7952329360780065,0.19133261105092092,0.013434452871072589,0,0,0,0,0.0,0.0,0.0,2787,0,0.6039003250270856,0.0
6910,28021,Claiborne,Mississippi,2004,4362,950,43,5355,0.8145658263305322,0.17740429505135388,0.008029878618113911,692,-19,67,740,0.019332890252525714,-0.005404574252958677,-0.013928315999567037,3412,625,0.6371615312791783,0.03326120625209272
6911,28021,Claiborne,Mississippi,2008,4682,748,23,5453,0.8586099394828535,0.13717219878965706,0.004217861727489456,320,-20,-202,98,0.04404411315232126,-0.003812016890624456,-0.040232096261696826,3934,522,0.7214377406931964,0.08427620941401814
6912,28021,Claiborne,Mississippi,2012,4838,625,21,5484,0.8822027716994895,0.11396790663749089,0.0038293216630196935,156,-2,-123,31,0.023592832216635995,-0.00038854006446976215,-0.02320429215216617,4213,279,0.7682348650619986,0.04679712436880212
6913,28021,Claiborne,Mississippi,2016,3708,540,24,4272,0.8679775280898876,0.12640449438202248,0.0056179775280898875,-1130,3,-85,-1212,-0.014225243609601868,0.001788655865070194,0.012436587744531588,3168,-1045,0.7415730337078651,-0.02666183135413347
6914,28023,Clarke,Mississippi,2000,2368,4503,48,6919,0.3422459893048128,0.6508165919930626,0.006937418702124584,0,0,0,0,0.0,0.0,0.0,-2135,0,-0.3085706026882498,0.0
6915,28023,Clarke,Mississippi,2004,2402,5068,37,7507,0.3199680298388171,0.6751032369788198,0.0049287331823631274,34,-11,565,588,-0.0222779594659957,-0.0020086855197614566,0.024286644985757166,-2666,-531,-0.3551352071400027,-0.04656460445175287
6916,28023,Clarke,Mississippi,2008,3121,5229,47,8397,0.3716803620340598,0.6227224008574491,0.005597237108491128,719,10,161,890,0.05171233219524268,0.0006685039261280007,-0.05238083612137068,-2108,558,-0.2510420388233893,0.10409316831661336
6917,28023,Clarke,Mississippi,2012,3111,5049,93,8253,0.3769538349691021,0.6117775354416576,0.011268629589240277,-10,46,-180,-144,0.005273472935042323,0.005671392480749149,-0.010944865415791538,-1938,170,-0.23482370047255546,0.01621833835083386
6918,28023,Clarke,Mississippi,2016,2585,5137,69,7791,0.3317930945963291,0.6593505326658965,0.008856372737774355,-526,-24,88,-462,-0.04516074037277301,-0.002412256851465922,0.04757299722423891,-2552,-614,-0.3275574380695674,-0.09273373759701192
6919,28025,Clay,Mississippi,2000,4515,3570,80,8165,0.5529699938763013,0.43723208818126147,0.009797917942437232,0,0,0,0,0.0,0.0,0.0,945,0,0.11573790569503983,0.0
6920,28025,Clay,Mississippi,2004,4753,4342,46,9141,0.5199649928891806,0.47500273493053274,0.005032272180286621,238,-34,772,976,-0.03300500098712067,-0.0047656457621506115,0.037770646749271275,411,-534,0.04496225795864789,-0.07077564773639194
6921,28025,Clay,Mississippi,2008,6558,4466,68,11092,0.5912369275153264,0.4026325279480707,0.006130544536602957,1805,22,124,1951,0.07127193462614578,0.0010982723563163366,-0.07237020698246205,2092,1681,0.18860439956725572,0.14364214160860783
6922,28025,Clay,Mississippi,2012,6712,4291,69,11072,0.6062138728323699,0.3875541907514451,0.0062319364161849715,154,1,-175,-20,0.014976945317043522,0.00010139187958201415,-0.015078337196625602,2421,329,0.21865968208092484,0.030055282513669124
6923,28025,Clay,Mississippi,2016,5722,4150,131,10003,0.5720283914825552,0.41487553733879834,0.013096071178646406,-990,62,-141,-1069,-0.034185481349814695,0.006864134762461434,0.027321346587353246,1572,-849,0.1571528541437569,-0.06150682793716794
6924,28027,Coahoma,Mississippi,2000,5662,3695,196,9553,0.5926933947451063,0.3867894902124987,0.02051711504239506,0,0,0,0,0.0,0.0,0.0,1967,0,0.2059039045326076,0.0
6925,28027,Coahoma,Mississippi,2004,6805,3676,127,10608,0.6414969834087482,0.3465309200603318,0.011972096530920061,1143,-69,-19,1055,0.04880358866364187,-0.008545018511474997,-0.040258570152166884,3129,1162,0.29496606334841635,0.08906215881580876
6926,28027,Coahoma,Mississippi,2008,7597,2917,54,10568,0.7188682816048448,0.2760219530658592,0.005109765329295988,792,-73,-759,-40,0.07737129819609667,-0.0068623312016240735,-0.07050896699447262,4680,1551,0.44284632853898565,0.1478802651905693
6927,28027,Coahoma,Mississippi,2012,7792,2712,45,10549,0.7386482131007679,0.25708597971371694,0.004265807185515215,195,-9,-205,-19,0.019779931495923053,-0.0008439581437807726,-0.018935973352142255,5080,400,0.48156223338705095,0.03871590484806531
6928,28027,Coahoma,Mississippi,2016,6378,2426,108,8912,0.7156642728904847,0.2722172351885099,0.012118491921005385,-1414,63,-286,-1637,-0.02298394021028316,0.007852684735490171,0.015131255474792937,3952,-1128,0.44344703770197486,-0.0381151956850761
6929,28029,Copiah,Mississippi,2000,4845,5643,99,10587,0.45763672428449986,0.5330121847548881,0.009351090960612072,0,0,0,0,0.0,0.0,0.0,-798,0,-0.07537546047038823,0.0
6930,28029,Copiah,Mississippi,2004,4961,6374,58,11393,0.4354428157640656,0.5594663389800755,0.005090845255858861,116,-41,731,806,-0.022193908520434236,-0.004260245704753211,0.026454154225187376,-1413,-615,-0.12402352321600985,-0.04864806274562161
6931,28029,Copiah,Mississippi,2008,7710,6701,91,14502,0.531650806785271,0.4620741966625293,0.006274996552199696,2749,33,327,3109,0.09620799102120536,0.0011841512963408352,-0.09739214231754617,1009,2422,0.06957661012274169,0.19360013333875153
6932,28029,Copiah,Mississippi,2012,7749,6282,92,14123,0.548679459038448,0.4448063442611343,0.006514196700417758,39,1,-419,-379,0.017028652253176957,0.00023920014821806213,-0.017267852401395,1467,458,0.10387311477731365,0.03429650465457196
6933,28029,Copiah,Mississippi,2016,6741,6103,138,12982,0.5192574333692805,0.4701124634108766,0.01063010321984286,-1008,46,-179,-1141,-0.029422025669167406,0.004115906519425101,0.02530611914974229,638,-829,0.04914496995840395,-0.054728144818909696
6934,28031,Covington,Mississippi,2000,2623,4180,78,6881,0.38119459380903936,0.607469844499346,0.011335561691614591,0,0,0,0,0.0,0.0,0.0,-1557,0,-0.22627525069030668,0.0
6935,28031,Covington,Mississippi,2004,3158,5044,50,8252,0.38269510421715947,0.6112457586039748,0.0060591371788657295,535,-28,864,1371,0.0015005104081201037,-0.005276424512748862,0.0037759141046287414,-1886,-329,-0.22855065438681532,-0.0022754036965086377
6936,28031,Covington,Mississippi,2008,3852,5523,86,9461,0.4071451220801184,0.583764929711447,0.009089948208434626,694,36,479,1209,0.024450017862958917,0.0030308110295688964,-0.027480828892527787,-1671,215,-0.17661980763132862,0.051930846755486704
6937,28031,Covington,Mississippi,2012,3878,5405,65,9348,0.41484809584937954,0.5781985451433461,0.006953359007274283,26,-21,-118,-113,0.007702973769261157,-0.002136589201160343,-0.0055663845681008794,-1527,144,-0.16335044929396658,0.013269358337362036
6938,28031,Covington,Mississippi,2016,3276,5435,100,8811,0.3718079673135853,0.616842583134718,0.011349449551696743,-602,35,30,-537,-0.04304012853579425,0.00439609054442246,0.03864403799137184,-2159,-632,-0.24503461582113267,-0.08168416652716609
6939,28033,DeSoto,Mississippi,2000,9586,24879,471,34936,0.2743874513395924,0.7121307533776048,0.01348179528280284,0,0,0,0,0.0,0.0,0.0,-15293,0,-0.43774330203801237,0.0
6940,28033,DeSoto,Mississippi,2004,13583,36306,326,50215,0.27049686348700586,0.7230110524743603,0.006492084038633874,3997,-145,11427,15279,-0.003890587852586558,-0.0069897112441689654,0.010880299096755475,-22723,-7430,-0.4525141889873544,-0.014770886949342033
6941,28033,DeSoto,Mississippi,2008,19627,44222,474,64323,0.30513191237970866,0.6874990283413398,0.007369059278951541,6044,148,7916,14108,0.0346350488927028,0.0008769752403176671,-0.03551202413302046,-24595,-1872,-0.38236711596163114,0.07014707302572326
6942,28033,DeSoto,Mississippi,2012,21575,43559,660,65794,0.3279174392801775,0.6620512508739399,0.010031309845882604,1948,186,-663,1471,0.022785526900468867,0.0026622505669310625,-0.0254477774673999,-21984,2611,-0.3341338115937624,0.04823330436786877
6943,28033,DeSoto,Mississippi,2016,20591,43089,2475,66155,0.31125387347895095,0.6513339883606681,0.03741213816038092,-984,1815,-470,361,-0.016663565801226576,0.02738082831449832,-0.010717262513271764,-22498,-514,-0.3400801148817172,-0.005946303287954813
6944,28035,Forrest,Mississippi,2000,8500,13281,470,22251,0.38200530313244346,0.5968720506943508,0.021122646173205698,0,0,0,0,0.0,0.0,0.0,-4781,0,-0.21486674756190732,0.0
6945,28035,Forrest,Mississippi,2004,10220,16318,207,26745,0.3821275004673771,0.6101327350906711,0.0077397644419517665,1720,-263,3037,4494,0.00012219733493362694,-0.013382881731253932,0.013260684396320332,-6098,-1317,-0.22800523462329403,-0.013138487061386706
6946,28035,Forrest,Mississippi,2008,11622,15296,266,27184,0.42753090052972337,0.5626839317245439,0.009785167745732784,1402,59,-1022,439,0.04540340006234628,0.002045403303781017,-0.047448803366127223,-3674,2424,-0.13515303119482053,0.0928522034284735
6947,28035,Forrest,Mississippi,2012,13272,16574,390,30236,0.4389469506548485,0.5481545177933589,0.012898531551792564,1650,124,1278,3052,0.011416050125125143,0.0031133638060597806,-0.014529413931185009,-3302,372,-0.10920756713851038,0.025945464056310152
6948,28035,Forrest,Mississippi,2016,11716,15461,887,28064,0.41747434435575825,0.5509193272519954,0.031606328392246294,-1556,497,-1113,-2172,-0.021472606299090258,0.01870779684045373,0.0027648094586365524,-3745,-443,-0.13344498289623719,-0.02423741575772681
6949,28037,Franklin,Mississippi,2000,1486,2427,40,3953,0.37591702504427016,0.6139640779155072,0.010118897040222615,0,0,0,0,0.0,0.0,0.0,-941,0,-0.23804705287123706,0.0
6950,28037,Franklin,Mississippi,2004,1574,2893,24,4491,0.35047873524827433,0.6441772433756402,0.005344021376085505,88,-16,466,538,-0.025438289795995828,-0.00477487566413711,0.030213165460132974,-1319,-378,-0.29369850812736586,-0.0556514552561288
6951,28037,Franklin,Mississippi,2008,1733,2909,43,4685,0.36990394877267874,0.6209178228388473,0.009178228388473852,159,19,16,194,0.019425213524404406,0.0038342070123883474,-0.023259420536792863,-1176,143,-0.2510138740661686,0.04268463406119727
6952,28037,Franklin,Mississippi,2012,1726,2735,32,4493,0.3841531270865791,0.6087246828399733,0.007122190073447585,-7,-11,-174,-192,0.01424917831390038,-0.002056038315026267,-0.012193139998874059,-1009,167,-0.22457155575339416,0.026442318312774438
6953,28037,Franklin,Mississippi,2016,1502,2721,67,4290,0.35011655011655013,0.6342657342657343,0.015617715617715617,-224,35,-14,-203,-0.03403657697002899,0.008495525544268032,0.02554105142576102,-1219,-210,-0.28414918414918416,-0.059577628395790005
6954,28039,George,Mississippi,2000,1977,5143,164,7284,0.2714168039538715,0.706068094453597,0.022515101592531575,0,0,0,0,0.0,0.0,0.0,-3166,0,-0.43465129049972545,0.0
6955,28039,George,Mississippi,2004,1724,6223,54,8001,0.21547306586676665,0.7777777777777778,0.006749156355455568,-253,-110,1080,717,-0.05594373808710487,-0.015765945237076008,0.07170968332418082,-4499,-1333,-0.5623047119110112,-0.12765342141128572
6956,28039,George,Mississippi,2008,1532,7700,103,9335,0.16411355115158008,0.8248527048741296,0.011033743974290305,-192,49,1477,1334,-0.05135951471518657,0.004284587618834737,0.04707492709635186,-6168,-1669,-0.6607391537225495,-0.09843444181153838
6957,28039,George,Mississippi,2012,1359,8376,121,9856,0.13788555194805194,0.8498376623376623,0.012276785714285714,-173,18,676,521,-0.02622799920352814,0.001243041739995409,0.024984957463532687,-7017,-849,-0.7119521103896104,-0.05121295666706083
6958,28039,George,Mississippi,2016,1027,8696,168,9891,0.10383176625214842,0.8791830957436053,0.016985138004246284,-332,47,320,35,-0.03405378569590352,0.00470835228996057,0.029345433405942978,-7669,-652,-0.7753513294914569,-0.06339921910184654
6959,28041,Greene,Mississippi,2000,1317,3082,37,4436,0.29688908926961227,0.6947700631199278,0.008340847610459874,0,0,0,0,0.0,0.0,0.0,-1765,0,-0.39788097385031557,0.0
6960,28041,Greene,Mississippi,2004,1421,3850,28,5299,0.26816380449141347,0.726552179656539,0.005284015852047556,104,-9,768,863,-0.0287252847781988,-0.0030568317584123176,0.031782116536611116,-2429,-664,-0.4583883751651255,-0.06050740131480992
6961,28041,Greene,Mississippi,2008,1366,4361,62,5789,0.23596476075315254,0.7533252720677146,0.010709967179132838,-55,34,511,490,-0.032199043738260935,0.005425951327085282,0.026773092411175647,-2995,-566,-0.5173605113145621,-0.05897213614943658
6962,28041,Greene,Mississippi,2012,1325,4531,66,5922,0.223741979061128,0.765113137453563,0.011144883485309016,-41,4,170,133,-0.012222781692024537,0.00043491630617617863,0.011787865385848417,-3206,-211,-0.541371158392435,-0.024010647077872926
6963,28041,Greene,Mississippi,2016,974,4335,60,5369,0.1814118085304526,0.8074129260569939,0.011175265412553549,-351,-6,-196,-553,-0.04233017053067539,3.0381927244532356e-05,0.042299788603430866,-3361,-155,-0.6260011175265413,-0.08462995913410631
6964,28043,Grenada,Mississippi,2000,4163,5129,93,9385,0.4435801811401172,0.5465103889184869,0.009909429941395844,0,0,0,0,0.0,0.0,0.0,-966,0,-0.1029302077783697,0.0
6965,28043,Grenada,Mississippi,2004,4180,5872,59,10111,0.41341113638611415,0.5807536346553259,0.0058352289585599845,17,-34,743,726,-0.03016904475400306,-0.00407420098283586,0.03424324573683901,-1692,-726,-0.16734249826921177,-0.06441229049084207
6966,28043,Grenada,Mississippi,2008,5029,6234,58,11321,0.4442187085946471,0.55065806907517,0.005123222330182846,849,-1,362,1210,0.030807572208532974,-0.0007120066283771388,-0.030095565580155914,-1205,487,-0.10643936048052288,0.06090313778868889
6967,28043,Grenada,Mississippi,2012,5288,5986,61,11335,0.46651962946625497,0.5280988089986767,0.005381561535068372,259,3,-248,14,0.022300920871607843,0.00025833920488552674,-0.022559260076493337,-698,507,-0.0615791795324217,0.04486018094810118
6968,28043,Grenada,Mississippi,2016,4424,5970,119,10513,0.4208123275944069,0.5678683534671359,0.011319318938457149,-864,58,-16,-822,-0.04570730187184807,0.0059377574033887765,0.03976954446845926,-1546,-848,-0.14705602587272903,-0.08547684634030733
6969,28045,Hancock,Mississippi,2000,4801,9326,421,14548,0.3300109980753368,0.6410503161946659,0.02893868572999725,0,0,0,0,0.0,0.0,0.0,-4525,0,-0.3110393181193291,0.0
6970,28045,Hancock,Mississippi,2004,5107,12581,181,17869,0.2858022273210588,0.7040684985169847,0.010129274161956461,306,-240,3255,3321,-0.04420877075427798,-0.018809411568040786,0.06301818232231882,-7474,-2949,-0.4182662711959259,-0.1072269530765968
6971,28045,Hancock,Mississippi,2008,3768,13020,268,17056,0.22091932457786118,0.7633677298311444,0.01571294559099437,-1339,87,439,-813,-0.06488290274319763,0.0055836714290379095,0.059299231314159706,-9252,-1778,-0.5424484052532832,-0.12418213405735729
6972,28045,Hancock,Mississippi,2012,3917,12964,286,17167,0.22817032678977106,0.7551698025281063,0.016659870682122678,149,18,-56,111,0.007251002211909885,0.0009469250911283075,-0.008197927303038144,-9047,205,-0.5269994757383352,0.015448929514948029
6973,28045,Hancock,Mississippi,2016,3344,13811,482,17637,0.18960140613483017,0.7830696830526733,0.027328910812496457,-573,196,847,470,-0.038568920654940886,0.010669040130373779,0.027899880524567044,-10467,-1420,-0.5934682769178432,-0.06646880117950804
6974,28047,Harrison,Mississippi,2000,19142,32256,1218,52616,0.36380568648319905,0.6130454614565911,0.02314885206020982,0,0,0,0,0.0,0.0,0.0,-13114,0,-0.24923977497339206,0.0
6975,28047,Harrison,Mississippi,2004,23076,39703,509,63288,0.3646188850967008,0.6273385159903931,0.00804259891290608,3934,-709,7447,10672,0.0008131986135017644,-0.01510625314730374,0.01429305453380203,-16627,-3513,-0.2627196308936923,-0.013479855920300265
6976,28047,Harrison,Mississippi,2008,22673,38757,527,61957,0.3659473505818552,0.6255467501654374,0.008505899252707522,-403,18,-946,-1331,0.001328465485154362,0.000463300339801442,-0.001791765824955771,-16084,543,-0.2595993995835822,0.003120231310110133
6977,28047,Harrison,Mississippi,2012,23119,39470,739,63328,0.3650675846387064,0.6232630116220313,0.011669403739262254,446,212,713,1371,-0.0008797659431487581,0.0031635044865547315,-0.002283738543406022,-16351,-267,-0.2581954269833249,0.001403972600257264
6978,28047,Harrison,Mississippi,2016,21169,40354,1790,63313,0.3343547138818252,0.6373730513480643,0.028272234770110403,-1950,1051,884,-15,-0.030712870756881228,0.01660283103084815,0.014110039726032975,-19185,-2834,-0.30301833746623913,-0.0448229104829142
6979,28049,Hinds,Mississippi,2000,46789,37753,3228,87770,0.5330864760168622,0.43013558163381566,0.03677794234932209,0,0,0,0,0.0,0.0,0.0,9036,0,0.10295089438304655,0.0
6980,28049,Hinds,Mississippi,2004,54845,36975,680,92500,0.5929189189189189,0.39972972972972975,0.0073513513513513516,8056,-2548,-778,4730,0.05983244290205669,-0.029426590997970743,-0.0304058519040859,17870,8834,0.19318918918918915,0.0902382948061426
6981,28049,Hinds,Mississippi,2008,75401,32949,552,108902,0.6923747956878662,0.3025564268792125,0.005068777432921342,20556,-128,-4026,16402,0.0994558767689473,-0.0022825739184300095,-0.09717330285051723,42452,24582,0.38981836880865367,0.19662917961946452
6982,28049,Hinds,Mississippi,2012,76112,29664,715,106491,0.7147270661370444,0.278558751443784,0.006714182419171573,711,163,-3285,-2411,0.022352270449178202,0.0016454049862502313,-0.023997675435428523,46448,3996,0.4361683146932604,0.046349945884606725
6983,28049,Hinds,Mississippi,2016,67594,25275,2208,95077,0.7109395542560241,0.2658371635621654,0.023223282181810533,-8518,1493,-4389,-11414,-0.0037875118810203334,0.016509099762638958,-0.01272158788161859,42319,-4129,0.44510239069385865,0.008934076000598257
6984,28051,Holmes,Mississippi,2000,5447,1937,38,7422,0.7338992185394773,0.26098086769064943,0.005119913769873349,0,0,0,0,0.0,0.0,0.0,3510,0,0.47291835084882783,0.0
6985,28051,Holmes,Mississippi,2004,6366,1961,56,8383,0.7593940116903256,0.2339258022187761,0.006680186090898247,919,18,24,961,0.02549479315084835,0.0015602723210248973,-0.027055065471873335,4405,895,0.5254682094715495,0.05254985862272166
6986,28051,Holmes,Mississippi,2008,7765,1714,64,9543,0.8136854238709001,0.179608089699256,0.006706486429843865,1399,8,-247,1160,0.05429141218057454,2.6300338945618035e-05,-0.054317712519520084,6051,1646,0.6340773341716441,0.10860912470009465
6987,28051,Holmes,Mississippi,2012,7812,1435,41,9288,0.8410852713178295,0.15450043066322136,0.004414298018949182,47,-23,-279,-255,0.02739984744692936,-0.0022921884108946826,-0.025107659036034652,6377,326,0.6865848406546081,0.052507506482963984
6988,28051,Holmes,Mississippi,2016,6689,1309,78,8076,0.8282565626547796,0.16208519068845964,0.009658246656760773,-1123,37,-126,-1212,-0.01282870866304986,0.005243948637811591,0.00758476002523828,5380,-997,0.66617137196632,-0.020413468688288083
6989,28053,Humphreys,Mississippi,2000,2288,1628,28,3944,0.5801217038539553,0.4127789046653144,0.007099391480730223,0,0,0,0,0.0,0.0,0.0,660,0,0.16734279918864092,0.0
6990,28053,Humphreys,Mississippi,2004,3168,1679,53,4900,0.6465306122448979,0.3426530612244898,0.010816326530612244,880,25,51,956,0.0664089083909426,0.0037169350498820215,-0.07012584344082462,1489,829,0.30387755102040814,0.13653475183176722
6991,28053,Humphreys,Mississippi,2008,3634,1462,30,5126,0.7089348419820523,0.2852126414358174,0.005852516582130316,466,-23,-217,226,0.062404229737154315,-0.004963809948481929,-0.05744041978867237,2172,683,0.42372220054623483,0.11984464952582669
6992,28053,Humphreys,Mississippi,2012,3903,1293,16,5212,0.748848810437452,0.2480813507290867,0.0030698388334612432,269,-14,-169,86,0.03991396845539974,-0.0027826777486690724,-0.03713129070673071,2610,438,0.5007674597083653,0.07704525916213051
6993,28053,Humphreys,Mississippi,2016,3071,1151,31,4253,0.7220785328003763,0.27063249470961676,0.0072889724900070535,-832,15,-142,-959,-0.026770277637075734,0.004219133656545811,0.022551143980530042,1920,-690,0.4514460380907595,-0.04932142161760583
6994,28055,Issaquena,Mississippi,2000,555,366,20,941,0.589798087141339,0.3889479277364506,0.021253985122210415,0,0,0,0,0.0,0.0,0.0,189,0,0.20085015940488837,0.0
6995,28055,Issaquena,Mississippi,2004,516,439,15,970,0.5319587628865979,0.45257731958762887,0.015463917525773196,-39,-5,73,29,-0.05783932425474103,-0.0057900675964372185,0.06362939185117827,77,-112,0.07938144329896907,-0.1214687161059193
6996,28055,Issaquena,Mississippi,2008,579,364,7,950,0.6094736842105263,0.3831578947368421,0.007368421052631579,63,-8,-75,-20,0.07751492132392834,-0.008095496473141617,-0.06941942485078678,215,138,0.2263157894736842,0.14693434617471512
6997,28055,Issaquena,Mississippi,2012,479,302,6,787,0.6086404066073697,0.38373570520965694,0.007623888182973317,-100,-1,-62,-163,-0.0008332776031565459,0.00025546713034173794,0.0005778104728148548,177,-38,0.2249047013977128,-0.0014110880759714006
6998,28055,Issaquena,Mississippi,2016,395,298,6,699,0.5650929899856938,0.4263233190271817,0.008583690987124463,-84,0,-4,-88,-0.04354741662167594,0.0009598028041511468,0.04258761381752474,97,-80,0.13876967095851211,-0.08613503043920068
6999,28057,Itawamba,Mississippi,2000,2994,5424,146,8564,0.3496029892573564,0.6333489023820644,0.01704810836057917,0,0,0,0,0.0,0.0,0.0,-2430,0,-0.28374591312470804,0.0
7000,28057,Itawamba,Mississippi,2004,2802,6833,79,9714,0.288449660284126,0.7034177475808112,0.008132592135062795,-192,-67,1409,1150,-0.06115332897323039,-0.008915516225516375,0.07006884519874679,-4031,-1601,-0.4149680872966852,-0.13122217417197718
7001,28057,Itawamba,Mississippi,2008,2084,7663,204,9951,0.20942618832278162,0.7700733594613607,0.020500452215857702,-718,125,830,237,-0.07902347196134438,0.012367860080794907,0.06665561188054947,-5579,-1548,-0.5606471711385791,-0.14567908384189387
7002,28057,Itawamba,Mississippi,2012,1706,7393,219,9318,0.18308649924876583,0.7934106031337197,0.02350289761751449,-378,15,-270,-633,-0.026339689074015793,0.003002445401656787,0.02333724367235901,-5687,-108,-0.6103241038849538,-0.04967693274637475
7003,28057,Itawamba,Mississippi,2016,1117,8470,150,9737,0.11471705864229229,0.8698777857656362,0.01540515559207148,-589,-69,1077,419,-0.06836944060647354,-0.008097742025443009,0.07646718263191654,-7353,-1666,-0.7551607271233439,-0.14483662323839008
7004,28059,Jackson,Mississippi,2000,14193,30068,846,45107,0.3146518278759394,0.6665927683064713,0.01875540381758929,0,0,0,0,0.0,0.0,0.0,-15875,0,-0.35194094043053187,0.0
7005,28059,Jackson,Mississippi,2004,15572,35134,369,51075,0.3048849730788057,0.6878903573176701,0.007224669603524229,1379,-477,5066,5968,-0.00976685479713374,-0.011530734214065058,0.021297589011198825,-19562,-3687,-0.38300538423886443,-0.031064443808332565
7006,28059,Jackson,Mississippi,2008,17781,35993,522,54296,0.32748268749079124,0.6629033446294387,0.009613967879770148,2209,153,859,3221,0.022597714411985548,0.002389298276245919,-0.024987012688231447,-18212,1350,-0.33542065713864744,0.047584727100216995
7007,28059,Jackson,Mississippi,2012,17299,35747,609,53655,0.3224117044077905,0.6662380020501352,0.011350293542074364,-482,87,-246,-641,-0.005070983083000746,0.0017363256623042153,0.0033346574206964963,-18448,-236,-0.3438262976423447,-0.008405640503697243
7008,28059,Jackson,Mississippi,2016,14657,33629,1281,49567,0.29570076865656586,0.678455423971594,0.025843807371840135,-2642,672,-2118,-4088,-0.02671093575122463,0.014493513829765771,0.012217421921458804,-18972,-524,-0.3827546553150281,-0.038928357672683433
7009,28061,Jasper,Mississippi,2000,3104,3294,49,6447,0.48146424693655965,0.5109353187529083,0.00760043431053203,0,0,0,0,0.0,0.0,0.0,-190,0,-0.02947107181634867,0.0
7010,28061,Jasper,Mississippi,2004,4117,3855,37,8009,0.5140466974653515,0.4813334998127107,0.0046198027219378195,1013,-12,561,1562,0.03258245052879183,-0.0029806315885942108,-0.029601818940197644,262,452,0.0327131976526408,0.06218426946898947
7011,28061,Jasper,Mississippi,2008,5025,4135,50,9210,0.5456026058631922,0.4489685124864278,0.0054288816503800215,908,13,280,1201,0.031555908397840726,0.000809078928442202,-0.0323649873262829,890,628,0.09663409337676443,0.06392089572412363
7012,28061,Jasper,Mississippi,2012,5097,4193,50,9340,0.5457173447537473,0.44892933618843683,0.0053533190578158455,72,0,58,130,0.00011473889055513276,-7.556259256417605e-05,-3.917629799093936e-05,904,14,0.0967880085653105,0.0001539151885460721
7013,28061,Jasper,Mississippi,2016,4368,4038,69,8475,0.5153982300884956,0.47646017699115045,0.008141592920353982,-729,19,-155,-865,-0.030319114665251723,0.0027882738625381364,0.02753084080271362,330,-574,0.03893805309734516,-0.05784995546796534
7014,28063,Jefferson,Mississippi,2000,2786,600,22,3408,0.8174882629107981,0.176056338028169,0.006455399061032864,0,0,0,0,0.0,0.0,0.0,2186,0,0.6414319248826291,0.0
7015,28063,Jefferson,Mississippi,2004,2821,630,18,3469,0.8132026520611128,0.18160853271836264,0.0051888152205246466,35,-4,30,61,-0.004285610849685373,-0.0012665838405082177,0.005552194690193635,2191,5,0.6315941193427501,-0.009837805539879008
7016,28063,Jefferson,Mississippi,2008,3883,551,44,4478,0.8671281822242073,0.12304600267976776,0.00982581509602501,1062,26,-79,1009,0.05392553016309454,0.004636999875500364,-0.05856253003859488,3332,1141,0.7440821795444396,0.11248806020168944
7017,28063,Jefferson,Mississippi,2012,3951,468,14,4433,0.8912700203022784,0.10557184750733138,0.003158132190390255,68,-30,-83,-45,0.02414183807807113,-0.006667682905634756,-0.017474155172436376,3483,151,0.785698172794947,0.041615993250507466
7018,28063,Jefferson,Mississippi,2016,3337,490,33,3860,0.8645077720207254,0.12694300518134716,0.00854922279792746,-614,19,22,-573,-0.026762248281553047,0.005391090607537206,0.021371157674015775,2847,-636,0.7375647668393782,-0.04813340595556881
7019,28065,Jeff Davis,Mississippi,2000,2835,2437,45,5317,0.5331954109460222,0.45834116983261236,0.008463419221365431,0,0,0,0,0.0,0.0,0.0,398,0,0.07485424111340983,0.0
7020,28065,Jeff Davis,Mississippi,2004,2959,2668,138,5765,0.5132697311361665,0.46279271465741545,0.02393755420641804,124,93,231,448,-0.019925679809855712,0.015474134985052608,0.004451544824803089,291,-107,0.050477016478751024,-0.0243772246346588
7021,28065,Jeff Davis,Mississippi,2008,4454,2871,45,7370,0.6043419267299864,0.3895522388059702,0.006105834464043419,1495,-93,203,1605,0.09107219559381996,-0.01783171974237462,-0.07324047585144527,1583,1292,0.21478968792401626,0.16431267144526523
7022,28065,Jeff Davis,Mississippi,2012,4267,2507,90,6864,0.6216491841491841,0.36523892773892774,0.013111888111888112,-187,45,-364,-506,0.017307257419197697,0.007006053647844693,-0.02431331106704243,1760,177,0.2564102564102564,0.04162056848624013
7023,28065,Jeff Davis,Mississippi,2016,3720,2466,51,6237,0.5964405964405964,0.3953823953823954,0.008177008177008177,-547,-39,-41,-627,-0.025208587708587693,-0.004934879934879935,0.030143467643467647,1254,-506,0.20105820105820105,-0.05535205535205534
7024,28067,Jones,Mississippi,2000,7713,16341,286,24340,0.316885784716516,0.6713640098603122,0.011750205423171733,0,0,0,0,0.0,0.0,0.0,-8628,0,-0.3544782251437962,0.0
7025,28067,Jones,Mississippi,2004,7398,19125,143,26666,0.277431935798395,0.7172054301357534,0.005362634065851646,-315,-143,2784,2326,-0.03945384891812104,-0.0063875713573200875,0.04584142027544125,-11727,-3099,-0.43977349433735846,-0.08529526919356228
7026,28067,Jones,Mississippi,2008,8846,20157,270,29273,0.3021897311515731,0.6885867522973389,0.009223516551088034,1448,127,1032,2607,0.024757795353178125,0.003860882485236388,-0.02861867783841454,-11311,416,-0.3863970211457658,0.053376473191592666
7027,28067,Jones,Mississippi,2012,9211,20687,261,30159,0.30541463576378525,0.6859312311416161,0.008654133094598627,365,-9,530,886,0.0032249046122121428,-0.0005693834564894067,-0.002655521155722762,-11476,-165,-0.3805165953778309,0.005880425767934905
7028,28067,Jones,Mississippi,2016,7791,20133,428,28352,0.2747954288939052,0.7101086343115124,0.015095936794582392,-1420,167,-554,-1807,-0.030619206869880067,0.006441803699983765,0.02417740316989625,-12342,-866,-0.4353132054176072,-0.05479661003977632
7029,28069,Kemper,Mississippi,2000,2311,1915,35,4261,0.5423609481342407,0.449425017601502,0.008214034264257217,0,0,0,0,0.0,0.0,0.0,396,0,0.09293593053273874,0.0
7030,28069,Kemper,Mississippi,2004,2465,2109,29,4603,0.5355203128394526,0.4581794481859657,0.006300238974581794,154,-6,194,342,-0.006840635294788178,-0.0019137952896754228,0.00875443058446368,356,-40,0.07734086465348688,-0.015595065879251857
7031,28069,Kemper,Mississippi,2008,3256,1935,32,5223,0.6233965154125981,0.3704767375071798,0.006126747080222095,791,3,-174,620,0.08787620257314555,-0.0001734918943596996,-0.08770271067878588,1321,965,0.2529197779054183,0.17557891325193142
7032,28069,Kemper,Mississippi,2012,3239,1789,24,5052,0.6411322248614411,0.35411718131433095,0.004750593824228029,-17,-8,-146,-171,0.01773570944884295,-0.001376153255994066,-0.016359556192848845,1450,129,0.2870150435471101,0.034095265641691797
7033,28069,Kemper,Mississippi,2016,2827,1778,34,4639,0.6093985772795861,0.3832722569519293,0.007329165768484587,-412,10,-11,-413,-0.03173364758185493,0.0025785719442565583,0.029155075637598338,1049,-401,0.22612632032765684,-0.06088872321945327
7034,28071,Lafayette,Mississippi,2000,5139,7081,458,12678,0.4053478466635116,0.5585265814797287,0.03612557185675974,0,0,0,0,0.0,0.0,0.0,-1942,0,-0.15317873481621708,0.0
7035,28071,Lafayette,Mississippi,2004,6218,9004,179,15401,0.40374001688202066,0.5846373612103111,0.011622621907668333,1079,-279,1923,2723,-0.0016078297814909326,-0.02450294994909141,0.0261107797305824,-2786,-844,-0.1808973443282904,-0.027718609512073333
7036,28071,Lafayette,Mississippi,2008,7997,10278,185,18460,0.4332069339111593,0.556771397616468,0.010021668472372697,1779,6,1274,3059,0.029466917029138617,-0.001600953435295635,-0.02786596359384308,-2281,505,-0.12356446370530871,0.0573328806229817
7037,28071,Lafayette,Mississippi,2012,8091,11075,339,19505,0.4148167136631633,0.5678031274032299,0.017380158933606768,94,154,797,1045,-0.01839022024799597,0.0073584904612340706,0.011031729786761924,-2984,-703,-0.1529864137400666,-0.029421950034757893
7038,28071,Lafayette,Mississippi,2016,7969,10872,802,19643,0.4056915949702184,0.5534796110573741,0.040828793972407476,-122,463,-203,138,-0.009125118692944911,0.023448635038800708,-0.014323516345855825,-2903,81,-0.1477880160871557,0.005198397652910913
7039,28073,Lamar,Mississippi,2000,3478,12795,329,16602,0.2094928321888929,0.7706902782797254,0.019816889531381762,0,0,0,0,0.0,0.0,0.0,-9317,0,-0.5611974460908324,0.0
7040,28073,Lamar,Mississippi,2004,3923,16410,132,20465,0.19169313462008306,0.8018568287319814,0.0064500366479355,445,-197,3615,3863,-0.017799697568809836,-0.013366852883446263,0.031166550452256025,-12487,-3170,-0.6101636941118983,-0.04896624802106586
7041,28073,Lamar,Mississippi,2008,5159,18497,254,23910,0.21576746131325805,0.7736093684650773,0.010623170221664575,1236,122,2087,3445,0.024074326693174997,0.004173133573729075,-0.028247460266904056,-13338,-851,-0.5578419071518192,0.05232178696007905
7042,28073,Lamar,Mississippi,2012,5494,19101,294,24889,0.220740085981759,0.7674474667523806,0.01181244726586042,335,40,604,979,0.004972624668500958,0.0011892770441958456,-0.006161901712696705,-13607,-269,-0.5467073807706216,0.011134526381197607
7043,28073,Lamar,Mississippi,2016,5190,18751,651,24592,0.21104424202992844,0.7624837345478205,0.026472023422251138,-304,357,-350,-297,-0.009695843951830568,0.014659576156390717,-0.004963732204560145,-13561,46,-0.551439492517892,-0.0047321117472703955
7044,28075,Lauderdale,Mississippi,2000,8412,17315,243,25970,0.32391220639199075,0.6667308432807085,0.009356950327300731,0,0,0,0,0.0,0.0,0.0,-8903,0,-0.3428186368887178,0.0
7045,28075,Lauderdale,Mississippi,2004,10292,19736,142,30170,0.34113357640039776,0.6541597613523368,0.004706662247265496,1880,-101,2421,4200,0.01722137000840701,-0.004650288080035235,-0.012571081928371752,-9444,-541,-0.313026184951939,0.029792451936778763
7046,28075,Lauderdale,Mississippi,2008,13332,19582,200,33114,0.4026091683275956,0.5913510901733405,0.00603974149906384,3040,58,-154,2944,0.061475591927197815,0.0013330792517983444,-0.06280867117899624,-6250,3194,-0.18874192184574495,0.12428426310619406
7047,28075,Lauderdale,Mississippi,2012,13814,18700,263,32777,0.4214540684016231,0.5705220123867346,0.00802391921164231,482,63,-882,-337,0.018844900074027504,0.0019841777125784704,-0.02082907778660592,-4886,1364,-0.14906794398511153,0.039673977860633425
7048,28075,Lauderdale,Mississippi,2016,11269,17741,496,29506,0.381922320883888,0.6012675388056666,0.016810140310445334,-2545,233,-959,-3271,-0.03953174751773508,0.008786221098803023,0.030745526418932023,-6472,-1586,-0.21934521792177863,-0.0702772739366671
7049,28077,Lawrence,Mississippi,2000,2841,3674,72,6587,0.43130408380142704,0.557765295278579,0.010930620919993927,0,0,0,0,0.0,0.0,0.0,-833,0,-0.12646121147715195,0.0
7050,28077,Lawrence,Mississippi,2004,2308,3956,42,6306,0.36600063431652397,0.6273390421820488,0.006660323501427212,-533,-30,282,-281,-0.06530344948490308,-0.004270297418566714,0.06957374690346985,-1648,-815,-0.26133840786552487,-0.13487719638837292
7051,28077,Lawrence,Mississippi,2008,2587,4369,53,7009,0.36909687544585534,0.62334141817663,0.007561706377514624,279,11,413,703,0.0030962411293313785,0.0009013828760874119,-0.0039976240054188095,-1782,-134,-0.2542445427307747,0.007093865134750188
7052,28077,Lawrence,Mississippi,2012,2468,4192,38,6698,0.3684681994625261,0.6258584652134965,0.005673335323977307,-119,-15,-177,-311,-0.0006286759833292188,-0.0018883710535373176,0.0025170470368665043,-1724,58,-0.2573902657509704,-0.003145723020195723
7053,28077,Lawrence,Mississippi,2016,2195,4091,78,6364,0.3449088623507228,0.6428346951602766,0.01225644248900063,-273,40,-101,-334,-0.023559337111803302,0.006583107165023323,0.016976229946780053,-1896,-172,-0.29792583280955376,-0.040535567058583355
7054,28079,Leake,Mississippi,2000,2793,4114,45,6952,0.4017548906789413,0.5917721518987342,0.006472957422324511,0,0,0,0,0.0,0.0,0.0,-1321,0,-0.1900172612197929,0.0
7055,28079,Leake,Mississippi,2004,3212,4962,40,8214,0.39103968833698566,0.6040905770635501,0.004869734599464329,419,-5,848,1262,-0.010715202341955665,-0.0016032228228601815,0.01231842516481585,-1750,-429,-0.2130508887265644,-0.023033627506771515
7056,28079,Leake,Mississippi,2008,4151,5148,60,9359,0.443530291697831,0.5500587669622823,0.00641094133988674,939,20,186,1145,0.05249060336084532,0.0015412067404224107,-0.054031810101267785,-997,753,-0.1065284752644513,0.10652241346211311
7057,28079,Leake,Mississippi,2012,4079,4863,41,8983,0.4540799287543137,0.5413558944673271,0.0045641767783591225,-72,-19,-285,-376,0.010549637056482708,-0.0018467645615276177,-0.00870287249495516,-784,213,-0.08727596571301344,0.01925250955143787
7058,28079,Leake,Mississippi,2016,3584,4782,83,8449,0.424192212096106,0.5659841401349273,0.009823647768966742,-495,42,-81,-534,-0.029887716658207664,0.00525947099060762,0.024628245667600135,-1198,-414,-0.14179192803882124,-0.0545159623258078
7059,28081,Lee,Mississippi,2000,9142,15551,401,25094,0.36431019367179407,0.6197098908105523,0.015979915517653622,0,0,0,0,0.0,0.0,0.0,-6409,0,-0.2553996971387582,0.0
7060,28081,Lee,Mississippi,2004,10127,20254,258,30639,0.330526453213225,0.66105290642645,0.008420640360325075,985,-143,4703,5545,-0.03378374045856908,-0.007559275157328547,0.041343015615897705,-10127,-3718,-0.330526453213225,-0.07512675607446678
7061,28081,Lee,Mississippi,2008,12021,22694,245,34960,0.34385011441647595,0.6491418764302059,0.007008009153318078,1894,-13,2440,4321,0.013323661203250958,-0.0014126312070069976,-0.011911029996244049,-10673,-546,-0.30529176201373,0.025234691199495007
7062,28081,Lee,Mississippi,2012,12563,22415,328,35306,0.3558318699371212,0.6348779244321079,0.009290205630770973,542,83,-279,346,0.011981755520645232,0.002282196477452895,-0.014263951998098046,-9852,821,-0.2790460544949867,0.026245707518743278
7063,28081,Lee,Mississippi,2016,10029,22220,664,32913,0.30471242366238266,0.6751131771640385,0.020174399173578828,-2534,336,-195,-2393,-0.05111944627473852,0.010884193542807855,0.040235252731930626,-12191,-2339,-0.37040075350165585,-0.09135469900666915
7064,28083,Leflore,Mississippi,2000,6401,4626,249,11276,0.5676658389499822,0.4102518623625399,0.02208229868747783,0,0,0,0,0.0,0.0,0.0,1775,0,0.15741397658744233,0.0
7065,28083,Leflore,Mississippi,2004,7566,4635,262,12463,0.6070769477653856,0.371900826446281,0.021022225788333467,1165,13,9,1187,0.03941110881540333,-0.0010600728991443618,-0.038351035916258935,2931,1156,0.2351761213191046,0.07776214473166226
7066,28083,Leflore,Mississippi,2008,8914,4105,62,13081,0.6814463726014831,0.313813928598731,0.004739698799785949,1348,-200,-530,618,0.07436942483609754,-0.016282526988547517,-0.05808689784755,4809,1878,0.36763244400275213,0.13245632268364754
7067,28083,Leflore,Mississippi,2012,9119,3587,67,12773,0.7139278164879042,0.2808267439129414,0.005245439599154467,205,5,-518,-308,0.032481443886421046,0.0005057407993685177,-0.032987184685789595,5532,723,0.4331010725749628,0.06546862857221064
7068,28083,Leflore,Mississippi,2016,7787,3212,141,11140,0.6990125673249551,0.2883303411131059,0.01265709156193896,-1332,74,-375,-1633,-0.014915249162949062,0.007411651962784493,0.007503597200164525,4575,-957,0.4106822262118492,-0.022418846363113587
7069,28085,Lincoln,Mississippi,2000,4358,8540,102,13000,0.3352307692307692,0.6569230769230769,0.007846153846153846,0,0,0,0,0.0,0.0,0.0,-4182,0,-0.3216923076923077,0.0
7070,28085,Lincoln,Mississippi,2004,4418,10008,70,14496,0.3047737306843267,0.6903973509933775,0.004828918322295806,60,-32,1468,1496,-0.030457038546442494,-0.0030172355238580403,0.03347427407030057,-5590,-1408,-0.3856236203090508,-0.06393131261674306
7071,28085,Lincoln,Mississippi,2008,5505,10781,116,16402,0.33562980124375075,0.6572978905011584,0.007072308255090843,1087,46,773,1906,0.03085607055942402,0.0022433899327950367,-0.033099460492219124,-5276,314,-0.32166808925740764,0.06395553105164314
7072,28085,Lincoln,Mississippi,2012,5471,10839,104,16414,0.33331302546606556,0.6603509199463873,0.0063360545875472156,-34,-12,58,12,-0.002316775777685187,-0.0007362536675436272,0.003053029445228894,-5368,-92,-0.3270378944803217,-0.005369805222914081
7073,28085,Lincoln,Mississippi,2016,4458,10550,185,15193,0.2934246034357928,0.6943987362601198,0.012176660304087409,-1013,81,-289,-1221,-0.03988842203027276,0.005840605716540193,0.03404781631373255,-6092,-724,-0.40097413282432703,-0.07393623834400531
7074,28087,Lowndes,Mississippi,2000,7537,11404,289,19230,0.39193967758710346,0.5930317212688507,0.015028601144045762,0,0,0,0,0.0,0.0,0.0,-3867,0,-0.20109204368174727,0.0
7075,28087,Lowndes,Mississippi,2004,10408,13690,172,24270,0.4288421920065925,0.5640708693860733,0.007086938607334157,2871,-117,2286,5040,0.03690251441948905,-0.007941662536711604,-0.028960851882777416,-3282,585,-0.1352286773794808,0.06586336630226647
7076,28087,Lowndes,Mississippi,2008,13209,13994,262,27465,0.4809393773894047,0.5095212088112143,0.00953941379938103,2801,90,304,3195,0.05209718538281216,0.002452475192046873,-0.054549660574858994,-785,2497,-0.028581831421809645,0.10664684595767115
7077,28087,Lowndes,Mississippi,2012,13388,13518,252,27158,0.49296708152293983,0.4977538846748656,0.009279033802194565,179,-10,-476,-307,0.012027704133535155,-0.00026037999718646516,-0.011767324136348734,-130,655,-0.004786803151925756,0.02379502826988389
7078,28087,Lowndes,Mississippi,2016,11819,13271,605,25695,0.45997275734578713,0.5164818057987935,0.023545436855419342,-1569,353,-247,-1463,-0.0329943241771527,0.014266403053224777,0.01872792112392796,-1452,-1322,-0.056509048453006416,-0.05172224530108066
7079,28089,Madison,Mississippi,2000,10416,19109,334,29859,0.34883954586556815,0.639974547037744,0.011185907096687766,0,0,0,0,0.0,0.0,0.0,-8693,0,-0.2911350011721759,0.0
7080,28089,Madison,Mississippi,2004,13268,24257,203,37728,0.3516751484308736,0.6429442324003393,0.005380619168787108,2852,-131,5148,7869,0.0028356025653054617,-0.0058052879279006575,0.0029696853625952313,-10989,-2296,-0.29126908396946566,-0.00013408279728976957
7081,28089,Madison,Mississippi,2008,19831,27203,235,47269,0.41953500179821873,0.5754934523683598,0.004971545833421481,6563,32,2946,9541,0.06785985336734512,-0.000409073335365627,-0.06745078003197946,-7372,3617,-0.15595845057014107,0.1353106333993246
7082,28089,Madison,Mississippi,2012,20722,28507,342,49571,0.4180266688184624,0.5750741360876319,0.006899195093905711,891,107,1304,2302,-0.0015083329797563327,0.0019276492604842297,-0.0004193162807278883,-7785,-413,-0.15704746726916952,-0.0010890166990284444
7083,28089,Madison,Mississippi,2016,20343,28265,1523,50131,0.4057968123516387,0.5638227843051206,0.03038040334324071,-379,1181,-242,560,-0.012229856466823674,0.023481208249335,-0.011251351782511354,-7922,-137,-0.15802597195348184,-0.0009785046843123202
7084,28091,Marion,Mississippi,2000,4114,6796,88,10998,0.3740680123658847,0.6179305328241499,0.008001454809965449,0,0,0,0,0.0,0.0,0.0,-2682,0,-0.24386252045826518,0.0
7085,28091,Marion,Mississippi,2004,3888,7999,60,11947,0.3254373482882732,0.6695404704109819,0.005022181300744957,-226,-28,1203,949,-0.04863066407761152,-0.0029792735092204915,0.051609937586831967,-4111,-1429,-0.34410312212270866,-0.10024060166444348
7086,28091,Marion,Mississippi,2008,4422,8513,75,13010,0.3398923904688701,0.6543428132205995,0.005764796310530361,534,15,514,1063,0.0144550421805969,0.0007426150097854037,-0.015197657190382352,-4091,20,-0.3144504227517294,0.029652699370979252
7087,28091,Marion,Mississippi,2012,4393,8237,99,12729,0.3451174483462959,0.6471050357451489,0.007777515908555267,-29,24,-276,-281,0.005225057877425776,0.002012719598024906,-0.007237777475450624,-3844,247,-0.301987587398853,0.0124628353528764
7088,28091,Marion,Mississippi,2016,3677,7836,180,11693,0.314461643718464,0.6701445309159326,0.015393825365603353,-716,81,-401,-1036,-0.03065580462783185,0.007616309457048086,0.02303949517078374,-4159,-315,-0.3556828871974686,-0.05369529979861559
7089,28093,Marshall,Mississippi,2000,7735,4723,134,12592,0.6142789072426937,0.375079415501906,0.010641677255400253,0,0,0,0,0.0,0.0,0.0,3012,0,0.23919949174078775,0.0
7090,28093,Marshall,Mississippi,2004,8591,5975,83,14649,0.5864564134070585,0.4078776708307734,0.005665915762168066,856,-51,1252,2057,-0.027822493835635287,-0.004975761493232187,0.03279825532886743,2616,-396,0.17857874257628503,-0.06062074916450272
7091,28093,Marshall,Mississippi,2008,9685,6683,110,16478,0.5877533681271999,0.40557106444956914,0.006675567423230975,1094,27,708,1829,0.0012969547201414633,0.0010096516610629087,-0.002306606381204279,3002,386,0.18218230367763077,0.0036035611013457425
7092,28093,Marshall,Mississippi,2012,9650,6473,117,16240,0.5942118226600985,0.39858374384236456,0.007204433497536946,-35,7,-210,-238,0.0064584545328986165,0.0005288660743059713,-0.0069873206072045835,3177,175,0.19562807881773397,0.0134457751401032
7093,28093,Marshall,Mississippi,2016,8023,6587,229,14839,0.5406698564593302,0.4438978367814543,0.01543230675921558,-1627,112,114,-1401,-0.05354196620076834,0.008227873261678634,0.04531409293908972,1436,-1741,0.09677201967787591,-0.09885605913985807
7094,28095,Monroe,Mississippi,2000,5783,7397,180,13360,0.43285928143712576,0.5536676646706586,0.01347305389221557,0,0,0,0,0.0,0.0,0.0,-1614,0,-0.12080838323353288,0.0
7095,28095,Monroe,Mississippi,2004,6237,9308,87,15632,0.398989252814739,0.5954452405322416,0.005565506653019447,454,-93,1911,2272,-0.03387002862238675,-0.007907547239196122,0.04177757586158293,-3071,-1457,-0.19645598771750256,-0.07564760448396968
7096,28095,Monroe,Mississippi,2008,7169,10184,143,17496,0.40975080018289894,0.5820759030635574,0.008173296753543667,932,56,876,1864,0.01076154736815993,0.0026077901005242196,-0.013369337468684184,-3015,56,-0.17232510288065844,0.024130884836844113
7097,28095,Monroe,Mississippi,2012,7056,9723,139,16918,0.41707057571817,0.5747133230878354,0.008216101193994562,-113,-4,-461,-578,0.007319775535271078,4.280444045089496e-05,-0.007362579975721983,-2667,348,-0.15764274736966538,0.014682355510993061
7098,28095,Monroe,Mississippi,2016,5524,10167,193,15884,0.347771342231176,0.6400780659783429,0.012150591790480987,-1532,54,444,-1034,-0.06929923348699402,0.003934490596486425,0.06536474289050753,-4643,-1976,-0.29230672374716693,-0.13466397637750155
7099,28097,Montgomery,Mississippi,2000,2187,2630,32,4849,0.4510208290369148,0.5423798721385853,0.006599298824499897,0,0,0,0,0.0,0.0,0.0,-443,0,-0.09135904310167048,0.0
7100,28097,Montgomery,Mississippi,2004,2473,3002,22,5497,0.44988175368382755,0.5461160633072585,0.004002183008913953,286,-10,372,648,-0.001139075353087271,-0.002597115815585944,0.0037361911686731863,-529,-86,-0.09623430962343094,-0.004875266521760457
7101,28097,Montgomery,Mississippi,2008,2609,3071,32,5712,0.4567577030812325,0.5376400560224089,0.0056022408963585435,136,10,69,215,0.006875949397404935,0.0016000578874445903,-0.00847600728484954,-462,67,-0.08088235294117646,0.015351956682254475
7102,28097,Montgomery,Mississippi,2012,2675,2947,23,5645,0.4738706820194863,0.5220549158547387,0.004074402125775022,66,-9,-124,-67,0.01711297893825381,-0.0015278387705835216,-0.015585140167670208,-272,190,-0.048184233835252444,0.03269811910592402
7103,28097,Montgomery,Mississippi,2016,2115,2818,63,4996,0.4233386709367494,0.5640512409927942,0.012610088070456365,-560,40,-129,-649,-0.050532011082736916,0.008535685944681343,0.04199632513805551,-703,-431,-0.14071257005604487,-0.09252833622079243
7104,28099,Neshoba,Mississippi,2000,2563,6409,94,9066,0.2827046106331348,0.7069269799249945,0.010368409441870726,0,0,0,0,0.0,0.0,0.0,-3846,0,-0.42422236929185975,0.0
7105,28099,Neshoba,Mississippi,2004,2600,7780,39,10419,0.24954410212112488,0.7467127363470583,0.003743161531816873,37,-55,1371,1353,-0.03316050851200991,-0.0066252479100538525,0.03978575642206372,-5180,-1334,-0.4971686342259334,-0.07294626493407363
7106,28099,Neshoba,Mississippi,2008,3114,8209,79,11402,0.2731099807051395,0.7199614102788985,0.0069286090159621115,514,40,429,983,0.0235658785840146,0.0031854474841452383,-0.026751326068159775,-5095,85,-0.446851429573759,0.050317204652174374
7107,28099,Neshoba,Mississippi,2012,3089,7837,89,11015,0.2804357694053563,0.711484339536995,0.00807989105764866,-25,10,-372,-387,0.007325788700216829,0.0011512820416865492,-0.008477070741903514,-4748,347,-0.43104857013163866,0.015802859442120343
7108,28099,Neshoba,Mississippi,2016,2715,7679,159,10553,0.2572728134179854,0.7276603809343315,0.015066805647683123,-374,70,-158,-462,-0.023162955987370892,0.006986914590034463,0.016176041397336527,-4964,-216,-0.4703875675163461,-0.03933899738470742
7109,28101,Newton,Mississippi,2000,2147,5540,51,7738,0.27746187645386405,0.7159472731972086,0.006590850348927371,0,0,0,0,0.0,0.0,0.0,-3393,0,-0.4384853967433446,0.0
7110,28101,Newton,Mississippi,2004,2280,6165,43,8488,0.26861451460885954,0.7263195098963242,0.005065975494816211,133,-8,625,750,-0.008847361845004509,-0.0015248748541111601,0.010372236699115578,-3885,-492,-0.45770499528746467,-0.019219598544120087
7111,28101,Newton,Mississippi,2008,3218,6579,58,9855,0.3265347539320142,0.6675799086757991,0.005885337392186708,938,15,414,1367,0.057920239323154654,0.0008193618973704967,-0.05873960122052513,-3361,524,-0.3410451547437849,0.11665984054367978
7112,28101,Newton,Mississippi,2012,3319,6394,64,9777,0.33947018512836247,0.6539838396236064,0.006545975248031094,101,6,-185,-78,0.012935431196348268,0.0006606378558443862,-0.013596069052192683,-3075,286,-0.31451365449524393,0.02653150024854095
7113,28101,Newton,Mississippi,2016,2756,6548,134,9438,0.29201101928374656,0.6937910574274211,0.01419792328883238,-563,70,154,-339,-0.0474591658446159,0.0076519480408012855,0.03980721780381469,-3792,-717,-0.4017800381436745,-0.08726638364843059
7114,28103,Noxubee,Mississippi,2000,3383,1530,41,4954,0.6828825191764231,0.3088413403310456,0.008276140492531288,0,0,0,0,0.0,0.0,0.0,1853,0,0.37404117884537746,0.0
7115,28103,Noxubee,Mississippi,2004,4346,1723,28,6097,0.7128095784812203,0.2825979990159095,0.004592422502870264,963,-13,193,1143,0.02992705930479722,-0.0036837179896610237,-0.026243341315136115,2623,770,0.4302115794653108,0.056170400619933336
7116,28103,Noxubee,Mississippi,2008,5030,1525,34,6589,0.7633935346790105,0.2314463499772348,0.005160115343754742,684,6,-198,492,0.050583956197790214,0.0005676928408844782,-0.051151649038674696,3505,882,0.5319471847017757,0.10173560523646491
7117,28103,Noxubee,Mississippi,2012,4920,1325,19,6264,0.7854406130268199,0.21152618135376755,0.003033205619412516,-110,-15,-200,-325,0.02204707834780939,-0.0021269097243422266,-0.019920168623467238,3595,90,0.5739144316730523,0.04196724697127663
7118,28103,Noxubee,Mississippi,2016,4347,1200,27,5574,0.7798708288482239,0.21528525296017223,0.004843918191603875,-573,8,-125,-690,-0.005569784178595993,0.0018107125721913593,0.003759071606404679,3147,-448,0.5645855758880517,-0.009328855785000645
7119,28105,Oktibbeha,Mississippi,2000,6443,7959,402,14804,0.4352202107538503,0.5376249662253445,0.02715482302080519,0,0,0,0,0.0,0.0,0.0,-1516,0,-0.10240475547149419,0.0
7120,28105,Oktibbeha,Mississippi,2004,7015,9068,207,16290,0.43063228974831186,0.5566605279312462,0.01270718232044199,572,-195,1109,1486,-0.004587921005538453,-0.0144476407003632,0.019035561705901705,-2053,-537,-0.12602823818293435,-0.023623482711440158
7121,28105,Oktibbeha,Mississippi,2008,9326,9320,146,18792,0.49627501064282675,0.4959557258407833,0.007769263516389954,2311,-61,252,2502,0.0656427208945149,-0.004937918804052036,-0.06070480209046292,6,2059,0.00031928480204346243,0.1263475229849778
7122,28105,Oktibbeha,Mississippi,2012,9095,8761,261,18117,0.5020146823425512,0.48357895898879505,0.014406358668653751,-231,115,-559,-675,0.005739671699724447,0.006637095152263798,-0.012376766851988241,334,328,0.01843572335375615,0.018116438551712688
7123,28105,Oktibbeha,Mississippi,2016,8859,8576,689,18124,0.4887993820348709,0.4731847274332377,0.038015890531891416,-236,428,-185,7,-0.013215300307680311,0.023609531863237665,-0.010394231555557354,283,-51,0.015614654601633193,-0.002821068752122957
7124,28107,Panola,Mississippi,2000,5880,5424,85,11389,0.5162876459741856,0.47624901220475896,0.007463341821055404,0,0,0,0,0.0,0.0,0.0,456,0,0.04003863376942668,0.0
7125,28107,Panola,Mississippi,2004,6615,6769,56,13440,0.4921875,0.5036458333333333,0.004166666666666667,735,-29,1345,2051,-0.02410014597418564,-0.0032966751543887377,0.02739682112857439,-154,-610,-0.011458333333333348,-0.05149696710276003
7126,28107,Panola,Mississippi,2008,8690,7620,106,16416,0.5293615984405458,0.4641812865497076,0.006457115009746588,2075,50,851,2976,0.037174098440545755,0.0022904483430799217,-0.039464546783625765,1070,1224,0.06518031189083817,0.07663864522417152
7127,28107,Panola,Mississippi,2012,9079,7629,118,16826,0.5395815999049091,0.4534054439557827,0.007012956139308213,389,12,9,410,0.010220001464363304,0.0005558411295616249,-0.01077584259392489,1450,380,0.08617615594912637,0.020995844058288193
7128,28107,Panola,Mississippi,2016,7431,7449,184,15064,0.49329527349973445,0.494490175252257,0.012214551248008496,-1648,66,-180,-1762,-0.046286326405174605,0.005201595108700283,0.04108473129647433,-18,-1468,-0.0011949017525225702,-0.08737105770164894
7129,28109,Pearl River,Mississippi,2000,4611,11575,291,16477,0.2798446319111489,0.7024943861139771,0.017660981974874066,0,0,0,0,0.0,0.0,0.0,-6964,0,-0.4226497542028282,0.0
7130,28109,Pearl River,Mississippi,2004,4472,14896,119,19487,0.2294863242161441,0.7644070405911634,0.006106635192692564,-139,-172,3321,3010,-0.050358307695004795,-0.011554346782181502,0.0619126544771863,-10424,-3460,-0.5349207163750193,-0.11227096217219107
7131,28109,Pearl River,Mississippi,2008,4320,17881,242,22443,0.1924876353428686,0.7967294924920911,0.010782872165040324,-152,123,2985,2956,-0.03699868887327548,0.00467623697234776,0.03232245190092775,-13561,-3137,-0.6042418571492225,-0.06932114077420326
7132,28109,Pearl River,Mississippi,2012,4366,17549,309,22224,0.1964542836573074,0.7896418286537077,0.013903887688984881,46,67,-332,-219,0.003966648314438798,0.0031210155239445574,-0.00708766383838344,-13183,378,-0.5931875449964003,0.011054312152822265
7133,28109,Pearl River,Mississippi,2016,3604,17782,497,21883,0.164694054745693,0.8125942512452589,0.02271169400904812,-762,188,233,-341,-0.0317602289116144,0.00880780632006324,0.02295242259155117,-14178,-995,-0.6479001964995659,-0.05471265150316562
7134,28111,Perry,Mississippi,2000,1285,3026,48,4359,0.2947923835742143,0.6941959164946089,0.011011699931176875,0,0,0,0,0.0,0.0,0.0,-1741,0,-0.3994035329203946,0.0
7135,28111,Perry,Mississippi,2004,1261,3747,22,5030,0.2506958250497018,0.7449304174950299,0.00437375745526839,-24,-26,721,671,-0.0440965585245125,-0.006637942475908485,0.050734501000420984,-2486,-745,-0.4942345924453281,-0.09483105952493348
7136,28111,Perry,Mississippi,2008,1533,4067,64,5664,0.2706567796610169,0.7180437853107344,0.011299435028248588,272,42,320,634,0.01996095461131514,0.006925677572980198,-0.026886632184295434,-2534,-48,-0.4473870056497175,0.046847586795610574
7137,28111,Perry,Mississippi,2012,1527,4137,58,5722,0.2668647326109752,0.722998951415589,0.010136315973435861,-6,-6,70,58,-0.0037920470500417136,-0.0011631190548127262,0.00495516610485458,-2610,-76,-0.4561342188046138,-0.008747213154896294
7138,28111,Perry,Mississippi,2016,1220,4135,77,5432,0.22459499263622976,0.7612297496318114,0.014175257731958763,-307,19,-2,-290,-0.04226973997474545,0.0040389417585229015,0.03823079821622244,-2915,-305,-0.5366347569955817,-0.08050053819096792
7139,28113,Pike,Mississippi,2000,6544,7464,158,14166,0.4619511506423832,0.5268953833121559,0.011153466045460962,0,0,0,0,0.0,0.0,0.0,-920,0,-0.06494423266977273,0.0
7140,28113,Pike,Mississippi,2004,7881,8660,91,16632,0.47384559884559885,0.5206830206830206,0.005471380471380472,1337,-67,1196,2466,0.011894448203215668,-0.0056820855740804905,-0.006212362629135271,-779,141,-0.04683742183742179,0.01810681083235094
7141,28113,Pike,Mississippi,2008,9276,8651,128,18055,0.5137635004153974,0.4791470506784824,0.007089448906120188,1395,37,-9,1423,0.039917901569798575,0.0016180684347397167,-0.041535970004538236,625,1404,0.03461644973691502,0.08145387157433681
7142,28113,Pike,Mississippi,2012,9650,8181,143,17974,0.5368866139979971,0.45515744964949373,0.00795593635250918,374,15,-470,-81,0.023123113582599664,0.0008664874463889917,-0.023989601028988672,1469,844,0.08172916434850336,0.047112714611588336
7143,28113,Pike,Mississippi,2016,8043,8009,308,16360,0.4916259168704156,0.4895476772616137,0.01882640586797066,-1607,165,-172,-1614,-0.04526069712758146,0.010870469515461481,0.03439022761211996,34,-1435,0.002078239608801935,-0.07965092473970142
7144,28115,Pontotoc,Mississippi,2000,2771,6601,138,9510,0.29137749737118823,0.694111461619348,0.014511041009463722,0,0,0,0,0.0,0.0,0.0,-3830,0,-0.40273396424815977,0.0
7145,28115,Pontotoc,Mississippi,2004,2660,8480,100,11240,0.23665480427046262,0.7544483985765125,0.008896797153024912,-111,-38,1879,1730,-0.05472269310072561,-0.00561424385643881,0.060336936957164466,-5820,-1990,-0.5177935943060499,-0.1150596300578901
7146,28115,Pontotoc,Mississippi,2008,2982,9727,159,12868,0.23173764376748524,0.7559061237177495,0.012356232514765308,322,59,1247,1628,-0.004917160502977386,0.0034594353617403966,0.0014577251412369874,-6745,-925,-0.5241684799502642,-0.00637488564421429
7147,28115,Pontotoc,Mississippi,2012,2804,9448,159,12411,0.22592861171541376,0.7612601724276851,0.012811215856901136,-178,0,-279,-457,-0.005809032052071478,0.00045498334213582743,0.0053540487099356104,-6644,101,-0.5353315607122713,-0.011163080762007116
7148,28115,Pontotoc,Mississippi,2016,2386,10336,262,12984,0.18376463339494764,0.7960566851509551,0.02017868145409735,-418,103,888,573,-0.04216397832046612,0.0073674655971962145,0.03479651272327,-7950,-1306,-0.6122920517560074,-0.07696049104373615
7149,28117,Prentiss,Mississippi,2000,3287,5101,94,8482,0.387526526762556,0.6013911813251591,0.011082291912284839,0,0,0,0,0.0,0.0,0.0,-1814,0,-0.21386465456260312,0.0
7150,28117,Prentiss,Mississippi,2004,3327,6538,67,9932,0.33497784937575514,0.6582762786951268,0.006745871929118003,40,-27,1437,1450,-0.05254867738680086,-0.004336419983166836,0.05688509736996772,-3211,-1397,-0.3232984293193717,-0.10943377475676858
7151,28117,Prentiss,Mississippi,2008,3020,7703,221,10944,0.27595029239766083,0.7038559941520468,0.0201937134502924,-307,154,1165,1012,-0.05902755697809431,0.013447841521174397,0.04557971545691997,-4683,-1472,-0.42790570175438597,-0.10460727243501428
7152,28117,Prentiss,Mississippi,2012,2817,7075,141,10033,0.2807734476228446,0.7051729293332004,0.014053623043954949,-203,-80,-628,-911,0.004823155225183784,-0.006140090406337451,0.0013169351811536112,-4258,425,-0.4243994817103558,0.0035062200440301727
7153,28117,Prentiss,Mississippi,2016,2067,7648,157,9872,0.20938006482982172,0.7747163695299838,0.01590356564019449,-750,16,573,-161,-0.0713933827930229,0.0018499425962395406,0.06954344019678338,-5581,-1323,-0.565336304700162,-0.14093682298980625
7154,28119,Quitman,Mississippi,2000,2103,1280,30,3413,0.61617345443891,0.37503662467037796,0.008789920890711983,0,0,0,0,0.0,0.0,0.0,823,0,0.24113682976853207,0.0
7155,28119,Quitman,Mississippi,2004,2032,1360,26,3418,0.5944997074312464,0.3978935049736688,0.0076067875950848445,-71,-4,80,5,-0.02167374700766367,-0.0011831332956271385,0.02285688030329086,672,-151,0.19660620245757754,-0.04453062731095453
7156,28119,Quitman,Mississippi,2008,2803,1334,31,4168,0.6725047984644914,0.32005758157389635,0.007437619961612284,771,5,-26,750,0.07800509103324504,-0.00016916763347256045,-0.07783592339977247,1469,797,0.35244721689059505,0.1558410144330175
7157,28119,Quitman,Mississippi,2012,2837,1116,26,3979,0.7129932143754713,0.2804724805227444,0.006534305101784368,34,-5,-218,-189,0.04048841591097985,-0.000903314859827916,-0.03958510105115193,1721,252,0.4325207338527268,0.08007351696213177
7158,28119,Quitman,Mississippi,2016,2312,1001,52,3365,0.687072808320951,0.2974739970282318,0.015453194650817237,-525,26,-115,-614,-0.025920406054520284,0.008918889549032869,0.01700151650548737,1311,-410,0.38959881129271917,-0.04292192256000765
7159,28121,Rankin,Mississippi,2000,8050,32983,402,41435,0.1942801979003258,0.7960178592976952,0.009701942801979004,0,0,0,0,0.0,0.0,0.0,-24933,0,-0.6017376613973694,0.0
7160,28121,Rankin,Mississippi,2004,11005,43054,667,54726,0.2010927164419106,0.7867192924752403,0.012187991082849103,2955,265,10071,13291,0.006812518541584794,0.002486048280870099,-0.00929856682245489,-32049,-7116,-0.5856265760333297,0.016111085364039712
7161,28121,Rankin,Mississippi,2008,14372,48140,665,63177,0.2274878515915602,0.7619861658514966,0.010525982556943191,3367,-2,5086,8451,0.026395135149649612,-0.0016620085259059121,-0.024733126623743718,-33768,-1719,-0.5344983142599364,0.051128261773393247
7162,28121,Rankin,Mississippi,2012,14988,48444,713,64145,0.2336581183256684,0.755226440096656,0.01111544157767558,616,48,304,968,0.0061702667341081985,0.0005894590207323885,-0.006759725754840629,-33456,312,-0.5215683217709876,0.012929992488948883
7163,28121,Rankin,Mississippi,2016,14110,47178,1822,63110,0.2235778798922516,0.7475518935192521,0.028870226588496275,-878,1109,-1266,-1035,-0.010080238433416794,0.017754785010820694,-0.007674546577403851,-33068,388,-0.5239740136270005,-0.002405691856012915
7164,28123,Scott,Mississippi,2000,3548,5601,57,9206,0.3854008255485553,0.6084075602867695,0.006191614164675212,0,0,0,0,0.0,0.0,0.0,-2053,0,-0.22300673473821414,0.0
7165,28123,Scott,Mississippi,2004,3802,6395,31,10228,0.3717246773562769,0.6252444270629645,0.0030308955807587016,254,-26,794,1022,-0.013676148192278414,-0.00316071858391651,0.016836866776195003,-2593,-540,-0.25351974970668756,-0.030513014968473418
7166,28123,Scott,Mississippi,2008,5025,6584,62,11671,0.43055436552137777,0.5641333219090052,0.005312312569616999,1223,31,189,1443,0.05882968816510087,0.0022814169888582974,-0.06111110515395923,-1559,1034,-0.13357895638762746,0.1199407933190601
7167,28123,Scott,Mississippi,2012,5031,6089,82,11202,0.44911622924477773,0.5435636493483307,0.007320121406891627,6,20,-495,-469,0.018561863723399963,0.002007808837274628,-0.020569672560674546,-1058,501,-0.09444742010355295,0.03913153628407451
7168,28123,Scott,Mississippi,2016,4268,6122,132,10522,0.40562630678578215,0.5818285497053792,0.012545143508838624,-763,50,33,-680,-0.04348992245899558,0.005225022101946997,0.03826490035704855,-1854,-796,-0.17620224291959707,-0.08175482281604413
7169,28125,Sharkey,Mississippi,2000,1706,1074,123,2903,0.5876679297278677,0.3699621081639683,0.04236996210816397,0,0,0,0,0.0,0.0,0.0,632,0,0.21770582156389945,0.0
7170,28125,Sharkey,Mississippi,2004,1560,1120,413,3093,0.504364694471387,0.3621079857743291,0.13352731975428386,-146,290,46,190,-0.08330323525648076,0.0911573576461199,-0.007854122389639173,440,-192,0.14225670869705787,-0.07544911286684158
7171,28125,Sharkey,Mississippi,2008,1907,873,15,2795,0.6822898032200357,0.31234347048300537,0.005366726296958855,347,-398,-247,-298,0.17792510874864875,-0.128160593457325,-0.04976451529132375,1034,594,0.36994633273703037,0.2276896240399725
7172,28125,Sharkey,Mississippi,2012,1782,737,13,2532,0.7037914691943128,0.2910742496050553,0.005134281200631911,-125,-2,-136,-263,0.02150166597427705,-0.00023244509632694334,-0.02126922087795008,1045,11,0.4127172195892575,0.04277088685222713
7173,28125,Sharkey,Mississippi,2016,1479,692,19,2190,0.6753424657534246,0.31598173515981737,0.008675799086757991,-303,6,-45,-342,-0.028449003440888188,0.0035415178861260797,0.024907485554762077,787,-258,0.35936073059360724,-0.053356488995650264
7174,28127,Simpson,Mississippi,2000,3227,6254,93,9574,0.3370587006475872,0.6532274911217881,0.009713808230624609,0,0,0,0,0.0,0.0,0.0,-3027,0,-0.31616879047420093,0.0
7175,28127,Simpson,Mississippi,2004,3272,7138,64,10474,0.31239259117815543,0.6814970402902425,0.006110368531602062,45,-29,884,900,-0.024666109469431763,-0.0036034396990225464,0.028269549168454366,-3866,-839,-0.36910444911208706,-0.05293565863788613
7176,28127,Simpson,Mississippi,2008,4817,7641,152,12610,0.3819984139571768,0.6059476605868358,0.012053925455987312,1545,88,503,2136,0.06960582277902139,0.00594355692438525,-0.0755493797034067,-2824,1042,-0.22394924662965898,0.14515520248242808
7177,28127,Simpson,Mississippi,2012,4723,7424,102,12249,0.385582496530329,0.6060902930851498,0.008327210384521186,-94,-50,-217,-361,0.003584082573152181,-0.0037267150714661267,0.00014263249831403257,-2701,123,-0.22050779655482083,0.0034414500748381482
7178,28127,Simpson,Mississippi,2016,3874,7393,152,11419,0.3392591295209738,0.6474297223925037,0.013311148086522463,-849,50,-31,-830,-0.04632336700935519,0.004983937702001277,0.0413394293073539,-3519,-818,-0.3081705928715299,-0.08766279631670909
7179,28129,Smith,Mississippi,2000,1620,4838,70,6528,0.24816176470588236,0.7411151960784313,0.010723039215686275,0,0,0,0,0.0,0.0,0.0,-3218,0,-0.492953431372549,0.0
7180,28129,Smith,Mississippi,2004,1496,5577,47,7120,0.2101123595505618,0.7832865168539326,0.006601123595505618,-124,-23,739,592,-0.03804940515532057,-0.004121915620180656,0.04217132077550123,-4081,-863,-0.5731741573033708,-0.08022072593082186
7181,28129,Smith,Mississippi,2008,1968,6265,72,8305,0.23696568332329923,0.7543648404575557,0.008669476219145093,472,25,688,1185,0.026853323772737442,0.002068352623639475,-0.028921676396376883,-4297,-216,-0.5173991571342564,0.05577500016911441
7182,28129,Smith,Mississippi,2012,1979,6049,71,8099,0.24435115446351402,0.7468823311519941,0.008766514384491912,11,-1,-216,-206,0.007385471140214789,9.703816534681851e-05,-0.007482509305561602,-4070,227,-0.5025311766884801,0.014867980445776308
7183,28129,Smith,Mississippi,2016,1617,5928,82,7627,0.21200996459944932,0.7772387570473318,0.010751278353218829,-362,11,-121,-472,-0.0323411898640647,0.001984763968726917,0.030356425895337713,-4311,-241,-0.5652287924478825,-0.06269761575940236
7184,28131,Stone,Mississippi,2000,1677,3702,144,5523,0.30363932645301467,0.6702878870179251,0.026072786529060293,0,0,0,0,0.0,0.0,0.0,-2025,0,-0.3666485605649104,0.0
7185,28131,Stone,Mississippi,2004,1528,4146,61,5735,0.2664341761115955,0.7229293809938971,0.01063644289450741,-149,-83,444,212,-0.03720515034141919,-0.015436343634552882,0.052641493975972065,-2618,-593,-0.45649520488230166,-0.08984664431739126
7186,28131,Stone,Mississippi,2008,1996,5149,101,7246,0.27546232404085014,0.7105989511454596,0.013938724813690313,468,40,1003,1511,0.00902814792925466,0.0033022819191829023,-0.012330429848437574,-3153,-535,-0.43513662710460943,0.021358577777692234
7187,28131,Stone,Mississippi,2012,2003,5420,109,7532,0.2659320233669676,0.7195963887413701,0.014471587891662242,7,8,271,286,-0.009530300673882552,0.000532863077971929,0.00899743759591054,-3417,-264,-0.4536643653744025,-0.018527738269793093
7188,28131,Stone,Mississippi,2016,1573,5306,166,7045,0.22327892122072393,0.7531582682753726,0.023562810503903478,-430,57,-114,-487,-0.042653102146243654,0.009091222612241236,0.03356187953400247,-3733,-316,-0.5298793470546487,-0.07621498168024615
7189,28133,Sunflower,Mississippi,2000,4981,3369,65,8415,0.591919191919192,0.40035650623885916,0.007724301841948901,0,0,0,0,0.0,0.0,0.0,1612,0,0.1915626856803328,0.0
7190,28133,Sunflower,Mississippi,2004,6359,3534,122,10015,0.6349475786320519,0.3528706939590614,0.01218172740888667,1378,57,165,1600,0.04302838671285991,0.0044574255669377685,-0.04748581227979776,2825,1213,0.28207688467299047,0.09051419899265767
7191,28133,Sunflower,Mississippi,2008,7838,3245,110,11193,0.700259090502993,0.2899133386938265,0.00982757080318056,1479,-12,-289,1178,0.06531151187094109,-0.00235415660570611,-0.06295735526523488,4593,1768,0.41034575180916644,0.12826886713617597
7192,28133,Sunflower,Mississippi,2012,8199,2929,100,11228,0.7302280014250089,0.2608656929105807,0.008906305664410403,361,-10,-316,35,0.029968910922015923,-0.0009212651387701561,-0.029047645783245812,5270,677,0.4693623085144282,0.059016556705261736
7193,28133,Sunflower,Mississippi,2016,6725,2794,79,9598,0.7006668055844968,0.2911023129818712,0.008230881433632006,-1474,-21,-135,-1630,-0.02956119584051209,-0.0006754242307783972,0.03023662007129052,3931,-1339,0.40956449260262556,-0.05979781591180261
7194,28135,Tallahatchie,Mississippi,2000,3041,2428,54,5523,0.5506065544088358,0.4396161506427666,0.00977729494839761,0,0,0,0,0.0,0.0,0.0,613,0,0.11099040376606917,0.0
7195,28135,Tallahatchie,Mississippi,2004,3420,2737,60,6217,0.5501045520347434,0.44024449091201545,0.009650957053241113,379,6,309,694,-0.0005020023740923696,-0.00012633789515649647,0.0006283402692488504,683,70,0.10986006112272795,-0.00113034264334122
7196,28135,Tallahatchie,Mississippi,2008,4105,2786,52,6943,0.5912429785395362,0.40126746363243554,0.00748955782802823,685,-8,49,726,0.041138426504792824,-0.0021613992252128827,-0.03897702727957991,1319,636,0.18997551490710068,0.08011545378437274
7197,28135,Tallahatchie,Mississippi,2012,3959,2499,45,6503,0.6087959403352299,0.38428417653390745,0.006919883130862679,-146,-7,-287,-440,0.017552961795693656,-0.000569674697165551,-0.016983287098528088,1460,141,0.22451176380132243,0.034536248894221744
7198,28135,Tallahatchie,Mississippi,2016,3337,2462,71,5870,0.5684838160136286,0.4194207836456559,0.012095400340715502,-622,26,-37,-633,-0.04031212432160125,0.005175517209852823,0.03513660711174843,875,-585,0.14906303236797275,-0.07544873143334968
7199,28137,Tate,Mississippi,2000,3441,5148,104,8693,0.3958357298976188,0.5922006211894628,0.01196364891291844,0,0,0,0,0.0,0.0,0.0,-1707,0,-0.19636489129184403,0.0
7200,28137,Tate,Mississippi,2004,4347,6760,60,11167,0.38927196203098413,0.6053550640279395,0.005372973941076386,906,-44,1612,2474,-0.006563767866634651,-0.006590674971842055,0.013154442838476665,-2413,-706,-0.21608310199695535,-0.019718210705111316
7201,28137,Tate,Mississippi,2008,5003,7678,97,12778,0.391532321177023,0.6008765064955393,0.007591172327437784,656,37,918,1611,0.0022603591460388928,0.002218198386361398,-0.004478557532400229,-2675,-262,-0.20934418531851623,0.006738916678439122
7202,28137,Tate,Mississippi,2012,4933,7332,141,12406,0.39763017894567143,0.5910043527325488,0.011365468321779783,-70,44,-346,-372,0.006097857768648407,0.003774295994342,-0.009872153762990443,-2399,276,-0.19337417378687738,0.01597001153163885
7203,28137,Tate,Mississippi,2016,3926,7495,206,11627,0.33766233766233766,0.6446202803818698,0.017717381955792554,-1007,65,163,-779,-0.05996784128333377,0.00635191363401277,0.053615927649320994,-3569,-1170,-0.30695794271953214,-0.11358376893265476
7204,28139,Tippah,Mississippi,2000,2908,5381,114,8403,0.34606688087587767,0.6403665357610377,0.013566583363084613,0,0,0,0,0.0,0.0,0.0,-2473,0,-0.2942996548851601,0.0
7205,28139,Tippah,Mississippi,2004,3016,6174,85,9275,0.3251752021563342,0.6656603773584906,0.009164420485175202,108,-29,793,872,-0.02089167871954345,-0.004402162877909411,0.02529384159745285,-3158,-685,-0.3404851752021564,-0.0461855203169963
7206,28139,Tippah,Mississippi,2008,2623,6937,165,9725,0.2697172236503856,0.7133161953727506,0.01696658097686375,-393,80,763,450,-0.055457978505948635,0.00780216049168855,0.04765581801426,-4314,-1156,-0.443598971722365,-0.10311379652020863
7207,28139,Tippah,Mississippi,2012,2317,6717,130,9164,0.2528371890004365,0.7329768659973811,0.014185945002182452,-306,-35,-220,-561,-0.016880034649949083,-0.0027806359746812993,0.019660670624630505,-4400,-86,-0.4801396769969446,-0.03654070527457959
7208,28139,Tippah,Mississippi,2016,1842,7240,178,9260,0.19892008639308856,0.7818574514038877,0.019222462203023757,-475,48,523,96,-0.053917102607347944,0.005036517200841304,0.04888058540650664,-5398,-998,-0.5829373650107992,-0.10279768801385458
7209,28141,Tishomingo,Mississippi,2000,2747,4122,123,6992,0.39287757437070936,0.5895308924485125,0.01759153318077803,0,0,0,0,0.0,0.0,0.0,-1375,0,-0.19665331807780317,0.0
7210,28141,Tishomingo,Mississippi,2004,2846,5379,113,8338,0.3413288558407292,0.6451187335092349,0.013552410650035979,99,-10,1257,1346,-0.051548718529980164,-0.004039122530742052,0.05558784106072234,-2533,-1158,-0.3037898776685057,-0.10713655959070251
7211,28141,Tishomingo,Mississippi,2008,1962,6249,208,8419,0.2330443045492339,0.742249673357881,0.02470602209288514,-884,95,870,81,-0.1082845512914953,0.011153611442849163,0.09713093984864607,-4287,-1754,-0.5092053688086471,-0.2054154911401414
7212,28141,Tishomingo,Mississippi,2012,1643,6133,160,7936,0.20703125,0.7728074596774194,0.020161290322580645,-319,-48,-116,-483,-0.02601305454923389,-0.004544731770304497,0.030557786319538427,-4490,-203,-0.5657762096774194,-0.05657084086877229
7213,28141,Tishomingo,Mississippi,2016,999,7166,206,8371,0.1193405805757974,0.8560506510572213,0.024608768366981244,-644,46,1033,435,-0.0876906694242026,0.004447478044400599,0.08324319137980196,-6167,-1677,-0.7367100704814239,-0.17093386080400452
7214,28143,Tunica,Mississippi,2000,1539,792,35,2366,0.650464919695689,0.33474218089602703,0.014792899408284023,0,0,0,0,0.0,0.0,0.0,747,0,0.31572273879966195,0.0
7215,28143,Tunica,Mississippi,2004,2140,950,39,3129,0.6839245765420262,0.30361137743688077,0.012464046021093002,601,4,158,763,0.03345965684633723,-0.002328853387191021,-0.03113080345914626,1190,443,0.38031319910514544,0.06459046030548349
7216,28143,Tunica,Mississippi,2008,3279,1017,36,4332,0.7569252077562327,0.2347645429362881,0.008310249307479225,1139,-3,67,1203,0.07300063121420652,-0.004153796713613777,-0.06884683450059267,2262,1072,0.5221606648199446,0.14184746571479917
7217,28143,Tunica,Mississippi,2012,3475,883,24,4382,0.7930168872660885,0.20150616157005932,0.005476951163852123,196,-12,-134,50,0.03609167950985581,-0.002833298143627102,-0.03325838136622877,2592,330,0.5915107256960292,0.06935006087608464
7218,28143,Tunica,Mississippi,2016,2667,853,47,3567,0.7476871320437343,0.23913652929632745,0.013176338659938324,-808,23,-30,-815,-0.04532975522235427,0.007699387496086201,0.03763036772626813,1814,-778,0.5085506027474068,-0.08296012294862243
7219,28145,Union,Mississippi,2000,3094,6087,130,9311,0.3322951347868113,0.6537428847599613,0.013961980453227366,0,0,0,0,0.0,0.0,0.0,-2993,0,-0.32144774997315007,0.0
7220,28145,Union,Mississippi,2004,2839,7906,74,10819,0.2624087253905167,0.7307514557722525,0.006839818837230798,-255,-56,1819,1508,-0.06988640939629459,-0.007122161615996568,0.0770085710122912,-5067,-2074,-0.46834273038173585,-0.14689498040858578
7221,28145,Union,Mississippi,2008,2985,9072,138,12195,0.24477244772447723,0.7439114391143912,0.01131611316113161,146,64,1166,1376,-0.01763627766603945,0.004476294323900813,0.013159983342138637,-6087,-1020,-0.4991389913899139,-0.03079626100817806
7222,28145,Union,Mississippi,2012,2742,8498,125,11365,0.2412670479542455,0.7477342718873735,0.010998680158380994,-243,-13,-574,-830,-0.003505399770231732,-0.00031743300275061635,0.003822832772982343,-5756,331,-0.506467223933128,-0.00732823254321413
7223,28145,Union,Mississippi,2016,2012,9235,249,11496,0.17501739735560196,0.8033228949199722,0.021659707724425888,-730,124,737,131,-0.06624965059864354,0.010661027566044893,0.055588623032598705,-7223,-1467,-0.6283054975643703,-0.12183827363124222
7224,28147,Walthall,Mississippi,2000,2356,3476,63,5895,0.3996607294317218,0.5896522476675149,0.010687022900763359,0,0,0,0,0.0,0.0,0.0,-1120,0,-0.18999151823579308,0.0
7225,28147,Walthall,Mississippi,2004,2435,3888,33,6356,0.3831025802391441,0.6117054751415985,0.005191944619257395,79,-30,412,461,-0.016558149192577698,-0.005495078281505964,0.02205322747408356,-1453,-333,-0.22860289490245433,-0.03861137666666126
7226,28147,Walthall,Mississippi,2008,3456,4253,71,7780,0.4442159383033419,0.5466580976863753,0.009125964010282777,1021,38,365,1424,0.061113358064197765,0.003934019391025382,-0.06504737745522315,-797,656,-0.10244215938303342,0.12616073551942092
7227,28147,Walthall,Mississippi,2012,3422,4051,78,7551,0.4531850086081314,0.536485233743875,0.010329757647993643,-34,7,-202,-229,0.008969070304789495,0.0012037936377108666,-0.010172863942500276,-629,168,-0.08330022513574364,0.01914193424728977
7228,28147,Walthall,Mississippi,2016,2790,4056,73,6919,0.4032374620609915,0.5862118803295274,0.010550657609481139,-632,-5,5,-632,-0.0499475465471399,0.00022089996148749562,0.0497266465856524,-1266,-637,-0.18297441826853594,-0.0996741931327923
7229,28149,Warren,Mississippi,2000,7485,10892,246,18623,0.4019223540782903,0.5848681737636257,0.013209472158084089,0,0,0,0,0.0,0.0,0.0,-3407,0,-0.18294581968533535,0.0
7230,28149,Warren,Mississippi,2004,8224,11356,103,19683,0.417822486409592,0.576944571457603,0.005232942132804959,739,-143,464,1060,0.01590013233130172,-0.00797653002527913,-0.007923602306022626,-3132,275,-0.159122085048011,0.023823734637324345
7231,28149,Warren,Mississippi,2008,10489,11152,123,21764,0.48194265759970595,0.5124058077559273,0.005651534644366844,2265,20,-204,2081,0.06412017119011393,0.0004185925115618855,-0.06453876370167577,-663,2469,-0.030463150156221308,0.1286589348917897
7232,28149,Warren,Mississippi,2012,10786,10457,148,21391,0.504230751250526,0.48885045112430464,0.006918797625169464,297,25,-695,-373,0.022288093650820018,0.0012672629808026196,-0.023555356631622615,329,992,0.015380300126221325,0.04584345028244263
7233,28149,Warren,Mississippi,2016,9284,9767,365,19416,0.4781623403378657,0.5030387309435517,0.018798928718582613,-1502,217,-690,-1975,-0.026068410912660267,0.011880131093413149,0.01418827981924703,-483,-812,-0.024876390605685972,-0.040256690731907296
7234,28151,Washington,Mississippi,2000,10405,7367,556,18328,0.5677106067219555,0.40195329550414666,0.030336097773897862,0,0,0,0,0.0,0.0,0.0,3038,0,0.16575731121780884,0.0
7235,28151,Washington,Mississippi,2004,11569,7731,297,19597,0.5903454610399551,0.394499158034393,0.015155380925651886,1164,-259,364,1269,0.02263485431799961,-0.015180716848245976,-0.007454137469753652,3838,800,0.1958463030055621,0.03008899178775326
7236,28151,Washington,Mississippi,2008,13148,6347,88,19583,0.6713986621048869,0.3241076443854363,0.004493693509676761,1579,-209,-1384,-14,0.08105320106493175,-0.010661687415975125,-0.07039151364895668,6801,2963,0.34729101771945053,0.15144471471388843
7237,28151,Washington,Mississippi,2012,13981,5651,83,19715,0.709155465381689,0.2866345422267309,0.004209992391580015,833,-5,-696,132,0.0377568032768022,-0.00028370111809674584,-0.03747310215870542,8330,1529,0.42252092315495815,0.07522990543550762
7238,28151,Washington,Mississippi,2016,11380,5244,201,16825,0.6763744427934621,0.3116790490341753,0.011946508172362556,-2601,118,-407,-2890,-0.032781022588226905,0.007736515780782541,0.02504450680744441,6136,-2194,0.36469539375928683,-0.057825529395671316
7239,28153,Wayne,Mississippi,2000,2981,4635,89,7705,0.3868916288124594,0.6015574302401038,0.011550940947436729,0,0,0,0,0.0,0.0,0.0,-1654,0,-0.21466580142764435,0.0
7240,28153,Wayne,Mississippi,2004,3193,5562,40,8795,0.36304718590108015,0.6324047754405913,0.0045480386583285955,212,-49,927,1090,-0.02384444291137927,-0.007002902289108133,0.030847345200487486,-2369,-715,-0.2693575895395111,-0.05469178811186676
7241,28153,Wayne,Mississippi,2008,3890,6070,62,10022,0.38814607862702055,0.6056675314308522,0.00618638994212732,697,22,508,1227,0.025098892725940403,0.0016383512837987247,-0.026737244009739092,-2180,189,-0.21752145280383162,0.051836136735679494
7242,28153,Wayne,Mississippi,2012,4148,6111,73,10332,0.40147115756871854,0.5914634146341463,0.007065427797135114,258,11,41,310,0.013325078941697988,0.0008790378550077938,-0.014204116796705857,-1963,217,-0.18999225706542777,0.027529195738403844
7243,28153,Wayne,Mississippi,2016,3524,5990,85,9599,0.3671215751640796,0.6240233357641422,0.00885508907177831,-624,12,-121,-733,-0.03434958240463892,0.0017896612746431968,0.03255992112999584,-2466,-503,-0.25690176060006253,-0.06690950353463476
7244,28155,Webster,Mississippi,2000,1426,3069,50,4545,0.3137513751375138,0.6752475247524753,0.011001100110011002,0,0,0,0,0.0,0.0,0.0,-1643,0,-0.3614961496149615,0.0
7245,28155,Webster,Mississippi,2004,1341,3708,19,5068,0.26460142067876874,0.7316495659037096,0.003749013417521705,-85,-31,639,523,-0.04914995445874504,-0.007252086692489296,0.05640204115123426,-2367,-724,-0.4670481452249408,-0.1055519956099793
7246,28155,Webster,Mississippi,2008,1349,4072,36,5457,0.24720542422576508,0.7461975444383361,0.006597031335898846,8,17,364,389,-0.01739599645300366,0.002848017918377141,0.014547978534626527,-2723,-356,-0.498992120212571,-0.031943974987630186
7247,28155,Webster,Mississippi,2012,1190,3992,52,5234,0.2273595720290409,0.7627053878486817,0.009935040122277417,-159,16,-80,-223,-0.01984585219672419,0.0033380087863785707,0.016507843410345613,-2802,-79,-0.5353458158196408,-0.0363536956070698
7248,28155,Webster,Mississippi,2016,1019,3976,74,5069,0.20102584336160978,0.7843756164924048,0.014598540145985401,-171,22,-16,-165,-0.02633372866743111,0.0046635000237079845,0.021670228643723144,-2957,-155,-0.5833497731307951,-0.048003957311154255
7249,28157,Wilkinson,Mississippi,2000,2551,1423,124,4098,0.6224987798926306,0.3472425573450464,0.030258662762323085,0,0,0,0,0.0,0.0,0.0,1128,0,0.2752562225475842,0.0
7250,28157,Wilkinson,Mississippi,2004,2794,1563,28,4385,0.6371721778791334,0.356442417331813,0.0063854047890535915,243,-96,140,287,0.0146733979865028,-0.023873257973269495,0.00919985998676659,1231,103,0.2807297605473204,0.005473537999736211
7251,28157,Wilkinson,Mississippi,2008,3534,1560,45,5139,0.6876824284880327,0.30356100408639813,0.008756567425569177,740,17,-3,754,0.050510250608899354,0.0023711626365155855,-0.05288141324541484,1974,743,0.3841214244016346,0.1033916638543142
7252,28157,Wilkinson,Mississippi,2012,3412,1415,26,4853,0.7030702658149598,0.2915722233669895,0.00535751081805069,-122,-19,-145,-286,0.015387837326927056,-0.003399056607518487,-0.01198878071940862,1997,23,0.4114980424479703,0.027376618046335677
7253,28157,Wilkinson,Mississippi,2016,2857,1318,43,4218,0.677335229966809,0.31247036510194404,0.010194404931247037,-555,17,-97,-635,-0.025735035848150845,0.004836894113196347,0.020898141734954523,1539,-458,0.3648648648648649,-0.04663317758310537
7254,28159,Winston,Mississippi,2000,3672,4645,51,8368,0.43881453154875716,0.5550908221797323,0.006094646271510516,0,0,0,0,0.0,0.0,0.0,-973,0,-0.11627629063097511,0.0
7255,28159,Winston,Mississippi,2004,3978,5386,51,9415,0.4225172596919809,0.5720658523632501,0.005416887944768986,306,0,741,1047,-0.016297271856776263,-0.0006777583267415302,0.01697503018351787,-1408,-435,-0.14954859267126924,-0.03327230204029413
7256,28159,Winston,Mississippi,2008,4653,5497,71,10221,0.455239213384209,0.5378143038841601,0.006946482731630956,675,20,111,806,0.03272195369222808,0.0015295947868619701,-0.034251548479090066,-844,564,-0.0825750904999511,0.06697350217131814
7257,28159,Winston,Mississippi,2012,4607,5168,54,9829,0.4687150269610337,0.5257910265540747,0.005493946484891647,-46,-17,-329,-392,0.013475813576824702,-0.0014525362467393086,-0.012023277330085347,-561,283,-0.05707599959304105,0.02549909090691005
7258,28159,Winston,Mississippi,2016,3850,4910,121,8881,0.4335097398941561,0.552865668280599,0.013624591825244906,-757,67,-258,-948,-0.03520528706687759,0.008130645340353258,0.027074641726524296,-1060,-499,-0.11935592838644293,-0.062279928793401884
7259,28161,Yalobusha,Mississippi,2000,2674,2470,84,5228,0.5114766641162969,0.4724560061208875,0.016067329762815608,0,0,0,0,0.0,0.0,0.0,204,0,0.03902065799540938,0.0
7260,28161,Yalobusha,Mississippi,2004,2656,3278,38,5972,0.4447421299397187,0.5488948425987944,0.006363027461486939,-18,-46,808,744,-0.06673453417657821,-0.009704302301328668,0.07643883647790689,-622,-826,-0.10415271265907572,-0.1431733706544851
7261,28161,Yalobusha,Mississippi,2008,3151,3628,47,6826,0.461617345443891,0.5314972165250512,0.00688543803105772,495,9,350,854,0.016875215504172314,0.0005224105695707812,-0.017397626073743178,-477,145,-0.06987987108116023,0.03427284157791549
7262,28161,Yalobusha,Mississippi,2012,3030,3276,48,6354,0.4768649669499528,0.5155807365439093,0.007554296506137866,-121,1,-352,-472,0.015247621506061793,0.0006688584750801458,-0.015916479981141873,-246,231,-0.03871576959395656,0.031164101487203666
7263,28161,Yalobusha,Mississippi,2016,2582,3376,119,6077,0.42488069771268716,0.5555372716801054,0.019582030607207503,-448,71,100,-277,-0.05198426923726562,0.012027734101069637,0.039956535136196014,-794,-548,-0.1306565739674182,-0.09194080437346164
7264,28163,Yazoo,Mississippi,2000,4997,5254,265,10516,0.47518067706352224,0.49961962723469,0.02519969570178775,0,0,0,0,0.0,0.0,0.0,-257,0,-0.02443895017116776,0.0
7265,28163,Yazoo,Mississippi,2004,5013,5672,302,10987,0.45626649676890874,0.5162464731045782,0.027487030126513153,16,37,418,471,-0.018914180294613503,0.0022873344247254027,0.016626845869888163,-659,-402,-0.05997997633566943,-0.035541026164501666
7266,28163,Yazoo,Mississippi,2008,6116,5290,71,11477,0.5328918706979175,0.46092184368737477,0.006186285614707676,1103,-231,-382,490,0.07662537392900881,-0.021300744511805476,-0.0553246294172034,826,1485,0.07197002701054278,0.1319500033462122
7267,28163,Yazoo,Mississippi,2012,6603,4941,76,11620,0.5682444061962134,0.42521514629948365,0.006540447504302926,487,5,-349,143,0.03535253549829587,0.0003541618895952503,-0.03570669738789112,1662,836,0.14302925989672977,0.07105923288618698
7268,28163,Yazoo,Mississippi,2016,5369,4598,103,10070,0.533167825223436,0.45660377358490567,0.010228401191658392,-1234,27,-343,-1550,-0.03507658097277744,0.003687953687355466,0.03138862728542202,771,-891,0.0765640516385303,-0.06646520825819946
7269,29001,Adair,Missouri,2000,4101,6050,401,10552,0.3886467020470053,0.5733510235026535,0.03800227445034117,0,0,0,0,0.0,0.0,0.0,-1949,0,-0.18470432145564825,0.0
7270,29001,Adair,Missouri,2004,4938,6367,99,11404,0.43300596282006315,0.558312872676254,0.008681164503682918,837,-302,317,852,0.04435926077305785,-0.02932110994665825,-0.015038150826399588,-1429,520,-0.1253069098561908,0.05939741159945744
7271,29001,Adair,Missouri,2008,5735,5891,245,11871,0.4831101002442928,0.49625136888214977,0.02063853087355741,797,146,-476,467,0.050104137424229644,0.011957366369874491,-0.06206150379410419,-156,1273,-0.013141268637856973,0.11216564121833383
7272,29001,Adair,Missouri,2012,4219,5651,256,10126,0.41665020738692476,0.5580683389294885,0.025281453683586808,-1516,11,-240,-1745,-0.06645989285736803,0.0046429228100293984,0.061816970047338715,-1432,-1276,-0.14141813154256372,-0.12827686290470675
7273,29001,Adair,Missouri,2016,3500,6030,696,10226,0.3422648151769998,0.589673381576374,0.06806180324662625,-719,440,379,100,-0.07438539220992496,0.042780349563039444,0.03160504264688546,-2530,-1098,-0.24740856639937414,-0.10599043485681042
7274,29003,Andrew,Missouri,2000,2795,4257,222,7274,0.384245257080011,0.5852350838603244,0.03051965905966456,0,0,0,0,0.0,0.0,0.0,-1462,0,-0.2009898267803134,0.0
7275,29003,Andrew,Missouri,2004,3069,5135,62,8266,0.3712799419308009,0.6212194531817082,0.007500604887490926,274,-160,878,992,-0.012965315149210122,-0.023019054172173634,0.035984369321383824,-2066,-604,-0.24993951125090735,-0.048949684470593946
7276,29003,Andrew,Missouri,2008,3345,5279,166,8790,0.38054607508532423,0.6005688282138794,0.01888509670079636,276,104,144,524,0.009266133154523348,0.011384491813305433,-0.02065062496782888,-1934,132,-0.22002275312855513,0.029916758122352227
7277,29003,Andrew,Missouri,2012,2649,5457,235,8341,0.31758781920633017,0.6542381009471286,0.028174079846541182,-696,69,178,-449,-0.06295825587899406,0.009288983145744823,0.053669272733249285,-2808,-874,-0.3366502817407985,-0.11662752861224335
7278,29003,Andrew,Missouri,2016,2045,6665,484,9194,0.2224276702197085,0.7249293017185121,0.05264302806177942,-604,249,1208,853,-0.09516014898662167,0.02446894821523824,0.07069120077138347,-4620,-1812,-0.5025016314988036,-0.16585134975800508
7279,29005,Atchison,Missouri,2000,1013,1798,60,2871,0.35283873214907696,0.6262626262626263,0.02089864158829676,0,0,0,0,0.0,0.0,0.0,-785,0,-0.27342389411354934,0.0
7280,29005,Atchison,Missouri,2004,1005,2137,14,3156,0.31844106463878324,0.6771229404309252,0.004435994930291508,-8,-46,339,285,-0.03439766751029372,-0.016462646658005252,0.05086031416829895,-1132,-347,-0.358681875792142,-0.08525798167859266
7281,29005,Atchison,Missouri,2008,1000,1936,40,2976,0.33602150537634407,0.6505376344086021,0.013440860215053764,-5,26,-201,-180,0.01758044073756082,0.009004865284762256,-0.02658530602232312,-936,196,-0.31451612903225806,0.04416574675988394
7282,29005,Atchison,Missouri,2012,756,1902,51,2709,0.27906976744186046,0.7021040974529347,0.018826135105204873,-244,11,-34,-267,-0.056951737934483604,0.00538527489015111,0.051566463044332544,-1146,-210,-0.4230343300110742,-0.10851820097881615
7283,29005,Atchison,Missouri,2016,541,2060,129,2730,0.19816849816849816,0.7545787545787546,0.04725274725274725,-215,78,158,21,-0.0809012692733623,0.028426612147542378,0.05247465712581989,-1519,-373,-0.5564102564102564,-0.13337592639918222
7284,29007,Audrain,Missouri,2000,4551,5256,178,9985,0.4557836755132699,0.5263895843765648,0.01782674011016525,0,0,0,0,0.0,0.0,0.0,-705,0,-0.07060590886329488,0.0
7285,29007,Audrain,Missouri,2004,4318,6294,71,10683,0.4041935785827951,0.5891603482167931,0.006646073200411869,-233,-107,1038,698,-0.05159009693047484,-0.011180666909753379,0.06277076384022828,-1976,-1271,-0.184966769633998,-0.11436086077070312
7286,29007,Audrain,Missouri,2008,4434,6167,180,10781,0.41127910212410723,0.5720248585474446,0.016696039328448195,116,109,-127,98,0.007085523541312144,0.010049966128036325,-0.017135489669348525,-1733,243,-0.16074575642333733,0.02422101321066067
7287,29007,Audrain,Missouri,2012,3539,6186,257,9982,0.3545381687036666,0.6197154878781808,0.025746343418152674,-895,77,19,-799,-0.05674093342044062,0.009050304089704479,0.0476906293307362,-2647,-914,-0.26517731917451415,-0.10443156275117682
7288,29007,Audrain,Missouri,2016,2570,6981,582,10133,0.2536267640382907,0.688937136090003,0.05743609987170631,-969,325,795,151,-0.1009114046653759,0.03168975645355364,0.0692216482118222,-4411,-1764,-0.43531037205171225,-0.1701330528771981
7289,29009,Barry,Missouri,2000,4135,7885,348,12368,0.33433053040103494,0.63753234152652,0.02813712807244502,0,0,0,0,0.0,0.0,0.0,-3750,0,-0.3032018111254851,0.0
7290,29009,Barry,Missouri,2004,4223,9599,105,13927,0.30322395347167375,0.6892367344008042,0.007539312127522079,88,-243,1714,1559,-0.031106576929361196,-0.02059781594492294,0.05170439287428419,-5376,-1626,-0.3860127809291305,-0.08281096980364538
7291,29009,Barry,Missouri,2008,4630,9758,256,14644,0.31617044523354276,0.6663479923518164,0.017481562414640807,407,151,159,717,0.012946491761869017,0.009942250287118728,-0.02288874204898783,-5128,248,-0.35017754711827365,0.03583523381085685
7292,29009,Barry,Missouri,2012,3667,9832,307,13806,0.2656091554396639,0.7121541358829494,0.022236708677386644,-963,51,74,-838,-0.05056128979387886,0.004755146262745837,0.04580614353113299,-6165,-1037,-0.4465449804432855,-0.09636743332501185
7293,29009,Barry,Missouri,2016,2710,11428,467,14605,0.18555289284491613,0.7824717562478604,0.03197535090722355,-957,160,1596,799,-0.08005626259474777,0.009738642229836909,0.07031762036491096,-8718,-2553,-0.5969188634029442,-0.1503738829596587
7294,29011,Barton,Missouri,2000,1424,3836,106,5366,0.2653745806932538,0.7148714125978383,0.01975400670890794,0,0,0,0,0.0,0.0,0.0,-2412,0,-0.44949683190458445,0.0
7295,29011,Barton,Missouri,2004,1373,4572,46,5991,0.22917709898180605,0.7631447170756134,0.007678183942580538,-51,-60,736,625,-0.036197481711447765,-0.012075822766327403,0.048273304477775114,-3199,-787,-0.5339676180938073,-0.08447078618922288
7296,29011,Barton,Missouri,2008,1455,4414,79,5948,0.24462004034969737,0.7420981842636181,0.0132817753866846,82,33,-158,-43,0.015442941367891316,0.005603591444104062,-0.02104653281199531,-2959,240,-0.4974781439139207,0.03648947417988663
7297,29011,Barton,Missouri,2012,1230,4418,98,5746,0.21406195614340412,0.7688827010093978,0.017055342847198052,-225,19,4,-202,-0.030558084206293246,0.0037735674605134523,0.02678451674577975,-3188,-229,-0.5548207448659936,-0.05734260095207294
7298,29011,Barton,Missouri,2016,795,4959,185,5939,0.13386091934669136,0.8349890553965315,0.031150025256777236,-435,87,541,193,-0.08020103679671275,0.014094682409579184,0.06610635438713364,-4164,-976,-0.70112813604984,-0.1463073911838464
7299,29013,Bates,Missouri,2000,3386,4245,161,7792,0.4345482546201232,0.5447895277207392,0.020662217659137578,0,0,0,0,0.0,0.0,0.0,-859,0,-0.11024127310061599,0.0
7300,29013,Bates,Missouri,2004,3398,5004,64,8466,0.4013701866288684,0.5910701630049611,0.007559650366170565,12,-97,759,674,-0.03317806799125478,-0.013102567292967014,0.04628063528422188,-1606,-747,-0.18969997637609265,-0.07945870327547666
7301,29013,Bates,Missouri,2008,3271,4833,179,8283,0.39490522757455027,0.5834842448388265,0.021610527586623206,-127,115,-171,-183,-0.006464959054318153,0.014050877220452642,-0.00758591816613452,-1562,44,-0.18857901726427628,0.0011209591118163664
7302,29013,Bates,Missouri,2012,2557,5020,194,7771,0.329043881096384,0.6459915068845709,0.02496461201904517,-714,15,187,-512,-0.06586134647816627,0.003354084432421963,0.0625072620457443,-2463,-901,-0.31694762578818686,-0.12836860852391058
7303,29013,Bates,Missouri,2016,1618,6001,464,8083,0.2001732030186812,0.7424223679326982,0.05740442904862056,-939,270,981,312,-0.1288706780777028,0.032439817029575393,0.09643086104812737,-4383,-1920,-0.5422491649140171,-0.22530153912583023
7304,29015,Benton,Missouri,2000,3150,4218,166,7534,0.41810459251393683,0.5598619591186621,0.022033448367401114,0,0,0,0,0.0,0.0,0.0,-1068,0,-0.14175736660472527,0.0
7305,29015,Benton,Missouri,2004,3381,5575,53,9009,0.3752913752913753,0.6188256188256188,0.005883005883005883,231,-113,1357,1475,-0.04281321722256154,-0.01615044248439523,0.05896365970695672,-2194,-1126,-0.24353424353424352,-0.10177687692951826
7306,29015,Benton,Missouri,2008,3629,5759,223,9611,0.3775881802101758,0.5992092394131724,0.023202580376651752,248,170,184,602,0.0022968049188005213,0.017319574493645868,-0.019616379412446427,-2130,64,-0.22162105920299657,0.02191318433124695
7307,29015,Benton,Missouri,2012,2925,6069,163,9157,0.3194277601834662,0.6627716501037457,0.017800589712788032,-704,-60,310,-454,-0.058160420026709625,-0.00540199066386372,0.06356241069057333,-3144,-1014,-0.34334388992027953,-0.12172283071728296
7308,29015,Benton,Missouri,2016,2025,7213,352,9590,0.21115745568300312,0.7521376433785193,0.03670490093847758,-900,189,1144,433,-0.10827030450046307,0.018904311225689547,0.08936599327477357,-5188,-2044,-0.5409801876955161,-0.1976362977752366
7309,29017,Bollinger,Missouri,2000,1692,3487,115,5294,0.3196071023800529,0.6586701926709483,0.021722704948998868,0,0,0,0,0.0,0.0,0.0,-1795,0,-0.3390630902908954,0.0
7310,29017,Bollinger,Missouri,2004,1754,4102,39,5895,0.29754028837998303,0.695843935538592,0.0066157760814249365,62,-76,615,601,-0.02206681400006988,-0.015106928867573931,0.037173742867643744,-2348,-553,-0.398303647158609,-0.05924055686771362
7311,29017,Bollinger,Missouri,2008,1690,3972,122,5784,0.2921853388658368,0.6867219917012448,0.021092669432918397,-64,83,-130,-111,-0.005354949514146223,0.01447689335149346,-0.009121943837347213,-2282,66,-0.394536652835408,0.0037669943232009895
7312,29017,Bollinger,Missouri,2012,1213,4095,148,5456,0.2223240469208211,0.7505498533724341,0.027126099706744868,-477,26,123,-328,-0.0698612919450157,0.006033430273826471,0.06382786167118926,-2882,-600,-0.528225806451613,-0.13368915361620498
7313,29017,Bollinger,Missouri,2016,705,4827,144,5676,0.12420718816067654,0.8504228329809725,0.02536997885835095,-508,-4,732,220,-0.09811685876014457,-0.0017561208483939175,0.09987297960853847,-4122,-1240,-0.726215644820296,-0.197989838368683
7314,29019,Boone,Missouri,2000,28811,28426,2372,59609,0.4833330537334966,0.47687429750541027,0.039792648761093126,0,0,0,0,0.0,0.0,0.0,385,0,0.0064587562280863375,0.0
7315,29019,Boone,Missouri,2004,37643,37801,602,76046,0.49500302448518,0.4970807143044999,0.00791626121032007,8832,-1770,9375,16437,0.011669970751683412,-0.03187638755077306,0.020206416799089633,-158,-543,-0.0020776898193198834,-0.008536446047406221
7316,29019,Boone,Missouri,2008,47062,36849,1340,85251,0.5520404452733693,0.43224126403209345,0.01571829069453731,9419,738,-952,9205,0.05703742078818924,0.0078020294842172395,-0.06483945027240645,10213,10371,0.11979918124127581,0.12187687106059569
7317,29019,Boone,Missouri,2012,39847,37404,2171,79422,0.5017123718868828,0.47095263277177607,0.02733499534134119,-7215,831,555,-5829,-0.05032807338648648,0.01161670464680388,0.03871136873968262,2443,-7770,0.03075973911510671,-0.0890394421261691
7318,29019,Boone,Missouri,2016,41125,36200,6543,83868,0.4903538894453188,0.43163065770019554,0.07801545285448562,1278,4372,-1204,4446,-0.011358482441563955,0.05068045751314443,-0.03932197507158053,4925,2482,0.05872323174512328,0.027963492630016573
7319,29021,Buchanan,Missouri,2000,17085,16423,1243,34751,0.49164052833012,0.47259071681390463,0.03576875485597537,0,0,0,0,0.0,0.0,0.0,662,0,0.019049811516215376,0.0
7320,29021,Buchanan,Missouri,2004,17799,19812,339,37950,0.46901185770750986,0.5220553359683795,0.008932806324110672,714,-904,3389,3199,-0.022628670622610148,-0.026835948531864696,0.049464619154474865,-2013,-2675,-0.053043478260869636,-0.07209328977708501
7321,29021,Buchanan,Missouri,2008,19164,19110,986,39260,0.48813041263372386,0.4867549668874172,0.02511462047885889,1365,647,-702,1310,0.019118554926214004,0.016181814154748217,-0.03530036908096229,54,2067,0.0013754457463066583,0.054418924007176295
7322,29021,Buchanan,Missouri,2012,15594,18660,852,35106,0.4441975730644334,0.5315330712698684,0.02426935566569817,-3570,-134,-450,-4154,-0.04393283956929045,-0.0008452648131607211,0.04477810438245117,-3066,-3120,-0.08733549820543496,-0.08871094395174162
7323,29021,Buchanan,Missouri,2016,12013,21320,2631,35964,0.3340284729173618,0.5928150372594817,0.07315648982315649,-3581,1779,2660,858,-0.1101691001470716,0.04888713415745832,0.06128196598961333,-9307,-6241,-0.2587865643421199,-0.17145106613668493
7324,29023,Butler,Missouri,2000,4996,9111,290,14397,0.34701673959852747,0.632840175036466,0.0201430853650066,0,0,0,0,0.0,0.0,0.0,-4115,0,-0.2858234354379385,0.0
7325,29023,Butler,Missouri,2004,4666,11696,79,16441,0.28380268840094885,0.711392251079618,0.004805060519433125,-330,-211,2585,2044,-0.06321405119757861,-0.015338024845573475,0.07855207604315206,-7030,-2915,-0.42758956267866916,-0.14176612724073068
7326,29023,Butler,Missouri,2008,5316,11805,217,17338,0.3066097589110624,0.6808743799746222,0.012515861114315376,650,138,109,897,0.022807070510113547,0.007710800594882251,-0.03051787110499582,-6489,541,-0.3742646210635598,0.05332494161510937
7327,29023,Butler,Missouri,2012,4363,12248,278,16889,0.2583338267511398,0.7252057552252946,0.016460418023565633,-953,61,443,-449,-0.0482759321599226,0.003944556909250257,0.04433137525067243,-7885,-1396,-0.4668719284741548,-0.09260730741059503
7328,29023,Butler,Missouri,2016,3036,13650,573,17259,0.17590822179732313,0.7908917086737355,0.033200069528941424,-1327,295,1402,370,-0.08242560495381668,0.01673965150537579,0.06568595344844086,-10614,-2729,-0.6149834868764124,-0.14811155840225754
7329,29025,Caldwell,Missouri,2000,1488,2220,142,3850,0.3864935064935065,0.5766233766233766,0.036883116883116886,0,0,0,0,0.0,0.0,0.0,-732,0,-0.1901298701298701,0.0
7330,29025,Caldwell,Missouri,2004,1645,2593,30,4268,0.38542642924086223,0.6075445173383318,0.007029053420805998,157,-112,373,418,-0.0010670772526442662,-0.029854063462310888,0.03092114071495522,-948,-216,-0.22211808809746958,-0.031988217967599486
7331,29025,Caldwell,Missouri,2008,1814,2654,96,4564,0.3974583698510079,0.5815074496056091,0.021034180543382998,169,66,61,296,0.012031940610145675,0.014005127122577,-0.02603706773272274,-840,108,-0.18404907975460116,0.038069008342868416
7332,29025,Caldwell,Missouri,2012,1312,2721,134,4167,0.3148548116150708,0.6529877609791217,0.032157427405807536,-502,38,67,-397,-0.08260355823593712,0.011123246862424538,0.07148031137351263,-1409,-569,-0.3381329493640509,-0.15408386960944975
7333,29025,Caldwell,Missouri,2016,838,3232,242,4312,0.19434137291280149,0.7495361781076066,0.05612244897959184,-474,108,511,145,-0.1205134387022693,0.0239650215737843,0.09654841712848494,-2394,-985,-0.5551948051948051,-0.2170618558307542
7334,29027,Callaway,Missouri,2000,6708,8238,362,15308,0.43820224719101125,0.538149986934936,0.023647765874052783,0,0,0,0,0.0,0.0,0.0,-1530,0,-0.09994773974392474,0.0
7335,29027,Callaway,Missouri,2004,6559,11108,106,17773,0.3690429302875148,0.6249929668598436,0.005964102852641647,-149,-256,2870,2465,-0.06915931690349647,-0.017683663021411136,0.08684297992490764,-4549,-3019,-0.25595003657232884,-0.1560022968284041
7336,29027,Callaway,Missouri,2008,7580,11389,397,19366,0.3914076216048745,0.5880925333057937,0.02049984508933182,1021,291,281,1593,0.02236469131735974,0.014535742236690172,-0.03690043355404993,-3809,740,-0.19668491170091917,0.05926512487140967
7337,29027,Callaway,Missouri,2012,6071,11745,416,18232,0.3329859587538394,0.6441970162351909,0.022817025010969723,-1509,19,356,-1134,-0.05842166285103512,0.002317179921637904,0.05610448292939718,-5674,-1865,-0.31121105748135147,-0.1145261457804323
7338,29027,Callaway,Missouri,2016,4989,13057,1287,19333,0.2580561733822997,0.6753737133398852,0.06657011327781513,-1082,871,1312,1101,-0.07492978537153971,0.04375308826684541,0.031176697104694284,-8068,-2394,-0.41731753995758547,-0.106106482476234
7339,29029,Camden,Missouri,2000,6323,10358,418,17099,0.3697877068834435,0.6057664190888356,0.02444587402772092,0,0,0,0,0.0,0.0,0.0,-4035,0,-0.23597871220539207,0.0
7340,29029,Camden,Missouri,2004,6296,13122,101,19519,0.3225575080690609,0.6722680465187766,0.005174445412162509,-27,-317,2764,2420,-0.04723019881438256,-0.01927142861555841,0.06650162742994103,-6826,-2791,-0.34971053844971567,-0.1137318262443236
7341,29029,Camden,Missouri,2008,7773,14074,350,22197,0.3501824570887958,0.6340496463486057,0.01576789656259855,1477,249,952,2678,0.02762494901973489,0.010593451150436042,-0.03821840017017086,-6301,525,-0.2838671892598099,0.06584334918990575
7342,29029,Camden,Missouri,2012,6458,15092,465,22015,0.29334544628662274,0.6855325914149444,0.021121962298432887,-1315,115,1018,-182,-0.05683701080217307,0.005354065735834336,0.05148294506633866,-8634,-2333,-0.39218714512832165,-0.10831995586851173
7343,29029,Camden,Missouri,2016,4768,16944,925,22637,0.21062861686619253,0.7485090780580466,0.04086230507576092,-1690,460,1852,622,-0.08271682942043021,0.019740342777328033,0.06297648664310218,-12176,-3542,-0.5378804611918541,-0.14569331606353242
7344,29031,Cape Girardeau,Missouri,2000,9334,19832,693,29859,0.3126025653906695,0.6641883519206939,0.02320908268863659,0,0,0,0,0.0,0.0,0.0,-10498,0,-0.3515857865300244,0.0
7345,29031,Cape Girardeau,Missouri,2004,10568,23814,183,34565,0.30574280341385796,0.6889628236655576,0.005294372920584406,1234,-510,3982,4706,-0.00685976197681154,-0.017914709768052185,0.02477447174486369,-13246,-2748,-0.38322002025169966,-0.03163423372167523
7346,29031,Cape Girardeau,Missouri,2008,12208,24768,470,37446,0.3260161298937136,0.6614324627463547,0.012551407359931635,1640,287,954,2881,0.020273326479855636,0.0072570344393472295,-0.027530360919202912,-12560,686,-0.3354163328526411,0.04780368739905855
7347,29031,Cape Girardeau,Missouri,2012,9728,25370,731,35829,0.2715119037651065,0.7080856289597812,0.02040246727511234,-2480,261,602,-1617,-0.054504226128607114,0.007851059915180704,0.04665316621342652,-15642,-3082,-0.43657372519467474,-0.10115739234203364
7348,29031,Cape Girardeau,Missouri,2016,8492,27017,1802,37311,0.22760043954865858,0.72410281150331,0.04829674894803141,-1236,1071,1647,1482,-0.0439114642164479,0.02789428167291907,0.016017182543528796,-18525,-2883,-0.4965023719546514,-0.05992864675997667
7349,29033,Carroll,Missouri,2000,1620,2880,81,4581,0.35363457760314343,0.6286836935166994,0.01768172888015717,0,0,0,0,0.0,0.0,0.0,-1260,0,-0.27504911591355596,0.0
7350,29033,Carroll,Missouri,2004,1568,3155,18,4741,0.3307319130985024,0.6654714195317444,0.0037966673697532164,-52,-63,275,160,-0.022902664504641013,-0.013885061510403954,0.036787726015044986,-1587,-327,-0.33473950643324196,-0.059690390519686
7351,29033,Carroll,Missouri,2008,1535,2955,48,4538,0.3382547377699427,0.6511679153812252,0.010577346848832084,-33,30,-200,-203,0.007522824671440276,0.006780679479078868,-0.014303504150519175,-1420,167,-0.3129131776112825,0.02182632882195945
7352,29033,Carroll,Missouri,2012,1154,3072,78,4304,0.26812267657992567,0.7137546468401487,0.01812267657992565,-381,30,117,-234,-0.07013206119001703,0.007545329731093566,0.06258673145892346,-1918,-498,-0.445631970260223,-0.1327187926489405
7353,29033,Carroll,Missouri,2016,745,3480,136,4361,0.1708323778949782,0.7979821141939922,0.03118550791102958,-409,58,408,57,-0.09729029868494746,0.01306283133110393,0.08422746735384357,-2735,-817,-0.627149736299014,-0.18151776603879105
7354,29035,Carter,Missouri,2000,997,1730,81,2808,0.35505698005698005,0.6160968660968661,0.028846153846153848,0,0,0,0,0.0,0.0,0.0,-733,0,-0.26103988603988604,0.0
7355,29035,Carter,Missouri,2004,964,1797,18,2779,0.34688736955739474,0.6466354803886291,0.006477150053976251,-33,-63,67,-29,-0.008169610499585311,-0.022369003792177596,0.030538614291762967,-833,-100,-0.2997481108312343,-0.03870822479134828
7356,29035,Carter,Missouri,2008,984,1840,74,2898,0.33954451345755693,0.6349206349206349,0.025534851621808144,20,56,43,119,-0.007342856099837813,0.019057701567831892,-0.011714845467994173,-856,-23,-0.29537612146307796,0.004371989368156359
7357,29035,Carter,Missouri,2012,754,1978,67,2799,0.2693819221150411,0.706680957484816,0.023937120400142908,-230,-7,138,-99,-0.07016259134251585,-0.0015977312216652363,0.07176032256418108,-1224,-368,-0.4372990353697749,-0.14192291390669692
7358,29035,Carter,Missouri,2016,436,2324,90,2850,0.1529824561403509,0.8154385964912281,0.031578947368421054,-318,23,346,51,-0.1163994659746902,0.007641826968278146,0.10875763900641211,-1888,-664,-0.6624561403508772,-0.2251571049811023
7359,29037,Cass,Missouri,2000,14921,20113,835,35869,0.41598594886949736,0.560734896428671,0.023279154701831666,0,0,0,0,0.0,0.0,0.0,-5192,0,-0.14474894755917367,0.0
7360,29037,Cass,Missouri,2004,16681,27253,283,44217,0.377253092701902,0.6163466540018545,0.006400253296243526,1760,-552,7140,8348,-0.038732856167595364,-0.01687890140558814,0.055611757573183485,-10572,-5380,-0.23909356129995252,-0.09434461374077885
7361,29037,Cass,Missouri,2008,19844,29695,802,50341,0.39419161319798973,0.58987703859677,0.01593134820524026,3163,519,2442,6124,0.01693852049608774,0.009531094908996734,-0.026469615405084523,-9851,721,-0.19568542539878025,0.04340813590117226
7362,29037,Cass,Missouri,2012,17044,30912,1148,49104,0.34710003258390354,0.6295210166177908,0.023378950798305636,-2800,346,1217,-1237,-0.04709158061408619,0.007447602593065376,0.03964397802102082,-13868,-4017,-0.28242098403388727,-0.08673555863510701
7363,29037,Cass,Missouri,2016,14846,33098,3465,51409,0.2887821198622809,0.6438172304460309,0.06740064969168823,-2198,2317,2186,2305,-0.05831791272162262,0.04402169889338259,0.01429621382824009,-18252,-4384,-0.35503511058375,-0.07261412654986271
7364,29039,Cedar,Missouri,2000,1979,3530,154,5663,0.34946141621048915,0.6233445170404379,0.027194066749072928,0,0,0,0,0.0,0.0,0.0,-1551,0,-0.27388310082994877,0.0
7365,29039,Cedar,Missouri,2004,1910,4238,55,6203,0.3079155247460906,0.683217797839755,0.008866677414154442,-69,-99,708,540,-0.04154589146439858,-0.018327389334918488,0.059873280799317086,-2328,-777,-0.37530227309366443,-0.10141917226371566
7366,29039,Cedar,Missouri,2008,2060,4194,100,6354,0.3242052250550834,0.660056657223796,0.015738117721120555,150,45,-44,151,0.01628970030899285,0.0068714403069661135,-0.023161140615958975,-2134,194,-0.3358514321687126,0.039450840924951824
7367,29039,Cedar,Missouri,2012,1537,4376,132,6045,0.2542597187758478,0.723904052936311,0.02183622828784119,-523,32,182,-309,-0.06994550627923563,0.006098110566720636,0.06384739571251496,-2839,-705,-0.4696443341604632,-0.1337929019917506
7368,29039,Cedar,Missouri,2016,1011,5021,295,6327,0.15979137031768612,0.7935830567409515,0.046625572941362416,-526,163,645,282,-0.09446834845816168,0.024789344653521225,0.06967900380464054,-4010,-1171,-0.6337916864232654,-0.16414735226280225
7369,29041,Chariton,Missouri,2000,1792,2300,62,4154,0.431391429947039,0.5536831969186327,0.014925373134328358,0,0,0,0,0.0,0.0,0.0,-508,0,-0.12229176697159366,0.0
7370,29041,Chariton,Missouri,2004,1892,2421,27,4340,0.4359447004608295,0.5578341013824885,0.006221198156682027,100,-35,121,186,0.004553270513790508,-0.00870417497764633,0.004150904463855798,-529,-21,-0.12188940092165895,0.00040236604993471037
7371,29041,Chariton,Missouri,2008,1799,2339,76,4214,0.4269102990033223,0.5550545799715235,0.018035121025154248,-93,49,-82,-126,-0.009034401457507224,0.01181392286847222,-0.0027795214109649358,-540,-11,-0.12814428096820124,-0.006254880046542288
7372,29041,Chariton,Missouri,2012,1339,2402,80,3821,0.35043182412980894,0.6286312483643025,0.02093692750588851,-460,4,63,-393,-0.07647847487351334,0.0029018064807342613,0.07357666839277899,-1063,-523,-0.27819942423449356,-0.15005514326629232
7373,29041,Chariton,Missouri,2016,888,2950,131,3969,0.2237339380196523,0.7432602670697909,0.033005794910556815,-451,51,548,148,-0.12669788611015664,0.012068867404668306,0.11462901870548836,-2062,-999,-0.5195263290501386,-0.24132690481564506
7374,29043,Christian,Missouri,2000,7896,14824,508,23228,0.3399345617358361,0.6381952815567419,0.021870156707422077,0,0,0,0,0.0,0.0,0.0,-6928,0,-0.2982607198209058,0.0
7375,29043,Christian,Missouri,2004,9059,22102,187,31348,0.2889817532218961,0.7050529539364553,0.00596529284164859,1163,-321,7278,8120,-0.05095280851393996,-0.015904863865773486,0.0668576723797134,-13043,-6115,-0.41607120071455916,-0.11781048089365337
7376,29043,Christian,Missouri,2008,11883,25382,572,37837,0.3140576684198007,0.6708248539789096,0.015117477601289743,2824,385,3280,6489,0.025075915197904586,0.009152184759641153,-0.03422809995754572,-13499,-456,-0.35676718555910886,0.05930401515545031
7377,29043,Christian,Missouri,2012,9813,27473,678,37964,0.25848171952375937,0.7236592561373933,0.01785902433884733,-2070,106,2091,127,-0.05557594889604134,0.002741546737557587,0.052834402158483784,-17660,-4161,-0.465177536613634,-0.10841035105452512
7378,29043,Christian,Missouri,2016,8508,30946,2409,41863,0.20323435969710724,0.7392207916298402,0.057544848673052575,-1305,1731,3473,3899,-0.05524735982665213,0.03968582433420524,0.015561535492446876,-22438,-4778,-0.535986431932733,-0.07080889531909901
7379,29045,Clark,Missouri,2000,1812,1899,91,3802,0.4765912677538138,0.4994739610731194,0.023934771173066808,0,0,0,0,0.0,0.0,0.0,-87,0,-0.022882693319305647,0.0
7380,29045,Clark,Missouri,2004,1794,1899,43,3736,0.4801927194860814,0.5082976445396146,0.011509635974304069,-18,-48,0,-66,0.003601451732267613,-0.01242513519876274,0.008823683466495147,-105,-18,-0.02810492505353318,-0.005222231734227534
7381,29045,Clark,Missouri,2008,1572,1782,102,3456,0.4548611111111111,0.515625,0.029513888888888888,-222,59,-117,-280,-0.025331608374970283,0.01800425291458482,0.007327355460385432,-210,-105,-0.060763888888888895,-0.032658963835355714
7382,29045,Clark,Missouri,2012,1398,1730,97,3225,0.43348837209302327,0.5364341085271318,0.03007751937984496,-174,-5,-52,-231,-0.02137273901808784,0.0005636304909560734,0.020809108527131803,-332,-122,-0.10294573643410854,-0.04218184754521964
7383,29045,Clark,Missouri,2016,724,2458,134,3316,0.218335343787696,0.741254523522316,0.040410132689987936,-674,37,728,91,-0.21515302830532726,0.010332613310142975,0.20482041499518422,-1734,-1402,-0.52291917973462,-0.41997344330051145
7384,29047,Clay,Missouri,2000,39084,39083,2006,80173,0.4874957903533609,0.4874833173262819,0.025020892320357226,0,0,0,0,0.0,0.0,0.0,1,0,1.2473027078963028e-05,0.0
7385,29047,Clay,Missouri,2004,44670,51193,597,96460,0.4630935102633216,0.5307173958117354,0.006189093924942981,5586,-1409,12110,16287,-0.024402280090039308,-0.018831798395414247,0.043234078485453464,-6523,-6524,-0.06762388554841381,-0.06763635857549277
7386,29047,Clay,Missouri,2008,53761,54516,1748,110025,0.48862531242899343,0.4954873892297205,0.01588729834128607,9091,1151,3323,13565,0.025531802165671857,0.009698204416343089,-0.03523000658201486,-755,5768,-0.0068620768007270905,0.06076180874768672
7387,29047,Clay,Missouri,2012,47310,56191,2542,106043,0.4461397734881133,0.5298888186867592,0.023971407825127543,-6451,794,1675,-3982,-0.04248553894088014,0.008084109483841473,0.03440142945703867,-8881,-8126,-0.0837490451986459,-0.07688696839791881
7388,29047,Clay,Missouri,2016,45304,57476,8390,111170,0.40752001439237207,0.5170099847081047,0.07547000089952326,-2006,5848,1285,5127,-0.038619759095741224,0.051498593074395714,-0.012878833978654525,-12172,-3291,-0.1094899703157326,-0.0257409251170867
7389,29049,Clinton,Missouri,2000,3994,4323,214,8531,0.4681748915719142,0.5067401242527253,0.02508498417536045,0,0,0,0,0.0,0.0,0.0,-329,0,-0.03856523268081108,0.0
7390,29049,Clinton,Missouri,2004,4165,5287,88,9540,0.43658280922431864,0.5541928721174004,0.009224318658280923,171,-126,964,1009,-0.031592082347595585,-0.015860665517079528,0.04745274786467513,-1122,-793,-0.11761006289308179,-0.07904483021227071
7391,29049,Clinton,Missouri,2008,4545,5709,200,10454,0.4347618136598431,0.5461067533958294,0.01913143294432753,380,112,422,914,-0.0018209955644755138,0.009907114286046606,-0.008086118721571056,-1164,-42,-0.11134493973598625,0.006265123157095542
7392,29049,Clinton,Missouri,2012,3688,5931,242,9861,0.37399858026569316,0.6014602981442044,0.024541121590102424,-857,42,222,-593,-0.06076323339414996,0.005409688645774895,0.05535354474837506,-2243,-1079,-0.22746171787851127,-0.11611677814252502
7393,29049,Clinton,Missouri,2016,2572,7067,662,10301,0.2496844966508106,0.6860498980681488,0.06426560528104068,-1116,420,1136,440,-0.12431408361488255,0.039724483690938256,0.08458959992394433,-4495,-2252,-0.43636540141733815,-0.20890368353882688
7394,29051,Cole,Missouri,2000,12056,20167,552,32775,0.3678413424866514,0.6153165522501907,0.016842105263157894,0,0,0,0,0.0,0.0,0.0,-8111,0,-0.24747520976353926,0.0
7395,29051,Cole,Missouri,2004,11753,24752,196,36701,0.3202365058172802,0.674423040244135,0.0053404539385847796,-303,-356,4585,3926,-0.04760483666937121,-0.011501651324573115,0.05910648799394436,-12999,-4888,-0.3541865344268548,-0.10671132466331557
7396,29051,Cole,Missouri,2008,13959,24385,490,38834,0.3594530565998867,0.6279291342637895,0.01261780913632384,2206,294,-367,2133,0.039216550782606496,0.0072773551977390605,-0.04649390598034553,-10426,2573,-0.2684760776639028,0.08571045676295203
7397,29051,Cole,Missouri,2012,12005,24490,695,37190,0.3228018284485077,0.6585103522452272,0.018687819306265126,-1954,205,105,-1644,-0.036651228151379,0.006070010169941286,0.03058121798143776,-12485,-2059,-0.33570852379671956,-0.06723244613281676
7398,29051,Cole,Missouri,2016,10913,24616,2127,37656,0.2898077331633737,0.6537072445294243,0.05648502230720204,-1092,1432,126,466,-0.03299409528513397,0.03779720300093691,-0.004803107715802946,-13703,-1218,-0.3638995113660506,-0.028190987569331027
7399,29053,Cooper,Missouri,2000,2567,4072,151,6790,0.3780559646539028,0.5997054491899853,0.02223858615611193,0,0,0,0,0.0,0.0,0.0,-1505,0,-0.22164948453608246,0.0
7400,29053,Cooper,Missouri,2004,2400,5058,50,7508,0.3196590303676079,0.6736814064997336,0.006659563132658497,-167,-101,986,718,-0.05839693428629489,-0.015579023023453433,0.07397595730974837,-2658,-1153,-0.3540223761321257,-0.13237289159604326
7401,29053,Cooper,Missouri,2008,2996,4902,128,8026,0.37328681784201345,0.6107650137054572,0.01594816845252928,596,78,-156,518,0.05362778747440555,0.009288605319870783,-0.06291639279427641,-1906,752,-0.23747819586344376,0.11654418026868196
7402,29053,Cooper,Missouri,2012,2474,4887,150,7511,0.3293835707628811,0.6506457196112369,0.01997070962588204,-522,22,-15,-515,-0.043903247079132346,0.00402254117335276,0.039880705905779634,-2413,-507,-0.32126214884835574,-0.08378395298491198
7403,29053,Cooper,Missouri,2016,1932,5624,430,7986,0.24192336589030805,0.7042324067117456,0.053844227397946406,-542,280,737,475,-0.08746020487257306,0.03387351777206436,0.053586687100508734,-3692,-1279,-0.46230904082143753,-0.1410468919730818
7404,29055,Crawford,Missouri,2000,3350,4754,198,8302,0.40351722476511687,0.572633100457721,0.02384967477716213,0,0,0,0,0.0,0.0,0.0,-1404,0,-0.1691158756926041,0.0
7405,29055,Crawford,Missouri,2004,3632,5686,63,9381,0.38716554738300824,0.6061187506662403,0.006715701950751519,282,-135,932,1079,-0.01635167738210863,-0.01713397282641061,0.033485650208519346,-2054,-650,-0.2189532032832321,-0.04983732759062798
7406,29055,Crawford,Missouri,2008,3911,6007,167,10085,0.3878036688150719,0.5956370847793753,0.016559246405552803,279,104,321,704,0.0006381214320636541,0.009843544454801283,-0.010481665886865055,-2096,-42,-0.20783341596430338,0.011119787318928709
7407,29055,Crawford,Missouri,2012,2951,6434,194,9579,0.30806973588057207,0.6716776281449003,0.020252635974527613,-960,27,427,-506,-0.07973393293449982,0.00369338956897481,0.07604054336552502,-3483,-1387,-0.3636078922643282,-0.15577447630002483
7408,29055,Crawford,Missouri,2016,1824,7724,372,9920,0.18387096774193548,0.7786290322580646,0.0375,-1127,178,1290,341,-0.12419876813863659,0.017247364025472386,0.10695140411316428,-5900,-2417,-0.5947580645161291,-0.2311501722518009
7409,29057,Dade,Missouri,2000,1193,2468,91,3752,0.3179637526652452,0.6577825159914712,0.024253731343283583,0,0,0,0,0.0,0.0,0.0,-1275,0,-0.339818763326226,0.0
7410,29057,Dade,Missouri,2004,1104,2963,22,4089,0.26999266324284665,0.7246270481780387,0.005380288579114698,-89,-69,495,337,-0.04797108942239853,-0.018873442764168885,0.0668445321865675,-1859,-584,-0.45463438493519204,-0.11481562160896602
7411,29057,Dade,Missouri,2008,1184,2864,64,4112,0.28793774319066145,0.6964980544747081,0.01556420233463035,80,42,-99,23,0.0179450799478148,0.010183913755515653,-0.02812899370333055,-1680,179,-0.4085603112840467,0.04607407365114535
7412,29057,Dade,Missouri,2012,939,2895,62,3896,0.2410164271047228,0.7430698151950719,0.01591375770020534,-245,-2,31,-216,-0.046921316085938664,0.00034955536557498834,0.04657176072036373,-1956,-276,-0.502053388090349,-0.09349307680630237
7413,29057,Dade,Missouri,2016,637,3184,130,3951,0.16122500632751202,0.8058719311566692,0.03290306251581878,-302,68,289,55,-0.07979142077721077,0.01698930481561344,0.06280211596159735,-2547,-591,-0.6446469248291572,-0.14259353673880815
7414,29059,Dallas,Missouri,2000,2311,3723,185,6219,0.3716031516320952,0.5986493005306319,0.029747547837272872,0,0,0,0,0.0,0.0,0.0,-1412,0,-0.22704614889853675,0.0
7415,29059,Dallas,Missouri,2004,2407,4788,64,7259,0.3315883730541397,0.6595949855351977,0.008816641410662625,96,-121,1065,1040,-0.04001477857795549,-0.020930906426610246,0.060945685004565764,-2381,-969,-0.328006612481058,-0.10096046358252125
7416,29059,Dallas,Missouri,2008,2656,4895,132,7683,0.3456982949368736,0.6371209163087336,0.017180788754392814,249,68,107,424,0.014109921882733911,0.008364147343730189,-0.02247406922646411,-2239,142,-0.29142262137186,0.03658399110919802
7417,29059,Dallas,Missouri,2012,2122,4992,165,7279,0.291523560928699,0.6858084901772221,0.022667948894078856,-534,33,97,-404,-0.054174734008174574,0.005487160139686042,0.04868757386848854,-2870,-631,-0.3942849292485231,-0.10286230787666312
7418,29059,Dallas,Missouri,2016,1272,5895,286,7453,0.17066952904870522,0.7909566617469476,0.03837380920434724,-850,121,903,174,-0.1208540318799938,0.015705860310268386,0.10514817156972545,-4623,-1753,-0.6202871326982423,-0.22600220344971922
7419,29061,Daviess,Missouri,2000,1367,2011,116,3494,0.39124212936462505,0.5755580995993131,0.03319977103606182,0,0,0,0,0.0,0.0,0.0,-644,0,-0.1843159702346881,0.0
7420,29061,Daviess,Missouri,2004,1402,2351,41,3794,0.3695308381655245,0.6196626251976806,0.01080653663679494,35,-75,340,300,-0.021711291199100535,-0.02239323439926688,0.04410452559836742,-949,-305,-0.25013178703215605,-0.06581581679746795
7421,29061,Daviess,Missouri,2008,1400,2263,123,3786,0.369783412572636,0.5977284733227681,0.03248811410459588,-2,82,-88,-8,0.0002525744071115166,0.021681577467800937,-0.021934151874912433,-863,86,-0.2279450607501321,0.02218672628202395
7422,29061,Daviess,Missouri,2012,1125,2290,106,3521,0.31951150241408693,0.6503834138028969,0.030105083783016188,-275,-17,27,-265,-0.050271910158549094,-0.0023830303215796912,0.052654940480128753,-1165,-302,-0.33087191138880995,-0.10292685063867785
7423,29061,Daviess,Missouri,2016,730,2767,241,3738,0.19529159978598182,0.7402354200107009,0.06447298020331728,-395,135,477,217,-0.12421990262810512,0.034367896420301094,0.08985200620780398,-2037,-872,-0.544943820224719,-0.21407190883590904
7424,29063,DeKalb,Missouri,2000,1562,2363,124,4049,0.3857742652506792,0.5836008891084218,0.030624845640898988,0,0,0,0,0.0,0.0,0.0,-801,0,-0.19782662385774258,0.0
7425,29063,DeKalb,Missouri,2004,1707,2941,38,4686,0.36427656850192064,0.627614169867691,0.00810926163038839,145,-86,578,637,-0.021497696748758566,-0.022515584010510598,0.04401328075926925,-1234,-433,-0.2633376013657704,-0.06551097750802781
7426,29063,DeKalb,Missouri,2008,1692,2889,133,4714,0.35893084429359357,0.6128553245651251,0.02821383114128129,-15,95,-52,28,-0.005345724208327074,0.0201045695108929,-0.014758845302565882,-1197,37,-0.2539244802715316,0.009413121094238808
7427,29063,DeKalb,Missouri,2012,1194,3056,100,4350,0.27448275862068966,0.7025287356321839,0.022988505747126436,-498,-33,167,-364,-0.0844480856729039,-0.005225325394154854,0.08967341106705873,-1862,-665,-0.4280459770114942,-0.17412149673996263
7428,29063,DeKalb,Missouri,2016,824,3540,262,4626,0.17812364894076957,0.7652399481193255,0.056636402939904885,-370,162,484,276,-0.09635910967992009,0.03364789719277845,0.06271121248714162,-2716,-854,-0.5871162991785559,-0.15907032216706168
7429,29065,Dent,Missouri,2000,1839,3996,153,5988,0.30711422845691383,0.6673346693386774,0.02555110220440882,0,0,0,0,0.0,0.0,0.0,-2157,0,-0.3602204408817635,0.0
7430,29065,Dent,Missouri,2004,1865,4369,70,6304,0.2958439086294416,0.6930520304568528,0.011104060913705584,26,-83,373,316,-0.01127031982747223,-0.014447041290703235,0.025717361118175464,-2504,-347,-0.3972081218274112,-0.036987680945647694
7431,29065,Dent,Missouri,2008,2056,4655,157,6868,0.2993593476994758,0.6777810133954572,0.022859638905066978,191,87,286,564,0.0035154390700342097,0.011755577991361394,-0.015271017061395664,-2599,-95,-0.37842166569598135,0.018786456131429874
7432,29065,Dent,Missouri,2012,1585,4883,203,6671,0.2375955628841253,0.7319742167591066,0.030430220356768102,-471,46,228,-197,-0.0617637848153505,0.007570581451701124,0.05419320336364941,-3298,-699,-0.49437865387498126,-0.11595698817899991
7433,29065,Dent,Missouri,2016,978,5600,213,6791,0.14401413635694302,0.8246208216757474,0.03136504196730967,-607,10,717,120,-0.0935814265271823,0.000934821610541571,0.09264660491664078,-4622,-1324,-0.6806066853188043,-0.18622803144382305
7434,29067,Douglas,Missouri,2000,1546,3599,136,5281,0.29274758568452947,0.6814997159628858,0.025752698352584737,0,0,0,0,0.0,0.0,0.0,-2053,0,-0.38875213027835637,0.0
7435,29067,Douglas,Missouri,2004,1741,4498,88,6327,0.2751699067488541,0.710921447763553,0.013908645487592856,195,-48,899,1046,-0.017577678935675356,-0.011844052864991881,0.029421731800667206,-2757,-704,-0.43575154101469893,-0.04699941073634256
7436,29067,Douglas,Missouri,2008,2140,4405,167,6712,0.31883194278903454,0.6562872467222884,0.024880810488676998,399,79,-93,385,0.04366203604018043,0.010972165001084142,-0.054634201041264596,-2265,492,-0.3374553039332539,0.09829623708144503
7437,29067,Douglas,Missouri,2012,1710,4649,198,6557,0.2607899954247369,0.7090132682629251,0.03019673631233796,-430,31,244,-155,-0.05804194736429763,0.0053159258236609615,0.05272602154063666,-2939,-674,-0.4482232728381882,-0.11076796890493429
7438,29067,Douglas,Missouri,2016,984,5486,196,6666,0.1476147614761476,0.8229822982298229,0.029402940294029404,-726,-2,837,109,-0.1131752339485893,-0.0007937960183085555,0.11396902996689784,-4502,-1563,-0.6753675367536753,-0.22714426391548714
7439,29069,Dunklin,Missouri,2000,4947,5426,152,10525,0.47002375296912113,0.5155344418052257,0.014441805225653206,0,0,0,0,0.0,0.0,0.0,-479,0,-0.04551068883610454,0.0
7440,29069,Dunklin,Missouri,2004,4901,6720,56,11677,0.41971396762867175,0.5754902800376809,0.004795752333647341,-46,-96,1294,1152,-0.05030978534044939,-0.009646052892005865,0.059955838232455205,-1819,-1340,-0.15577631240900913,-0.11026562357290459
7441,29069,Dunklin,Missouri,2008,4540,7044,180,11764,0.38592315538932337,0.5987759265555933,0.015300918055083304,-361,124,324,87,-0.03379081223934838,0.010505165721435963,0.02328564651791243,-2504,-685,-0.21285277116626994,-0.057076458757260806
7442,29069,Dunklin,Missouri,2012,3636,6850,165,10651,0.34137639658248053,0.6431321002722749,0.015491503145244579,-904,-15,-194,-1113,-0.044546758806842834,0.00019058509016127434,0.044356173716681546,-3214,-710,-0.3017557036897943,-0.08890293252352438
7443,29069,Dunklin,Missouri,2016,2360,8026,192,10578,0.22310455662696163,0.7587445641898279,0.018150879183210438,-1276,27,1176,-73,-0.1182718399555189,0.0026593760379658594,0.11561246391755309,-5666,-2452,-0.5356400075628663,-0.23388430387307202
7444,29071,Franklin,Missouri,2000,16172,21863,1159,39194,0.41261417563912844,0.5578149716793387,0.029570852681532887,0,0,0,0,0.0,0.0,0.0,-5691,0,-0.14520079604021024,0.0
7445,29071,Franklin,Missouri,2004,18556,26429,333,45318,0.40946202391985526,0.5831899024670109,0.007348073613133854,2384,-826,4566,6124,-0.0031521517192731885,-0.022222779068399034,0.025374930787672167,-7873,-2182,-0.1737278785471556,-0.028527082506945356
7446,29071,Franklin,Missouri,2008,21256,27355,847,49458,0.42977880221602166,0.5530955558251446,0.01712564195883376,2700,514,926,4140,0.020316778296166405,0.009777568345699907,-0.030094346641866276,-6099,1774,-0.12331675360912292,0.05041112493803268
7447,29071,Franklin,Missouri,2012,16347,29396,1186,46929,0.3483347184043981,0.6263930618594047,0.025272219736197234,-4909,339,2041,-2529,-0.08144408381162355,0.008146577777363474,0.07329750603426011,-13049,-6950,-0.2780583434550066,-0.15474158984588365
7448,29071,Franklin,Missouri,2016,12341,35430,2701,50472,0.2445118085275004,0.7019733713742273,0.05351482009827231,-4006,1515,6034,3543,-0.10382290987689771,0.028242600362075078,0.07558030951482264,-23089,-10040,-0.4574615628467269,-0.17940321939172033
7449,29073,Gasconade,Missouri,2000,2257,4190,182,6629,0.3404736762709308,0.6320712022929552,0.027455121436114043,0,0,0,0,0.0,0.0,0.0,-1933,0,-0.29159752602202443,0.0
7450,29073,Gasconade,Missouri,2004,2355,4753,63,7171,0.3284060800446242,0.6628085343745642,0.008785385580811602,98,-119,563,542,-0.012067596226306598,-0.01866973585530244,0.030737332081609003,-2398,-465,-0.33440245432994004,-0.0428049283079156
7451,29073,Gasconade,Missouri,2008,2899,4763,109,7771,0.3730536610474842,0.6129198301376915,0.014026508814824347,544,46,10,600,0.04464758100286004,0.005241123234012745,-0.04988870423687275,-1864,534,-0.23986616909020725,0.09453628523973279
7452,29073,Gasconade,Missouri,2012,2099,4895,140,7134,0.29422483880011213,0.6861508270255117,0.019624334174376225,-800,31,132,-637,-0.07882882224737209,0.005597825359551879,0.0732309968878202,-2796,-932,-0.39192598822539954,-0.1520598191351923
7453,29073,Gasconade,Missouri,2016,1520,5670,261,7451,0.20399946315930748,0.7609716816534693,0.03502885518722319,-579,121,775,317,-0.09022537564080466,0.015404521012846967,0.07482085462795762,-4150,-1354,-0.5569722184941618,-0.16504623026876225
7454,29075,Gentry,Missouri,2000,1271,1771,63,3105,0.40933977455716586,0.5703703703703704,0.020289855072463767,0,0,0,0,0.0,0.0,0.0,-500,0,-0.16103059581320456,0.0
7455,29075,Gentry,Missouri,2004,1201,2085,26,3312,0.3626207729468599,0.6295289855072463,0.00785024154589372,-70,-37,314,207,-0.046719001610305955,-0.012439613526570047,0.059158615136875925,-884,-384,-0.26690821256038644,-0.10587761674718188
7456,29075,Gentry,Missouri,2008,1235,1964,93,3292,0.37515188335358446,0.5965978128797084,0.028250303766707167,34,67,-121,-20,0.012531110406724555,0.020400062220813447,-0.032931172627537975,-729,155,-0.2214459295261239,0.04546228303426253
7457,29075,Gentry,Missouri,2012,937,1988,74,2999,0.3124374791597199,0.6628876292097365,0.024674891630543514,-298,-19,24,-293,-0.06271440419386454,-0.0035754121361636533,0.06628981633002817,-1051,-322,-0.3504501500500166,-0.1290042205238927
7458,29075,Gentry,Missouri,2016,605,2304,134,3043,0.1988169569503779,0.7571475517581334,0.04403549129148866,-332,60,316,44,-0.11362052220934202,0.01936059966094515,0.09425992254839688,-1699,-648,-0.5583305948077555,-0.20788044475773887
7459,29077,Greene,Missouri,2000,41091,59178,2657,102926,0.39922857198375533,0.5749567650545052,0.025814662961739503,0,0,0,0,0.0,0.0,0.0,-18087,0,-0.17572819307074988,0.0
7460,29077,Greene,Missouri,2004,46657,77885,724,125266,0.3724633978892916,0.6217569013140039,0.0057797007967046125,5566,-1933,18707,22340,-0.026765174094463717,-0.020034962165034892,0.04680013625949864,-31228,-13141,-0.24929350342471224,-0.07356531035396235
7461,29077,Greene,Missouri,2008,56181,77683,2283,136147,0.41264956260512536,0.5705817976158123,0.016768639779062337,9524,1559,-202,10881,0.04018616471583375,0.010988938982357725,-0.05117510369819156,-21502,9726,-0.15793223501068693,0.09136126841402531
7462,29077,Greene,Missouri,2012,46219,76900,3300,126419,0.3656016896194401,0.6082946392551752,0.026103671125384635,-9962,1017,-783,-9728,-0.047047872985685246,0.009335031346322298,0.03771284163936295,-30681,-9179,-0.24269294963573512,-0.0847607146250482
7463,29077,Greene,Missouri,2016,42728,78035,9760,130523,0.3273599289014197,0.5978639779962153,0.0747760931023651,-3491,6460,1135,4104,-0.038241760718020434,0.04867242197698047,-0.010430661258959972,-35307,-4626,-0.2705040490947956,-0.027811099459060462
7464,29079,Grundy,Missouri,2000,1563,2976,169,4708,0.3319881053525913,0.6321155480033984,0.035896346644010195,0,0,0,0,0.0,0.0,0.0,-1413,0,-0.3001274426508071,0.0
7465,29079,Grundy,Missouri,2004,1561,3172,75,4808,0.3246672212978369,0.6597337770382695,0.01559900166389351,-2,-94,196,100,-0.007320884054754395,-0.020297344980116684,0.0276182290348711,-1611,-198,-0.3350665557404326,-0.034939113089625495
7466,29079,Grundy,Missouri,2008,1580,3006,154,4740,0.3333333333333333,0.6341772151898735,0.032489451476793246,19,79,-166,-68,0.008666112035496387,0.016890449812899735,-0.025556561848396053,-1426,185,-0.30084388185654015,0.03422267388389244
7467,29079,Grundy,Missouri,2012,1212,3030,132,4374,0.27709190672153633,0.6927297668038409,0.03017832647462277,-368,-22,24,-366,-0.056241426611796985,-0.0023111250021704763,0.05855255161396744,-1818,-392,-0.4156378600823046,-0.11479397822576443
7468,29079,Grundy,Missouri,2016,780,3462,186,4428,0.17615176151761516,0.7818428184281843,0.04200542005420054,-432,54,432,54,-0.10094014520392117,0.011827093579577772,0.08911305162434335,-2682,-864,-0.6056910569105691,-0.19005319682826455
7469,29081,Harrison,Missouri,2000,1328,2552,111,3991,0.3327486845402155,0.6394387371586069,0.02781257830117765,0,0,0,0,0.0,0.0,0.0,-1224,0,-0.3066900526183914,0.0
7470,29081,Harrison,Missouri,2004,1279,2729,40,4048,0.3159584980237154,0.6741600790513834,0.009881422924901186,-49,-71,177,57,-0.016790186516500105,-0.017931155376276466,0.034721341892776536,-1450,-226,-0.358201581027668,-0.05151152840927664
7471,29081,Harrison,Missouri,2008,1287,2512,116,3915,0.32873563218390806,0.6416347381864623,0.02962962962962963,8,76,-217,-133,0.01277713416019266,0.019748206704728447,-0.03252534086492109,-1225,225,-0.3128991060025543,0.04530247502511375
7472,29081,Harrison,Missouri,2012,984,2624,87,3695,0.26630581867388364,0.710148849797023,0.02354533152909337,-303,-29,112,-220,-0.06242981351002441,-0.006084298100536262,0.06851411161056065,-1640,-415,-0.44384303112313933,-0.13094392512058506
7473,29081,Harrison,Missouri,2016,574,2965,150,3689,0.1555977229601518,0.8037408511791814,0.040661425860666844,-410,63,341,-6,-0.11070809571373183,0.017116094331573475,0.0935920013821584,-2391,-751,-0.6481431282190295,-0.2043000970958902
7474,29083,Henry,Missouri,2000,4459,5120,199,9778,0.45602372673348335,0.5236244630803846,0.020351810186132132,0,0,0,0,0.0,0.0,0.0,-661,0,-0.06760073634690122,0.0
7475,29083,Henry,Missouri,2004,4461,6361,55,10877,0.41013147007446904,0.5848119885997978,0.0050565413257331986,2,-144,1241,1099,-0.04589225665901431,-0.015295268860398933,0.0611875255194132,-1900,-1239,-0.17468051852532873,-0.10707978217842751
7476,29083,Henry,Missouri,2008,4869,6095,195,11159,0.43632942019894255,0.5461958956895779,0.017474684111479524,408,140,-266,282,0.026197950124473512,0.012418142785746326,-0.038616092910219835,-1226,674,-0.10986647549063538,0.06481404303469335
7477,29083,Henry,Missouri,2012,3606,6229,347,10182,0.3541543901001768,0.611765861323905,0.034079748575918285,-1263,152,134,-977,-0.08217503009876576,0.01660506446443876,0.06556996563432704,-2623,-1397,-0.2576114712237282,-0.1477449957330928
7478,29083,Henry,Missouri,2016,2357,7075,480,9912,0.23779257465698145,0.7137812752219532,0.048426150121065374,-1249,133,846,-270,-0.11636181544319535,0.014346401545147089,0.10201541389804825,-4718,-2095,-0.4759887005649718,-0.2183772293412436
7479,29085,Hickory,Missouri,2000,1961,2172,105,4238,0.46271826333176025,0.5125058990089665,0.024775837659273242,0,0,0,0,0.0,0.0,0.0,-211,0,-0.04978763567720623,0.0
7480,29085,Hickory,Missouri,2004,2043,2791,32,4866,0.4198520345252774,0.5735717221537197,0.006576243321002877,82,-73,619,628,-0.04286622880648283,-0.018199594338270366,0.06106582314475317,-748,-537,-0.15371968762844224,-0.103932051951236
7481,29085,Hickory,Missouri,2008,2171,2850,94,5115,0.4244379276637341,0.5571847507331378,0.018377321603128056,128,62,59,249,0.004585893138456698,0.01180107828212518,-0.016386971420581875,-679,69,-0.13274682306940366,0.020972864559038573
7482,29085,Hickory,Missouri,2012,1733,2835,112,4680,0.3702991452991453,0.6057692307692307,0.023931623931623933,-438,18,-15,-435,-0.0541387823645888,0.005554302328495877,0.04858448003609295,-1102,-423,-0.2354700854700854,-0.10272326240068175
7483,29085,Hickory,Missouri,2016,1016,3542,166,4724,0.21507197290431837,0.7497883149872989,0.03513971210838273,-717,54,707,44,-0.15522717239482695,0.011208088176758797,0.1440190842180682,-2526,-1424,-0.5347163420829806,-0.29924625661289517
7484,29087,Holt,Missouri,2000,871,1738,53,2662,0.32719759579263713,0.6528925619834711,0.019909842223891812,0,0,0,0,0.0,0.0,0.0,-867,0,-0.325694966190834,0.0
7485,29087,Holt,Missouri,2004,811,1864,16,2691,0.3013749535488666,0.6926793013749536,0.005945745076179859,-60,-37,126,29,-0.02582264224377051,-0.013964097147711952,0.03978673939148247,-1053,-186,-0.391304347826087,-0.06560938163525298
7486,29087,Holt,Missouri,2008,802,1794,37,2633,0.30459551842005317,0.6813520698822636,0.01405241169768325,-9,21,-70,-58,0.0032205648711865487,0.008106666621503392,-0.011327231492689993,-992,61,-0.37675655146221043,0.014547796363876542
7487,29087,Holt,Missouri,2012,551,1725,34,2310,0.23852813852813853,0.7467532467532467,0.01471861471861472,-251,-3,-69,-323,-0.06606737989191463,0.000666203020931469,0.06540117687098312,-1174,-182,-0.5082251082251081,-0.1314685567628977
7488,29087,Holt,Missouri,2016,347,1926,82,2355,0.1473460721868365,0.8178343949044586,0.03481953290870488,-204,48,201,45,-0.09118206634130202,0.02010091819009016,0.07108114815121191,-1579,-405,-0.6704883227176222,-0.16226321449251402
7489,29089,Howard,Missouri,2000,1944,2414,154,4512,0.4308510638297872,0.5350177304964538,0.034131205673758866,0,0,0,0,0.0,0.0,0.0,-470,0,-0.10416666666666663,0.0
7490,29089,Howard,Missouri,2004,1972,2915,34,4921,0.40073155862629545,0.5923592765698029,0.006909164803901646,28,-120,501,409,-0.03011950520349177,-0.02722204086985722,0.05734154607334907,-943,-473,-0.19162771794350747,-0.08746105127684084
7491,29089,Howard,Missouri,2008,2036,2708,111,4855,0.41936148300720905,0.5577754891864057,0.02286302780638517,64,77,-207,-66,0.0186299243809136,0.015953863002483526,-0.03458378738339718,-672,271,-0.1384140061791967,0.05321371176431078
7492,29089,Howard,Missouri,2012,1723,3017,127,4867,0.35401684816108486,0.6198890486952948,0.0260941031436203,-313,16,309,12,-0.06534463484612418,0.0032310753372351286,0.06211355950888908,-1294,-622,-0.26587220053420996,-0.12745819435501327
7493,29089,Howard,Missouri,2016,1283,3277,308,4868,0.2635579293344289,0.6731717337715695,0.06327033689400165,-440,181,260,1,-0.09045891882665597,0.03717623375038134,0.05328268507627465,-1994,-700,-0.40961380443714057,-0.14374160390293061
7494,29091,Howell,Missouri,2000,4641,9018,416,14075,0.3297335701598579,0.6407104795737123,0.02955595026642984,0,0,0,0,0.0,0.0,0.0,-4377,0,-0.3109769094138544,0.0
7495,29091,Howell,Missouri,2004,5118,11097,164,16379,0.3124732889675804,0.6775138897368582,0.01001282129556139,477,-252,2079,2304,-0.01726028119227746,-0.01954312897086845,0.03680341016314592,-5979,-1602,-0.3650406007692778,-0.05406369135542338
7496,29091,Howell,Missouri,2008,5736,10982,311,17029,0.3368371601385871,0.644899876680956,0.01826296318045687,618,147,-115,650,0.02436387117100669,0.008250141884895479,-0.03261401305590217,-5246,733,-0.30806271654236894,0.05697788422690886
7497,29091,Howell,Missouri,2012,4395,11544,407,16346,0.26887311880582404,0.7062278233206901,0.02489905787348587,-1341,96,562,-683,-0.06796404133276307,0.006636094693029001,0.061327946639734066,-7149,-1903,-0.4373547045148661,-0.12929198797249714
7498,29091,Howell,Missouri,2016,2881,13893,681,17455,0.1650529934116299,0.7959323975938126,0.039014608994557436,-1514,274,2349,1109,-0.10382012539419413,0.014115551121071566,0.0897045742731225,-11012,-3863,-0.6308794041821827,-0.1935246996673166
7499,29093,Iron,Missouri,2000,2044,2237,133,4414,0.46307204349796105,0.5067965564114182,0.030131400090620753,0,0,0,0,0.0,0.0,0.0,-193,0,-0.043724512913457136,0.0
7500,29093,Iron,Missouri,2004,2157,2477,45,4679,0.46099593930326993,0.5293866210728788,0.00961743962385125,113,-88,240,265,-0.0020761041946911196,-0.020513960466769503,0.02259006466146063,-320,-127,-0.06839068176960889,-0.02466616885615175
7501,29093,Iron,Missouri,2008,2213,2090,111,4414,0.5013593112822836,0.47349342999546895,0.025147258722247396,56,66,-387,-265,0.040363371979013685,0.015529819098396146,-0.055893191077409865,123,443,0.027865881286814664,0.09625656305642355
7502,29093,Iron,Missouri,2012,1669,2252,110,4031,0.41404118084842473,0.5586703051352022,0.027288514016373108,-544,-1,162,-383,-0.08731813043385889,0.0021412552941257115,0.08517687513973327,-583,-706,-0.1446291242867775,-0.17249500557359215
7503,29093,Iron,Missouri,2016,933,3173,163,4269,0.21855235418130708,0.743265401733427,0.03818224408526587,-736,53,921,238,-0.19548882666711764,0.01089373006889276,0.18459509659822482,-2240,-1657,-0.52471304755212,-0.3800839232653425
7504,29095,Jackson,Missouri,2000,160419,104418,7225,272062,0.5896413317552617,0.38380222155244026,0.026556446692298077,0,0,0,0,0.0,0.0,0.0,56001,0,0.20583911020282142,0.0
7505,29095,Jackson,Missouri,2004,183654,130500,1839,315993,0.5811964189080138,0.41298383192032734,0.005819749171658866,23235,-5386,26082,43931,-0.00844491284724791,-0.02073669752063921,0.02918161036788708,53154,-2847,0.16821258698768643,-0.03762652321513499
7506,29095,Jackson,Missouri,2008,210824,124687,3755,339266,0.621412107314025,0.36751988115519973,0.011068011530775261,27170,1916,-5813,23273,0.040215688406011196,0.0052482623591163955,-0.0454639507651276,86137,32983,0.25389222615882523,0.0856796391711388
7507,29095,Jackson,Missouri,2012,183953,122708,5400,312061,0.5894776982705304,0.3932179926360551,0.01730430909341443,-26871,1645,-1979,-27205,-0.03193440904349454,0.006236297562639168,0.02569811148085538,61245,-24892,0.1962597056344753,-0.05763252052434992
7508,29095,Jackson,Missouri,2016,168972,116211,19504,304687,0.5545756793036789,0.3814110874438358,0.06401323325248534,-14981,14104,-6497,-7374,-0.03490201896685152,0.04670892415907091,-0.01180690519221933,52761,-8484,0.17316459185984312,-0.023095113774632192
7509,29097,Jasper,Missouri,2000,11737,24899,845,37481,0.3131453269656626,0.6643099170246258,0.02254475600971159,0,0,0,0,0.0,0.0,0.0,-13162,0,-0.3511645900589632,0.0
7510,29097,Jasper,Missouri,2004,13002,31846,237,45085,0.2883885993124099,0.7063546634135521,0.005256737274037929,1265,-608,6947,7604,-0.024756727653252708,-0.01728801873567366,0.0420447463889263,-18844,-5682,-0.41796606410114223,-0.06680147404217901
7511,29097,Jasper,Missouri,2008,15730,31667,822,48219,0.32621995478960575,0.6567328231609947,0.017047222049399614,2728,585,-179,3134,0.03783135547719585,0.011790484775361685,-0.04962184025255745,-15937,2907,-0.33051286837138893,0.0874531957297533
7512,29097,Jasper,Missouri,2012,12809,31349,1060,45218,0.28327214825954267,0.6932858596134283,0.02344199212702906,-2921,238,-318,-3001,-0.04294780653006308,0.0063947700776294455,0.036553036452433574,-18540,-2603,-0.4100137113538856,-0.07950084298249666
7513,29097,Jasper,Missouri,2016,10572,35070,2684,48326,0.2187642262964036,0.7256963125439722,0.05553946115962422,-2237,1624,3721,3108,-0.06450792196313906,0.032097469032595166,0.0324104529305439,-24498,-5958,-0.5069320862475686,-0.09691837489368299
7514,29099,Jefferson,Missouri,2000,38616,36766,1822,77204,0.5001813377545204,0.47621884876431275,0.023599813481166777,0,0,0,0,0.0,0.0,0.0,1850,0,0.023962488990207698,0.0
7515,29099,Jefferson,Missouri,2004,46057,46624,583,93264,0.4938347057814376,0.49991422199348085,0.006251072225081489,7441,-1239,9858,16060,-0.006346631973082828,-0.01734874125608529,0.023695373229168093,-567,-2417,-0.006079516212043223,-0.03004200520225092
7516,29099,Jefferson,Missouri,2008,53467,50804,1779,106050,0.5041678453559642,0.47905704856199904,0.016775106082036775,7410,1196,4180,12786,0.010333139574526529,0.010524033856955287,-0.0208571734314818,2663,3230,0.025110796793965107,0.03119031300600833
7517,29099,Jefferson,Missouri,2012,41564,53978,2482,98024,0.42401860768791316,0.550661062596915,0.025320329715171796,-11903,703,3174,-8026,-0.08014923766805099,0.008545223633135021,0.07160401403491601,-12414,-15077,-0.1266424549090019,-0.151753251702967
7518,29099,Jefferson,Missouri,2016,31568,69036,6391,106995,0.29504182438431703,0.6452264124491799,0.05973176316650311,-9996,3909,15058,8971,-0.12897678330359613,0.03441143345133131,0.09456534985226484,-37468,-25054,-0.35018458806486286,-0.22354213315586097
7519,29101,Johnson,Missouri,2000,6926,9339,522,16787,0.41258116399594924,0.5563233454458807,0.031095490558170014,0,0,0,0,0.0,0.0,0.0,-2413,0,-0.14374218144993145,0.0
7520,29101,Johnson,Missouri,2004,7790,12257,189,20236,0.3849575014825064,0.6057027080450682,0.00933979047242538,864,-333,2918,3449,-0.027623662513442837,-0.021755700085744633,0.049379362599187515,-4467,-2054,-0.2207452065625618,-0.07700302511263035
7521,29101,Johnson,Missouri,2008,9480,12183,417,22080,0.42934782608695654,0.5517663043478261,0.01888586956521739,1690,228,-74,1844,0.04439032460445014,0.00954607909279201,-0.053936403697242064,-2703,1764,-0.1224184782608696,0.0983267283016922
7522,29101,Johnson,Missouri,2012,7667,12763,591,21021,0.36473050758765047,0.6071547500118929,0.028114742400456687,-1813,174,580,-1059,-0.06461731849930608,0.009228872835239297,0.055388445664066754,-5096,-2393,-0.24242424242424243,-0.12000576416337283
7523,29101,Johnson,Missouri,2016,5930,13719,1713,21362,0.2775957307368224,0.6422151483943451,0.08018912086883251,-1737,1122,956,341,-0.08713477685082804,0.05207437846837582,0.03506039838245223,-7789,-2693,-0.3646194176575227,-0.12219517523328027
7524,29103,Knox,Missouri,2000,787,1226,42,2055,0.3829683698296837,0.5965936739659368,0.020437956204379562,0,0,0,0,0.0,0.0,0.0,-439,0,-0.21362530413625308,0.0
7525,29103,Knox,Missouri,2004,761,1207,10,1978,0.38473205257836196,0.6102123356926188,0.005055611729019211,-26,-32,-19,-77,0.0017636827486782747,-0.015382344475360351,0.013618661726682024,-446,-7,-0.22548028311425683,-0.01185497897800375
7526,29103,Knox,Missouri,2008,759,1212,58,2029,0.374075899457861,0.5973385904386397,0.02858551010349926,-2,48,5,51,-0.010656153120500944,0.023529898374480048,-0.012873745253979108,-453,-7,-0.22326269098077867,0.0022175921334781634
7527,29103,Knox,Missouri,2012,698,1205,54,1957,0.35666836995401124,0.6157383750638733,0.027593254982115484,-61,-4,-7,-72,-0.017407529503849772,-0.0009922551213837755,0.018399784625233617,-507,-54,-0.25907000510986206,-0.03580731412908339
7528,29103,Knox,Missouri,2016,379,1416,75,1870,0.20267379679144384,0.7572192513368984,0.040106951871657755,-319,21,211,-87,-0.1539945731625674,0.012513696889542271,0.14148087627302508,-1037,-530,-0.5545454545454546,-0.2954754494355925
7529,29105,LaClede,Missouri,2000,4183,8556,307,13046,0.3206346772957228,0.6558332055802545,0.02353211712402269,0,0,0,0,0.0,0.0,0.0,-4373,0,-0.33519852828453167,0.0
7530,29105,LaClede,Missouri,2004,4213,10578,78,14869,0.2833411796354832,0.7114130069271639,0.0052458134373528816,30,-229,2022,1823,-0.037293497660239594,-0.018286303686669808,0.05557980134690943,-6365,-1992,-0.4280718272916807,-0.09287329900714902
7531,29105,LaClede,Missouri,2008,5218,10875,286,16379,0.31857866780633737,0.6639599487148178,0.017461383478844864,1005,208,297,1510,0.03523748817085415,0.012215570041491982,-0.04745305821234613,-5657,708,-0.3453812809084804,0.08269054638320028
7532,29105,LaClede,Missouri,2012,4093,10934,408,15435,0.2651765468091999,0.7083900226757369,0.026433430515063167,-1125,122,59,-944,-0.05340212099713748,0.008972047036218303,0.044430073960919136,-6841,-1184,-0.44321347586653703,-0.09783219495805662
7533,29105,LaClede,Missouri,2016,2553,12881,706,16140,0.15817843866171002,0.7980793060718712,0.04374225526641883,-1540,298,1947,705,-0.10699810814748986,0.017308824751355666,0.08968928339613425,-10328,-3487,-0.6399008674101612,-0.19668739154362413
7534,29107,Lafayette,Missouri,2000,6343,7849,328,14520,0.43684573002754823,0.540564738292011,0.022589531680440773,0,0,0,0,0.0,0.0,0.0,-1506,0,-0.10371900826446279,0.0
7535,29107,Lafayette,Missouri,2004,6412,9656,114,16182,0.39624273884563094,0.5967123964899271,0.0070448646644419724,69,-214,1807,1662,-0.04060299118191729,-0.015544667015998801,0.05614765819791612,-3244,-1738,-0.2004696576442962,-0.09675064937983341
7536,29107,Lafayette,Missouri,2008,6902,9442,256,16600,0.4157831325301205,0.5687951807228916,0.015421686746987951,490,142,-214,418,0.019540393684489565,0.00837682208254598,-0.02791721576703554,-2540,704,-0.1530120481927711,0.04745760945152511
7537,29107,Lafayette,Missouri,2012,5655,9803,408,15866,0.35642253876213287,0.6178620950460103,0.0257153661918568,-1247,152,361,-734,-0.059360593767987635,0.01029367944486885,0.049066914323118715,-4148,-1608,-0.26143955628387744,-0.10842750809110635
7538,29107,Lafayette,Missouri,2016,4053,10988,934,15975,0.25370892018779345,0.6878247261345853,0.058466353677621284,-1602,526,1185,109,-0.10271361857433942,0.03275098748576448,0.06996263108857503,-6935,-2787,-0.4341158059467919,-0.17267624966291445
7539,29109,Lawrence,Missouri,2000,4235,8305,363,12903,0.32821824381926684,0.6436487638533674,0.028132992327365727,0,0,0,0,0.0,0.0,0.0,-4070,0,-0.3154305200341006,0.0
7540,29109,Lawrence,Missouri,2004,4506,11194,106,15806,0.285081614576743,0.7082120713653043,0.006706314057952676,271,-257,2889,2903,-0.043136629242523816,-0.021426678269413052,0.06456330751193684,-6688,-2618,-0.42313045678856126,-0.10769993675446066
7541,29109,Lawrence,Missouri,2008,5097,11263,325,16685,0.3054839676356008,0.6750374587953252,0.01947857356907402,591,219,69,879,0.02040235305885779,0.012772259511121344,-0.03317461256997911,-6166,522,-0.36955349115972436,0.0535769656288369
7542,29109,Lawrence,Missouri,2012,4017,11421,317,15755,0.25496667724531896,0.7249127261186925,0.020120596635988575,-1080,-8,158,-930,-0.050517290390281855,0.0006420230669145557,0.049875267323367334,-7404,-1238,-0.46994604887337355,-0.10039255771364919
7543,29109,Lawrence,Missouri,2016,2901,13089,821,16811,0.1725655820593659,0.7785973469751948,0.048837070965439294,-1116,504,1668,1056,-0.08240109518595307,0.02871647432945072,0.053684620856502274,-10188,-2784,-0.6060317649158289,-0.13608571604245534
7544,29111,Lewis,Missouri,2000,2023,2388,73,4484,0.4511596788581623,0.5325602140945584,0.016280107047279214,0,0,0,0,0.0,0.0,0.0,-365,0,-0.08140053523639612,0.0
7545,29111,Lewis,Missouri,2004,1754,2862,28,4644,0.3776916451335056,0.6162790697674418,0.006029285099052541,-269,-45,474,160,-0.07346803372465671,-0.010250821948226673,0.0837188556728834,-1108,-743,-0.23858742463393623,-0.1571868893975401
7546,29111,Lewis,Missouri,2008,1837,2594,71,4502,0.4080408707241226,0.576188360728565,0.015770768547312304,83,43,-268,-142,0.03034922559061698,0.009741483448259763,-0.04009070903887679,-757,351,-0.16814749000444246,0.07043993462949377
7547,29111,Lewis,Missouri,2012,1508,2677,94,4279,0.3524187894367843,0.6256134610890395,0.02196774947417621,-329,23,83,-223,-0.05562208128733831,0.006196980926863906,0.04942510036047443,-1169,-412,-0.2731946716522552,-0.10504718164781274
7548,29111,Lewis,Missouri,2016,934,3344,202,4480,0.20848214285714287,0.7464285714285714,0.045089285714285714,-574,108,667,201,-0.14393664657964142,0.023121536240109503,0.12081511033953196,-2410,-1241,-0.5379464285714286,-0.2647517569191734
7549,29113,Lincoln,Missouri,2000,6961,8549,403,15913,0.4374410859046063,0.5372337082888204,0.025325205806573242,0,0,0,0,0.0,0.0,0.0,-1588,0,-0.09979262238421416,0.0
7550,29113,Lincoln,Missouri,2004,8368,11316,155,19839,0.42179545339986896,0.5703916528050809,0.007812893795050154,1407,-248,2767,3926,-0.015645632504737328,-0.01751231201152309,0.03315794451626042,-2948,-1360,-0.1485961994052119,-0.048803577020997746
7551,29113,Lincoln,Missouri,2008,10234,12924,461,23619,0.4332952284177992,0.547186587069732,0.019518184512468777,1866,306,1608,3780,0.011499775017930258,0.011705290717418623,-0.023205065735348862,-2690,258,-0.11389135865193278,0.03470484075327912
7552,29113,Lincoln,Missouri,2012,7734,14332,710,22776,0.33956796628029506,0.6292588689848964,0.03117316473480857,-2500,249,1408,-843,-0.09372726213750415,0.011654980222339795,0.08207228191516436,-6598,-3908,-0.2896909027046013,-0.1757995440526685
7553,29113,Lincoln,Missouri,2016,5575,18159,1380,25114,0.22198773592418572,0.7230628334793342,0.05494943059648005,-2159,670,3827,2338,-0.11758023035610934,0.023776265861671482,0.09380396449443784,-12584,-5986,-0.5010750975551485,-0.21138419485054716
7554,29115,Linn,Missouri,2000,2646,3246,118,6010,0.44026622296173046,0.540099833610649,0.01963394342762063,0,0,0,0,0.0,0.0,0.0,-600,0,-0.09983361064891849,0.0
7555,29115,Linn,Missouri,2004,2440,3422,36,5898,0.4136995591726009,0.5801966768396066,0.006103763987792472,-206,-82,176,-112,-0.026566663789129585,-0.01353017943982816,0.04009684322895768,-982,-382,-0.16649711766700576,-0.06666350701808726
7556,29115,Linn,Missouri,2008,2638,3140,153,5931,0.4447816557073006,0.5294216826842016,0.025796661608497723,198,117,-282,33,0.031082096534699732,0.019692897620705252,-0.050774994155404984,-502,480,-0.08464002697690104,0.08185709069010472
7557,29115,Linn,Missouri,2012,2041,3344,165,5550,0.36774774774774777,0.6025225225225225,0.02972972972972973,-597,12,204,-381,-0.07703390795955284,0.0039330681212320084,0.07310083983832083,-1303,-801,-0.2347747747747747,-0.15013474779787367
7558,29115,Linn,Missouri,2016,1240,4088,259,5587,0.2219437981027385,0.7316985860032218,0.046357615894039736,-801,94,744,37,-0.14580394964500926,0.016627886164310005,0.12917606348069932,-2848,-1545,-0.5097547879004833,-0.27498001312570863
7559,29117,Livingston,Missouri,2000,2425,3709,142,6276,0.3863926067558955,0.5909815168897387,0.02262587635436584,0,0,0,0,0.0,0.0,0.0,-1284,0,-0.20458891013384317,0.0
7560,29117,Livingston,Missouri,2004,2278,4029,39,6346,0.35896627797037506,0.6348881184998424,0.00614560352978254,-147,-103,320,70,-0.027426328785520426,-0.016480272824583298,0.043906601610103735,-1751,-467,-0.27592184052946733,-0.07133293039562416
7561,29117,Livingston,Missouri,2008,2435,3993,124,6552,0.37164224664224665,0.6094322344322345,0.018925518925518924,157,85,-36,206,0.012675968671871596,0.012779915395736384,-0.025455884067607903,-1558,193,-0.23778998778998783,0.0381318527394795
7562,29117,Livingston,Missouri,2012,1906,4006,142,6054,0.3148331681532871,0.6617112652791542,0.02345556656755864,-529,18,13,-498,-0.05680907848895955,0.004530047642039715,0.05227903084691976,-2100,-542,-0.34687809712586715,-0.10908810933587931
7563,29117,Livingston,Missouri,2016,1265,4879,277,6421,0.19700981155583241,0.7598504905777916,0.043139697866375955,-641,135,873,367,-0.11782335659745469,0.019684131298817315,0.09813922529863739,-3614,-1514,-0.5628406790219592,-0.21596258189609208
7564,29119,McDonald,Missouri,2000,1866,4460,203,6529,0.28580180732118243,0.683106141828764,0.031092050850053607,0,0,0,0,0.0,0.0,0.0,-2594,0,-0.3973043345075815,0.0
7565,29119,McDonald,Missouri,2004,2215,5443,67,7725,0.2867313915857605,0.7045954692556634,0.008673139158576051,349,-136,983,1196,0.000929584264578065,-0.022418911691477555,0.021489327426899463,-3228,-634,-0.4178640776699029,-0.020559743162321398
7566,29119,McDonald,Missouri,2008,2454,5499,182,8135,0.30165949600491704,0.6759680393362016,0.022372464658881378,239,115,56,410,0.01492810441915654,0.013699325500305327,-0.028627429919461767,-3045,183,-0.3743085433312846,0.04355553433861831
7567,29119,McDonald,Missouri,2012,1920,5694,203,7817,0.24561852373033133,0.7284124344377638,0.025969041831904825,-534,21,195,-318,-0.05604097227458571,0.0035965771730234464,0.05244439510156218,-3774,-729,-0.4827939107074325,-0.10848536737614789
7568,29119,McDonald,Missouri,2016,1329,6599,314,8242,0.16124727008007766,0.8006551807813638,0.038097549138558603,-591,111,905,425,-0.08437125365025366,0.012128507306653779,0.07224274634359995,-5270,-1496,-0.6394079107012861,-0.15661399999385361
7569,29121,Macon,Missouri,2000,2817,4232,126,7175,0.39261324041811846,0.5898257839721255,0.0175609756097561,0,0,0,0,0.0,0.0,0.0,-1415,0,-0.19721254355400702,0.0
7570,29121,Macon,Missouri,2004,2856,4673,41,7570,0.37727873183619554,0.6173051519154558,0.005416116248348745,39,-85,441,395,-0.015334508581922923,-0.012144859361407355,0.02747936794333028,-1817,-402,-0.24002642007926023,-0.0428138765252532
7571,29121,Macon,Missouri,2008,2784,4586,104,7474,0.3724913031843725,0.6135937918116136,0.013914905004013914,-72,63,-87,-96,-0.0047874286518230225,0.00849878875566517,-0.0037113601038422095,-1802,15,-0.24110248862724104,-0.001076068547980813
7572,29121,Macon,Missouri,2012,2309,4701,150,7160,0.3224860335195531,0.6565642458100559,0.02094972067039106,-475,46,115,-314,-0.05000526966481944,0.007034815666377146,0.04297045399844235,-2392,-590,-0.33407821229050283,-0.09297572366326179
7573,29121,Macon,Missouri,2016,1548,5798,285,7631,0.20285676844450268,0.7597955706984668,0.037347660857030535,-761,135,1097,471,-0.1196292650750504,0.016397940186639474,0.10323132488841091,-4250,-1858,-0.5569388022539641,-0.22286058996346125
7574,29123,Madison,Missouri,2000,1828,2460,85,4373,0.4180196661330894,0.5625428767436542,0.019437457123256344,0,0,0,0,0.0,0.0,0.0,-632,0,-0.14452321061056483,0.0
7575,29123,Madison,Missouri,2004,1972,2905,41,4918,0.40097600650671006,0.590687271248475,0.008336722244814965,144,-44,445,545,-0.017043659626379326,-0.01110073487844138,0.028144394504820758,-933,-301,-0.18971126474176492,-0.045188054131200084
7576,29123,Madison,Missouri,2008,2042,2897,89,5028,0.40612569610182975,0.5761734287987271,0.01770087509944312,70,48,-8,110,0.005149689595119689,0.009364152854628154,-0.014513842449747849,-855,78,-0.17004773269689738,0.019663532044867538
7577,29123,Madison,Missouri,2012,1588,3227,115,4930,0.32210953346855986,0.6545638945233265,0.02332657200811359,-454,26,330,-98,-0.08401616263326989,0.005625696908670472,0.0783904657245994,-1639,-784,-0.33245436105476667,-0.1624066283578693
7578,29123,Madison,Missouri,2016,1005,4102,214,5321,0.1888742717534298,0.770907724112009,0.04021800413456117,-583,99,875,391,-0.13323526171513006,0.01689143212644758,0.1163438295886825,-3097,-1458,-0.5820334523585793,-0.24957909130381262
7579,29125,Maries,Missouri,2000,1554,2216,84,3854,0.40321743642968344,0.5749870264660093,0.021795537104307212,0,0,0,0,0.0,0.0,0.0,-662,0,-0.17176959003632586,0.0
7580,29125,Maries,Missouri,2004,1563,2825,36,4424,0.3533001808318264,0.6385623869801085,0.0081374321880651,9,-48,609,570,-0.049917255597857035,-0.013658104916242112,0.06357536051409918,-1262,-600,-0.28526220614828207,-0.11349261611195621
7581,29125,Maries,Missouri,2008,1599,2853,107,4559,0.3507348102654091,0.6257951305110769,0.023470059223513928,36,71,28,135,-0.002565370566417313,0.015332627035448828,-0.01276725646903154,-1254,8,-0.27506032024566784,0.010201885902614227
7582,29125,Maries,Missouri,2012,1299,3165,74,4538,0.2862494490965183,0.6974438078448656,0.01630674305861613,-300,-33,312,-21,-0.06448536116889081,-0.007163316164897796,0.07164867733378866,-1866,-612,-0.4111943587483473,-0.13613403850267947
7583,29125,Maries,Missouri,2016,794,3561,145,4500,0.17644444444444443,0.7913333333333333,0.03222222222222222,-505,71,396,-38,-0.10980500465207385,0.01591547916360609,0.09388952548846774,-2767,-901,-0.6148888888888889,-0.20369453014054162
7584,29127,Marion,Missouri,2000,4993,6550,169,11712,0.42631489071038253,0.5592554644808743,0.01442964480874317,0,0,0,0,0.0,0.0,0.0,-1557,0,-0.13294057377049173,0.0
7585,29127,Marion,Missouri,2004,4568,7815,70,12453,0.3668192403436923,0.6275596241869429,0.005621135469364812,-425,-99,1265,741,-0.059495650366690245,-0.008808509339378358,0.06830415970606862,-3247,-1690,-0.2607403838432506,-0.12779981007275887
7586,29127,Marion,Missouri,2008,4703,7705,145,12553,0.3746514777344061,0.6137974986059109,0.011551023659682944,135,75,-110,100,0.007832237390713814,0.005929888190318132,-0.013762125581031959,-3002,245,-0.23914602087150483,0.021594362971745773
7587,29127,Marion,Missouri,2012,4031,7923,204,12158,0.33155124198058894,0.6516696825135713,0.016779075505839777,-672,59,218,-395,-0.04310023575381716,0.005228051846156833,0.03787218390766034,-3892,-890,-0.32011844053298233,-0.0809724196614775
7588,29127,Marion,Missouri,2016,2994,9419,525,12938,0.23141134642139435,0.7280105116710466,0.04057814190755913,-1037,321,1496,780,-0.10013989555919459,0.023799066401719353,0.07634082915747531,-6425,-2533,-0.4965991652496522,-0.17648072471666987
7589,29129,Mercer,Missouri,2000,555,1250,37,1842,0.30130293159609123,0.6786102062975027,0.02008686210640608,0,0,0,0,0.0,0.0,0.0,-695,0,-0.37730727470141145,0.0
7590,29129,Mercer,Missouri,2004,582,1207,28,1817,0.3203082003302146,0.6642817831590534,0.015410016510731976,27,-9,-43,-25,0.019005268734123393,-0.004676845595674103,-0.014328423138449287,-625,70,-0.3439735828288388,0.03333369187257268
7591,29129,Mercer,Missouri,2008,519,1169,60,1748,0.29691075514874143,0.6687643020594966,0.034324942791762014,-63,32,-38,-69,-0.023397445181473187,0.018914926281030038,0.004482518900443155,-650,-25,-0.3718535469107551,-0.027879964081916342
7592,29129,Mercer,Missouri,2012,353,1255,47,1655,0.21329305135951662,0.7583081570996979,0.0283987915407855,-166,-13,86,-93,-0.08361770378922481,-0.005926151250976515,0.08954385504020135,-902,-252,-0.5450151057401813,-0.1731615588294262
7593,29129,Mercer,Missouri,2016,216,1486,43,1745,0.12378223495702005,0.8515759312320917,0.02464183381088825,-137,-4,231,90,-0.08951081640249657,-0.0037569577298972485,0.09326777413239384,-1270,-368,-0.7277936962750717,-0.18277859053489043
7594,29131,Miller,Missouri,2000,3217,5945,194,9356,0.34384352287302267,0.6354211201368106,0.020735356990166737,0,0,0,0,0.0,0.0,0.0,-2728,0,-0.29157759726378796,0.0
7595,29131,Miller,Missouri,2004,2959,7797,75,10831,0.27319730403471515,0.7198781275967131,0.006924568368571692,-258,-119,1852,1475,-0.07064621883830752,-0.013810788621595044,0.08445700745990248,-4838,-2110,-0.44668082356199795,-0.15510322629821
7596,29131,Miller,Missouri,2008,3553,7797,213,11563,0.3072731989968001,0.6743059759577964,0.018420825045403443,594,138,0,732,0.03407589496208496,0.01149625667683175,-0.0455721516389167,-4244,594,-0.3670327769609963,0.07964804660100167
7597,29131,Miller,Missouri,2012,2651,8099,298,11048,0.23995293265749457,0.7330738595220855,0.026973207820419984,-902,85,302,-515,-0.06732026633930555,0.008552382775016541,0.05876788356428908,-5448,-1204,-0.4931209268645909,-0.12608814990359463
7598,29131,Miller,Missouri,2016,1750,9285,447,11482,0.1524124716948267,0.8086570283922662,0.03893049991290716,-901,149,1186,434,-0.08754046096266788,0.011957292092487175,0.07558316887018068,-7535,-2087,-0.6562445566974395,-0.16312362983284862
7599,29133,Mississippi,Missouri,2000,2756,2395,64,5215,0.5284755512943432,0.4592521572387344,0.012272291466922339,0,0,0,0,0.0,0.0,0.0,361,0,0.06922339405560879,0.0
7600,29133,Mississippi,Missouri,2004,2374,2903,21,5298,0.4480936202340506,0.5479426198565497,0.003963759909399773,-382,-43,508,83,-0.08038193106029262,-0.008308531557522566,0.08869046261781527,-529,-890,-0.0998489996224991,-0.1690723936781079
7601,29133,Mississippi,Missouri,2008,2247,3034,75,5356,0.41952949962658703,0.5664675130694549,0.014002987303958178,-127,54,131,58,-0.02856412060746355,0.010039227394558405,0.01852489321290518,-787,-258,-0.14693801344286783,-0.04708901382036873
7602,29133,Mississippi,Missouri,2012,1858,2997,65,4920,0.3776422764227642,0.6091463414634146,0.013211382113821139,-389,-10,-37,-436,-0.04188722320382282,-0.0007916051901370388,0.042678828393959756,-1139,-352,-0.2315040650406504,-0.08456605159778258
7603,29133,Mississippi,Missouri,2016,1458,3600,111,5169,0.2820661636680209,0.6964596633778294,0.021474172954149738,-400,46,603,249,-0.09557611275474331,0.008262790840328599,0.08731332191441477,-2142,-1003,-0.4143934997098085,-0.18288943466915808
7604,29135,Moniteau,Missouri,2000,2176,3764,125,6065,0.3587798845836768,0.6206100577081616,0.020610057708161583,0,0,0,0,0.0,0.0,0.0,-1588,0,-0.26183017312448476,0.0
7605,29135,Moniteau,Missouri,2004,1913,4743,35,6691,0.28590644148856675,0.7088626513226722,0.005230907188761022,-263,-90,979,626,-0.07287344309511007,-0.01537915051940056,0.08825259361451065,-2830,-1242,-0.4229562098341055,-0.16112603670962072
7606,29135,Moniteau,Missouri,2008,2084,4467,114,6665,0.3126781695423856,0.6702175543885972,0.017104276069017255,171,79,-276,-26,0.026771728053818833,0.011873368880256233,-0.03864509693407503,-2383,447,-0.3575393848462116,0.06541682498789386
7607,29135,Moniteau,Missouri,2012,1608,4704,131,6443,0.24957318019556107,0.7300946763929846,0.02033214341145429,-476,17,237,-222,-0.06310498934682451,0.003227867342437036,0.05987712200438744,-3096,-713,-0.48052149619742357,-0.12298211135121195
7608,29135,Moniteau,Missouri,2016,1237,5347,246,6830,0.18111273792093704,0.7828696925329429,0.03601756954612006,-371,115,643,387,-0.06846044227462403,0.015685426134665767,0.052775016139958275,-4110,-1014,-0.6017569546120058,-0.12123545841458228
7609,29137,Monroe,Missouri,2000,1860,2175,59,4094,0.45432340009770394,0.5312652662432829,0.01441133365901319,0,0,0,0,0.0,0.0,0.0,-315,0,-0.07694186614557891,0.0
7610,29137,Monroe,Missouri,2004,1647,2632,28,4307,0.3824007429765498,0.611098212212677,0.00650104481077316,-213,-31,457,213,-0.07192265712115414,-0.00791028884824003,0.07983294596939416,-985,-670,-0.22869746923612722,-0.1517556030905483
7611,29137,Monroe,Missouri,2008,1703,2533,78,4314,0.3947612424663885,0.5871580899397311,0.01808066759388039,56,50,-99,7,0.012360499489838694,0.011579622783107231,-0.023940122272945952,-830,155,-0.19239684747334257,0.036300621762784646
7612,29137,Monroe,Missouri,2012,1398,2564,95,4057,0.3445895982252896,0.6319940842987429,0.023416317475967462,-305,17,31,-257,-0.05017164424109888,0.005335649882087071,0.044835994359011866,-1166,-336,-0.2874044860734533,-0.09500763860011074
7613,29137,Monroe,Missouri,2016,853,3159,144,4156,0.20524542829643888,0.7601058710298364,0.03464870067372473,-545,49,595,99,-0.13934416992885074,0.011232383197757271,0.12811178673109347,-2306,-1140,-0.5548604427333975,-0.2674559566599442
7614,29139,Montgomery,Missouri,2000,2092,3106,105,5303,0.3944936828210447,0.5857062040354516,0.01980011314350368,0,0,0,0,0.0,0.0,0.0,-1014,0,-0.1912125212144069,0.0
7615,29139,Montgomery,Missouri,2004,2147,3563,50,5760,0.37274305555555554,0.6185763888888889,0.008680555555555556,55,-55,457,457,-0.021750627265489153,-0.011119557587948123,0.03287018485343729,-1416,-402,-0.24583333333333335,-0.05462081211892644
7616,29139,Montgomery,Missouri,2008,2347,3428,81,5856,0.40078551912568305,0.5853825136612022,0.013831967213114754,200,31,-135,96,0.028042463570127518,0.005151411657559198,-0.03319387522768669,-1081,335,-0.18459699453551914,0.061236338797814205
7617,29139,Montgomery,Missouri,2012,1740,3490,114,5344,0.3255988023952096,0.6530688622754491,0.02133233532934132,-607,33,62,-512,-0.07518671673047345,0.007500368116226565,0.06768634861424694,-1750,-669,-0.32747005988023953,-0.14287306534472038
7618,29139,Montgomery,Missouri,2016,1119,4127,183,5429,0.20611530668631423,0.7601768281451464,0.033707865168539325,-621,69,637,85,-0.11948349570889538,0.012375529839198006,0.10710796586969729,-3008,-1258,-0.5540615214588323,-0.22659146157859272
7619,29141,Morgan,Missouri,2000,3235,4460,186,7881,0.4104809034386499,0.565918030706763,0.023601065854586982,0,0,0,0,0.0,0.0,0.0,-1225,0,-0.15543712726811315,0.0
7620,29141,Morgan,Missouri,2004,3053,5657,61,8771,0.3480788963630145,0.6449663664348421,0.006954737202143427,-182,-125,1197,890,-0.062402007075635424,-0.016646328652443556,0.07904833572807901,-2604,-1379,-0.2968874700718276,-0.14145034280371444
7621,29141,Morgan,Missouri,2008,3565,5451,133,9149,0.3896600721390316,0.5958028199803257,0.014537107880642693,512,72,-206,378,0.04158117577601711,0.007582370678499266,-0.04916354645451637,-1886,718,-0.2061427478412941,0.09074472223053348
7622,29141,Morgan,Missouri,2012,2773,5733,182,8688,0.3191758747697974,0.6598756906077348,0.02094843462246777,-792,49,282,-461,-0.07048419736923417,0.006411326741825077,0.06407287062740907,-2960,-1074,-0.34069981583793735,-0.13455706799664324
7623,29141,Morgan,Missouri,2016,1768,6760,293,8821,0.20043079015984583,0.7663530211994105,0.03321618864074368,-1005,111,1027,133,-0.11874508460995159,0.01226775401827591,0.10647733059167575,-4992,-2032,-0.5659222310395646,-0.22522241520162728
7624,29143,New Madrid,Missouri,2000,3738,3416,112,7266,0.5144508670520231,0.4701348747591522,0.015414258188824663,0,0,0,0,0.0,0.0,0.0,322,0,0.04431599229287092,0.0
7625,29143,New Madrid,Missouri,2004,3716,4154,37,7907,0.46996332363728344,0.525357278360946,0.004679398001770583,-22,-75,738,641,-0.044487543414739705,-0.01073486018705408,0.05522240360179381,-438,-760,-0.0553939547236626,-0.09970994701653352
7626,29143,New Madrid,Missouri,2008,3370,4593,129,8092,0.41646070192782997,0.5675976272862086,0.015941670785961443,-346,92,439,185,-0.05350262170945347,0.01126227278419086,0.042240348925262516,-1223,-785,-0.15113692535837858,-0.09574297063471598
7627,29143,New Madrid,Missouri,2012,2814,4284,152,7250,0.38813793103448274,0.5908965517241379,0.020965517241379312,-556,23,-309,-842,-0.028322770893347227,0.0050238464554178686,0.023298924437929358,-1470,-247,-0.20275862068965517,-0.051621695331276585
7628,29143,New Madrid,Missouri,2016,1933,5270,154,7357,0.2627429658828327,0.7163245888269675,0.02093244529019981,-881,2,986,107,-0.12539496515165005,-3.307195117950232e-05,0.12542803710282957,-3337,-1867,-0.4535816229441348,-0.2508230022544796
7629,29145,Newton,Missouri,2000,6447,14232,483,21162,0.30464984406010776,0.6725262262546073,0.022823929685284943,0,0,0,0,0.0,0.0,0.0,-7785,0,-0.3678763821944996,0.0
7630,29145,Newton,Missouri,2004,6564,17187,138,23889,0.27477081501946504,0.7194524676629411,0.005776717317593872,117,-345,2955,2727,-0.029879029040642713,-0.01704721236769107,0.04692624140833379,-10623,-2838,-0.4446816526434761,-0.0768052704489765
7631,29145,Newton,Missouri,2008,7450,17637,319,25406,0.29323781783830594,0.6942060930488861,0.012556089112807998,886,181,450,1517,0.018467002818840894,0.0067793717952141265,-0.02524637461405499,-10187,436,-0.4009682752105802,0.043713377432895884
7632,29145,Newton,Missouri,2012,6425,18181,587,25193,0.2550311594490533,0.7216687175008931,0.023300123050053585,-1025,268,544,-213,-0.038206658389252635,0.010744033937245587,0.02746262445200698,-11756,-1569,-0.4666375580518398,-0.06566928284125961
7633,29145,Newton,Missouri,2016,4990,20553,1264,26807,0.18614540978102734,0.7667027268996904,0.047151863319282276,-1435,677,2372,1614,-0.06888574966802596,0.02385174026922869,0.045034009398797314,-15563,-3807,-0.5805573171186631,-0.11391975906682328
7634,29147,Nodaway,Missouri,2000,3553,5161,335,9049,0.39264007072604706,0.5703392640070726,0.03702066526688032,0,0,0,0,0.0,0.0,0.0,-1608,0,-0.1776991932810255,0.0
7635,29147,Nodaway,Missouri,2004,3830,6226,63,10119,0.3784958988042297,0.6152781895444214,0.006225911651348948,277,-272,1065,1070,-0.014144171921817383,-0.03079475361553137,0.044938925537348795,-2396,-788,-0.2367822907401917,-0.05908309745916618
7636,29147,Nodaway,Missouri,2008,4493,5568,158,10219,0.43967120070456994,0.5448674038555632,0.015461395439866915,663,95,-658,100,0.06117530190034026,0.009235483788517967,-0.07041078568885817,-1075,1321,-0.10519620315099326,0.13158608758919843
7637,29147,Nodaway,Missouri,2012,3172,5593,211,8976,0.3533868092691622,0.6231060606060606,0.023507130124777183,-1321,53,25,-1243,-0.08628439143540773,0.008045734684910268,0.07823865675049735,-2421,-1346,-0.26971925133689834,-0.16452304818590507
7638,29147,Nodaway,Missouri,2016,2529,6380,549,9458,0.26739268344258826,0.6745612180164939,0.05804609854091774,-643,338,787,482,-0.08599412582657395,0.034538968416140556,0.05145515741043338,-3851,-1430,-0.40716853457390567,-0.13744928323700734
7639,29149,Oregon,Missouri,2000,1568,2521,144,4233,0.3704228679423577,0.5955587054098748,0.03401842664776754,0,0,0,0,0.0,0.0,0.0,-953,0,-0.22513583746751709,0.0
7640,29149,Oregon,Missouri,2004,1823,2769,81,4673,0.3901134175048149,0.5925529638347956,0.01733361866038947,255,-63,248,440,0.019690549562457194,-0.016684807987378068,-0.003005741575079157,-946,7,-0.20243954632998074,0.02269629113753635
7641,29149,Oregon,Missouri,2008,1811,2652,128,4591,0.3944674362883903,0.5776519276846003,0.027880636027009367,-12,47,-117,-82,0.004354018783575442,0.010547017366619896,-0.014901036150195335,-841,105,-0.18318449139620996,0.019255054933770777
7642,29149,Oregon,Missouri,2012,1419,2886,116,4421,0.3209681067631758,0.6527934856367338,0.026238407600090476,-392,-12,234,-170,-0.07349932952521454,-0.0016422284269188916,0.07514155795213351,-1467,-626,-0.331825378873558,-0.14864088747734805
7643,29149,Oregon,Missouri,2016,865,3671,132,4668,0.18530419880034277,0.7864181662382177,0.028277634961439587,-554,16,785,247,-0.135663907962833,0.0020392273613491115,0.13362468060148391,-2806,-1339,-0.6011139674378749,-0.2692885885643169
7644,29151,Osage,Missouri,2000,1938,4154,86,6178,0.3136937520233085,0.6723858853998058,0.013920362576885724,0,0,0,0,0.0,0.0,0.0,-2216,0,-0.3586921333764973,0.0
7645,29151,Osage,Missouri,2004,1673,4975,23,6671,0.25078698845750264,0.7457652525858193,0.003447758956678159,-265,-63,821,493,-0.06290676356580588,-0.010472603620207565,0.07337936718601346,-3302,-1086,-0.49497826412831664,-0.13628613075181933
7646,29151,Osage,Missouri,2008,1907,5062,110,7079,0.26938833168526627,0.715072750388473,0.01553891792626077,234,87,87,408,0.018601343227763634,0.012091158969582612,-0.030692502197346316,-3155,147,-0.4456844187032067,0.04929384542510995
7647,29151,Osage,Missouri,2012,1473,5329,117,6919,0.2128920364214482,0.7701980054921231,0.016909958086428676,-434,7,267,-160,-0.05649629526381808,0.0013710401601679054,0.055125255103650184,-3856,-701,-0.557305969070675,-0.11162155036746829
7648,29151,Osage,Missouri,2016,998,5856,236,7090,0.14076163610719322,0.8259520451339916,0.033286318758815235,-475,119,527,171,-0.07213040031425497,0.01637636067238656,0.055754039641868425,-4858,-1002,-0.6851904090267984,-0.12788443995612342
7649,29153,Ozark,Missouri,2000,1432,2663,197,4292,0.3336439888164026,0.6204566635601119,0.045899347623485555,0,0,0,0,0.0,0.0,0.0,-1231,0,-0.28681267474370925,0.0
7650,29153,Ozark,Missouri,2004,1561,3083,63,4707,0.33163373698746546,0.6549819417888252,0.01338432122370937,129,-134,420,415,-0.0020102518289371596,-0.03251502639977619,0.03452527822871332,-1522,-291,-0.32334820480135973,-0.03653553005765048
7651,29153,Ozark,Missouri,2008,1661,2918,107,4686,0.3544600938967136,0.6227059325650875,0.02283397353819889,100,44,-165,-21,0.02282635690924817,0.009449652314489519,-0.032276009223737634,-1257,265,-0.2682458386683739,0.0551023661329858
7652,29153,Ozark,Missouri,2012,1261,3080,112,4453,0.28317987873343814,0.6916685380642263,0.025151583202335504,-400,5,162,-233,-0.07128021516327548,0.0023176096641366155,0.0689626054991388,-1819,-562,-0.4084886593307882,-0.14024282066241428
7653,29153,Ozark,Missouri,2016,724,3639,142,4505,0.16071032186459488,0.8077691453940067,0.031520532741398447,-537,30,559,52,-0.12246955686884325,0.006368949539062942,0.11610060732978034,-2915,-1096,-0.6470588235294118,-0.2385701641986236
7654,29155,Pemiscot,Missouri,2000,3245,2750,65,6060,0.5354785478547854,0.4537953795379538,0.010726072607260726,0,0,0,0,0.0,0.0,0.0,495,0,0.08168316831683164,0.0
7655,29155,Pemiscot,Missouri,2004,3381,3398,27,6806,0.49676755803702616,0.4992653540993241,0.0039670878636497205,136,-38,648,746,-0.03871098981775928,-0.006758984743611005,0.04546997456137031,-17,-512,-0.002497796062297941,-0.08418096437912959
7656,29155,Pemiscot,Missouri,2008,3029,3954,64,7047,0.42982829572867887,0.5610898254576415,0.00908187881367958,-352,37,556,241,-0.06693926230834729,0.00511479095002986,0.06182447135831742,-925,-908,-0.13126152972896266,-0.12876373366666471
7657,29155,Pemiscot,Missouri,2012,2671,3598,66,6335,0.42162588792423045,0.5679558011049723,0.010418310970797158,-358,2,-356,-712,-0.00820240780444842,0.0013364321571175779,0.006865975647330824,-927,-2,-0.1463299131807419,-0.015068383451779244
7658,29155,Pemiscot,Missouri,2016,1947,3964,116,6027,0.3230462916874067,0.6577069852331177,0.019246723079475694,-724,50,366,-308,-0.09857959623682377,0.008828412108678536,0.08975118412814531,-2017,-1090,-0.334660693545711,-0.18833078036496909
7659,29157,Perry,Missouri,2000,2085,4667,151,6903,0.3020425901781834,0.6760828625235404,0.021874547298276113,0,0,0,0,0.0,0.0,0.0,-2582,0,-0.374040272345357,0.0
7660,29157,Perry,Missouri,2004,2621,5583,43,8247,0.31781253789256697,0.6769734448890505,0.005214017218382442,536,-108,916,1344,0.01576994771438356,-0.01666053007989367,0.0008905823655100953,-2962,-380,-0.35916090699648356,0.014879365348873463
7661,29157,Perry,Missouri,2008,3005,5527,115,8647,0.347519370880074,0.6391812189198566,0.013299410200069387,384,72,-56,400,0.029706832987507037,0.008085392981686946,-0.03779222596919396,-2522,440,-0.29166184803978257,0.067499058956701
7662,29157,Perry,Missouri,2012,2184,5669,134,7987,0.27344434706397897,0.7097783898835608,0.01677726305246025,-821,19,142,-660,-0.07407502381609504,0.003477852852390861,0.07059717096370421,-3485,-963,-0.4363340428195818,-0.14467219477979926
7663,29157,Perry,Missouri,2016,1520,6908,312,8740,0.17391304347826086,0.7903890160183067,0.035697940503432495,-664,178,1239,753,-0.0995313035857181,0.018920677450972246,0.0806106261347459,-5388,-1903,-0.6164759725400458,-0.180141929720464
7664,29159,Pettis,Missouri,2000,5855,9533,367,15755,0.37162805458584575,0.6050777530942558,0.023294192319898446,0,0,0,0,0.0,0.0,0.0,-3678,0,-0.23344969850841008,0.0
7665,29159,Pettis,Missouri,2004,5801,11603,92,17496,0.33156149977137633,0.6631801554641061,0.005258344764517604,-54,-275,2070,1741,-0.04006655481446941,-0.018035847555380843,0.058102402369850314,-5802,-2124,-0.3316186556927298,-0.09816895718431973
7666,29159,Pettis,Missouri,2008,6932,11018,315,18265,0.37952367916780727,0.6032302217355598,0.017246099096632904,1131,223,-585,769,0.04796217939643094,0.0119877543321153,-0.05994993372854629,-4086,1716,-0.22370654256775258,0.10791211312497723
7667,29159,Pettis,Missouri,2012,5904,10842,429,17175,0.34375545851528383,0.6312663755458515,0.02497816593886463,-1028,114,-176,-1090,-0.03576822065252344,0.007732066842231725,0.028036153810291675,-4938,-852,-0.2875109170305677,-0.06380437446281512
7668,29159,Pettis,Missouri,2016,4324,12810,1070,18204,0.23753021313996925,0.7036914963744232,0.05877829048560756,-1580,641,1968,1029,-0.10622524537531458,0.03380012454674293,0.07242512082857167,-8486,-3548,-0.46616128323445394,-0.17865036620388625
7669,29161,Phelps,Missouri,2000,6262,9444,440,16146,0.3878359965316487,0.5849126718691936,0.027251331599157685,0,0,0,0,0.0,0.0,0.0,-3182,0,-0.19707667533754492,0.0
7670,29161,Phelps,Missouri,2004,6666,11874,160,18700,0.3564705882352941,0.6349732620320856,0.008556149732620321,404,-280,2430,2554,-0.03136540829635459,-0.018695181866537364,0.050060590162891994,-5208,-2026,-0.2785026737967915,-0.08142599845924658
7671,29161,Phelps,Missouri,2008,7394,11706,424,19524,0.37871337840606434,0.5995697602950215,0.021716861298914158,728,264,-168,824,0.022242790170770244,0.013160711566293837,-0.03540350173706408,-4312,896,-0.22085638188895718,0.057646291907834324
7672,29161,Phelps,Missouri,2012,5798,11895,593,18286,0.3170731707317073,0.6504976484742426,0.03242918079405009,-1596,169,189,-1238,-0.06164020767435702,0.010712319495135934,0.050927888179221115,-6097,-1785,-0.3334244777425353,-0.11256809585357813
7673,29161,Phelps,Missouri,2016,4766,12709,1238,18713,0.25468925346016136,0.6791535296318068,0.06615721690803185,-1032,645,814,427,-0.06238391727154596,0.03372803611398176,0.028655881157564123,-7943,-1846,-0.4244642761716454,-0.09103979842911009
7674,29163,Pike,Missouri,2000,3557,3648,146,7351,0.48387974425248265,0.4962590123792681,0.019861243368249216,0,0,0,0,0.0,0.0,0.0,-91,0,-0.01237926812678547,0.0
7675,29163,Pike,Missouri,2004,3670,4314,56,8040,0.4564676616915423,0.5365671641791044,0.006965174129353234,113,-90,666,689,-0.027412082560940354,-0.012896069238895982,0.04030815179983632,-644,-553,-0.08009950248756215,-0.06772023436077668
7676,29163,Pike,Missouri,2008,3487,4268,153,7908,0.4409458775923116,0.5397066262013152,0.019347496206373292,-183,97,-46,-132,-0.015521784099230718,0.012382322077020058,0.003139462022210715,-781,-137,-0.09876074860900358,-0.018661246121441433
7677,29163,Pike,Missouri,2012,2582,4577,162,7321,0.35268405955470566,0.6251878158721487,0.022128124573145745,-905,9,309,-587,-0.08826181803760591,0.002780628366772453,0.08548118967083351,-1995,-1214,-0.272503756317443,-0.17374300770843942
7678,29163,Pike,Missouri,2016,1806,5274,302,7382,0.2446491465727445,0.7144405310214034,0.04091032240585207,-776,140,697,61,-0.10803491298196116,0.018782197832706328,0.0892527151492547,-3468,-1473,-0.46979138444865887,-0.19728762813121586
7679,29165,Platte,Missouri,2000,15325,17785,944,34054,0.4500205555881835,0.522258765490104,0.027720678921712573,0,0,0,0,0.0,0.0,0.0,-2460,0,-0.07223820990192048,0.0
7680,29165,Platte,Missouri,2004,18412,23302,256,41970,0.4386943054562783,0.5552060995949488,0.006099594948772933,3087,-688,5517,7916,-0.011326250131905191,-0.021621083972939638,0.03294733410484485,-4890,-2430,-0.11651179413867052,-0.04427358423675004
7681,29165,Platte,Missouri,2008,21459,24460,721,46640,0.46009862778730704,0.524442538593482,0.015458833619210978,3047,465,1158,4670,0.021404322331028736,0.009359238670438044,-0.03076356100146682,-3001,1889,-0.06434391080617496,0.05216788333249556
7682,29165,Platte,Missouri,2012,19175,25618,917,45710,0.4194924524174141,0.56044629183986,0.02006125574272588,-2284,196,1158,-930,-0.040606175369892916,0.004602422123514903,0.036003753246377945,-6443,-3442,-0.14095383942244583,-0.07660992861627086
7683,29165,Platte,Missouri,2016,20057,25933,3618,49608,0.404309788743751,0.5227584260603129,0.07293178519593614,882,2701,315,3898,-0.01518266367366311,0.05287052945321026,-0.03768786577954708,-5876,567,-0.11844863731656186,0.02250520210588397
7684,29167,Polk,Missouri,2000,3606,6430,258,10294,0.35030114629881487,0.6246357101224014,0.025063143578783757,0,0,0,0,0.0,0.0,0.0,-2824,0,-0.2743345638235865,0.0
7685,29167,Polk,Missouri,2004,3775,8586,92,12453,0.30313980566931664,0.6894724162852325,0.007387778045450895,169,-166,2156,2159,-0.04716134062949823,-0.017675365533332862,0.0648367061628311,-4811,-1987,-0.38633261061591584,-0.11199804679232933
7686,29167,Polk,Missouri,2008,4553,8956,188,13697,0.3324085566182376,0.6538658100313938,0.013725633350368693,778,96,370,1244,0.029268750948920952,0.006337855304917798,-0.03560660625383871,-4403,408,-0.3214572534131562,0.06487535720275966
7687,29167,Polk,Missouri,2012,3580,9252,287,13119,0.2728866529461087,0.7052366796249714,0.021876667428919888,-973,99,296,-578,-0.059521903672128895,0.008151034078551195,0.05137086959357762,-5672,-1269,-0.4323500266788627,-0.11089277326570651
7688,29167,Polk,Missouri,2016,2631,10438,694,13763,0.19116471699484125,0.7584102303276902,0.05042505267746857,-949,407,1186,644,-0.08172193595126745,0.028548385248548684,0.053173550702718786,-7807,-2135,-0.5672455133328489,-0.1348954866539862
7689,29169,Pulaski,Missouri,2000,3800,6531,200,10531,0.36083942645522743,0.6201690247839712,0.018991548760801443,0,0,0,0,0.0,0.0,0.0,-2731,0,-0.25932959832874375,0.0
7690,29169,Pulaski,Missouri,2004,3551,8618,52,12221,0.2905654201783815,0.7051796088699779,0.004254970951640619,-249,-148,2087,1690,-0.07027400627684594,-0.014736577809160824,0.0850105840860067,-5067,-2336,-0.4146141886915964,-0.15528459036285264
7691,29169,Pulaski,Missouri,2008,5249,9552,199,15000,0.3499333333333333,0.6368,0.013266666666666666,1698,147,934,2779,0.059367913154951824,0.009011695715026047,-0.06837960886997785,-4303,764,-0.2868666666666667,0.12774752202492967
7692,29169,Pulaski,Missouri,2012,4199,9092,280,13571,0.3094097708348685,0.6699579986736424,0.020632230491489205,-1050,81,-460,-1429,-0.04052356249846484,0.007365563824822539,0.03315799867364233,-4893,-590,-0.3605482278387739,-0.07368156117210717
7693,29169,Pulaski,Missouri,2016,2922,9876,690,13488,0.2166370106761566,0.7322064056939501,0.05115658362989324,-1277,410,784,-83,-0.09277276015871189,0.030524353138404035,0.06224840702030776,-6954,-2061,-0.5155693950177935,-0.15502116717901965
7694,29171,Putnam,Missouri,2000,708,1593,33,2334,0.3033419023136247,0.6825192802056556,0.014138817480719794,0,0,0,0,0.0,0.0,0.0,-885,0,-0.3791773778920309,0.0
7695,29171,Putnam,Missouri,2004,772,1660,13,2445,0.31574642126789365,0.6789366053169734,0.005316973415132925,64,-20,67,111,0.012404518954268973,-0.008821844065586868,-0.003582674888682136,-888,-3,-0.36319018404907977,0.01598719384295111
7696,29171,Putnam,Missouri,2008,695,1591,53,2339,0.29713552800342025,0.6802052159042326,0.022659256092347157,-77,40,-69,-106,-0.018610893264473405,0.017342282677214233,0.0012686105872591336,-896,-8,-0.3830696879008123,-0.01987950385173254
7697,29171,Putnam,Missouri,2012,587,1673,49,2309,0.25422260718925943,0.7245560848852317,0.02122130792550888,-108,-4,82,-30,-0.042912920814160815,-0.0014379481668382772,0.04435086898099916,-1086,-190,-0.4703334776959723,-0.08726378979515997
7698,29171,Putnam,Missouri,2016,353,1936,57,2346,0.1504688832054561,0.8252344416027281,0.024296675191815855,-234,8,263,37,-0.10375372398380334,0.0030753672663069755,0.10067835671749636,-1583,-497,-0.674765558397272,-0.20443208070129976
7699,29173,Ralls,Missouri,2000,2033,2446,63,4542,0.4476001761338617,0.5385292822545135,0.013870541611624834,0,0,0,0,0.0,0.0,0.0,-413,0,-0.09092910612065175,0.0
7700,29173,Ralls,Missouri,2004,2031,2986,17,5034,0.4034564958283671,0.5931664680174811,0.003377036154151768,-2,-46,540,492,-0.04414368030549459,-0.010493505457473067,0.05463718576296761,-955,-542,-0.18970997218911395,-0.0987808660684622
7701,29173,Ralls,Missouri,2008,2041,2987,56,5084,0.4014555468135326,0.5875295043273013,0.011014948859166011,10,39,1,50,-0.0020009490148344966,0.007637912705014243,-0.0056369636901797415,-946,9,-0.1860739575137687,0.003636014675345245
7702,29173,Ralls,Missouri,2012,1736,3231,69,5036,0.34471803018268465,0.6415806195393169,0.013701350277998412,-305,13,244,-48,-0.05673751663084797,0.0026864014188324008,0.054051115212015555,-1495,-549,-0.29686258935663223,-0.11078863184286353
7703,29173,Ralls,Missouri,2016,1138,3969,187,5294,0.21496033245183227,0.7497166603702304,0.035323007177937286,-598,118,738,258,-0.12975769773085238,0.021621656899938876,0.10813604083091355,-2831,-1336,-0.5347563279183982,-0.237893738561766
7704,29175,Randolph,Missouri,2000,4116,4844,226,9186,0.4480731548007838,0.5273241889832354,0.02460265621598084,0,0,0,0,0.0,0.0,0.0,-728,0,-0.07925103418245161,0.0
7705,29175,Randolph,Missouri,2004,3586,6551,61,10198,0.3516375759952932,0.6423808589919592,0.005981565012747598,-530,-165,1707,1012,-0.09643557880549058,-0.018621091203233242,0.11505667000872377,-2965,-2237,-0.29074328299666596,-0.21149224881421436
7706,29175,Randolph,Missouri,2008,3984,6457,215,10656,0.3738738738738739,0.6059496996996997,0.020176426426426426,398,154,-94,458,0.02223629787858067,0.014194861413678829,-0.036431159292259485,-2473,492,-0.2320758258258258,0.058667457170840154
7707,29175,Randolph,Missouri,2012,3031,6667,277,9975,0.303859649122807,0.6683709273182957,0.027769423558897242,-953,62,210,-681,-0.07001422475106689,0.007592997132470816,0.06242122761859603,-3636,-1163,-0.36451127819548873,-0.13243545236966292
7708,29175,Randolph,Missouri,2016,2283,7529,497,10309,0.22145697933844213,0.7303327189834126,0.04821030167814531,-748,220,862,334,-0.08240266978436486,0.020440878119248065,0.06196179166511684,-5246,-1610,-0.5088757396449705,-0.14436446144948173
7709,29177,Ray,Missouri,2000,4970,4517,260,9747,0.5099004821996512,0.46342464348004514,0.026674874320303684,0,0,0,0,0.0,0.0,0.0,453,0,0.04647583871960609,0.0
7710,29177,Ray,Missouri,2004,5034,5673,81,10788,0.46662958843159064,0.5258620689655172,0.007508342602892102,64,-179,1156,1041,-0.04327089376806059,-0.019166531717411582,0.0624374254854721,-639,-1092,-0.0592324805339266,-0.10570831925353269
7711,29177,Ray,Missouri,2008,5241,5593,219,11053,0.47416990862209357,0.506016466117796,0.019813625260110376,207,138,-80,265,0.007540320190502936,0.012305282657218274,-0.01984560284772119,-352,287,-0.03184655749570248,0.027385923038224125
7712,29177,Ray,Missouri,2012,4275,5815,277,10367,0.4123661618597473,0.5609144400501591,0.026719398090093566,-966,58,222,-686,-0.06180374676234629,0.006905772829983191,0.054897973932363064,-1540,-1188,-0.14854827819041183,-0.11670172069470935
7713,29177,Ray,Missouri,2016,3090,7104,675,10869,0.2842947833287331,0.6536019873033397,0.06210322936792713,-1185,398,1289,502,-0.1280713785310142,0.035383831277833566,0.09268754725318062,-4014,-2474,-0.36930720397460665,-0.22075892578419481
7714,29179,Reynolds,Missouri,2000,1298,1762,71,3131,0.4145640370488662,0.5627595017566273,0.022676461194506548,0,0,0,0,0.0,0.0,0.0,-464,0,-0.14819546470776107,0.0
7715,29179,Reynolds,Missouri,2004,1449,1896,19,3364,0.4307372175980975,0.5636147443519619,0.005648038049940547,151,-52,134,233,0.016173180549231336,-0.017028423144566002,0.0008552425953346487,-447,17,-0.13287752675386438,0.015317937953896688
7716,29179,Reynolds,Missouri,2008,1418,1782,87,3287,0.4313964101003955,0.542135686035899,0.026467903863705507,-31,68,-114,-77,0.0006591925022979561,0.02081986581376496,-0.021479058316062893,-364,83,-0.11073927593550353,0.02213825081836085
7717,29179,Reynolds,Missouri,2012,1157,1931,114,3202,0.3613366645846346,0.6030605871330419,0.03560274828232355,-261,27,149,-85,-0.07005974551576089,0.009134844418618043,0.06092490109714288,-774,-410,-0.2417239225484073,-0.13098464661290377
7718,29179,Reynolds,Missouri,2016,540,2406,92,3038,0.17774851876234365,0.7919684002633312,0.030283080974325215,-617,-22,475,-164,-0.18358814582229094,-0.005319667307998335,0.18890781313028926,-1866,-1092,-0.6142198815009875,-0.3724959589525802
7719,29181,Ripley,Missouri,2000,1820,3121,124,5065,0.35932872655478776,0.6161895360315893,0.024481737413622903,0,0,0,0,0.0,0.0,0.0,-1301,0,-0.25686080947680157,0.0
7720,29181,Ripley,Missouri,2004,1907,3693,53,5653,0.33734300371484166,0.6532814434813373,0.00937555280382098,87,-71,572,588,-0.021985722839946098,-0.015106184609801922,0.037091907449747996,-1786,-485,-0.31593843976649566,-0.059077630289694094
7721,29181,Ripley,Missouri,2008,1795,3407,161,5363,0.3347007272049226,0.6352787618870035,0.03002051090807384,-112,108,-286,-290,-0.0026422765099190504,0.020644958104252858,-0.018002681594333825,-1612,174,-0.3005780346820809,0.015360405084414774
7722,29181,Ripley,Missouri,2012,1396,3743,124,5263,0.26524795743872315,0.7111913357400722,0.023560706821204636,-399,-37,336,-100,-0.06945276976619946,-0.006459804086869202,0.07591257385306871,-2347,-735,-0.44594337830134906,-0.14536534361926817
7723,29181,Ripley,Missouri,2016,830,4522,172,5524,0.1502534395365677,0.8186097031136857,0.031136857349746562,-566,48,779,261,-0.11499451790215545,0.007576150528541926,0.10741836737361354,-3692,-1345,-0.6683562635771181,-0.22241288527576902
7724,29183,St. Charles,Missouri,2000,53806,72114,2766,128686,0.41811852105124103,0.5603872993177191,0.021494179631039896,0,0,0,0,0.0,0.0,0.0,-18308,0,-0.1422687782664781,0.0
7725,29183,St. Charles,Missouri,2004,66855,95826,807,163488,0.4089290957134469,0.5861347621843805,0.004936142102172637,13049,-1959,23712,34802,-0.009189425337794155,-0.01655803752886726,0.025747462866661408,-28971,-10663,-0.17720566647093366,-0.03493688820445556
7726,29183,St. Charles,Missouri,2008,84183,102550,2224,188957,0.4455140587541081,0.542716067676773,0.0117698735691189,17328,1417,6724,25469,0.03658496304066122,0.006833731466946263,-0.04341869450760749,-18367,10604,-0.09720200892266495,0.08000365754826871
7727,29183,St. Charles,Missouri,2012,71838,110784,3744,186366,0.3854673062683107,0.5944431924278033,0.020089501303885902,-12345,1520,8234,-2591,-0.06004675248579738,0.008319627734767002,0.05172712475103025,-38946,-20579,-0.20897588615949259,-0.11177387723682763
7728,29183,St. Charles,Missouri,2016,68626,121650,12892,203168,0.3377795715860765,0.598765553630493,0.06345487478343047,-3212,9148,10866,16802,-0.047687734682234195,0.04336537347954457,0.004322361202689695,-53024,-14078,-0.2609859820444165,-0.05201009588492389
7729,29185,St. Clair,Missouri,2000,1866,2731,142,4739,0.3937539565309137,0.5762819160160372,0.029964127453049168,0,0,0,0,0.0,0.0,0.0,-865,0,-0.18252795948512346,0.0
7730,29185,St. Clair,Missouri,2004,1841,3098,26,4965,0.3707955689828802,0.6239677744209466,0.0052366565961732125,-25,-116,367,226,-0.022958387548033532,-0.024727470856875954,0.047685858404909465,-1257,-392,-0.25317220543806646,-0.070644245952943
7731,29185,St. Clair,Missouri,2008,1886,2981,121,4988,0.3781074578989575,0.5976343223736968,0.02425821972734563,45,95,-117,23,0.007311888916077314,0.01902156313117242,-0.026333452047249795,-1095,162,-0.21952686447473935,0.03364534096332711
7732,29185,St. Clair,Missouri,2012,1460,3019,147,4626,0.3156074362300043,0.6526156506701254,0.031776913099870296,-426,26,38,-362,-0.06250002166895319,0.007518693372524667,0.054981328296428544,-1559,-464,-0.3370082144401211,-0.11748134996538173
7733,29185,St. Clair,Missouri,2016,936,3501,193,4630,0.2021598272138229,0.7561555075593952,0.04168466522678186,-524,46,482,4,-0.11344760901618142,0.009907752126911563,0.10353985688926981,-2565,-1006,-0.5539956803455723,-0.21698746590545126
7734,29186,Ste. Genevieve,Missouri,2000,3600,3505,206,7311,0.4924086992203529,0.4794145807687047,0.028176720010942416,0,0,0,0,0.0,0.0,0.0,95,0,0.012994118451648218,0.0
7735,29186,Ste. Genevieve,Missouri,2004,4281,3791,74,8146,0.525534004419347,0.4653817824699239,0.009084213110729192,681,-132,286,835,0.03312530519899404,-0.019092506900213226,-0.014032798298780791,490,395,0.060152221949423046,0.04715810349777483
7736,29186,Ste. Genevieve,Missouri,2008,4979,3732,114,8825,0.5641926345609065,0.42288951841359773,0.012917847025495751,698,40,-59,679,0.03865863014155957,0.003833633914766559,-0.04249226405632617,1247,757,0.14130311614730878,0.08115089419788574
7737,29186,Ste. Genevieve,Missouri,2012,3813,4055,202,8070,0.4724907063197026,0.5024783147459727,0.025030978934324658,-1166,88,323,-755,-0.09170192824120393,0.012113131908828907,0.07958879633237498,-242,-1489,-0.02998760842627013,-0.1712907245735789
7738,29186,Ste. Genevieve,Missouri,2016,2542,5496,431,8469,0.3001535010036604,0.648955012398158,0.0508914865981816,-1271,229,1441,399,-0.17233720531604219,0.025860507663856943,0.1464766976521853,-2954,-2712,-0.3488015113944976,-0.3188139029682275
7739,29187,St. Francois,Missouri,2000,9075,9327,439,18841,0.48166233214797516,0.49503741839605114,0.023300249455973674,0,0,0,0,0.0,0.0,0.0,-252,0,-0.013375086248075985,0.0
7740,29187,St. Francois,Missouri,2004,10748,12087,98,22933,0.468669602755854,0.5270570793180134,0.004273317926132648,1673,-341,2760,4092,-0.01299272939212115,-0.019026931529841026,0.032019660921962234,-1339,-1087,-0.05838747656215937,-0.045012390314083384
7741,29187,St. Francois,Missouri,2008,11540,12660,350,24550,0.47006109979633404,0.5156822810590631,0.014256619144602852,792,252,573,1617,0.0013914970404800275,0.009983301218470204,-0.01137479825895027,-1120,219,-0.04562118126272907,0.012766295299430297
7742,29187,St. Francois,Missouri,2012,8829,13248,628,22705,0.38885707993833957,0.5834838141378551,0.02765910592380533,-2711,278,588,-1845,-0.08120401985799447,0.013402486779202478,0.067801533078792,-4419,-3299,-0.19462673419951554,-0.14900555293678647
7743,29187,St. Francois,Missouri,2016,6250,17468,1202,24920,0.25080256821829855,0.7009630818619582,0.04823434991974318,-2579,574,4220,2215,-0.13805451172004102,0.02057524399593785,0.11747926772410311,-11218,-6799,-0.45016051364365967,-0.2555337794441441
7744,29189,St. Louis County,Missouri,2000,250631,224689,11564,486884,0.5147653239786069,0.46148363881335186,0.02375103720804134,0,0,0,0,0.0,0.0,0.0,25942,0,0.053281685165255,0.0
7745,29189,St. Louis County,Missouri,2004,295284,244969,2730,542983,0.5438181305860404,0.4511540876970366,0.005027781716922998,44653,-8834,20280,56099,0.02905280660743359,-0.01872325549111834,-0.010329551116315283,50315,24373,0.09266404288900387,0.03938235772374887
7746,29189,St. Louis County,Missouri,2008,333123,221705,5026,559854,0.5950176295962876,0.39600502988279085,0.008977340520921527,37839,2296,-23264,16871,0.05119949901024712,0.003949558803998529,-0.05514905781424573,111418,61103,0.19901259971349672,0.10634855682449285
7747,29189,St. Louis County,Missouri,2012,297097,224742,8277,530116,0.5604377155188676,0.42394872065736555,0.015613563823766873,-36026,3251,3037,-29738,-0.034579914077420004,0.006636223302845346,0.027943690774574703,72355,-39063,0.136488994861502,-0.06252360485199471
7748,29189,St. Louis County,Missouri,2016,286704,202434,30548,519686,0.551686980214976,0.38953137086625383,0.058781648918770184,-10393,22271,-22308,-10430,-0.008750735303891588,0.04316808509500331,-0.03441734979111172,84270,11915,0.16215560934872214,0.02566661448722013
7749,29195,Saline,Missouri,2000,4585,4572,198,9355,0.4901122394441475,0.4887226082308926,0.021165152324959916,0,0,0,0,0.0,0.0,0.0,13,0,0.001389631213254916,0.0
7750,29195,Saline,Missouri,2004,4479,5389,71,9939,0.4506489586477513,0.5422074655397927,0.007143575812455981,-106,-127,817,584,-0.039463280796396216,-0.014021576512503936,0.053484857308900124,-910,-923,-0.09155850689204142,-0.09294813810529634
7751,29195,Saline,Missouri,2008,4712,4962,174,9848,0.4784727863525589,0.5038586515028433,0.017668562144597888,233,103,-427,-91,0.027823827704807624,0.010524986332141908,-0.03834881403694945,-250,660,-0.025385865150284348,0.06617264174175708
7752,29195,Saline,Missouri,2012,3790,5104,214,9108,0.41611769872639437,0.5603864734299517,0.023495827843653932,-922,40,142,-740,-0.06235508762616454,0.005827265699056044,0.05652782192710848,-1314,-1064,-0.14426877470355737,-0.11888290955327302
7753,29195,Saline,Missouri,2016,2789,5977,508,9274,0.30073323269355184,0.6444899719646323,0.05477679534181583,-1001,294,873,166,-0.11538446603284253,0.031280967498161893,0.08410349853468058,-3188,-1874,-0.34375673927108047,-0.1994879645675231
7754,29197,Schuyler,Missouri,2000,808,1159,39,2006,0.40279162512462613,0.577766699900299,0.019441674975074777,0,0,0,0,0.0,0.0,0.0,-351,0,-0.17497507477567292,0.0
7755,29197,Schuyler,Missouri,2004,894,1124,13,2031,0.4401772525849335,0.5534219596258001,0.006400787789266372,86,-26,-35,25,0.03738562746030738,-0.013040887185808404,-0.024344740274498955,-230,121,-0.11324470704086659,0.061730367734806335
7756,29197,Schuyler,Missouri,2008,775,1139,69,1983,0.3908219868885527,0.5743822491174987,0.03479576399394856,-119,56,15,-48,-0.04935526569638082,0.02839497620468219,0.02096028949169859,-364,-134,-0.183560262228946,-0.07031555518807941
7757,29197,Schuyler,Missouri,2012,697,1174,68,1939,0.3594636410520887,0.6054667354306343,0.035069623517276945,-78,-1,35,-44,-0.03135834583646396,0.0002738595233283819,0.03108448631313565,-477,-113,-0.24600309437854562,-0.062442832149599614
7758,29197,Schuyler,Missouri,2016,354,1505,77,1936,0.1828512396694215,0.7773760330578512,0.03977272727272727,-343,9,331,-3,-0.17661240138266723,0.0047031037554503274,0.17190929762721685,-1151,-674,-0.5945247933884297,-0.34852169900988406
7759,29199,Scotland,Missouri,2000,790,1335,54,2179,0.3625516291877008,0.6126663607159247,0.024782010096374485,0,0,0,0,0.0,0.0,0.0,-545,0,-0.25011473152822394,0.0
7760,29199,Scotland,Missouri,2004,828,1352,17,2197,0.37687756030951297,0.6153846153846154,0.007737824305871643,38,-37,17,18,0.014325931121812185,-0.01704418579050284,0.0027182546686906894,-524,21,-0.23850705507510245,0.011607676453121496
7761,29199,Scotland,Missouri,2008,793,1249,56,2098,0.37797902764537655,0.5953288846520496,0.02669208770257388,-35,39,-103,-99,0.0011014673358635818,0.01895426339670224,-0.020055730732565835,-456,68,-0.21734985700667303,0.021157198068429417
7762,29199,Scotland,Missouri,2012,643,1246,47,1936,0.33212809917355374,0.643595041322314,0.02427685950413223,-150,-9,-3,-162,-0.045850928471822816,-0.0024152281984416504,0.04826615667026446,-603,-147,-0.3114669421487603,-0.09411708514208728
7763,29199,Scotland,Missouri,2016,365,1525,78,1968,0.18546747967479674,0.7748983739837398,0.039634146341463415,-278,31,279,32,-0.146660619498757,0.015357286837331185,0.1313033326614258,-1160,-557,-0.5894308943089431,-0.2779639521601828
7764,29201,Scott,Missouri,2000,6452,8999,253,15704,0.4108507386653082,0.5730387162506367,0.016110545084055017,0,0,0,0,0.0,0.0,0.0,-2547,0,-0.16218797758532855,0.0
7765,29201,Scott,Missouri,2004,6057,11330,61,17448,0.34714580467675377,0.6493580926180651,0.0034961027051811098,-395,-192,2331,1744,-0.06370493398855442,-0.012614442378873908,0.07631937636742836,-5273,-2726,-0.30221228794131133,-0.14002431035598278
7766,29201,Scott,Missouri,2008,6258,11563,261,18082,0.3460900342882425,0.6394757217122,0.014434243999557572,201,200,233,634,-0.0010557703885112901,0.010938141294376463,-0.009882370905865079,-5305,-32,-0.29338568742395754,0.008826600517353789
7767,29201,Scott,Missouri,2012,5122,11623,254,16999,0.3013118418730514,0.6837461027119243,0.014942055415024413,-1136,-7,60,-1083,-0.0447781924151911,0.0005078114154668419,0.044270380999724246,-6501,-1196,-0.3824342608388729,-0.08904857341491534
7768,29201,Scott,Missouri,2016,3575,13168,594,17337,0.20620637941973813,0.7595316375382131,0.0342619830420488,-1547,340,1545,338,-0.09510546245331325,0.019319927627024384,0.0757855348262888,-9593,-3092,-0.5533252581184749,-0.170890997279602
7769,29203,Shannon,Missouri,2000,1430,2245,106,3781,0.3782068235916424,0.5937582650092568,0.028034911399100765,0,0,0,0,0.0,0.0,0.0,-815,0,-0.21555144141761434,0.0
7770,29203,Shannon,Missouri,2004,1618,2511,38,4167,0.3882889368850492,0.6025917926565875,0.00911927045836333,188,-68,266,386,0.010082113293406747,-0.018915640940737437,0.008833527647330697,-893,-78,-0.2143028557715383,0.0012485856460760503
7771,29203,Shannon,Missouri,2008,1637,2075,126,3838,0.4265242313705055,0.5406461698801459,0.03282959874934862,19,88,-436,-329,0.03823529448545632,0.023710328290985287,-0.061945622776441556,-438,455,-0.11412193850964042,0.10018091726189787
7772,29203,Shannon,Missouri,2012,1302,2262,128,3692,0.35265438786565545,0.6126760563380281,0.03466955579631636,-335,2,187,-146,-0.07386984350485004,0.0018399570469677384,0.07202988645788222,-960,-522,-0.2600216684723727,-0.14589972996273226
7773,29203,Shannon,Missouri,2016,776,2966,162,3904,0.1987704918032787,0.7597336065573771,0.04149590163934426,-526,34,704,212,-0.15388389606237676,0.006826345843027902,0.14705755021934896,-2190,-1230,-0.5609631147540984,-0.30094144628172576
7774,29205,Shelby,Missouri,2000,1262,1936,59,3257,0.38747313478661344,0.5944120356155972,0.018114829597789376,0,0,0,0,0.0,0.0,0.0,-674,0,-0.20693890082898375,0.0
7775,29205,Shelby,Missouri,2004,1201,2280,21,3502,0.34294688749286123,0.6510565391205025,0.005996573386636208,-61,-38,344,245,-0.04452624729375221,-0.012118256211153169,0.05664450350490535,-1079,-405,-0.3081096516276413,-0.10117075079865756
7776,29205,Shelby,Missouri,2008,1114,2166,36,3316,0.33594692400482506,0.6531966224366706,0.010856453558504222,-87,15,-114,-186,-0.006999963488036165,0.004859880171868014,0.0021400833161681065,-1052,27,-0.3172496984318456,-0.009140046804204272
7777,29205,Shelby,Missouri,2012,966,2188,78,3232,0.2988861386138614,0.676980198019802,0.024133663366336634,-148,42,22,-84,-0.03706078539096369,0.013277209807832412,0.023783575583131378,-1222,-170,-0.37809405940594065,-0.06084436097409507
7778,29205,Shelby,Missouri,2016,606,2524,144,3274,0.18509468540012217,0.7709224190592547,0.04398289554062309,-360,66,336,42,-0.11379145321373921,0.019849232174286455,0.09394222103945271,-1918,-696,-0.5858277336591325,-0.2077336742531919
7779,29207,Stoddard,Missouri,2000,4476,7727,251,12454,0.35940260157379156,0.6204432310904128,0.02015416733579573,0,0,0,0,0.0,0.0,0.0,-3251,0,-0.2610406295166212,0.0
7780,29207,Stoddard,Missouri,2004,3946,9242,64,13252,0.2977663748868095,0.6974041654089949,0.004829459704195593,-530,-187,1515,798,-0.06163622668698204,-0.015324707631600137,0.07696093431858209,-5296,-2045,-0.39963779052218534,-0.13859716100556413
7781,29207,Stoddard,Missouri,2008,3899,9172,191,13262,0.29399788870456944,0.6916000603227266,0.014402050972703966,-47,127,-70,10,-0.0037684861822400717,0.009572591268508374,-0.005804105086268274,-5273,23,-0.39760217161815714,0.0020356189040282024
7782,29207,Stoddard,Missouri,2012,3153,9496,217,12866,0.2450645111145655,0.7380693300170993,0.016866158868335146,-746,26,324,-396,-0.048933377590003935,0.0024641078956311804,0.046469269694372706,-6343,-1070,-0.4930048189025338,-0.09540264728437664
7783,29207,Stoddard,Missouri,2016,1876,11079,336,13291,0.14114814536152284,0.8335715897976074,0.025280264840869763,-1277,119,1583,425,-0.10391636575304267,0.008414105972534617,0.09550225978050808,-9203,-2860,-0.6924234444360845,-0.19941862553355072
7784,29209,Stone,Missouri,2000,4055,7793,303,12151,0.33371738951526625,0.641346391243519,0.024936219241214714,0,0,0,0,0.0,0.0,0.0,-3738,0,-0.30762900172825275,0.0
7785,29209,Stone,Missouri,2004,4578,10534,77,15189,0.30140233063401145,0.6935282112054777,0.005069458160510896,523,-226,2741,3038,-0.0323150588812548,-0.01986676108070382,0.0521818199619587,-5956,-2218,-0.39212588057146625,-0.0844968788432135
7786,29209,Stone,Missouri,2008,5029,11147,269,16445,0.30580723624201883,0.6778352082699909,0.01635755548799027,451,192,613,1256,0.004404905608007381,0.011288097327479374,-0.01569300293548681,-6118,-162,-0.37202797202797205,0.020097908543494192
7787,29209,Stone,Missouri,2012,3923,11787,337,16047,0.24446937122203527,0.7345298186576931,0.0210008101202717,-1106,68,640,-398,-0.06133786501998356,0.0046432546322814315,0.05669461038770218,-7864,-1746,-0.4900604474356578,-0.11803247540768574
7788,29209,Stone,Missouri,2016,2887,13158,600,16645,0.1734454791228597,0.7905076599579454,0.036046860919194956,-1036,263,1371,598,-0.07102389209917556,0.015046050798923256,0.055977841300252296,-10271,-2407,-0.6170621808350857,-0.12700173339942789
7789,29211,Sullivan,Missouri,2000,1127,1877,60,3064,0.36781984334203655,0.612597911227154,0.0195822454308094,0,0,0,0,0.0,0.0,0.0,-750,0,-0.24477806788511747,0.0
7790,29211,Sullivan,Missouri,2004,1178,1880,31,3089,0.3813531887342182,0.6086112010359339,0.010035610229847848,51,-29,3,25,0.01353334539218165,-0.009546635200961552,-0.0039867101912201,-702,48,-0.22725801230171572,0.01752005558340175
7791,29211,Sullivan,Missouri,2008,1173,1607,89,2869,0.4088532589752527,0.5601254792610666,0.031021261763680724,-5,58,-273,-220,0.027500070241034513,0.020985651533832875,-0.04848572177486732,-434,268,-0.15127222028581389,0.07598579201590183
7792,29211,Sullivan,Missouri,2012,908,1610,77,2595,0.34990366088631986,0.6204238921001927,0.029672447013487476,-265,-12,3,-274,-0.05894959808893285,-0.001348814750193248,0.06029841283912607,-702,-268,-0.2705202312138728,-0.11924801092805892
7793,29211,Sullivan,Missouri,2016,526,1884,76,2486,0.21158487530168946,0.7578439259855189,0.030571198712791632,-382,-1,274,-109,-0.1383187855846304,0.000898751699304156,0.1374200338853262,-1358,-656,-0.5462590506838294,-0.2757388194699566
7794,29213,Taney,Missouri,2000,5092,9647,373,15112,0.3369507676019058,0.6383668607728957,0.024682371625198516,0,0,0,0,0.0,0.0,0.0,-4555,0,-0.30141609317098994,0.0
7795,29213,Taney,Missouri,2004,5601,13578,101,19280,0.29050829875518674,0.7042531120331951,0.005238589211618257,509,-272,3931,4168,-0.04644246884671904,-0.01944378241358026,0.06588625126029934,-7977,-3422,-0.4137448132780083,-0.11232872010701839
7796,29213,Taney,Missouri,2008,6683,14736,322,21741,0.307391564325468,0.6777977093969919,0.014810726277540131,1082,221,1158,2461,0.016883265570281247,0.009572137065921874,-0.026455402636203162,-8053,-76,-0.3704061450715239,0.04333866820648441
7797,29213,Taney,Missouri,2012,5479,15746,513,21738,0.2520471064495354,0.7243536663906524,0.02359922715981231,-1204,191,1010,-3,-0.05534445787593262,0.008788500882272178,0.04655595699366044,-10267,-2214,-0.472306559941117,-0.10190041486959306
7798,29213,Taney,Missouri,2016,4373,18276,1024,23673,0.18472521437925063,0.772018755544291,0.04325603007645841,-1106,511,2530,1935,-0.06732189207028474,0.0196568029166461,0.04766508915363865,-13903,-3636,-0.5872935411650404,-0.11498698122392342
7799,29215,Texas,Missouri,2000,3486,6136,310,9932,0.3509867096254531,0.6178010471204188,0.03121224325412807,0,0,0,0,0.0,0.0,0.0,-2650,0,-0.26681433749496575,0.0
7800,29215,Texas,Missouri,2004,3664,7234,120,11018,0.3325467416954075,0.6565619894717735,0.010891268832819023,178,-190,1098,1086,-0.018439967930045598,-0.02032097442130905,0.03876094235135463,-3570,-920,-0.324015247776366,-0.05720091028140023
7801,29215,Texas,Missouri,2008,3410,7215,226,10851,0.3142567505299051,0.6649156759745646,0.020827573495530365,-254,106,-19,-167,-0.018289991165502395,0.009936304662711342,0.008353686502791113,-3805,-235,-0.3506589254446595,-0.02664367766829351
7802,29215,Texas,Missouri,2012,2871,7618,275,10764,0.26672240802675584,0.7077294685990339,0.025548123374210332,-539,49,403,-87,-0.04753434250314925,0.0047205498786799666,0.04281379262446927,-4747,-942,-0.441007060572278,-0.09034813512761852
7803,29215,Texas,Missouri,2016,1728,8875,353,10956,0.15772179627601315,0.8100584154801023,0.03221978824388463,-1143,78,1257,192,-0.10900061175074269,0.006671664869674295,0.10232894688106842,-7147,-2400,-0.6523366192040891,-0.21132955863181113
7804,29217,Vernon,Missouri,2000,3156,4985,267,8408,0.3753568030447193,0.5928877259752616,0.03175547098001903,0,0,0,0,0.0,0.0,0.0,-1829,0,-0.21753092293054233,0.0
7805,29217,Vernon,Missouri,2004,3206,5732,54,8992,0.3565391459074733,0.6374555160142349,0.006005338078291815,50,-213,747,584,-0.01881765713724598,-0.025750132901727216,0.044567790038973265,-2526,-697,-0.28091637010676157,-0.06338544717621925
7806,29217,Vernon,Missouri,2008,3381,5334,163,8878,0.38082901554404147,0.6008109934669971,0.01835999098896148,175,109,-398,-114,0.02428986963656815,0.012354652910669664,-0.03664452254723782,-1953,573,-0.2199819779229556,0.060934392183805974
7807,29217,Vernon,Missouri,2012,2580,5758,183,8521,0.30278136368970776,0.6757422837695106,0.021476352540781597,-801,20,424,-357,-0.07804765185433371,0.003116361551820119,0.07493129030251355,-3178,-1225,-0.37296092007980286,-0.15297894215684726
7808,29217,Vernon,Missouri,2016,1707,6533,391,8631,0.19777546054918319,0.7569227204263701,0.045301819024446764,-873,208,775,110,-0.10500590314052458,0.023825466483665167,0.08118043665685948,-4826,-1648,-0.5591472598771869,-0.18618633979738408
7809,29219,Warren,Missouri,2000,4524,5979,237,10740,0.4212290502793296,0.5567039106145252,0.022067039106145252,0,0,0,0,0.0,0.0,0.0,-1455,0,-0.13547486033519557,0.0
7810,29219,Warren,Missouri,2004,5461,7883,88,13432,0.40656640857653364,0.586882072662299,0.006551518761167362,937,-149,1904,2692,-0.014662641702795964,-0.015515520344977891,0.030178162047773793,-2422,-967,-0.18031566408576533,-0.04484080375056976
7811,29219,Warren,Missouri,2008,6705,8675,196,15576,0.4304699537750385,0.5569465844889574,0.012583461736004109,1244,108,792,2144,0.02390354519850485,0.006031942974836747,-0.029935488173341573,-1970,452,-0.1264766307139189,0.05383903337184642
7812,29219,Warren,Missouri,2012,5219,9150,307,14676,0.3556146088852548,0.6234668847097302,0.02091850640501499,-1486,111,475,-900,-0.07485534488978368,0.008335044669010881,0.06652030022077282,-3931,-1961,-0.2678522758244754,-0.1413756451105565
7813,29219,Warren,Missouri,2016,3915,11111,758,15784,0.24803598580841357,0.7039406994424734,0.048023314749113026,-1304,451,1961,1108,-0.10757862307684124,0.027104808344098036,0.08047381473274318,-7196,-3265,-0.4559047136340598,-0.18805243780958442
7814,29221,Washington,Missouri,2000,4047,4020,198,8265,0.4896551724137931,0.4863883847549909,0.023956442831215972,0,0,0,0,0.0,0.0,0.0,27,0,0.0032667876588021727,0.0
7815,29221,Washington,Missouri,2004,4459,4641,78,9178,0.48583569405099153,0.5056657223796034,0.0084985835694051,412,-120,621,913,-0.003819478362801554,-0.015457859261810872,0.01927733762461248,-182,-209,-0.01983002832861186,-0.023096815987414032
7816,29221,Washington,Missouri,2008,4711,4706,197,9614,0.49001456209694194,0.4894944872061577,0.020490950696900354,252,119,65,436,0.004178868045950412,0.011992367127495254,-0.01617123517344571,5,187,0.0005200748907842612,0.02035010321939612
7817,29221,Washington,Missouri,2012,3417,5071,207,8695,0.39298447383553764,0.5832087406555492,0.02380678550891317,-1294,10,365,-919,-0.0970300882614043,0.0033158348120128148,0.0937142534493915,-1654,-1659,-0.19022426682001153,-0.1907443417107958
7818,29221,Washington,Missouri,2016,1926,7048,308,9282,0.20749838396897222,0.7593191122602887,0.033182503770739065,-1491,101,1977,587,-0.18548608986656542,0.009375718261825896,0.17611037160473952,-5122,-3468,-0.5518207282913165,-0.3615964614713049
7819,29223,Wayne,Missouri,2000,2387,3346,115,5848,0.40817373461012313,0.5721614227086184,0.01966484268125855,0,0,0,0,0.0,0.0,0.0,-959,0,-0.16398768809849523,0.0
7820,29223,Wayne,Missouri,2004,2250,3919,35,6204,0.36266924564796904,0.6316892327530625,0.005641521598968408,-137,-80,573,356,-0.04550448896215409,-0.014023321082290143,0.059527810044444185,-1669,-710,-0.2690199871050935,-0.10503229900659827
7821,29223,Wayne,Missouri,2008,2243,3784,127,6154,0.364478388040299,0.6148846278843029,0.020636984075398115,-7,92,-135,-50,0.0018091423923299321,0.014995462476429708,-0.016804604868759676,-1541,128,-0.2504062398440039,0.018613747261089608
7822,29223,Wayne,Missouri,2012,1813,3790,117,5720,0.31695804195804195,0.6625874125874126,0.020454545454545454,-430,-10,6,-434,-0.047520346082257026,-0.000182438620852661,0.047702784703109735,-1977,-436,-0.34562937062937066,-0.09522313078536676
7823,29223,Wayne,Missouri,2016,948,4658,156,5762,0.16452620617841027,0.8083998611593197,0.027073932662270046,-865,39,868,42,-0.15243183577963168,0.006619387207724592,0.14581244857190712,-3710,-1733,-0.6438736549809094,-0.29824428435153877
7824,29225,Webster,Missouri,2000,4174,7350,356,11880,0.35134680134680135,0.6186868686868687,0.029966329966329967,0,0,0,0,0.0,0.0,0.0,-3176,0,-0.2673400673400674,0.0
7825,29225,Webster,Missouri,2004,4657,10194,93,14944,0.3116300856531049,0.6821466809421841,0.006223233404710921,483,-263,2844,3064,-0.03971671569369645,-0.023743096561619048,0.06345981225531538,-5537,-2361,-0.3705165952890792,-0.10317652794901183
7826,29225,Webster,Missouri,2008,5685,10431,240,16356,0.34757887013939837,0.6377476155539251,0.014673514306676448,1028,147,237,1412,0.03594878448629346,0.008450280901965528,-0.044399065388258996,-4746,791,-0.29016874541452675,0.08034784987455246
7827,29225,Webster,Missouri,2012,4409,10708,379,15496,0.2845250387196696,0.6910170366546206,0.02445792462570986,-1276,139,277,-860,-0.06305383141972876,0.009784410319033413,0.053269421100695435,-6299,-1553,-0.40649199793495094,-0.11632325252042419
7828,29225,Webster,Missouri,2016,3177,12840,726,16743,0.1897509406916323,0.7668876545421968,0.04336140476617094,-1232,347,2132,1247,-0.0947740980280373,0.018903480140461077,0.07587061788757621,-9663,-3364,-0.5771367138505644,-0.17064471591561348
7829,29227,Worth,Missouri,2000,469,651,38,1158,0.40500863557858374,0.5621761658031088,0.03281519861830743,0,0,0,0,0.0,0.0,0.0,-182,0,-0.15716753022452506,0.0
7830,29227,Worth,Missouri,2004,436,691,5,1132,0.38515901060070673,0.6104240282685512,0.00441696113074205,-33,-33,40,-26,-0.019849624977877012,-0.02839823748756538,0.04824786246544244,-255,-73,-0.2252650176678445,-0.06809748744331945
7831,29227,Worth,Missouri,2008,427,707,40,1174,0.3637137989778535,0.6022146507666098,0.034071550255536626,-9,35,16,42,-0.021445211622853233,0.029654589124794576,-0.008209377501941395,-280,-25,-0.23850085178875635,-0.013235834120911838
7832,29227,Worth,Missouri,2012,341,664,43,1048,0.32538167938931295,0.6335877862595419,0.04103053435114504,-86,3,-43,-126,-0.03833211958854055,0.0069589840956084115,0.03137313549293208,-323,-43,-0.308206106870229,-0.06970525508147263
7833,29227,Worth,Missouri,2016,195,808,43,1046,0.1864244741873805,0.7724665391969407,0.04110898661567878,-146,0,144,-2,-0.13895720520193244,7.845226453374182e-05,0.13887875293739882,-613,-290,-0.5860420650095602,-0.27783595813933126
7834,29229,Wright,Missouri,2000,2250,5391,200,7841,0.2869531947455682,0.6875398546103814,0.025506950644050504,0,0,0,0,0.0,0.0,0.0,-3141,0,-0.4005866598648132,0.0
7835,29229,Wright,Missouri,2004,2188,6090,68,8346,0.2621615144979631,0.7296908698777858,0.008147615624251139,-62,-132,699,505,-0.024791680247605086,-0.017359335019799367,0.04215101526740439,-3902,-761,-0.46752935537982265,-0.06694269551500948
7836,29229,Wright,Missouri,2008,2557,5784,173,8514,0.300328870096312,0.6793516560958421,0.020319473807845902,369,105,-306,168,0.038167355598348884,0.012171858183594763,-0.050339213781943615,-3227,675,-0.37902278599953015,0.0885065693802925
7837,29229,Wright,Missouri,2012,1953,5830,172,7955,0.24550597108736644,0.732872407291012,0.021621621621621623,-604,-1,46,-559,-0.05482289900894555,0.0013021478137757204,0.05352075119516986,-3877,-650,-0.48736643620364556,-0.1083436502041154
7838,29229,Wright,Missouri,2016,1170,6707,242,8119,0.1441064170464343,0.8260869565217391,0.02980662643182658,-783,70,877,164,-0.10139955404093215,0.008185004810204958,0.09321454923072714,-5537,-1660,-0.6819805394753049,-0.19461410327165934
7839,29510,St. Louis City,Missouri,2000,96557,24799,3396,124752,0.7739915993330768,0.19878639220212901,0.02722200846479415,0,0,0,0,0.0,0.0,0.0,71758,0,0.5752052071309478,0.0
7840,29510,St. Louis City,Missouri,2004,116133,27793,712,144638,0.802921777126343,0.1921555884345746,0.004922634439082398,19576,-2684,2994,19886,0.028930177793266232,-0.022299374025711752,-0.006630803767554427,88340,16582,0.6107661886917685,0.03556098156082066
7841,29510,St. Louis City,Missouri,2008,132925,24662,1517,159104,0.8354598250201126,0.15500553097345132,0.009534644006436041,16792,805,-3131,14466,0.03253804789376957,0.004612009567353643,-0.037150057461123265,108263,19923,0.6804542940466614,0.06968810535489289
7842,29510,St. Louis City,Missouri,2012,118780,22943,2343,144066,0.8244832229672511,0.15925339774825428,0.016263379284494606,-14145,826,-1719,-15038,-0.01097660205286155,0.006728735278058565,0.004247866774802961,95837,-12426,0.6652298252189968,-0.015224468827664595
7843,29510,St. Louis City,Missouri,2016,104235,20832,7420,132487,0.7867564364805604,0.1572380686406968,0.05600549487874282,-14545,5077,-2111,-11579,-0.0377267864866907,0.039742115594248215,-0.002015329107557473,83403,-12434,0.6295183678398636,-0.03571145737913317
7844,30001,Beaverhead,Montana,2000,799,3113,284,4196,0.19041944709246902,0.7418970448045757,0.06768350810295519,0,0,0,0,0.0,0.0,0.0,-2314,0,-0.5514775977121067,0.0
7845,30001,Beaverhead,Montana,2004,1103,3067,72,4242,0.26001885902876004,0.723008015087223,0.016973125884016973,304,-212,-46,46,0.06959941193629102,-0.05071038221893821,-0.018889029717352734,-1964,350,-0.46298915605846297,0.08848844165364372
7846,30001,Beaverhead,Montana,2008,1617,3008,138,4763,0.3394919168591224,0.6315347470081881,0.02897333613268948,514,66,-59,521,0.07947305783036235,0.012000210248672507,-0.09147326807903489,-1391,573,-0.29204283014906574,0.17094632590939723
7847,30001,Beaverhead,Montana,2012,1371,3289,152,4812,0.28491271820448877,0.6834995843724023,0.03158769742310889,-246,14,281,49,-0.05457919865463362,0.0026143612904194133,0.0519648373642142,-1918,-527,-0.39858686616791356,-0.10654403601884782
7848,30001,Beaverhead,Montana,2016,1143,3353,353,4849,0.23571870488760568,0.6914827799546298,0.07279851515776449,-228,201,64,37,-0.049194013316883084,0.0412108177346556,0.007983195582227487,-2210,-292,-0.4557640750670241,-0.05717720889911054
7849,30003,Big Horn,Montana,2000,2345,1651,165,4161,0.5635664503725066,0.39677962028358565,0.03965392934390771,0,0,0,0,0.0,0.0,0.0,694,0,0.16678683008892098,0.0
7850,30003,Big Horn,Montana,2004,2215,2028,68,4311,0.5138019021108792,0.4704244954766875,0.01577360241243331,-130,-97,377,150,-0.04976454826162746,-0.0238803269314744,0.07364487519310187,187,-507,0.04337740663419165,-0.12340942345472933
7851,30003,Big Horn,Montana,2008,3516,1628,75,5219,0.6736922782142173,0.3119371527112474,0.014370569074535352,1301,7,-400,908,0.15989037610333812,-0.0014030333378979593,-0.15848734276544013,1888,1701,0.3617551255029699,0.31837771886877825
7852,30003,Big Horn,Montana,2012,2882,1667,77,4626,0.6230004323389537,0.3603545179420666,0.01664504971897968,-634,2,39,-593,-0.05069184587526354,0.0022744806444443284,0.04841736523081919,1215,-673,0.26264591439688717,-0.09910921110608273
7853,30003,Big Horn,Montana,2016,2094,1853,290,4237,0.49421760679726223,0.4373377389662497,0.06844465423648809,-788,213,186,-389,-0.12878282554169151,0.05179960451750841,0.07698322102418315,241,-974,0.05687986783101251,-0.20576604656587466
7854,30005,Blaine,Montana,2000,1246,1410,103,2759,0.45161290322580644,0.5110547299746285,0.03733236679956506,0,0,0,0,0.0,0.0,0.0,-164,0,-0.05944182674882209,0.0
7855,30005,Blaine,Montana,2004,1300,1424,44,2768,0.46965317919075145,0.5144508670520231,0.015895953757225433,54,-59,14,9,0.018040275964945007,-0.021436413042339626,0.003396137077394612,-124,40,-0.044797687861271696,0.014644138887550395
7856,30005,Blaine,Montana,2008,1702,1139,85,2926,0.5816814764183186,0.3892686261107314,0.029049897470950103,402,41,-285,158,0.11202829722756713,0.013153943713724671,-0.12518224094129177,563,687,0.1924128503075872,0.2372105381688589
7857,30005,Blaine,Montana,2012,1616,1178,65,2859,0.565232598810773,0.4120321790835957,0.02273522210563134,-86,-20,39,-67,-0.016448877607545542,-0.006314675365318764,0.02276355297286431,438,-125,0.15320041972717735,-0.03921243058040985
7858,30005,Blaine,Montana,2016,1202,1268,214,2684,0.44783904619970194,0.47242921013412814,0.07973174366616989,-414,149,90,-175,-0.1173935526110711,0.056996521560538554,0.06039703105053246,-66,-504,-0.0245901639344262,-0.17779058366160355
7859,30007,Broadwater,Montana,2000,462,1488,124,2074,0.2227579556412729,0.7174541947926711,0.05978784956605593,0,0,0,0,0.0,0.0,0.0,-1026,0,-0.49469623915139826,0.0
7860,30007,Broadwater,Montana,2004,533,1778,45,2356,0.2262308998302207,0.7546689303904923,0.019100169779286927,71,-79,290,282,0.0034729441889478074,-0.040687679786769,0.03721473559782118,-1245,-219,-0.5284380305602716,-0.033741791408873345
7861,30007,Broadwater,Montana,2008,857,1875,75,2807,0.3053081581759886,0.6679729248307802,0.026718916993231208,324,30,97,451,0.0790772583457679,0.007618747213944281,-0.08669600555971213,-1018,227,-0.3626647666547916,0.16577326390548003
7862,30007,Broadwater,Montana,2012,764,2152,95,3011,0.2537363002324809,0.7147127200265693,0.03155097974094985,-93,20,277,204,-0.051571857943507715,0.004832062747718642,0.04673979519578908,-1388,-370,-0.4609764197940884,-0.0983116531392968
7863,30007,Broadwater,Montana,2016,573,2348,212,3133,0.1828917969996808,0.7494414299393553,0.06766677306096393,-191,117,196,122,-0.07084450323280009,0.03611579332001408,0.03472870991278598,-1775,-387,-0.5665496329396744,-0.10557321314558604
7864,30009,Carbon,Montana,2000,1434,3008,347,4789,0.2994362079766131,0.6281060764251409,0.07245771559824599,0,0,0,0,0.0,0.0,0.0,-1574,0,-0.32866986844852786,0.0
7865,30009,Carbon,Montana,2004,1847,3342,132,5321,0.34711520390903966,0.628077429054689,0.02480736703627138,413,-215,334,532,0.04767899593242658,-0.04765034856197461,-2.8647370451939658e-05,-1495,79,-0.28096222514564934,0.04770764330287852
7866,30009,Carbon,Montana,2008,2443,3108,199,5750,0.42486956521739133,0.5405217391304348,0.034608695652173914,596,67,-234,429,0.07775436130835167,0.009801328615902535,-0.08755568992425422,-665,830,-0.11565217391304344,0.1653100512326059
7867,30009,Carbon,Montana,2012,2146,3533,168,5847,0.36702582520950916,0.6042414913630921,0.028732683427398667,-297,-31,425,97,-0.05784374000788217,-0.005876012224775247,0.06371975223265736,-1387,-722,-0.23721566615358297,-0.12156349224053953
7868,30009,Carbon,Montana,2016,1828,3748,415,5991,0.30512435319646136,0.6256050742780838,0.06927057252545485,-318,247,215,144,-0.0619014720130478,0.04053788909805618,0.02136358291499163,-1920,-533,-0.3204807210816224,-0.08326505492803943
7869,30011,Carter,Montana,2000,53,573,19,645,0.08217054263565891,0.8883720930232558,0.02945736434108527,0,0,0,0,0.0,0.0,0.0,-520,0,-0.8062015503875969,0.0
7870,30011,Carter,Montana,2004,76,623,10,709,0.1071932299012694,0.8787023977433004,0.014104372355430184,23,-9,50,64,0.02502268726561048,-0.015352991985655087,-0.009669695279955426,-547,-27,-0.7715091678420309,0.03469238254556595
7871,30011,Carter,Montana,2008,111,573,38,722,0.15373961218836565,0.7936288088642659,0.05263157894736842,35,28,-50,13,0.04654638228709626,0.038527206591938236,-0.08507358887903449,-462,85,-0.6398891966759003,0.13161997116613067
7872,30011,Carter,Montana,2012,96,678,22,796,0.12060301507537688,0.8517587939698492,0.02763819095477387,-15,-16,105,74,-0.033136597112988775,-0.024993387992594547,0.058129985105583315,-582,-120,-0.7311557788944724,-0.09126658221857209
7873,30011,Carter,Montana,2016,70,678,38,786,0.089058524173028,0.8625954198473282,0.04834605597964377,-26,16,0,-10,-0.031544490902348885,0.020707865024869897,0.010836625877479023,-608,-26,-0.7735368956743003,-0.04238111677982792
7874,30013,Cascade,Montana,2000,13137,18164,2016,33317,0.39430320857220036,0.5451871416994327,0.0605096497283669,0,0,0,0,0.0,0.0,0.0,-5027,0,-0.15088393312723236,0.0
7875,30013,Cascade,Montana,2004,13701,19028,730,33459,0.40948623688693625,0.5686960160196061,0.021817747093457664,564,-1286,864,142,0.015183028314735891,-0.03869190263490924,0.023508874320173345,-5327,-300,-0.15920977913266982,-0.008325846005437454
7876,30013,Cascade,Montana,2008,17664,16857,875,35396,0.49903943948468754,0.4762402531359476,0.0247203073793649,3963,145,-2171,1937,0.08955320259775129,0.0029025602859072373,-0.09245576288365848,807,6134,0.022799186348739953,0.18200896548140977
7877,30013,Cascade,Montana,2012,15232,18345,999,34576,0.44053678852383155,0.530570337806571,0.028892873669597408,-2432,124,1488,-820,-0.058502650960855995,0.004172566290232507,0.054330084670623446,-3113,-3920,-0.09003354928273949,-0.11283273563147944
7878,30013,Cascade,Montana,2016,12175,19632,2764,34571,0.3521737872783547,0.567874808365393,0.07995140435625235,-3057,1765,1287,-5,-0.08836300124547686,0.051058530686654946,0.03730447055882191,-7457,-4344,-0.21570102108703826,-0.12566747180429877
7879,30015,Chouteau,Montana,2000,686,2039,160,2885,0.23778162911611786,0.7067590987868284,0.05545927209705372,0,0,0,0,0.0,0.0,0.0,-1353,0,-0.4689774696707105,0.0
7880,30015,Chouteau,Montana,2004,946,1913,62,2921,0.32386169120164326,0.6549127011297501,0.021225607668606643,260,-98,-126,36,0.0860800620855254,-0.03423366442844708,-0.051846397657078325,-967,386,-0.3310510099281068,0.1379264597426037
7881,30015,Chouteau,Montana,2008,1122,1634,105,2861,0.39217056973086334,0.5711289758825585,0.03670045438657812,176,43,-279,-60,0.06830887852922007,0.015474846717971474,-0.08378372524719158,-512,455,-0.17895840615169517,0.15209260377641165
7882,30015,Chouteau,Montana,2012,978,1758,85,2821,0.3466855724920241,0.6231832683445586,0.03013115916341723,-144,-20,124,-40,-0.04548499723883925,-0.006569295223160888,0.05205429246200011,-780,-268,-0.27649769585253453,-0.09753928970083936
7883,30015,Chouteau,Montana,2016,732,1679,192,2603,0.2812139838647714,0.6450249711870918,0.07376104494813676,-246,107,-79,-218,-0.06547158862725266,0.04362988578471953,0.021841702842533173,-947,-167,-0.36381098732232037,-0.08731329146978584
7884,30017,Custer,Montana,2000,1501,3156,248,4905,0.30601427115188584,0.6434250764525994,0.05056065239551478,0,0,0,0,0.0,0.0,0.0,-1655,0,-0.33741080530071355,0.0
7885,30017,Custer,Montana,2004,1630,3297,121,5048,0.32290015847860537,0.6531299524564184,0.023969889064976227,129,-127,141,143,0.01688588732671953,-0.02659076333053855,0.009704876003818974,-1667,-12,-0.330229793977813,0.0071810113229005545
7886,30017,Custer,Montana,2008,2267,3047,138,5452,0.41581071166544387,0.5588774761555393,0.025311812179016874,637,17,-250,404,0.0929105531868385,0.0013419231140406468,-0.09425247630087907,-780,887,-0.14306676449009542,0.18716302948771757
7887,30017,Custer,Montana,2012,1833,3373,159,5365,0.34165890027958995,0.6287045666356011,0.029636533084808948,-434,21,326,-87,-0.07415181138585392,0.004324720905792074,0.06982709048006186,-1540,-760,-0.2870456663560112,-0.14397890186591578
7888,30017,Custer,Montana,2016,1176,3657,352,5185,0.22680810028929604,0.7053037608486017,0.06788813886210222,-657,193,284,-180,-0.1148507999902939,0.03825160577729328,0.07659919421300054,-2481,-941,-0.47849566055930565,-0.19144999420329445
7889,30019,Daniels,Montana,2000,303,750,57,1110,0.27297297297297296,0.6756756756756757,0.051351351351351354,0,0,0,0,0.0,0.0,0.0,-447,0,-0.4027027027027027,0.0
7890,30019,Daniels,Montana,2004,326,764,29,1119,0.291331546023235,0.6827524575513851,0.025915996425379804,23,-28,14,9,0.01835857305026206,-0.02543535492597155,0.007076781875709481,-438,9,-0.3914209115281501,0.01128179117455258
7891,30019,Daniels,Montana,2008,343,694,36,1073,0.3196644920782852,0.646784715750233,0.033550792171481825,17,7,-70,-46,0.028332946055050157,0.00763479574610202,-0.03596774180115214,-351,87,-0.3271202236719478,0.0643006878562023
7892,30019,Daniels,Montana,2012,237,740,30,1007,0.23535253227408143,0.7348560079443893,0.029791459781529295,-106,-6,46,-66,-0.08431195980420375,-0.0037593323899525292,0.08807129219415633,-503,-152,-0.4995034756703079,-0.17238325199836008
7893,30019,Daniels,Montana,2016,168,730,64,962,0.17463617463617465,0.7588357588357588,0.06652806652806653,-69,34,-10,-45,-0.06071635763790678,0.03673660674653724,0.0239797508913695,-562,-59,-0.5841995841995842,-0.08469610852927628
7894,30021,Dawson,Montana,2000,1364,2723,184,4271,0.31936314680402716,0.6375556075860455,0.04308124560992742,0,0,0,0,0.0,0.0,0.0,-1359,0,-0.3181924607820183,0.0
7895,30021,Dawson,Montana,2004,1494,2884,106,4484,0.33318465655664586,0.6431757359500446,0.023639607493309546,130,-78,161,213,0.0138215097526187,-0.019441638116617872,0.005620128363999166,-1390,-31,-0.30999107939339876,0.008201381388619533
7896,30021,Dawson,Montana,2008,1593,2639,212,4444,0.3584608460846085,0.5938343834383438,0.04770477047704771,99,106,-245,-40,0.025276189527962623,0.02406516298373816,-0.0493413525117008,-1046,344,-0.23537353735373534,0.07461754203966342
7897,30021,Dawson,Montana,2012,1219,3029,175,4423,0.275604793126837,0.6848293013791544,0.03956590549400859,-374,-37,390,-21,-0.08285605295777149,-0.008138864983039118,0.0909949179408106,-1810,-764,-0.40922450825231743,-0.1738509708985821
7898,30021,Dawson,Montana,2016,787,3320,302,4409,0.1784985257427988,0.7530052166024042,0.068496257654797,-432,127,291,-14,-0.09710626738403819,0.02893035216078841,0.06817591522324973,-2533,-723,-0.5745066908596054,-0.16528218260728794
7899,30023,Deer Lodge,Montana,2000,2672,1493,369,4534,0.5893250992501102,0.3292898103220115,0.08138509042787825,0,0,0,0,0.0,0.0,0.0,1179,0,0.26003528892809874,0.0
7900,30023,Deer Lodge,Montana,2004,2700,1725,118,4543,0.5943209333039842,0.37970504072198985,0.025974025974025976,28,-251,232,9,0.004995834053873938,-0.05541106445385228,0.05041523039997836,975,-204,0.21461589258199432,-0.045419396346104424
7901,30023,Deer Lodge,Montana,2008,3402,1502,170,5074,0.6704769412692156,0.29601891998423335,0.033504138746551046,702,52,-223,531,0.07615600796523148,0.00753011277252507,-0.0836861207377565,1900,925,0.3744580212849823,0.15984212870298797
7902,30023,Deer Lodge,Montana,2012,2860,1448,152,4460,0.6412556053811659,0.32466367713004485,0.034080717488789235,-542,-18,-54,-614,-0.02922133588804976,0.0005765787422381888,0.028644757145811495,1412,-488,0.31659192825112104,-0.057866093033861254
7903,30023,Deer Lodge,Montana,2016,2058,1763,385,4206,0.4893009985734665,0.4191631003328578,0.0915359010936757,-802,233,315,-254,-0.1519546068076994,0.05745518360488646,0.09449942320281296,295,-1117,0.07013789824060868,-0.24645403001051236
7904,30025,Fallon,Montana,2000,256,1061,52,1369,0.18699780861943024,0.775018261504748,0.03798392987582177,0,0,0,0,0.0,0.0,0.0,-805,0,-0.5880204528853177,0.0
7905,30025,Fallon,Montana,2004,289,1178,24,1491,0.1938296445338699,0.790073775989269,0.01609657947686117,33,-28,117,122,0.0068318359144396434,-0.0218873503989606,0.015055514484521026,-889,-84,-0.5962441314553991,-0.008223678570081439
7906,30025,Fallon,Montana,2008,318,1064,51,1433,0.22191207257501744,0.7424982554082344,0.03558967201674808,29,27,-114,-58,0.02808242804114755,0.01949309253988691,-0.047575520581034536,-746,143,-0.520586182833217,0.07565794862218211
7907,30025,Fallon,Montana,2012,237,1128,41,1406,0.16856330014224752,0.802275960170697,0.029160739687055477,-81,-10,64,-27,-0.05334877243276992,-0.006428932329692601,0.05977770476246258,-891,-145,-0.6337126600284495,-0.1131264771952325
7908,30025,Fallon,Montana,2016,154,1279,51,1484,0.10377358490566038,0.8618598382749326,0.03436657681940701,-83,10,151,78,-0.06478971523658714,0.005205837132351534,0.0595838781042356,-1125,-234,-0.7580862533692723,-0.12437359334082276
7909,30027,Fergus,Montana,2000,1352,4353,289,5994,0.2255588922255589,0.7262262262262262,0.048214881548214884,0,0,0,0,0.0,0.0,0.0,-3001,0,-0.5006673340006673,0.0
7910,30027,Fergus,Montana,2004,1582,4425,120,6127,0.2582014036233067,0.7222131548881998,0.019585441488493553,230,-169,72,133,0.03264251139774779,-0.02862944005972133,-0.004013071338026419,-2843,158,-0.46401175126489314,0.036655582735774184
7911,30027,Fergus,Montana,2008,1933,4108,191,6232,0.31017329910141206,0.6591784338896021,0.030648267008985878,351,71,-317,105,0.05197189547810538,0.011062825520492325,-0.06303472099859775,-2175,668,-0.34900513478819,0.11500661647670313
7912,30027,Fergus,Montana,2012,1640,4257,174,6071,0.2701367155328611,0.7012024378191402,0.028660846647998683,-293,-17,149,-161,-0.04003658356855094,-0.001987420360987195,0.04202400392953809,-2617,-442,-0.43106572228627904,-0.08206058749808903
7913,30027,Fergus,Montana,2016,1202,4269,369,5840,0.20582191780821918,0.7309931506849315,0.06318493150684931,-438,195,12,-231,-0.06431479772464194,0.034524084858850626,0.02979071286579138,-3067,-450,-0.5251712328767124,-0.09410551059043337
7914,30029,Flathead,Montana,2000,8329,22519,2991,33839,0.24613611513342593,0.6654747480717516,0.08838913679482255,0,0,0,0,0.0,0.0,0.0,-14190,0,-0.41933863293832563,0.0
7915,30029,Flathead,Montana,2004,11587,26019,1072,38678,0.2995759863488288,0.6727079993794922,0.02771601427167899,3258,-1919,3500,4839,0.05343987121540289,-0.06067312252314356,0.007233251307740662,-14432,-242,-0.3731320130306634,0.04620661990766223
7916,30029,Flathead,Montana,2008,16138,25559,2047,43744,0.36891916605705927,0.5842858449158742,0.046794989027066566,4551,975,-460,5066,0.06934317970823045,0.019078974755387577,-0.08842215446361801,-9421,5011,-0.21536667885881494,0.15776533417184846
7917,30029,Flathead,Montana,2012,13892,28309,1708,43909,0.3163816074153363,0.6447197613245577,0.03889863126010613,-2246,-339,2750,165,-0.05253755864172299,-0.00789635776696044,0.06043391640868345,-14417,-4996,-0.3283381539092214,-0.11297147505040644
7918,30029,Flathead,Montana,2016,13293,30240,3963,47496,0.2798762001010611,0.6366851945426983,0.08343860535624052,-599,2255,1931,3587,-0.03650540731427515,0.044539974096134395,-0.00803456678185932,-16947,-2530,-0.3568089944416372,-0.02847084053241583
7919,30031,Gallatin,Montana,2000,10009,18833,3198,32040,0.31239076154806494,0.5877965043695381,0.099812734082397,0,0,0,0,0.0,0.0,0.0,-8824,0,-0.2754057428214732,0.0
7920,30031,Gallatin,Montana,2004,16405,22392,1045,39842,0.41175141810150095,0.5620199789167211,0.026228602981778024,6396,-2153,3559,7802,0.09936065655343601,-0.07358413110061898,-0.025776525452817056,-5987,2837,-0.1502685608152201,0.12513718200625307
7921,30031,Gallatin,Montana,2008,24205,22578,1489,48272,0.501429400066291,0.46772456082200864,0.030846039111700363,7800,444,186,8430,0.08967798196479004,0.004617436129922339,-0.09429541809471242,1627,7614,0.03370483924428236,0.18397340005950247
7922,30031,Gallatin,Montana,2012,21961,24358,1587,47906,0.45841856969899386,0.5084540558593913,0.03312737444161483,-2244,98,1780,-366,-0.04301083036729714,0.002281335329914466,0.04072949503738266,-2397,-4024,-0.050035486160397435,-0.0837403254046798
7923,30031,Gallatin,Montana,2016,24246,23802,5771,53819,0.45051004292164476,0.44226016834203535,0.10722978873631989,2285,4184,-556,5913,-0.0079085267773491,0.07410241429470506,-0.06619388751735594,444,2841,0.008249874579609406,0.05828536074000684
7924,30033,Garfield,Montana,2000,61,651,32,744,0.08198924731182795,0.875,0.043010752688172046,0,0,0,0,0.0,0.0,0.0,-590,0,-0.793010752688172,0.0
7925,30033,Garfield,Montana,2004,52,590,13,655,0.07938931297709924,0.9007633587786259,0.01984732824427481,-9,-19,-61,-89,-0.002599934334728715,-0.023163424443897237,0.0257633587786259,-538,52,-0.8213740458015266,-0.028363293113354615
7926,30033,Garfield,Montana,2008,110,598,19,727,0.15130674002751032,0.8225584594222833,0.026134800550206328,58,6,8,72,0.07191742705041108,0.0062874723059315185,-0.07820489935634256,-488,50,-0.671251719394773,0.1501223264067536
7927,30033,Garfield,Montana,2012,66,622,13,701,0.09415121255349501,0.8873038516405135,0.018544935805991442,-44,-6,24,-26,-0.05715552747401531,-0.007589864744214886,0.06474539221823017,-556,-68,-0.7931526390870185,-0.12190091969224548
7928,30033,Garfield,Montana,2016,34,653,31,718,0.04735376044568245,0.9094707520891365,0.04317548746518106,-32,18,31,17,-0.04679745210781256,0.024630551659189617,0.022166900448623017,-619,-63,-0.8621169916434541,-0.06896435255643563
7929,30035,Glacier,Montana,2000,2211,1709,204,4124,0.5361299709020368,0.4144034917555771,0.049466537342386034,0,0,0,0,0.0,0.0,0.0,502,0,0.12172647914645973,0.0
7930,30035,Glacier,Montana,2004,2641,1828,93,4562,0.5789127575624726,0.40070144673388863,0.020385795703638757,430,-111,119,438,0.04278278666043578,-0.029080741638747278,-0.01370204502168848,813,311,0.178211310828584,0.05648483168212426
7931,30035,Glacier,Montana,2008,3423,1451,97,4971,0.6885938442969222,0.291892979279823,0.01951317642325488,782,4,-377,409,0.10968108673444954,-0.0008726192803838774,-0.10880846745406564,1972,1159,0.39670086501709917,0.21848955418851518
7932,30035,Glacier,Montana,2012,2924,1415,116,4455,0.656341189674523,0.3176206509539843,0.026038159371492706,-499,19,-36,-516,-0.032252654622399124,0.006524982948237827,0.02572767167416129,1509,-463,0.33872053872053876,-0.057980326296560414
7933,30035,Glacier,Montana,2016,3121,1620,334,5075,0.614975369458128,0.3192118226600985,0.0658128078817734,197,218,205,620,-0.04136582021639501,0.0397746485102807,0.001591171706114225,1501,-8,0.2957635467980295,-0.042956991922509236
7934,30037,Golden Valley,Montana,2000,88,405,38,531,0.1657250470809793,0.7627118644067796,0.07156308851224105,0,0,0,0,0.0,0.0,0.0,-317,0,-0.5969868173258004,0.0
7935,30037,Golden Valley,Montana,2004,119,396,7,522,0.22796934865900384,0.7586206896551724,0.013409961685823755,31,-31,-9,-9,0.06224430157802455,-0.058153126826417295,-0.004091174751607252,-277,40,-0.5306513409961685,0.06633547632963188
7936,30037,Golden Valley,Montana,2008,124,343,25,492,0.25203252032520324,0.6971544715447154,0.0508130081300813,5,18,-53,-30,0.024063171666199396,0.03740304644425754,-0.06146621811045694,-219,58,-0.4451219512195122,0.0855293897766563
7937,30037,Golden Valley,Montana,2012,110,351,18,479,0.22964509394572025,0.732776617954071,0.037578288100208766,-14,-7,8,-13,-0.02238742637948299,-0.013234720029872533,0.03562214640935557,-241,-22,-0.5031315240083507,-0.058009572788838504
7938,30037,Golden Valley,Montana,2016,71,365,38,474,0.14978902953586498,0.770042194092827,0.08016877637130802,-39,20,14,-5,-0.07985606440985527,0.04259048827109926,0.03726557613875603,-294,-53,-0.620253164556962,-0.1171216405486113
7939,30039,Granite,Montana,2000,295,1181,114,1590,0.18553459119496854,0.7427672955974842,0.07169811320754717,0,0,0,0,0.0,0.0,0.0,-886,0,-0.5572327044025157,0.0
7940,30039,Granite,Montana,2004,404,1144,57,1605,0.25171339563862927,0.712772585669782,0.03551401869158879,109,-57,-37,15,0.06617880444366073,-0.03618409451595838,-0.029994709927702257,-740,146,-0.4610591900311527,0.09617351437136301
7941,30039,Granite,Montana,2008,601,1013,104,1718,0.349825378346915,0.589639115250291,0.06053550640279395,197,47,-131,113,0.09811198270828575,0.02502148771120516,-0.12313347041949096,-412,328,-0.23981373690337598,0.22124545312777671
7942,30039,Granite,Montana,2012,533,1107,65,1705,0.3126099706744868,0.649266862170088,0.03812316715542522,-68,-39,94,-13,-0.0372154076724282,-0.022412339247368726,0.059627746919797,-574,-162,-0.3366568914956012,-0.0968431545922252
7943,30039,Granite,Montana,2016,472,1192,113,1777,0.26561620709060213,0.670793472144063,0.06359032076533483,-61,48,85,72,-0.046993763583884685,0.025467153609909608,0.02152660997397504,-720,-146,-0.4051772650534609,-0.06852037355785973
7944,30041,Hill,Montana,2000,2760,3392,406,6558,0.42086001829826164,0.5172308630680086,0.0619091186337298,0,0,0,0,0.0,0.0,0.0,-632,0,-0.09637084476974694,0.0
7945,30041,Hill,Montana,2004,2997,3505,155,6657,0.4502027940513745,0.5265134444945171,0.023283761454108456,237,-251,113,99,0.029342775753112837,-0.038625357179621345,0.009282581426508507,-508,124,-0.07631065044314261,0.02006019432660433
7946,30041,Hill,Montana,2008,3596,2787,242,6625,0.5427924528301887,0.42067924528301887,0.03652830188679245,599,87,-718,-32,0.09258965877881425,0.013244540432683995,-0.10583419921149823,809,1317,0.12211320754716987,0.19842385799031248
7947,30041,Hill,Montana,2012,3403,3164,258,6825,0.4986080586080586,0.4635897435897436,0.037802197802197804,-193,16,377,200,-0.04418439422213011,0.0012738959154053528,0.04291049830672472,239,-570,0.03501831501831504,-0.08709489252885483
7948,30041,Hill,Montana,2016,2371,3478,596,6445,0.3678820791311094,0.5396431342125679,0.09247478665632274,-1032,338,314,-380,-0.13072597947694925,0.05467258885412493,0.07605339062282435,-1107,-1346,-0.17176105508145856,-0.2067793700997736
7949,30043,Jefferson,Montana,2000,1513,3308,342,5163,0.29304667828781716,0.6407127638969591,0.06624055781522371,0,0,0,0,0.0,0.0,0.0,-1795,0,-0.3476660856091419,0.0
7950,30043,Jefferson,Montana,2004,1881,3844,143,5868,0.3205521472392638,0.6550783912747103,0.024369461486025902,368,-199,536,705,0.02750546895144662,-0.04187109632919781,0.014365627377751267,-1963,-168,-0.33452624403544656,0.013139841573695354
7951,30043,Jefferson,Montana,2008,2582,3538,221,6341,0.4071912947484624,0.5579561583346475,0.03485254691689008,701,78,-306,473,0.0866391475091986,0.01048308543086418,-0.09712223294006284,-956,1007,-0.15076486358618513,0.18376138044926144
7952,30043,Jefferson,Montana,2012,2272,4055,194,6521,0.34841282011961355,0.6218371415427082,0.02975003833767827,-310,-27,517,180,-0.05877847462884883,-0.005102508579211813,0.06388098320806068,-1783,-827,-0.27342432142309464,-0.12265945783690951
7953,30043,Jefferson,Montana,2016,1998,4177,539,6714,0.2975871313672922,0.6221328567173071,0.08028001191540066,-274,345,122,193,-0.05082568875232135,0.05052997357772239,0.0002957151745989206,-2179,-396,-0.3245457253500149,-0.05112140392692027
7954,30045,Judith Basin,Montana,2000,278,1057,59,1394,0.1994261119081779,0.7582496413199427,0.04232424677187949,0,0,0,0,0.0,0.0,0.0,-779,0,-0.5588235294117647,0.0
7955,30045,Judith Basin,Montana,2004,322,944,20,1286,0.25038880248833595,0.7340590979782271,0.015552099533437015,44,-39,-113,-108,0.05096269058015804,-0.02677214723844247,-0.024190543341715554,-622,157,-0.48367029548989116,0.07515323392187356
7956,30045,Judith Basin,Montana,2008,397,801,38,1236,0.32119741100323623,0.6480582524271845,0.030744336569579287,75,18,-143,-50,0.07080860851490028,0.015192237036142272,-0.08600084555104259,-404,218,-0.3268608414239483,0.15680945406594288
7957,30045,Judith Basin,Montana,2012,337,854,24,1215,0.2773662551440329,0.702880658436214,0.019753086419753086,-60,-14,53,-21,-0.04383115585920333,-0.010991250149826201,0.054822406009029434,-517,-113,-0.42551440329218104,-0.09865356186823276
7958,30045,Judith Basin,Montana,2016,235,872,101,1208,0.1945364238410596,0.7218543046357616,0.0836092715231788,-102,77,18,-7,-0.0828298313029733,0.06385618510342572,0.018973646199547667,-637,-120,-0.527317880794702,-0.10180347750252094
7959,30047,Lake,Montana,2000,3884,6441,1123,11448,0.3392732354996506,0.5626310272536688,0.09809573724668064,0,0,0,0,0.0,0.0,0.0,-2557,0,-0.22335779175401815,0.0
7960,30047,Lake,Montana,2004,4960,7245,371,12576,0.3944020356234097,0.5760973282442748,0.029500636132315523,1076,-752,804,1128,0.05512880012375909,-0.06859510111436512,0.013466300990606084,-2285,272,-0.18169529262086515,0.04166249913315301
7961,30047,Lake,Montana,2008,6766,6498,692,13956,0.48480940097449127,0.4656061908856406,0.049584408139868155,1806,321,-747,1380,0.09040736535108157,0.020083772007552632,-0.11049113735863425,268,2553,0.019203210088850675,0.20089850270971582
7962,30047,Lake,Montana,2012,5805,7135,364,13304,0.4363349368610944,0.5363048707155743,0.02736019242333133,-961,-328,637,-652,-0.04847446411339684,-0.022224215716536825,0.07069867982993372,-1330,-1598,-0.09996993385447989,-0.11917314394333056
7963,30047,Lake,Montana,2016,4776,7530,875,13181,0.3623397314316061,0.5712768378726956,0.06638343069569835,-1029,511,395,-123,-0.07399520542948834,0.03902323827236702,0.03497196715712125,-2754,-1424,-0.20893710644108948,-0.1089671725866096
7964,30049,Lewis and Clark,Montana,2000,9982,15091,2196,27269,0.36605669441490335,0.5534122996809564,0.08053100590414024,0,0,0,0,0.0,0.0,0.0,-5109,0,-0.18735560526605305,0.0
7965,30049,Lewis and Clark,Montana,2004,12717,16494,632,29843,0.42613008075595615,0.552692423683946,0.021177495560097844,2735,-1564,1403,2574,0.060073386341052804,-0.05935351034404239,-0.0007198759970103996,-3777,1332,-0.12656234292798985,0.0607932623380632
7966,30049,Lewis and Clark,Montana,2008,17114,14966,949,33029,0.5181507160374217,0.4531169578249417,0.028732326137636623,4397,317,-1528,3186,0.09202063528146553,0.007554830577538779,-0.09957546585900429,2148,5925,0.06503375821247998,0.19159610114046982
7967,30049,Lewis and Clark,Montana,2012,15620,16803,895,33318,0.4688156552013926,0.5043219881145327,0.026862356684074676,-1494,-54,1837,289,-0.049335060836029065,-0.0018699694535619475,0.05120503028959095,-1183,-3331,-0.03550633291314004,-0.10054009112562001
7968,30049,Lewis and Clark,Montana,2016,14478,16895,3923,35296,0.41018812330009063,0.47866613780598366,0.11114573889392566,-1142,3028,92,1978,-0.05862753190130199,0.08428338220985099,-0.025655850308549,-2417,-1234,-0.06847801450589303,-0.03297168159275299
7969,30051,Liberty,Montana,2000,243,752,49,1044,0.23275862068965517,0.7203065134099617,0.04693486590038314,0,0,0,0,0.0,0.0,0.0,-509,0,-0.4875478927203065,0.0
7970,30051,Liberty,Montana,2004,281,734,18,1033,0.27202323330106487,0.7105517909002904,0.017424975798644726,38,-31,-18,-11,0.039264612611409705,-0.029509890101738417,-0.009754722509671243,-453,56,-0.43852855759922554,0.049019335121080976
7971,30051,Liberty,Montana,2008,367,594,40,1001,0.36663336663336665,0.5934065934065934,0.03996003996003996,86,22,-140,-32,0.09461013333230178,0.022535064161395234,-0.117145197493697,-227,226,-0.22677322677322675,0.2117553308259988
7972,30051,Liberty,Montana,2012,257,702,39,998,0.2575150300601202,0.7034068136272545,0.03907815631262525,-110,-1,108,-3,-0.10911833657324643,-0.0008818836474147121,0.11000022022066114,-445,-218,-0.4458917835671343,-0.21911855679390757
7973,30051,Liberty,Montana,2016,206,698,57,961,0.21436004162330904,0.7263267429760666,0.05931321540062435,-51,18,-4,-37,-0.043154988436811176,0.0202350590879991,0.02291992934881204,-492,-47,-0.5119667013527576,-0.06607491778562324
7974,30053,Lincoln,Montana,2000,1629,5578,639,7846,0.2076217180729034,0.7109355085393831,0.08144277338771348,0,0,0,0,0.0,0.0,0.0,-3949,0,-0.5033137904664797,0.0
7975,30053,Lincoln,Montana,2004,2320,5889,240,8449,0.2745887087229258,0.6970055627884957,0.02840572848857853,691,-399,311,603,0.0669669906500224,-0.05303704489913495,-0.013929945750887462,-3569,380,-0.4224168540655699,0.08089693640090984
7976,30053,Lincoln,Montana,2008,3025,5704,498,9227,0.3278422022325783,0.6181857591850005,0.05397203858242115,705,258,-185,778,0.05325349350965253,0.025566310093842623,-0.07881980360349516,-2679,890,-0.2903435569524222,0.1320732971131477
7977,30053,Lincoln,Montana,2012,2552,6057,281,8890,0.2870641169853768,0.6813273340832396,0.031608548931383575,-473,-217,353,-337,-0.0407780852472015,-0.02236348965103758,0.06314157489823913,-3505,-826,-0.39426321709786283,-0.10391966014544063
7978,30053,Lincoln,Montana,2016,2041,6729,560,9330,0.2187566988210075,0.7212218649517685,0.06002143622722401,-511,279,672,440,-0.0683074181643693,0.028412887295840433,0.0398945308685289,-4688,-1183,-0.5024651661307611,-0.10820194903289826
7979,30055,McCone,Montana,2000,267,827,48,1142,0.23380035026269702,0.7241681260945709,0.04203152364273205,0,0,0,0,0.0,0.0,0.0,-560,0,-0.4903677758318739,0.0
7980,30055,McCone,Montana,2004,320,791,26,1137,0.28144239226033424,0.6956904133685137,0.022867194371152155,53,-22,-36,-5,0.04764204199763722,-0.019164329271579895,-0.028477712726057258,-471,89,-0.41424802110817943,0.07611975472369448
7981,30055,McCone,Montana,2008,321,726,44,1091,0.29422548120989916,0.6654445462878094,0.04032997250229148,1,18,-65,-46,0.012783088949564925,0.017462778131139323,-0.030245867080704314,-405,66,-0.3712190650779102,0.04302895603026924
7982,30055,McCone,Montana,2012,223,745,25,993,0.22457200402819738,0.7502517623363545,0.025176233635448138,-98,-19,19,-98,-0.06965347718170178,-0.01515373886684334,0.08480721604854513,-522,-117,-0.5256797583081572,-0.15446069323024697
7983,30055,McCone,Montana,2016,154,862,79,1095,0.14063926940639268,0.7872146118721461,0.07214611872146119,-69,54,117,102,-0.0839327346218047,0.046969885086013054,0.03696284953579165,-708,-186,-0.6465753424657534,-0.12089558415759627
7984,30057,Madison,Montana,2000,758,2656,242,3656,0.20733041575492342,0.7264770240700219,0.0661925601750547,0,0,0,0,0.0,0.0,0.0,-1898,0,-0.5191466083150985,0.0
7985,30057,Madison,Montana,2004,983,2868,82,3933,0.24993643529112636,0.7292143401983219,0.020849224510551743,225,-160,212,277,0.04260601953620294,-0.045343335664502965,0.0027373161282999714,-1885,13,-0.4792779049071955,0.039868703407902994
7986,30057,Madison,Montana,2008,1607,2822,139,4568,0.3517950963222417,0.6177758318739054,0.03042907180385289,624,57,-46,635,0.10185866103111535,0.009579847293301146,-0.11143850832441649,-1215,670,-0.2659807355516637,0.21329716935553183
7987,30057,Madison,Montana,2012,1289,3130,113,4532,0.2844218887908208,0.6906443071491615,0.02493380406001765,-318,-26,308,-36,-0.0673732075314209,-0.005495267743835238,0.07286847527525608,-1841,-626,-0.40622241835834066,-0.14024168280667698
7988,30057,Madison,Montana,2016,1180,3297,266,4743,0.2487876871178579,0.6951296647691335,0.05608264811300864,-109,153,167,211,-0.03563420167296291,0.031148844052990992,0.004485357619972041,-2117,-276,-0.4463419776512756,-0.040119559292934925
7989,30059,Meagher,Montana,2000,176,698,61,935,0.18823529411764706,0.746524064171123,0.06524064171122995,0,0,0,0,0.0,0.0,0.0,-522,0,-0.558288770053476,0.0
7990,30059,Meagher,Montana,2004,247,698,28,973,0.2538540596094553,0.7173689619732785,0.02877697841726619,71,-33,0,38,0.06561876549180823,-0.03646366329396376,-0.029155102197844562,-451,71,-0.4635149023638232,0.09477386768965279
7991,30059,Meagher,Montana,2008,298,624,44,966,0.3084886128364389,0.6459627329192547,0.045548654244306416,51,16,-74,-7,0.05463455322698363,0.016771675827040228,-0.07140622905402383,-326,125,-0.33747412008281574,0.12604078228100746
7992,30059,Meagher,Montana,2012,269,670,33,972,0.2767489711934156,0.6893004115226338,0.033950617283950615,-29,-11,46,6,-0.031739641643023286,-0.011598036960355801,0.043337678603379115,-401,-75,-0.41255144032921814,-0.0750773202464024
7993,30059,Meagher,Montana,2016,193,729,55,977,0.19754350051177072,0.7461617195496417,0.05629477993858751,-76,22,59,5,-0.07920547068164491,0.022344162654636894,0.05686130802700795,-536,-135,-0.548618219037871,-0.13606677870865286
7994,30061,Mineral,Montana,2000,382,1078,179,1639,0.23306894447834045,0.6577181208053692,0.10921293471629043,0,0,0,0,0.0,0.0,0.0,-696,0,-0.4246491763270287,0.0
7995,30061,Mineral,Montana,2004,542,1242,53,1837,0.2950462710941753,0.6761023407729995,0.02885138813282526,160,-126,164,198,0.061977326615834855,-0.08036154658346517,0.01838421996763029,-700,-4,-0.38105606967882416,0.04359310664820454
7996,30061,Mineral,Montana,2008,845,1053,99,1997,0.4231347020530796,0.5272909364046069,0.04957436154231347,303,46,-189,160,0.12808843095890432,0.02072297340948821,-0.14881140436839257,-208,492,-0.10415623435152727,0.2768998353272969
7997,30061,Mineral,Montana,2012,700,1216,105,2021,0.3463631865413162,0.6016823354774864,0.05195447798119743,-145,6,163,24,-0.07677151551176342,0.0023801164388839585,0.0743913990728795,-516,-308,-0.2553191489361702,-0.15116291458464293
7998,30061,Mineral,Montana,2016,519,1330,163,2012,0.25795228628230615,0.6610337972166997,0.08101391650099403,-181,58,114,-9,-0.08841090025901005,0.0290594385197966,0.05935146173921335,-811,-295,-0.4030815109343936,-0.1477623619982234
7999,30063,Missoula,Montana,2000,17241,21474,7861,46576,0.37016918584678804,0.46105290278254896,0.168777911370663,0,0,0,0,0.0,0.0,0.0,-4233,0,-0.09088371693576092,0.0
8000,30063,Missoula,Montana,2004,26983,23989,1482,52454,0.5144126282075724,0.45733404506805964,0.02825332672436802,9742,-6379,2515,5878,0.14424344236078435,-0.14052458464629497,-0.003718857714489321,2994,7227,0.05707858313951275,0.14796230007527367
8001,30063,Missoula,Montana,2008,36531,20743,2003,59277,0.6162761273343793,0.34993336369924255,0.03379050896637819,9548,521,-3246,6823,0.10186349912680692,0.0055371822420101705,-0.10740068136881709,15788,12794,0.26634276363513676,0.209264180495624
8002,30063,Missoula,Montana,2012,32824,22652,1756,57232,0.5735253005311713,0.3957925636007828,0.03068213586804585,-3707,-247,1909,-2045,-0.042750826803207964,-0.00310837309833234,0.04585919990154025,10172,-5616,0.17773273693038855,-0.08861002670474821
8003,30063,Missoula,Montana,2016,31543,22250,6929,60722,0.5194657619972992,0.3664240308290241,0.11411020717367676,-1281,5173,-402,3490,-0.05405953853387213,0.0834280713056309,-0.029368532771758715,9293,-879,0.15304173116827513,-0.024691005762113416
8004,30065,Musselshell,Montana,2000,512,1582,113,2207,0.23198912550974174,0.716810149524241,0.05120072496601722,0,0,0,0,0.0,0.0,0.0,-1070,0,-0.48482102401449934,0.0
8005,30065,Musselshell,Montana,2004,538,1663,46,2247,0.2394303515798843,0.7400979083222073,0.020471740097908322,26,-67,81,40,0.007441226070142554,-0.030728984868108898,0.023287758797966296,-1125,-55,-0.5006675567423231,-0.01584653272782377
8006,30065,Musselshell,Montana,2008,636,1581,89,2306,0.27580225498699046,0.6856027753686036,0.038594969644405897,98,43,-82,59,0.036371903407106165,0.018123229546497574,-0.05449513295360375,-945,180,-0.40980052038161313,0.09086703636070997
8007,30065,Musselshell,Montana,2012,492,1833,82,2407,0.2044038221852929,0.7615288741171583,0.03406730369754882,-144,-7,252,101,-0.07139843280169755,-0.004527665946857079,0.07592609874855472,-1341,-396,-0.5571250519318653,-0.1473245315502522
8008,30065,Musselshell,Montana,2016,332,1967,142,2441,0.1360098320360508,0.8058172879967227,0.058172879967226546,-160,60,134,34,-0.0683939901492421,0.024105576269677728,0.04428841387956439,-1635,-294,-0.6698074559606719,-0.11268240402880658
8009,30067,Park,Montana,2000,2154,4523,729,7406,0.29084526059951393,0.6107210369970294,0.09843370240345665,0,0,0,0,0.0,0.0,0.0,-2369,0,-0.31987577639751547,0.0
8010,30067,Park,Montana,2004,3199,4771,248,8218,0.389267461669506,0.580554879532733,0.030177658797761013,1045,-481,248,812,0.09842220106999205,-0.06825604360569565,-0.030166157464296406,-1572,797,-0.191287417863227,0.12858835853428846
8011,30067,Park,Montana,2008,4173,4376,349,8898,0.46898179366149695,0.4917959091930771,0.03922229714542594,974,101,-395,680,0.07971433199199096,0.009044638347664925,-0.08875897033965591,-203,1369,-0.022814115531580137,0.16847330233164687
8012,30067,Park,Montana,2012,3783,4709,276,8768,0.4314552919708029,0.537066605839416,0.031478102189781025,-390,-73,333,-130,-0.03752650169069405,-0.007744194955644913,0.045270696646338926,-926,-723,-0.10561131386861311,-0.08279719833703297
8013,30067,Park,Montana,2016,3595,4980,784,9359,0.38412223528154715,0.5321081312105994,0.08376963350785341,-188,508,271,591,-0.04733305668925575,0.05229153131807238,-0.0049584746288166,-1385,-459,-0.14798589592905226,-0.04237458206043915
8014,30069,Petroleum,Montana,2000,36,254,16,306,0.11764705882352941,0.8300653594771242,0.05228758169934641,0,0,0,0,0.0,0.0,0.0,-218,0,-0.7124183006535948,0.0
8015,30069,Petroleum,Montana,2004,55,228,9,292,0.18835616438356165,0.7808219178082192,0.030821917808219176,19,-7,-26,-14,0.07070910556003224,-0.02146566389112723,-0.04924344166890504,-173,45,-0.5924657534246576,0.11995254722893722
8016,30069,Petroleum,Montana,2008,68,227,5,300,0.22666666666666666,0.7566666666666667,0.016666666666666666,13,-4,-1,8,0.03831050228310501,-0.01415525114155251,-0.02415525114155248,-159,14,-0.53,0.062465753424657544
8017,30069,Petroleum,Montana,2012,49,240,9,298,0.1644295302013423,0.8053691275167785,0.030201342281879196,-19,4,13,-2,-0.06223713646532436,0.01353467561521253,0.04870246085011176,-191,-32,-0.6409395973154361,-0.11093959731543612
8018,30069,Petroleum,Montana,2016,30,278,14,322,0.09316770186335403,0.8633540372670807,0.043478260869565216,-19,5,38,24,-0.07126182833798826,0.01327691858768602,0.05798490975030224,-248,-57,-0.7701863354037267,-0.12924673808829057
8019,30071,Phillips,Montana,2000,423,1727,78,2228,0.18985637342908437,0.7751346499102334,0.03500897666068223,0,0,0,0,0.0,0.0,0.0,-1304,0,-0.585278276481149,0.0
8020,30071,Phillips,Montana,2004,456,1677,37,2170,0.21013824884792626,0.772811059907834,0.017050691244239632,33,-41,-50,-58,0.020281875418841883,-0.017958285416442597,-0.002323590002399345,-1221,83,-0.5626728110599077,0.02260546542124131
8021,30071,Phillips,Montana,2008,638,1423,62,2123,0.3005181347150259,0.6702779086198776,0.02920395666509656,182,25,-254,-47,0.09037988586709966,0.012153265420856929,-0.10253315128795648,-785,436,-0.36975977390485165,0.1929130371550561
8022,30071,Phillips,Montana,2012,471,1688,69,2228,0.2114003590664273,0.7576301615798923,0.03096947935368043,-167,7,265,105,-0.08911777564859863,0.001765522688583869,0.0873522529600147,-1217,-432,-0.546229802513465,-0.17647002860861333
8023,30071,Phillips,Montana,2016,318,1723,130,2171,0.14647627821280515,0.7936434822662367,0.059880239520958084,-153,61,35,-57,-0.06492408085362214,0.028910760167277654,0.03601332068634444,-1405,-188,-0.6471672040534315,-0.10093740153996655
8024,30073,Pondera,Montana,2000,792,1948,156,2896,0.27348066298342544,0.6726519337016574,0.05386740331491713,0,0,0,0,0.0,0.0,0.0,-1156,0,-0.399171270718232,0.0
8025,30073,Pondera,Montana,2004,956,1853,51,2860,0.33426573426573425,0.6479020979020979,0.01783216783216783,164,-105,-95,-36,0.06078507128230881,-0.0360352354827493,-0.024749835799559583,-897,259,-0.3136363636363636,0.0855349070818684
8026,30073,Pondera,Montana,2008,1223,1588,74,2885,0.4239168110918544,0.5504332755632583,0.025649913344887348,267,23,-265,25,0.08965107682612017,0.007817745512719517,-0.09746882233883958,-365,532,-0.12651646447140386,0.18711989916495975
8027,30073,Pondera,Montana,2012,975,1673,71,2719,0.35858771607208534,0.6152997425524089,0.0261125413755057,-248,-3,85,-166,-0.06532909501976908,0.00046262803061835125,0.06486646698915066,-698,-333,-0.2567120264803236,-0.13019556200891974
8028,30073,Pondera,Montana,2016,738,1799,186,2723,0.27102460521483657,0.6606683804627249,0.06830701432243849,-237,115,126,4,-0.08756311085724877,0.04219447294693279,0.04536863791031598,-1061,-363,-0.38964377524788835,-0.13293174876756475
8029,30075,Powder River,Montana,2000,115,860,33,1008,0.11408730158730158,0.8531746031746031,0.03273809523809524,0,0,0,0,0.0,0.0,0.0,-745,0,-0.7390873015873015,0.0
8030,30075,Powder River,Montana,2004,154,856,19,1029,0.14965986394557823,0.8318756073858115,0.0184645286686103,39,-14,-4,21,0.035572562358276646,-0.01427356656948494,-0.021298995788791686,-702,43,-0.6822157434402332,0.056871558147068346
8031,30075,Powder River,Montana,2008,208,802,28,1038,0.2003853564547206,0.7726396917148363,0.02697495183044316,54,9,-54,9,0.05072549250914238,0.00851042316183286,-0.05923591567097519,-594,108,-0.5722543352601157,0.10996140818011746
8032,30075,Powder River,Montana,2012,170,833,24,1027,0.1655306718597858,0.8111002921129503,0.023369036027263874,-38,-4,31,-11,-0.03485468459493482,-0.0036059158031792847,0.03846060039811405,-663,-69,-0.6455696202531646,-0.07331528499304885
8033,30075,Powder River,Montana,2016,127,884,42,1053,0.12060778727445394,0.8395061728395061,0.039886039886039885,-43,18,51,26,-0.04492288458533185,0.01651700385877601,0.02840588072655581,-757,-94,-0.7188983855650521,-0.07332876531188759
8034,30077,Powell,Montana,2000,638,1971,223,2832,0.2252824858757062,0.6959745762711864,0.07874293785310735,0,0,0,0,0.0,0.0,0.0,-1333,0,-0.4706920903954802,0.0
8035,30077,Powell,Montana,2004,761,1993,76,2830,0.268904593639576,0.7042402826855124,0.02685512367491166,123,-147,22,-2,0.043622107763869766,-0.051887814178195685,0.008265706414326002,-1232,101,-0.43533568904593645,0.035356401349543765
8036,30077,Powell,Montana,2008,1021,1683,110,2814,0.36282871357498225,0.5980810234541578,0.03909026297085998,260,34,-310,-16,0.09392411993540628,0.012235139295948324,-0.10615925923135461,-662,570,-0.23525230987917556,0.2000833791667609
8037,30077,Powell,Montana,2012,888,1806,83,2777,0.3197695354699316,0.6503420957868203,0.02988836874324811,-133,-27,123,-37,-0.043059178105050666,-0.009201894227611872,0.05226107233266253,-918,-256,-0.33057256031688875,-0.0953202504377132
8038,30077,Powell,Montana,2016,551,2029,214,2794,0.19720830350751611,0.7261989978525412,0.07659269863994274,-337,131,223,17,-0.12256123196241547,0.046704329896694624,0.07585690206572082,-1478,-560,-0.5289906943450251,-0.19841813402813635
8039,30079,Prairie,Montana,2000,164,541,41,746,0.21983914209115282,0.725201072386059,0.054959785522788206,0,0,0,0,0.0,0.0,0.0,-377,0,-0.5053619302949062,0.0
8040,30079,Prairie,Montana,2004,181,546,9,736,0.24592391304347827,0.7418478260869565,0.012228260869565218,17,-32,5,-10,0.026084770952325448,-0.04273152465322299,0.01664675370089752,-365,12,-0.49592391304347827,0.0094380172514279
8041,30079,Prairie,Montana,2008,211,503,21,735,0.2870748299319728,0.6843537414965987,0.02857142857142857,30,12,-43,-1,0.04115091688849454,0.01634316770186335,-0.057494084590357875,-292,73,-0.39727891156462586,0.09864500147885241
8042,30079,Prairie,Montana,2012,167,520,16,703,0.2375533428165007,0.7396870554765291,0.02275960170697013,-44,-5,17,-32,-0.04952148711547211,-0.005811826864458441,0.055333313979930465,-353,-61,-0.5021337126600285,-0.10485480109540263
8043,30079,Prairie,Montana,2016,100,556,33,689,0.14513788098693758,0.806966618287373,0.047895500725689405,-67,17,36,-14,-0.09241546182956312,0.025135899018719276,0.06727956281084391,-456,-103,-0.6618287373004355,-0.15969502464040697
8044,30081,Ravalli,Montana,2000,4451,11241,1546,17238,0.25820860888734193,0.6521058127392969,0.08968557837336118,0,0,0,0,0.0,0.0,0.0,-6790,0,-0.393897203851955,0.0
8045,30081,Ravalli,Montana,2004,6144,13279,444,19867,0.309256556098052,0.6683948255901747,0.022348618311773292,1693,-1102,2038,2629,0.0510479472107101,-0.06733696006158789,0.016289012850877804,-7135,-345,-0.3591382694921227,0.034758934359832294
8046,30081,Ravalli,Montana,2008,8400,13002,699,22101,0.3800732998506855,0.5882991719831682,0.03162752816614633,2256,255,-277,2234,0.07081674375263347,0.009278909854373036,-0.08009565360700655,-4602,2533,-0.20822587213248267,0.15091239735964002
8047,30081,Ravalli,Montana,2012,7285,14307,620,22212,0.3279758688996939,0.6441112911939492,0.027912839906356925,-1115,-79,1305,111,-0.05209743095099162,-0.0037146882597894025,0.055812119210781,-7022,-2420,-0.3161354222942553,-0.10790955016177262
8048,30081,Ravalli,Montana,2016,6223,14810,1523,22556,0.2758911154460011,0.6565880475261571,0.06752083702784181,-1062,903,503,344,-0.05208475345369279,0.039607997121484884,0.012476756332207906,-8587,-1565,-0.380696932080156,-0.0645615097859007
8049,30083,Richland,Montana,2000,1018,2858,157,4033,0.25241755516984876,0.7086536077361766,0.03892883709397471,0,0,0,0,0.0,0.0,0.0,-1840,0,-0.4562360525663278,0.0
8050,30083,Richland,Montana,2004,1120,3110,78,4308,0.25998142989786444,0.7219127205199629,0.018105849582172703,102,-79,252,275,0.007563874728015674,-0.020822987511802008,0.013259112783786331,-1990,-150,-0.4619312906220985,-0.005695238055770657
8051,30083,Richland,Montana,2008,1203,3184,129,4516,0.26638618246235607,0.7050487156775908,0.028565101860053146,83,51,74,208,0.006404752564491634,0.010459252277880443,-0.01686400484237216,-1981,9,-0.4386625332152347,0.023268757406863794
8052,30083,Richland,Montana,2012,1002,3510,136,4648,0.21557659208261618,0.7551635111876076,0.029259896729776247,-201,7,326,132,-0.050809590379739894,0.0006947948697231011,0.05011479551001685,-2508,-527,-0.5395869191049915,-0.10092438588975677
8053,30083,Richland,Montana,2016,671,3908,292,4871,0.13775405460890988,0.8022993225210429,0.05994662287004722,-331,156,398,223,-0.0778225374737063,0.030686726140270973,0.04713581133343525,-3237,-729,-0.664545267912133,-0.12495834880714152
8054,30085,Roosevelt,Montana,2000,2059,1605,149,3813,0.5399947547862576,0.4209284028324154,0.03907684238132704,0,0,0,0,0.0,0.0,0.0,454,0,0.11906635195384219,0.0
8055,30085,Roosevelt,Montana,2004,2195,1762,71,4028,0.54493545183714,0.4374379344587885,0.0176266137040715,136,-78,157,215,0.004940697050882403,-0.02145022867725554,0.016509531626373086,433,-21,0.1074975173783515,-0.011568834575490683
8056,30085,Roosevelt,Montana,2008,2564,1473,116,4153,0.61738502287503,0.3546833614254756,0.02793161569949434,369,45,-289,125,0.07244957103789007,0.010305001995422843,-0.0827545730333129,1091,658,0.2627016614495545,0.15520414407120298
8057,30085,Roosevelt,Montana,2012,2086,1514,72,3672,0.568082788671024,0.41230936819172115,0.0196078431372549,-478,-44,41,-481,-0.049302234204006035,-0.00832377256223944,0.057626006766245574,572,-519,0.15577342047930287,-0.10692824097025161
8058,30085,Roosevelt,Montana,2016,1560,1797,295,3652,0.42716319824753557,0.4920591456736035,0.0807776560788609,-526,223,283,-20,-0.14091959042348845,0.06116981294160599,0.07974977748188233,-237,-809,-0.06489594742606791,-0.22066936790537078
8059,30087,Rosebud,Montana,2000,1394,1826,203,3423,0.4072451066316097,0.5334501898919077,0.05930470347648262,0,0,0,0,0.0,0.0,0.0,-432,0,-0.12620508326029806,0.0
8060,30087,Rosebud,Montana,2004,1520,1982,83,3585,0.42398884239888424,0.5528591352859136,0.02315202231520223,126,-120,156,162,0.01674373576727456,-0.036152681161280384,0.01940894539400584,-462,-30,-0.12887029288702934,-0.0026652096267312797
8061,30087,Rosebud,Montana,2008,1919,1768,123,3810,0.5036745406824147,0.46404199475065616,0.03228346456692913,399,40,-214,225,0.07968569828353045,0.009131442251726903,-0.08881714053525741,151,613,0.03963254593175852,0.16850283881878786
8062,30087,Rosebud,Montana,2012,1422,2004,97,3523,0.4036332671019018,0.5688333806414987,0.02753335225659949,-497,-26,236,-287,-0.1000412735805129,-0.004750112310329645,0.10479138589084253,-582,-733,-0.1652001135395969,-0.20483265947135543
8063,30087,Rosebud,Montana,2016,987,2253,213,3453,0.2858384013900956,0.6524761077324066,0.06168549087749783,-435,116,249,-70,-0.1177948657118062,0.03415213862089834,0.08364272709090792,-1266,-684,-0.366637706342311,-0.20143759280271412
8064,30089,Sanders,Montana,2000,1165,3144,412,4721,0.2467697521711502,0.6659606015674645,0.0872696462613853,0,0,0,0,0.0,0.0,0.0,-1979,0,-0.41919084939631435,0.0
8065,30089,Sanders,Montana,2004,1502,3461,190,5153,0.29148069085969336,0.6716475839316903,0.03687172520861634,337,-222,317,432,0.04471093868854317,-0.050397921052768954,0.005686982364225823,-1959,20,-0.38016689307199697,0.03902395632431738
8066,30089,Sanders,Montana,2008,1970,3563,335,5868,0.33571915473755964,0.6071915473755964,0.0570892978868439,468,145,102,715,0.044238463877866285,0.02021757267822756,-0.06445603655609389,-1593,366,-0.2714723926380368,0.10869450043396017
8067,30089,Sanders,Montana,2012,1720,3980,201,5901,0.29147602101338754,0.6744619556007456,0.0340620233858668,-250,-134,417,33,-0.0442431337241721,-0.0230272745009771,0.06727040822514918,-2260,-667,-0.3829859345873581,-0.11151354194932128
8068,30089,Sanders,Montana,2016,1218,4286,449,5953,0.20460272131698304,0.7199731227952293,0.07542415588778767,-502,248,306,52,-0.0868732996964045,0.04136213250192087,0.04551116719448367,-3068,-808,-0.5153704014782463,-0.13238446689088823
8069,30091,Sheridan,Montana,2000,702,1176,87,1965,0.35725190839694654,0.5984732824427481,0.044274809160305344,0,0,0,0,0.0,0.0,0.0,-474,0,-0.24122137404580157,0.0
8070,30091,Sheridan,Montana,2004,846,1159,33,2038,0.4151128557409225,0.5686947988223748,0.01619234543670265,144,-54,-17,73,0.057860947343975955,-0.028082463723602694,-0.029778483620373275,-313,161,-0.15358194308145234,0.08763943096434923
8071,30091,Sheridan,Montana,2008,953,987,66,2006,0.47507477567298106,0.49202392821535396,0.03290129611166501,107,33,-172,-32,0.05996191993205857,0.016708950674962357,-0.07667087060702088,-34,279,-0.01694915254237289,0.13663279053907945
8072,30091,Sheridan,Montana,2012,665,1207,56,1928,0.3449170124481328,0.6260373443983402,0.029045643153526972,-288,-10,220,-78,-0.1301577632248483,-0.0038556529581380353,0.1340134161829863,-542,-508,-0.28112033195020747,-0.2641711794078346
8073,30091,Sheridan,Montana,2016,477,1241,117,1835,0.25994550408719347,0.6762942779291553,0.06376021798365122,-188,61,34,-93,-0.08497150836093931,0.03471457483012425,0.05025693353081506,-764,-222,-0.41634877384196184,-0.13522844189175437
8074,30093,Silver Bow,Montana,2000,8967,6299,1437,16703,0.5368496677243609,0.37711788301502724,0.08603244926061186,0,0,0,0,0.0,0.0,0.0,2668,0,0.1597317847093337,0.0
8075,30093,Silver Bow,Montana,2004,9307,6381,396,16084,0.5786495896543149,0.3967296692365083,0.024620741109176822,340,-1041,82,-619,0.041799921929953965,-0.06141170815143504,0.019611786221481076,2926,258,0.18191992041780658,0.02218813570847289
8076,30093,Silver Bow,Montana,2008,11676,4818,548,17042,0.6851308531862458,0.28271329656143646,0.032155850252317805,2369,152,-1563,958,0.10648126353193088,0.007535109143140983,-0.11401637267507186,6858,3932,0.4024175566248093,0.22049763620700275
8077,30093,Silver Bow,Montana,2012,10857,5430,469,16756,0.6479470040582478,0.32406302220100264,0.02798997374074958,-819,-79,612,-286,-0.03718384912799799,-0.004165876511568224,0.04134972563956618,5427,-1431,0.32388398185724515,-0.07853357476756417
8078,30093,Silver Bow,Montana,2016,8619,6376,1457,16452,0.5238876732312181,0.387551665451009,0.08856066131777292,-2238,988,946,-304,-0.12405933082702969,0.06057068757702334,0.06348864325000636,2243,-3184,0.1363360077802091,-0.18754797407703605
8079,30095,Stillwater,Montana,2000,925,2765,228,3918,0.23608984175599795,0.7057172026544155,0.05819295558958652,0,0,0,0,0.0,0.0,0.0,-1840,0,-0.46962736089841756,0.0
8080,30095,Stillwater,Montana,2004,1025,3090,98,4213,0.2432945644433895,0.7334441015903157,0.023261333966294803,100,-130,325,295,0.007204722687391557,-0.03493162162329172,0.02772689893590019,-2065,-225,-0.4901495371469262,-0.02052217624850866
8081,30095,Stillwater,Montana,2008,1512,2991,164,4667,0.3239768587958003,0.6408827940861367,0.03514034711806299,487,66,-99,454,0.08068229435241078,0.011879013151768189,-0.09256130750417901,-1479,586,-0.3169059352903364,0.17324360185658982
8082,30095,Stillwater,Montana,2012,1248,3337,117,4702,0.2654189706507869,0.7096980008507018,0.024883028498511272,-264,-47,346,35,-0.05855788814501339,-0.01025731861955172,0.0688152067645651,-2089,-610,-0.4442790301999149,-0.1273730949095785
8083,30095,Stillwater,Montana,2016,908,3661,304,4873,0.18633285450441206,0.751282577467679,0.062384568027908885,-340,187,324,171,-0.07908611614637484,0.03750153952939761,0.04158457661697723,-2753,-664,-0.564949722963267,-0.12067069276335207
8084,30097,Sweet Grass,Montana,2000,305,1450,91,1846,0.16522210184182015,0.7854821235102926,0.04929577464788732,0,0,0,0,0.0,0.0,0.0,-1145,0,-0.6202600216684724,0.0
8085,30097,Sweet Grass,Montana,2004,445,1509,29,1983,0.22440746343923348,0.7609682299546142,0.014624306606152295,140,-62,59,137,0.05918536159741333,-0.03467146804173503,-0.024513893555678345,-1064,81,-0.5365607665153808,0.08369925515309162
8086,30097,Sweet Grass,Montana,2008,541,1494,48,2083,0.2597215554488718,0.7172347575612098,0.023043686989918388,96,19,-15,100,0.03531409200963834,0.008419380383766092,-0.043733472393404416,-953,111,-0.457513202112338,0.07904756440304278
8087,30097,Sweet Grass,Montana,2012,475,1594,48,2117,0.22437411431270665,0.7529522909777988,0.02267359470949457,-66,0,100,34,-0.03534744113616517,-0.00037009228042381853,0.03571753341658901,-1119,-166,-0.5285781766650921,-0.07106497455275412
8088,30097,Sweet Grass,Montana,2016,402,1595,110,2107,0.19079259610821073,0.757000474608448,0.052206929283341245,-73,62,1,-10,-0.033581518204495925,0.029533334573846676,0.0040481836306491825,-1193,-74,-0.5662078785002372,-0.037629701835145135
8089,30099,Teton,Montana,2000,847,2294,173,3314,0.2555823777911889,0.692214846107423,0.05220277610138805,0,0,0,0,0.0,0.0,0.0,-1447,0,-0.4366324683162341,0.0
8090,30099,Teton,Montana,2004,1047,2232,80,3359,0.3116999106877047,0.6644834772253647,0.023816612086930634,200,-93,-62,45,0.056117532896515776,-0.028386164014457416,-0.027731368882058294,-1185,262,-0.35278356653766,0.08384890177857407
8091,30099,Teton,Montana,2008,1294,1874,104,3272,0.3954767726161369,0.5727383863080685,0.03178484107579462,247,24,-358,-87,0.0837768619284322,0.007968228988863988,-0.09174509091729621,-580,605,-0.1772616136919316,0.1755219528457284
8092,30099,Teton,Montana,2012,1082,2113,86,3281,0.3297775068576653,0.6440109722645535,0.026211520877781166,-212,-18,239,9,-0.06569926575847157,-0.005573320198013456,0.071272585956485,-1031,-451,-0.3142334654068882,-0.13697185171495657
8093,30099,Teton,Montana,2016,808,2170,210,3188,0.2534504391468005,0.6806775407779172,0.06587202007528231,-274,124,57,-93,-0.07632706771086484,0.03966049919750114,0.036666568513363695,-1362,-331,-0.4272271016311167,-0.11299363622422853
8094,30101,Toole,Montana,2000,630,1639,109,2378,0.2649285113540791,0.6892346509671994,0.04583683767872161,0,0,0,0,0.0,0.0,0.0,-1009,0,-0.4243061396131203,0.0
8095,30101,Toole,Montana,2004,690,1583,38,2311,0.298572046733016,0.6849848550411077,0.016443098225876245,60,-71,-56,-67,0.03364353537893694,-0.029393739452845367,-0.0042497959260916485,-893,116,-0.3864128083080917,0.03789333130502859
8096,30101,Toole,Montana,2008,737,1317,67,2121,0.3474776049033475,0.620933521923621,0.031588873173031586,47,29,-266,-190,0.04890555817033149,0.015145774947155341,-0.06405133311748679,-580,313,-0.27345591702027344,0.11295689128781827
8097,30101,Toole,Montana,2012,582,1440,80,2102,0.2768791627021884,0.6850618458610847,0.038058991436726926,-155,13,123,-19,-0.07059844220115913,0.00647011826369534,0.0641283239374637,-858,-278,-0.4081826831588963,-0.13472676613862283
8098,30101,Toole,Montana,2016,402,1497,138,2037,0.19734904270986744,0.7349042709867453,0.06774668630338733,-180,58,57,-65,-0.07953011999232093,0.029687694866660404,0.04984242512566062,-1095,-237,-0.5375552282768779,-0.12937254511798157
8099,30103,Treasure,Montana,2000,106,344,29,479,0.22129436325678498,0.7181628392484343,0.060542797494780795,0,0,0,0,0.0,0.0,0.0,-238,0,-0.4968684759916493,0.0
8100,30103,Treasure,Montana,2004,121,348,13,482,0.25103734439834025,0.7219917012448133,0.026970954356846474,15,-16,4,3,0.02974298114155527,-0.03357184313793432,0.003828861996378996,-227,11,-0.470954356846473,0.025914119145176273
8101,30103,Treasure,Montana,2008,156,314,16,486,0.32098765432098764,0.6460905349794238,0.03292181069958848,35,3,-34,4,0.06995030992264739,0.005950856342742006,-0.07590116626538945,-158,69,-0.3251028806584362,0.14585147618803684
8102,30103,Treasure,Montana,2012,114,319,22,455,0.25054945054945055,0.701098901098901,0.04835164835164835,-42,6,5,-31,-0.07043820377153709,0.015429837652059873,0.05500836611947724,-205,-47,-0.4505494505494505,-0.12544656989101433
8103,30103,Treasure,Montana,2016,59,351,33,443,0.13318284424379231,0.7923250564334086,0.0744920993227991,-55,11,32,-12,-0.11736660630565823,0.026140450971150746,0.09122615533450751,-292,-87,-0.6591422121896162,-0.2085927616401657
8104,30105,Valley,Montana,2000,1273,2500,190,3963,0.32122129699722435,0.6308352258390109,0.047943477163764826,0,0,0,0,0.0,0.0,0.0,-1227,0,-0.3096139288417865,0.0
8105,30105,Valley,Montana,2004,1431,2476,111,4018,0.3561473369835739,0.6162269785963166,0.027625684420109507,158,-79,-24,55,0.03492603998634958,-0.02031779274365532,-0.014608247242694272,-1045,182,-0.26007964161274266,0.04953428722904385
8106,30105,Valley,Montana,2008,1645,2121,145,3911,0.42060854001534137,0.5423165430836103,0.037074916901048326,214,34,-355,-107,0.06446120303176744,0.009449232480938818,-0.07391043551270626,-476,569,-0.12170800306826896,0.1383716385444737
8107,30105,Valley,Montana,2012,1385,2337,137,3859,0.35890126975900494,0.6055973050012957,0.0355014252396994,-260,-8,216,-52,-0.06170727025633643,-0.0015734916613489233,0.06328076191768539,-952,-476,-0.24669603524229078,-0.12498803217402182
8108,30105,Valley,Montana,2016,886,2698,310,3894,0.22752953261427838,0.6928608115048793,0.07960965588084232,-499,173,361,35,-0.13137173714472655,0.044108230641142915,0.08726350650358361,-1812,-860,-0.46533127889060094,-0.21863524364831016
8109,30107,Wheatland,Montana,2000,243,708,48,999,0.24324324324324326,0.7087087087087087,0.04804804804804805,0,0,0,0,0.0,0.0,0.0,-465,0,-0.46546546546546547,0.0
8110,30107,Wheatland,Montana,2004,250,706,23,979,0.2553626149131767,0.7211440245148111,0.02349336057201226,7,-25,-2,-20,0.012119371669933432,-0.02455468747603579,0.012435315806102354,-456,9,-0.4657814096016344,-0.0003159441361689219
8111,30107,Wheatland,Montana,2008,289,657,37,983,0.29399796541200407,0.6683621566632757,0.03763987792472025,39,14,-49,4,0.03863535049882738,0.014146517352707989,-0.05278186785153538,-368,88,-0.3743641912512716,0.09141721835036276
8112,30107,Wheatland,Montana,2012,272,693,27,992,0.27419354838709675,0.6985887096774194,0.02721774193548387,-17,-10,36,9,-0.019804417024907317,-0.010422135989236376,0.030226553014143676,-421,-53,-0.4243951612903226,-0.05003097003905099
8113,30107,Wheatland,Montana,2016,179,702,65,946,0.18921775898520085,0.7420718816067653,0.06871035940803383,-93,38,9,-46,-0.0849757894018959,0.04149261747254995,0.04348317192934592,-523,-102,-0.5528541226215644,-0.1284589613312418
8114,30109,Wibaux,Montana,2000,121,369,28,518,0.2335907335907336,0.7123552123552124,0.05405405405405406,0,0,0,0,0.0,0.0,0.0,-248,0,-0.4787644787644788,0.0
8115,30109,Wibaux,Montana,2004,144,407,9,560,0.2571428571428571,0.7267857142857143,0.01607142857142857,23,-19,38,42,0.02355212355212352,-0.03798262548262549,0.014430501930501882,-263,-15,-0.46964285714285714,0.009121621621621667
8116,30109,Wibaux,Montana,2008,146,379,38,563,0.25932504440497334,0.6731793960923623,0.0674955595026643,2,29,-28,3,0.0021821872621162197,0.051424130931235726,-0.05360631819335193,-233,30,-0.413854351687389,0.05578850545546815
8117,30109,Wibaux,Montana,2012,98,421,25,544,0.1801470588235294,0.7738970588235294,0.04595588235294118,-48,-13,42,-19,-0.07917798558144393,-0.021539677149723116,0.10071766273116711,-323,-90,-0.59375,-0.179895648312611
8118,30109,Wibaux,Montana,2016,55,463,23,541,0.10166358595194085,0.8558225508317929,0.04251386321626617,-43,-2,42,-3,-0.07848347287158856,-0.003442019136675009,0.08192549200826349,-408,-85,-0.7541589648798521,-0.16040896487985212
8119,30111,Yellowstone,Montana,2000,20370,33922,3207,57499,0.3542670307309692,0.5899580862275866,0.0557748830414442,0,0,0,0,0.0,0.0,0.0,-13552,0,-0.2356910554966174,0.0
8120,30111,Yellowstone,Montana,2004,24120,40903,1263,66286,0.3638777419062849,0.6170684609118064,0.019053797181908697,3750,-1944,6981,8787,0.0096107111753157,-0.0367210858595355,0.02711037468421984,-16783,-3231,-0.25319071900552154,-0.01749966350890414
8121,30111,Yellowstone,Montana,2008,32038,36483,2158,70679,0.4532888128015394,0.5161787801185642,0.030532407079896434,7918,895,-4420,4393,0.08941107089525446,0.011478609897987737,-0.10088968079324223,-4445,12338,-0.06288996731702484,0.1903007516884967
8122,30111,Yellowstone,Montana,2012,26403,40500,1904,68807,0.3837254930457657,0.5886029037743253,0.02767160317990902,-5635,-254,4017,-1872,-0.06956331975577368,-0.002860803899987413,0.07242412365576112,-14097,-9652,-0.20487741072855964,-0.1419874434115348
8123,30111,Yellowstone,Montana,2016,22171,40920,7395,70486,0.3145447322872627,0.5805408166160656,0.10491445109667168,-4232,5491,420,1679,-0.06918076075850299,0.07724284791676266,-0.008062087158259734,-18749,-4652,-0.2659960843288029,-0.061118673600243256
8124,31001,Adams,Nebraska,2000,3686,8162,590,12438,0.2963498954815887,0.6562148255346518,0.047435278983759446,0,0,0,0,0.0,0.0,0.0,-4476,0,-0.35986493005306314,0.0
8125,31001,Adams,Nebraska,2004,3791,9233,262,13286,0.2853379497215114,0.6949420442571127,0.019720006021375885,105,-328,1071,848,-0.011011945760077302,-0.02771527296238356,0.03872721872246088,-5442,-966,-0.4096040945356013,-0.04973916448253818
8126,31001,Adams,Nebraska,2008,4685,8252,273,13210,0.3546555639666919,0.6246782740348221,0.020666161998485994,894,11,-981,-76,0.06931761424518051,0.0009461559771101087,-0.07026377022229058,-3567,1875,-0.2700227100681302,0.1395813844674711
8127,31001,Adams,Nebraska,2012,4062,8316,292,12670,0.3205998421468035,0.656353591160221,0.023046566692975532,-623,19,64,-540,-0.03405572181988842,0.002380404694489538,0.03167531712539884,-4254,-687,-0.3357537490134175,-0.06573103894528726
8128,31001,Adams,Nebraska,2016,3302,9287,924,13513,0.2443572855768519,0.6872641160364094,0.0683785983867387,-760,632,971,843,-0.07624255656995158,0.04533203169376317,0.030910524876188394,-5985,-1731,-0.4429068304595575,-0.10715308144614
8129,31003,Antelope,Nebraska,2000,678,2562,128,3368,0.2013064133016627,0.7606888361045131,0.03800475059382423,0,0,0,0,0.0,0.0,0.0,-1884,0,-0.5593824228028503,0.0
8130,31003,Antelope,Nebraska,2004,613,2761,50,3424,0.1790303738317757,0.8063668224299065,0.014602803738317757,-65,-78,199,56,-0.022276039469887016,-0.02340194685550647,0.04567798632539344,-2148,-264,-0.6273364485981309,-0.06795402579528054
8131,31003,Antelope,Nebraska,2008,757,2383,45,3185,0.23767660910518054,0.7481946624803768,0.0141287284144427,144,-5,-378,-239,0.058646235273404845,-0.00047407532387505613,-0.058172159949529734,-1626,522,-0.5105180533751963,0.11681839522293458
8132,31003,Antelope,Nebraska,2012,571,2596,65,3232,0.1766707920792079,0.8032178217821783,0.020111386138613862,-186,20,213,47,-0.06100581702597263,0.005982657724171161,0.05502315930180146,-2025,-399,-0.6265470297029704,-0.11602897632777409
8133,31003,Antelope,Nebraska,2016,383,2732,166,3281,0.11673270344407193,0.8326729655592807,0.05059433099664736,-188,101,136,49,-0.059938088635135986,0.0304829448580335,0.029455143777102455,-2349,-324,-0.7159402621152088,-0.0893932324122384
8134,31005,Arthur,Nebraska,2000,26,235,11,272,0.09558823529411764,0.8639705882352942,0.04044117647058824,0,0,0,0,0.0,0.0,0.0,-209,0,-0.7683823529411765,0.0
8135,31005,Arthur,Nebraska,2004,24,240,2,266,0.09022556390977443,0.9022556390977443,0.007518796992481203,-2,-9,5,-6,-0.0053626713843432094,-0.032922379478107035,0.038285050862450154,-216,-7,-0.8120300751879699,-0.04364772224679336
8136,31005,Arthur,Nebraska,2008,39,217,7,263,0.1482889733840304,0.8250950570342205,0.026615969581749048,15,5,-23,-3,0.05806340947425598,0.019097172589267845,-0.07716058206352383,-178,38,-0.6768060836501901,0.13522399153777975
8137,31005,Arthur,Nebraska,2012,30,227,5,262,0.11450381679389313,0.8664122137404581,0.019083969465648856,-9,-2,10,-1,-0.03378515659013728,-0.0075320001161001925,0.04131715670623759,-197,-19,-0.751908396946565,-0.07510231329637485
8138,31005,Arthur,Nebraska,2016,17,244,12,273,0.06227106227106227,0.8937728937728938,0.04395604395604396,-13,7,17,11,-0.052232754522830854,0.024872074490395104,0.027360680032435747,-227,-30,-0.8315018315018315,-0.07959343455526657
8139,31007,Banner,Nebraska,2000,65,390,7,462,0.1406926406926407,0.8441558441558441,0.015151515151515152,0,0,0,0,0.0,0.0,0.0,-325,0,-0.7034632034632033,0.0
8140,31007,Banner,Nebraska,2004,56,379,2,437,0.12814645308924486,0.8672768878718535,0.004576659038901602,-9,-5,-11,-25,-0.012546187603395847,-0.010574856112613551,0.023121043716009426,-323,2,-0.7391304347826086,-0.0356672313194053
8141,31007,Banner,Nebraska,2008,62,348,6,416,0.14903846153846154,0.8365384615384616,0.014423076923076924,6,4,-31,-21,0.02089200844921668,0.009846417884175323,-0.030738426333391966,-286,37,-0.6875,0.05163043478260865
8142,31007,Banner,Nebraska,2012,55,346,10,411,0.13381995133819952,0.8418491484184915,0.024330900243309004,-7,4,-2,-5,-0.01521851020026202,0.00990782332023208,0.005310686880029891,-291,-5,-0.7080291970802919,-0.020529197080291883
8143,31007,Banner,Nebraska,2016,19,357,26,402,0.0472636815920398,0.8880597014925373,0.06467661691542288,-36,16,11,-9,-0.08655626974615971,0.04034571667211388,0.04621055307404587,-338,-47,-0.8407960199004976,-0.1327668228202057
8144,31009,Blaine,Nebraska,2000,43,299,7,349,0.12320916905444126,0.8567335243553008,0.02005730659025788,0,0,0,0,0.0,0.0,0.0,-256,0,-0.7335243553008596,0.0
8145,31009,Blaine,Nebraska,2004,38,301,0,339,0.11209439528023599,0.887905604719764,0.0,-5,-7,2,-10,-0.011114773774205278,-0.02005730659025788,0.031172080364463173,-263,-7,-0.775811209439528,-0.042286854138668395
8146,31009,Blaine,Nebraska,2008,43,266,7,316,0.1360759493670886,0.8417721518987342,0.022151898734177215,5,7,-35,-23,0.023981554086852624,0.022151898734177215,-0.04613345282102976,-223,40,-0.7056962025316456,0.07011500690788242
8147,31009,Blaine,Nebraska,2012,29,268,6,303,0.09570957095709572,0.8844884488448845,0.019801980198019802,-14,-1,2,-13,-0.040366378409992895,-0.002349918536157413,0.04271629694615031,-239,-16,-0.7887788778877888,-0.08308267535614322
8148,31009,Blaine,Nebraska,2016,30,276,11,317,0.0946372239747634,0.8706624605678234,0.03470031545741325,1,5,8,14,-0.0010723469823323145,0.014898335259393446,-0.013825988277061163,-246,-7,-0.77602523659306,0.01275364129472878
8149,31011,Boone,Nebraska,2000,575,2196,91,2862,0.20090845562543674,0.7672955974842768,0.03179594689028651,0,0,0,0,0.0,0.0,0.0,-1621,0,-0.56638714185884,0.0
8150,31011,Boone,Nebraska,2004,546,2309,40,2895,0.18860103626943006,0.7975820379965458,0.013816925734024179,-29,-51,113,33,-0.012307419356006682,-0.01797902115626233,0.03028644051226903,-1763,-142,-0.6089810017271158,-0.042593859868275796
8151,31011,Boone,Nebraska,2008,742,2042,52,2836,0.2616361071932299,0.7200282087447109,0.018335684062059238,196,12,-267,-59,0.07303507092379982,0.004518758328035059,-0.07755382925183496,-1300,463,-0.45839210155148097,0.1505889001756348
8152,31011,Boone,Nebraska,2012,615,2138,53,2806,0.21917320028510334,0.7619387027797576,0.018888096935138987,-127,1,96,-30,-0.04246290690812654,0.0005524128730797495,0.041910494035046764,-1523,-223,-0.5427655024946543,-0.0843734009431733
8153,31011,Boone,Nebraska,2016,414,2299,192,2905,0.14251290877796902,0.791394148020654,0.06609294320137693,-201,139,161,99,-0.07666029150713433,0.04720484626623794,0.029455445240896383,-1885,-362,-0.648881239242685,-0.10611573674803076
8154,31013,Box Butte,Nebraska,2000,1614,3208,267,5089,0.3171546472784437,0.6303792493613677,0.05246610336018864,0,0,0,0,0.0,0.0,0.0,-1594,0,-0.31322460208292396,0.0
8155,31013,Box Butte,Nebraska,2004,1657,3396,99,5152,0.32162267080745344,0.6591614906832298,0.019215838509316772,43,-168,188,63,0.0044680235290097126,-0.033250264850871875,0.028782241321862134,-1739,-145,-0.3375388198757764,-0.02431421779285242
8156,31013,Box Butte,Nebraska,2008,1886,2932,161,4979,0.3787909218718618,0.5888732677244427,0.03233581040369552,229,62,-464,-173,0.05716825106440837,0.01311997189437875,-0.07028822295878712,-1046,693,-0.2100823458525809,0.1274564740231955
8157,31013,Box Butte,Nebraska,2012,1692,2869,144,4705,0.3596174282678002,0.6097768331562168,0.030605738575982998,-194,-17,-63,-274,-0.01917349360406162,-0.0017300718277125232,0.020903565431774074,-1177,-131,-0.2501594048884166,-0.040077059035835694
8158,31013,Box Butte,Nebraska,2016,965,3617,342,4924,0.19597887896019497,0.7345653939886271,0.0694557270511779,-727,198,748,219,-0.1636385493076052,0.038849988475194906,0.1247885608324103,-2652,-1475,-0.5385865150284321,-0.28842711014001554
8159,31015,Boyd,Nebraska,2000,265,931,46,1242,0.21336553945249598,0.749597423510467,0.037037037037037035,0,0,0,0,0.0,0.0,0.0,-666,0,-0.536231884057971,0.0
8160,31015,Boyd,Nebraska,2004,228,911,9,1148,0.1986062717770035,0.7935540069686411,0.0078397212543554,-37,-37,-20,-94,-0.014759267675492488,-0.029197315782681636,0.0439565834581741,-683,-17,-0.5949477351916376,-0.05871585113366662
8161,31015,Boyd,Nebraska,2008,250,839,21,1110,0.22522522522522523,0.7558558558558559,0.01891891891891892,22,12,-72,-38,0.026618953448221738,0.01107919766456352,-0.03769815111278518,-589,94,-0.5306306306306307,0.06431710456100692
8162,31015,Boyd,Nebraska,2012,188,873,10,1071,0.17553688141923435,0.8151260504201681,0.009337068160597572,-62,-11,34,-39,-0.04968834380599088,-0.009581850758321348,0.05927019456431215,-685,-96,-0.6395891690009337,-0.108958538370303
8163,31015,Boyd,Nebraska,2016,128,983,45,1156,0.11072664359861592,0.8503460207612457,0.03892733564013841,-60,35,110,85,-0.06481023782061843,0.029590267479540834,0.0352199703410776,-855,-170,-0.7396193771626297,-0.10003020816169605
8164,31017,Brown,Nebraska,2000,250,1375,59,1684,0.14845605700712589,0.8165083135391924,0.03503562945368171,0,0,0,0,0.0,0.0,0.0,-1125,0,-0.6680522565320666,0.0
8165,31017,Brown,Nebraska,2004,268,1426,39,1733,0.15464512406231967,0.8228505481823427,0.022504327755337564,18,-20,51,49,0.0061890670551937865,-0.012531301698344145,0.006342234643150313,-1158,-33,-0.668205424120023,-0.0001531675879564709
8166,31017,Brown,Nebraska,2008,311,1208,48,1567,0.198468410976388,0.7708998085513721,0.03063178047223995,43,9,-218,-166,0.04382328691406834,0.008127452716902385,-0.05195073963097063,-897,261,-0.5724313975749841,0.09577402654503897
8167,31017,Brown,Nebraska,2012,224,1302,29,1555,0.1440514469453376,0.8372990353697749,0.01864951768488746,-87,-19,94,-12,-0.0544169640310504,-0.01198226278735249,0.06639922681840282,-1078,-181,-0.6932475884244373,-0.12081619084945328
8168,31017,Brown,Nebraska,2016,153,1385,59,1597,0.09580463368816532,0.8672510958046337,0.036944270507201005,-71,30,83,42,-0.0482468132571723,0.018294752822313545,0.029952060434858763,-1232,-154,-0.7714464621164684,-0.07819887369203105
8169,31019,Buffalo,Nebraska,2000,3927,11931,603,16461,0.2385638782577,0.7248040823765264,0.036632039365773646,0,0,0,0,0.0,0.0,0.0,-8004,0,-0.4862402041188264,0.0
8170,31019,Buffalo,Nebraska,2004,4100,14222,286,18608,0.220335339638865,0.7642949269131556,0.015369733447979364,173,-317,2291,2147,-0.018228538618835,-0.02126230591779428,0.03949084453662921,-10122,-2118,-0.5439595872742906,-0.05771938315546421
8171,31019,Buffalo,Nebraska,2008,5867,13097,329,19293,0.304099932618048,0.6788472502980356,0.017052817083916448,1767,43,-1125,685,0.08376459297918301,0.0016830836359370844,-0.08544767661511998,-7230,2892,-0.3747473176799876,0.16921226959430302
8172,31019,Buffalo,Nebraska,2012,5365,13570,518,19453,0.275792936822084,0.6975787796226803,0.026628283555235697,-502,189,473,160,-0.02830699579596402,0.009575466471319249,0.018731529324644725,-8205,-975,-0.42178584280059633,-0.04703852512060874
8173,31019,Buffalo,Nebraska,2016,4763,14569,1797,21129,0.22542477164087274,0.6895262435515169,0.08504898480761039,-602,1279,999,1676,-0.05036816518121126,0.058420701252374696,-0.008052536071163408,-9806,-1601,-0.4641014719106442,-0.04231562911004788
8174,31021,Burt,Nebraska,2000,1223,2056,113,3392,0.3605542452830189,0.6061320754716981,0.03331367924528302,0,0,0,0,0.0,0.0,0.0,-833,0,-0.24557783018867924,0.0
8175,31021,Burt,Nebraska,2004,1272,2349,47,3668,0.346782988004362,0.6404034896401308,0.012813522355507088,49,-66,293,276,-0.013771257278656857,-0.020500156889775932,0.03427141416843271,-1077,-244,-0.2936205016357688,-0.04804267144708957
8176,31021,Burt,Nebraska,2008,1413,1907,67,3387,0.4171833480956599,0.5630351343371716,0.019781517567168585,141,20,-442,-281,0.07040036009129785,0.006967995211661497,-0.07736835530295927,-494,583,-0.14585178624151168,0.14776871539425712
8177,31021,Burt,Nebraska,2012,1291,2029,55,3375,0.38251851851851854,0.6011851851851852,0.016296296296296295,-122,-12,122,-12,-0.03466482957714134,-0.00348522127087229,0.038150050848013595,-738,-244,-0.21866666666666662,-0.07281488042515494
8178,31021,Burt,Nebraska,2016,930,2367,261,3558,0.26138279932546377,0.6652613827993255,0.0733558178752108,-361,206,338,183,-0.12113571919305477,0.0570595215789145,0.0640761976141403,-1437,-699,-0.4038785834738617,-0.18521191680719507
8179,31023,Butler,Nebraska,2000,1028,2638,162,3828,0.26854754440961337,0.6891327063740856,0.04231974921630094,0,0,0,0,0.0,0.0,0.0,-1610,0,-0.42058516196447226,0.0
8180,31023,Butler,Nebraska,2004,1068,3016,84,4168,0.2562380038387716,0.7236084452975048,0.02015355086372361,40,-78,378,340,-0.01230954057084177,-0.02216619835257733,0.03447573892341915,-1948,-338,-0.4673704414587332,-0.04678527949426092
8181,31023,Butler,Nebraska,2008,1190,2557,92,3839,0.3099765563948945,0.6660588694972649,0.023964574107840583,122,8,-459,-329,0.05373855255612292,0.0038110232441169734,-0.057549575800239894,-1367,581,-0.3560823131023704,0.11128812835636281
8182,31023,Butler,Nebraska,2012,1045,2738,76,3859,0.2707955428867582,0.7095102358123866,0.019694221300855144,-145,-16,181,20,-0.0391810135081363,-0.004270352806985438,0.0434513663151217,-1693,-326,-0.43871469292562837,-0.082632379823258
8183,31023,Butler,Nebraska,2016,691,3079,211,3981,0.17357447877417734,0.7734237628736499,0.05300175835217282,-354,135,341,122,-0.09722106411258088,0.03330753705131768,0.0639135270612633,-2388,-695,-0.5998492840994726,-0.1611345911738442
8184,31025,Cass,Nebraska,2000,3656,6144,480,10280,0.3556420233463035,0.5976653696498054,0.04669260700389105,0,0,0,0,0.0,0.0,0.0,-2488,0,-0.24202334630350192,0.0
8185,31025,Cass,Nebraska,2004,3619,7763,147,11529,0.31390406800242865,0.6733454766241651,0.012750455373406194,-37,-333,1619,1249,-0.041737955343874866,-0.033942151630484856,0.07568010697435967,-4144,-1656,-0.35944140862173646,-0.11741806231823454
8186,31025,Cass,Nebraska,2008,4753,7120,249,12122,0.3920970136941099,0.5873618214816037,0.02054116482428642,1134,102,-643,593,0.07819294569168123,0.007790709450880227,-0.08598365514256145,-2367,1777,-0.19526480778749378,0.16417660083424268
8187,31025,Cass,Nebraska,2012,4367,7556,257,12180,0.35853858784893267,0.6203612479474548,0.02110016420361248,-386,8,436,58,-0.03355842584517721,0.0005589993793260577,0.03299942646585119,-3189,-822,-0.2618226600985222,-0.0665578523110284
8188,31025,Cass,Nebraska,2016,3484,8452,997,12933,0.26938838629861594,0.653521997989639,0.07708961571174515,-883,740,896,753,-0.08915020155031672,0.05598945150813267,0.033160750042184106,-4968,-1779,-0.384133611691023,-0.12231095159250083
8189,31027,Cedar,Nebraska,2000,1062,2989,218,4269,0.24877020379479972,0.7001639728273601,0.05106582337784024,0,0,0,0,0.0,0.0,0.0,-1927,0,-0.45139376903256034,0.0
8190,31027,Cedar,Nebraska,2004,1083,3387,66,4536,0.23875661375661375,0.7466931216931217,0.01455026455026455,21,-152,398,267,-0.010013590038185971,-0.03651555882757569,0.04652914886576165,-2304,-377,-0.507936507936508,-0.056542738903947676
8191,31027,Cedar,Nebraska,2008,1190,2912,72,4174,0.28509822712026833,0.6976521322472449,0.017249640632486823,107,6,-475,-362,0.04634161336365458,0.002699376082222274,-0.04904098944587687,-1722,582,-0.41255390512697654,0.09538260280953148
8192,31027,Cedar,Nebraska,2012,958,3278,98,4334,0.22104291647438856,0.7563451776649747,0.022611905860636824,-232,26,366,160,-0.06405531064587977,0.00536226522815,0.058693045417729794,-2320,-598,-0.5353022611905861,-0.12274835606360956
8193,31027,Cedar,Nebraska,2016,571,3532,317,4420,0.12918552036199096,0.7990950226244344,0.07171945701357466,-387,219,254,86,-0.0918573961123976,0.04910755115293783,0.04274984495945977,-2961,-641,-0.6699095022624435,-0.1346072410718574
8194,31029,Chase,Nebraska,2000,306,1505,64,1875,0.1632,0.8026666666666666,0.034133333333333335,0,0,0,0,0.0,0.0,0.0,-1199,0,-0.6394666666666666,0.0
8195,31029,Chase,Nebraska,2004,302,1652,19,1973,0.15306639635073493,0.8373035985808414,0.00963000506842372,-4,-45,147,98,-0.010133603649265077,-0.024503328264909613,0.03463693191417472,-1350,-151,-0.6842372022301064,-0.044770535563439795
8196,31029,Chase,Nebraska,2008,341,1477,26,1844,0.18492407809110628,0.8009761388286334,0.014099783080260303,39,7,-175,-129,0.031857681740371346,0.004469778011836583,-0.03632745975220797,-1136,214,-0.616052060737527,0.06818514149257937
8197,31029,Chase,Nebraska,2012,254,1584,29,1867,0.13604713444027852,0.8484199250133905,0.015532940546331012,-87,3,107,23,-0.04887694365082776,0.001433157466070709,0.047443786184757086,-1330,-194,-0.712372790573112,-0.09632072983558493
8198,31029,Chase,Nebraska,2016,171,1648,79,1898,0.09009483667017913,0.8682824025289779,0.04162276080084299,-83,50,64,31,-0.04595229777009939,0.02608982025451198,0.01986247751558745,-1477,-147,-0.7781875658587988,-0.0658147752856868
8199,31031,Cherry,Nebraska,2000,446,2322,79,2847,0.156656129258869,0.815595363540569,0.027748507200561996,0,0,0,0,0.0,0.0,0.0,-1876,0,-0.6589392342817001,0.0
8200,31031,Cherry,Nebraska,2004,483,2509,50,3042,0.15877712031558186,0.8247863247863247,0.01643655489809336,37,-29,187,195,0.002120991056712873,-0.011311952302468637,0.009190961245755691,-2026,-150,-0.6660092044707429,-0.007069970189042762
8201,31031,Cherry,Nebraska,2008,599,2360,100,3059,0.19581562602157568,0.7714939522719844,0.032690421706440015,116,50,-149,17,0.03703850570599382,0.016253866808346656,-0.05329237251434038,-1761,265,-0.5756783262504087,0.09033087822033414
8202,31031,Cherry,Nebraska,2012,436,2557,71,3064,0.1422976501305483,0.8345300261096605,0.023172323759791124,-163,-29,197,5,-0.053517975891027386,-0.009518097946648891,0.06303607383767618,-2121,-360,-0.6922323759791122,-0.11655404972870353
8203,31031,Cherry,Nebraska,2016,317,2623,178,3118,0.10166773572803078,0.8412443874278384,0.05708787684413085,-119,107,66,54,-0.04062991440251751,0.03391555308433973,0.0067143613181778194,-2306,-185,-0.7395766516998076,-0.04734427572069533
8204,31033,Cheyenne,Nebraska,2000,844,3207,135,4186,0.2016244624940277,0.7661251791686574,0.032250358337314856,0,0,0,0,0.0,0.0,0.0,-2363,0,-0.5645007166746296,0.0
8205,31033,Cheyenne,Nebraska,2004,893,3791,62,4746,0.18815844922039612,0.7987779182469448,0.013063632532659082,49,-73,584,560,-0.013466013273631589,-0.019186725804655774,0.03265273907828736,-2898,-535,-0.6106194690265486,-0.04611875235191898
8206,31033,Cheyenne,Nebraska,2008,1173,3572,94,4839,0.24240545567265964,0.7381690431907418,0.01942550113659847,280,32,-219,93,0.05424700645226352,0.006361868603939388,-0.06060887505620294,-2399,499,-0.4957635875180822,0.11485588150846643
8207,31033,Cheyenne,Nebraska,2012,1084,3449,116,4649,0.23316842331684234,0.7418799741879974,0.02495160249516025,-89,22,-123,-190,-0.009237032355817298,0.0055261013585617795,0.0037109309972556126,-2365,34,-0.508711550871155,-0.012947963353072856
8208,31033,Cheyenne,Nebraska,2016,711,3665,335,4711,0.15092337083421778,0.777966461473148,0.07111016769263426,-373,219,216,62,-0.08224505248262456,0.04615856519747401,0.036086487285150515,-2954,-589,-0.6270430906389302,-0.1183315397677751
8209,31035,Clay,Nebraska,2000,774,2326,115,3215,0.24074650077760498,0.7234836702954899,0.03576982892690513,0,0,0,0,0.0,0.0,0.0,-1552,0,-0.4827371695178849,0.0
8210,31035,Clay,Nebraska,2004,743,2543,51,3337,0.2226550794126461,0.7620617320946959,0.015283188492658075,-31,-64,217,122,-0.018091421364958893,-0.020486640434247055,0.038578061799205976,-1800,-248,-0.5394066526820498,-0.05666948316416487
8211,31035,Clay,Nebraska,2008,780,2177,76,3033,0.2571711177052423,0.7177711836465546,0.0250576986482031,37,25,-366,-304,0.034516038292596224,0.009774510155545023,-0.04429054844814129,-1397,403,-0.46060006594131225,0.07880658674073754
8212,31035,Clay,Nebraska,2012,667,2232,48,2947,0.22633186291143537,0.7573803868340685,0.016287750254496098,-113,-28,55,-86,-0.030839254793806947,-0.008769948393707,0.03960920318751393,-1565,-168,-0.5310485239226331,-0.07044845798132088
8213,31035,Clay,Nebraska,2016,477,2422,166,3065,0.15562805872756932,0.7902120717781403,0.05415986949429037,-190,118,190,118,-0.07070380418386604,0.03787211923979428,0.03283168494407185,-1945,-380,-0.634584013050571,-0.10353548912793786
8214,31037,Colfax,Nebraska,2000,863,2338,114,3315,0.2603318250377074,0.7052790346907994,0.034389140271493215,0,0,0,0,0.0,0.0,0.0,-1475,0,-0.44494720965309204,0.0
8215,31037,Colfax,Nebraska,2004,990,2589,54,3633,0.27250206440957886,0.7126341866226259,0.01486374896779521,127,-60,251,318,0.01217023937187145,-0.019525391303698007,0.0073551519318264535,-1599,-124,-0.44013212221304704,0.004815087440044996
8216,31037,Colfax,Nebraska,2008,1125,2018,60,3203,0.3512332188573213,0.6300343428036216,0.018732438339057134,135,6,-571,-430,0.07873115444774242,0.003868689371261924,-0.08259984381900431,-893,706,-0.2788011239463003,0.16133099826674674
8217,31037,Colfax,Nebraska,2012,969,2051,49,3069,0.31573802541544477,0.6682958618442489,0.01596611274030629,-156,-11,33,-134,-0.035495193441876516,-0.002766325598750844,0.038261519040627356,-1082,-189,-0.35255783642880417,-0.07375671248250387
8218,31037,Colfax,Nebraska,2016,859,2171,184,3214,0.2672682016179216,0.6754822650902302,0.05724953329184816,-110,135,120,145,-0.04846982379752318,0.04128342055154187,0.007186403245981299,-1312,-230,-0.40821406347230865,-0.05565622704350448
8219,31039,Cuming,Nebraska,2000,857,3232,126,4215,0.2033214709371293,0.766785290628707,0.0298932384341637,0,0,0,0,0.0,0.0,0.0,-2375,0,-0.5634638196915778,0.0
8220,31039,Cuming,Nebraska,2004,966,3330,53,4349,0.22212002759255,0.7656932628190388,0.01218670958841113,109,-73,98,134,0.018798556655420712,-0.01770652884575257,-0.0010920278096682168,-2364,11,-0.5435732352264888,0.019890584465088956
8221,31039,Cuming,Nebraska,2008,1274,2732,81,4087,0.31172008808416934,0.6684609738194275,0.01981893809640323,308,28,-598,-262,0.08960006049161934,0.007632228507992101,-0.09723228899961134,-1458,906,-0.35674088573525814,0.18683234949123068
8222,31039,Cuming,Nebraska,2012,1031,2876,69,3976,0.2593058350100604,0.7233400402414487,0.017354124748490945,-243,-12,144,-111,-0.05241425307410896,-0.0024648133479122855,0.05487906642202123,-1845,-387,-0.46403420523138833,-0.10729331949613019
8223,31039,Cuming,Nebraska,2016,719,3122,233,4074,0.17648502700049093,0.7663230240549829,0.05719194894452626,-312,164,246,98,-0.08282080800956945,0.03983782419603532,0.04298298381353416,-2403,-558,-0.5898379970544919,-0.12580379182310358
8224,31041,Custer,Nebraska,2000,976,4245,193,5414,0.18027336534909494,0.7840783154783894,0.0356483191725157,0,0,0,0,0.0,0.0,0.0,-3269,0,-0.6038049501292944,0.0
8225,31041,Custer,Nebraska,2004,1040,4518,54,5612,0.18531717747683535,0.8050605844618675,0.00962223806129722,64,-139,273,198,0.00504381212774041,-0.02602608111121848,0.020982268983478103,-3478,-209,-0.619743406985032,-0.015938456855737693
8226,31041,Custer,Nebraska,2008,1192,4301,85,5578,0.21369666547149516,0.7710648978128362,0.015238436715668699,152,31,-217,-34,0.028379487994659808,0.005616198654371478,-0.0339956866490313,-3109,369,-0.557368232341341,0.06237517464369102
8227,31041,Custer,Nebraska,2012,1083,4296,119,5498,0.19698072026191343,0.7813750454710804,0.021644234267006183,-109,34,-5,-80,-0.016715945209581723,0.006405797551337484,0.010310147658244229,-3213,-104,-0.584394325209167,-0.02702609286782598
8228,31041,Custer,Nebraska,2016,641,4695,316,5652,0.11341118188251946,0.8306794055201698,0.055909412597310686,-442,197,399,154,-0.08356953837939397,0.0342651783303045,0.049304360049089446,-4054,-841,-0.7172682236376504,-0.1328738984284834
8229,31043,Dakota,Nebraska,2000,2695,3119,247,6061,0.44464609800362975,0.5146015508991916,0.04075235109717868,0,0,0,0,0.0,0.0,0.0,-424,0,-0.06995545289556182,0.0
8230,31043,Dakota,Nebraska,2004,3027,3526,62,6615,0.4575963718820862,0.5330309901738474,0.009372637944066516,332,-185,407,554,0.01295027387845643,-0.031379713153112165,0.01842943927465579,-499,-75,-0.07543461829176118,-0.005479165396199359
8231,31043,Dakota,Nebraska,2008,2994,3292,110,6396,0.46810506566604126,0.5146966854283928,0.01719824890556598,-33,48,-234,-219,0.010508693783955081,0.007825610961499464,-0.01833430474545461,-298,201,-0.04659161976235149,0.02884299852940969
8232,31043,Dakota,Nebraska,2012,2922,3094,120,6136,0.4762059973924381,0.5042372881355932,0.01955671447196871,-72,10,-198,-260,0.00810093172639681,0.002358465566402731,-0.010459397292799544,-172,126,-0.028031290743155135,0.018560329019196353
8233,31043,Dakota,Nebraska,2016,2314,3616,349,6279,0.36853002070393376,0.5758878802357064,0.05558209906035993,-608,229,522,143,-0.10767597668850432,0.03602538458839122,0.07165059210011315,-1302,-1130,-0.2073578595317726,-0.17932656878861747
8234,31045,Dawes,Nebraska,2000,823,2549,249,3621,0.2272852803093068,0.7039491853079259,0.0687655343827672,0,0,0,0,0.0,0.0,0.0,-1726,0,-0.4766639049986191,0.0
8235,31045,Dawes,Nebraska,2004,1119,2809,66,3994,0.2801702553830746,0.7033049574361542,0.016524787180771158,296,-183,260,373,0.0528849750737678,-0.052240747201996035,-0.0006442278717717631,-1690,36,-0.42313470205307957,0.053529202945539534
8236,31045,Dawes,Nebraska,2008,1285,2376,114,3775,0.3403973509933775,0.6294039735099338,0.030198675496688743,166,48,-433,-219,0.06022709561030287,0.013673888315917586,-0.07390098392622035,-1091,599,-0.28900662251655634,0.13412807953652323
8237,31045,Dawes,Nebraska,2012,1132,2478,118,3728,0.30364806866952787,0.6646995708154506,0.03165236051502146,-153,4,102,-47,-0.03674928232384961,0.001453685018332717,0.03529559730551679,-1346,-255,-0.36105150214592274,-0.0720448796293664
8238,31045,Dawes,Nebraska,2016,801,2632,243,3676,0.2178998911860718,0.7159956474428727,0.0661044613710555,-331,125,154,-52,-0.08574817748345606,0.034452100856034035,0.05129607662742208,-1831,-485,-0.4980957562568009,-0.13704425411087817
8239,31047,Dawson,Nebraska,2000,1740,5511,256,7507,0.23178366857599575,0.7341148261622485,0.0341015052617557,0,0,0,0,0.0,0.0,0.0,-3771,0,-0.5023311575862528,0.0
8240,31047,Dawson,Nebraska,2004,1728,6149,79,7956,0.2171945701357466,0.7728758169934641,0.00992961287078934,-12,-177,638,449,-0.014589098440249137,-0.024171892390966357,0.038760990831215536,-4421,-650,-0.5556812468577175,-0.053350089271464674
8241,31047,Dawson,Nebraska,2008,2399,5460,127,7986,0.3004007012271475,0.6836964688204358,0.01590282995241673,671,48,-689,30,0.0832061310914009,0.005973217081627388,-0.0891793481730283,-3061,1360,-0.38329576759328826,0.1723854792644292
8242,31047,Dawson,Nebraska,2012,2199,5460,200,7859,0.27980659116935996,0.6947448784832676,0.02544853034737244,-200,73,0,-127,-0.02059411005778755,0.009545700394955711,0.011048409662831826,-3261,-200,-0.41493828731390764,-0.03164251972061938
8243,31047,Dawson,Nebraska,2016,2136,5984,515,8635,0.24736537348002316,0.6929936305732484,0.059640995946728434,-63,315,524,776,-0.032441217689336804,0.034192465599355994,-0.001751247910019238,-3848,-587,-0.4456282570932252,-0.03068996977931754
8244,31049,Deuel,Nebraska,2000,213,783,37,1033,0.20619554695062922,0.7579864472410455,0.03581800580832527,0,0,0,0,0.0,0.0,0.0,-570,0,-0.5517909002904162,0.0
8245,31049,Deuel,Nebraska,2004,222,820,11,1053,0.21082621082621084,0.7787274453941121,0.010446343779677113,9,-26,37,20,0.004630663875581614,-0.025371662028648156,0.020740998153066625,-598,-28,-0.5679012345679013,-0.016110334277485094
8246,31049,Deuel,Nebraska,2008,243,732,18,993,0.24471299093655588,0.7371601208459214,0.01812688821752266,21,7,-88,-60,0.033886780110345044,0.007680544437845547,-0.041567324548190676,-489,109,-0.49244712990936557,0.07545410465853575
8247,31049,Deuel,Nebraska,2012,215,763,39,1017,0.21140609636184857,0.7502458210422812,0.038348082595870206,-28,21,31,24,-0.03330689457470731,0.020221194378347546,0.013085700196359795,-548,-59,-0.5388397246804326,-0.04639259477106705
8248,31049,Deuel,Nebraska,2016,120,809,55,984,0.12195121951219512,0.8221544715447154,0.05589430894308943,-95,16,46,-33,-0.08945487684965345,0.017546226347219224,0.07190865050243422,-689,-141,-0.7002032520325203,-0.1613635273520877
8249,31051,Dixon,Nebraska,2000,820,1834,138,2792,0.29369627507163326,0.6568767908309455,0.0494269340974212,0,0,0,0,0.0,0.0,0.0,-1014,0,-0.36318051575931226,0.0
8250,31051,Dixon,Nebraska,2004,938,2028,43,3009,0.31173147224991693,0.6739780658025922,0.014290461947490861,118,-95,194,217,0.01803519717828367,-0.03513647214993034,0.017101274971646707,-1090,-76,-0.3622465935526753,0.0009339222066369612
8251,31051,Dixon,Nebraska,2008,946,1785,63,2794,0.33858267716535434,0.6388690050107373,0.022548317823908374,8,20,-243,-215,0.02685120491543741,0.008257855876417513,-0.03510906079185494,-839,251,-0.30028632784538295,0.06196026570729235
8252,31051,Dixon,Nebraska,2012,870,1745,71,2686,0.3239017125837677,0.6496649292628444,0.02643335815338794,-76,8,-40,-108,-0.01468096458158663,0.0038850403294795645,0.01079592425210707,-875,-36,-0.32576321667907665,-0.0254768888336937
8253,31051,Dixon,Nebraska,2016,556,2041,185,2782,0.19985621854780733,0.7336448598130841,0.06649892163910856,-314,114,296,96,-0.12404549403596038,0.04006556348572062,0.08397993055023978,-1485,-610,-0.5337886412652768,-0.20802542458620016
8254,31053,Dodge,Nebraska,2000,5021,8871,580,14472,0.34694582642343835,0.6129767827529021,0.04007739082365948,0,0,0,0,0.0,0.0,0.0,-3850,0,-0.2660309563294638,0.0
8255,31053,Dodge,Nebraska,2004,5250,10716,206,16172,0.32463517190205293,0.6626267623052189,0.012738065792728173,229,-374,1845,1700,-0.02231065452138542,-0.027339325030931304,0.04964997955231676,-5466,-1616,-0.33799159040316595,-0.07196063407370218
8256,31053,Dodge,Nebraska,2008,6689,8557,304,15550,0.43016077170418004,0.5502893890675241,0.01954983922829582,1439,98,-2159,-622,0.10552559980212711,0.006811773435567646,-0.11233737323769477,-1868,3598,-0.12012861736334407,0.21786297303982188
8257,31053,Dodge,Nebraska,2012,5673,8995,282,14950,0.3794648829431438,0.6016722408026756,0.0188628762541806,-1016,-22,438,-600,-0.050695888761036256,-0.0006869629741152183,0.05138285173515145,-3322,-1454,-0.22220735785953177,-0.1020787404961877
8258,31053,Dodge,Nebraska,2016,4544,9933,1052,15529,0.2926138193058149,0.6396419602034903,0.06774422049069483,-1129,770,938,579,-0.08685106363732886,0.048881344236514225,0.03796971940081473,-5389,-2067,-0.34702814089767536,-0.12482078303814359
8259,31055,Douglas,Nebraska,2000,73347,101025,8784,183156,0.40046190133001375,0.5515789818515364,0.047959116818449846,0,0,0,0,0.0,0.0,0.0,-27678,0,-0.15111708052152267,0.0
8260,31055,Douglas,Nebraska,2004,83330,120813,2928,207071,0.4024223575488601,0.5834375648932009,0.014140077557939064,9983,-5856,19788,23915,0.0019604562188463293,-0.03381903926051078,0.031858583041664446,-37483,-9805,-0.1810152073443408,-0.029898126822818116
8261,31055,Douglas,Nebraska,2008,116810,106291,3600,226701,0.5152601885302668,0.4688598638735603,0.015879947596172932,33480,672,-14522,19630,0.1128378309814067,0.0017398700382338685,-0.11457770101964054,10519,48002,0.04640032465670646,0.22741553200104725
8262,31055,Douglas,Nebraska,2012,106456,113220,4251,223927,0.4754049310712866,0.5056112036511899,0.01898386527752348,-10354,651,6929,-2774,-0.039855257458980164,0.0031039176813505466,0.03675133977762962,-6764,-17283,-0.030206272579903326,-0.07660659723660979
8263,31055,Douglas,Nebraska,2016,113798,108077,18558,240433,0.47330441328769346,0.4495098426588696,0.07718574405343692,7342,14307,-5143,16506,-0.0021005177835931588,0.05820187877591344,-0.056101360992320326,5721,12485,0.02379457062882384,0.05400084320872717
8264,31057,Dundy,Nebraska,2000,179,801,31,1011,0.17705242334322452,0.7922848664688428,0.03066271018793274,0,0,0,0,0.0,0.0,0.0,-622,0,-0.6152324431256182,0.0
8265,31057,Dundy,Nebraska,2004,186,858,9,1053,0.17663817663817663,0.8148148148148148,0.008547008547008548,7,-22,57,42,-0.0004142467050478882,-0.022115701640924194,0.022529948345971995,-672,-50,-0.6381766381766382,-0.022944195051019967
8266,31057,Dundy,Nebraska,2008,218,783,18,1019,0.2139352306182532,0.7684003925417076,0.017664376840039256,32,9,-75,-34,0.03729705398007657,0.009117368293030708,-0.046414422273107214,-565,107,-0.5544651619234544,0.08371147625318376
8267,31057,Dundy,Nebraska,2012,176,792,17,985,0.17868020304568527,0.8040609137055837,0.017258883248730966,-42,-1,9,-34,-0.03525502757256793,-0.00040549359130829035,0.03566052116387619,-616,-51,-0.6253807106598985,-0.07091554873644412
8268,31057,Dundy,Nebraska,2016,89,823,41,953,0.09338929695697797,0.863588667366212,0.04302203567681007,-87,24,31,-32,-0.0852909060887073,0.025763152428079108,0.059527753660628235,-734,-118,-0.770199370409234,-0.1448186597493355
8269,31059,Fillmore,Nebraska,2000,848,2024,126,2998,0.2828552368245497,0.6751167444963309,0.042028018679119414,0,0,0,0,0.0,0.0,0.0,-1176,0,-0.39226150767178114,0.0
8270,31059,Fillmore,Nebraska,2004,828,2314,51,3193,0.25931725649859066,0.7247103037895396,0.015972439711869714,-20,-75,290,195,-0.02353798032595905,-0.0260555789672497,0.049593559293208744,-1486,-310,-0.46539304729094894,-0.0731315396191678
8271,31059,Fillmore,Nebraska,2008,962,1913,72,2947,0.326433661350526,0.6491347132677299,0.024431625381744145,134,21,-401,-246,0.06711640485193532,0.008459185669874431,-0.07557559052180973,-951,535,-0.3227010519172039,0.14269199537374505
8272,31059,Fillmore,Nebraska,2012,807,2007,65,2879,0.2803056616880861,0.6971170545328239,0.022577283779089963,-155,-7,94,-68,-0.046127999662439856,-0.0018543416026541824,0.04798234126509404,-1200,-249,-0.4168113928447378,-0.0941103409275339
8273,31059,Fillmore,Nebraska,2016,613,2130,198,2941,0.20843250595035703,0.7242434546072765,0.06732403944236655,-194,133,123,62,-0.0718731557377291,0.044746755663276586,0.02712640007445255,-1517,-317,-0.5158109486569195,-0.09899955581218167
8274,31061,Franklin,Nebraska,2000,420,1196,52,1668,0.2517985611510791,0.7170263788968825,0.03117505995203837,0,0,0,0,0.0,0.0,0.0,-776,0,-0.46522781774580335,0.0
8275,31061,Franklin,Nebraska,2004,412,1277,25,1714,0.24037339556592766,0.7450408401400234,0.014585764294049008,-8,-27,81,46,-0.01142516558515147,-0.01658929565798936,0.028014461243140887,-865,-89,-0.5046674445740957,-0.039439626828292385
8276,31061,Franklin,Nebraska,2008,442,1079,31,1552,0.2847938144329897,0.6952319587628866,0.01997422680412371,30,6,-198,-162,0.04442041886706202,0.005388462510074701,-0.04980888137713679,-637,228,-0.4104381443298969,0.09422930024419884
8277,31061,Franklin,Nebraska,2012,384,1112,40,1536,0.25,0.7239583333333334,0.026041666666666668,-58,9,33,-16,-0.03479381443298968,0.006067439862542958,0.0287263745704468,-728,-91,-0.47395833333333337,-0.06352018900343648
8278,31061,Franklin,Nebraska,2016,250,1347,76,1673,0.14943215780035865,0.8051404662283324,0.045427375971309025,-134,36,235,137,-0.10056784219964135,0.019385709304642357,0.08118213289499898,-1097,-369,-0.6557083084279737,-0.1817499750946403
8279,31063,Frontier,Nebraska,2000,244,1102,47,1393,0.17516152189519024,0.7910983488872936,0.03374012921751615,0,0,0,0,0.0,0.0,0.0,-858,0,-0.6159368269921033,0.0
8280,31063,Frontier,Nebraska,2004,275,1160,32,1467,0.18745739604635311,0.7907293796864349,0.021813224267211998,31,-15,58,74,0.012295874151162872,-0.011926904950304153,-0.0003689692008587153,-885,-27,-0.6032719836400817,0.01266484335202156
8281,31063,Frontier,Nebraska,2008,349,1034,21,1404,0.24857549857549857,0.7364672364672364,0.014957264957264958,74,-11,-126,-63,0.06111810252914546,-0.00685595930994704,-0.05426214321919842,-685,200,-0.4878917378917379,0.11538024574834382
8282,31063,Frontier,Nebraska,2012,271,1007,27,1305,0.20766283524904214,0.7716475095785441,0.020689655172413793,-78,6,-27,-99,-0.04091266332645643,0.005732390215148835,0.03518027311130767,-736,-51,-0.563984674329502,-0.07609293643776405
8283,31063,Frontier,Nebraska,2016,161,1110,57,1328,0.12123493975903614,0.8358433734939759,0.04292168674698795,-110,30,103,23,-0.086427895490006,0.02223203157457416,0.06419586391543175,-949,-213,-0.7146084337349398,-0.15062375940543782
8284,31065,Furnas,Nebraska,2000,534,1849,48,2431,0.21966269025092555,0.7605923488276429,0.01974496092143151,0,0,0,0,0.0,0.0,0.0,-1315,0,-0.5409296585767174,0.0
8285,31065,Furnas,Nebraska,2004,492,1950,25,2467,0.19943250912038912,0.7904337251722741,0.010133765707336847,-42,-23,101,36,-0.02023018113053643,-0.009611195214094663,0.029841376344631132,-1458,-143,-0.5910012160518849,-0.05007155747516756
8286,31065,Furnas,Nebraska,2008,556,1725,47,2328,0.23883161512027493,0.740979381443299,0.020189003436426118,64,22,-225,-139,0.0393991059998858,0.010055237729089271,-0.04945434372897506,-1169,289,-0.502147766323024,0.08885344972886089
8287,31065,Furnas,Nebraska,2012,423,1782,35,2240,0.1888392857142857,0.7955357142857142,0.015625,-133,-12,57,-88,-0.049992329405989216,-0.004564003436426118,0.054556332842415234,-1359,-190,-0.6066964285714285,-0.10454866224840442
8288,31065,Furnas,Nebraska,2016,304,1921,115,2340,0.12991452991452992,0.8209401709401709,0.049145299145299144,-119,80,139,100,-0.058924755799755785,0.033520299145299144,0.025404456654456675,-1617,-258,-0.691025641025641,-0.08432921245421254
8289,31067,Gage,Nebraska,2000,3516,5538,452,9506,0.36987166000420785,0.5825794235219861,0.04754891647380602,0,0,0,0,0.0,0.0,0.0,-2022,0,-0.21270776351777826,0.0
8290,31067,Gage,Nebraska,2004,3655,6575,154,10384,0.35198382126348227,0.6331856702619415,0.014830508474576272,139,-298,1037,878,-0.01788783874072558,-0.032718407999229746,0.050606246739955396,-2920,-898,-0.28120184899845924,-0.06849408548068098
8291,31067,Gage,Nebraska,2008,4473,5435,252,10160,0.44025590551181104,0.5349409448818898,0.024803149606299212,818,98,-1140,-224,0.08827208424832877,0.00997264113172294,-0.09824472538005169,-962,1958,-0.09468503937007877,0.18651680962838046
8292,31067,Gage,Nebraska,2012,3903,5513,245,9661,0.40399544560604495,0.5706448607804575,0.025359693613497568,-570,-7,78,-499,-0.036260459905766096,0.0005565440071983556,0.035703915898567695,-1610,-648,-0.16664941517441256,-0.07196437580433379
8293,31067,Gage,Nebraska,2016,2935,6380,733,10048,0.29209792993630573,0.634952229299363,0.07294984076433121,-968,488,867,387,-0.11189751566973921,0.047590147150833643,0.0643073685189055,-3445,-1835,-0.3428542993630573,-0.17620488418864472
8294,31069,Garden,Nebraska,2000,203,963,53,1219,0.16652994257588188,0.7899917965545529,0.043478260869565216,0,0,0,0,0.0,0.0,0.0,-760,0,-0.6234618539786709,0.0
8295,31069,Garden,Nebraska,2004,201,970,12,1183,0.16990701606086223,0.819949281487743,0.01014370245139476,-2,-41,7,-36,0.003377073484980342,-0.03333455841817046,0.02995748493319017,-769,-9,-0.6500422654268808,-0.026580411448209884
8296,31069,Garden,Nebraska,2008,283,844,11,1138,0.24868189806678384,0.7416520210896309,0.009666080843585237,82,-1,-126,-45,0.07877488200592161,-0.00047762160780952245,-0.07829726039811213,-561,208,-0.49297012302284704,0.15707214240403378
8297,31069,Garden,Nebraska,2012,242,829,20,1091,0.22181484876260313,0.7598533455545371,0.01833180568285976,-41,9,-15,-47,-0.026867049304180712,0.008665724839274525,0.018201324464906188,-587,-26,-0.5380384967919339,-0.0450683737690869
8298,31069,Garden,Nebraska,2016,153,869,53,1075,0.14232558139534884,0.8083720930232559,0.04930232558139535,-89,33,40,-16,-0.07948926736725428,0.030970519898535588,0.04851874746871876,-716,-129,-0.6660465116279071,-0.12800801483597313
8299,31071,Garfield,Nebraska,2000,202,718,43,963,0.20976116303219106,0.7455867082035307,0.0446521287642783,0,0,0,0,0.0,0.0,0.0,-516,0,-0.5358255451713396,0.0
8300,31071,Garfield,Nebraska,2004,196,806,15,1017,0.1927236971484759,0.7925270403146509,0.014749262536873156,-6,-28,88,54,-0.017037465883715158,-0.029902866227405143,0.04694033211112025,-610,-94,-0.599803343166175,-0.06397779799483538
8301,31071,Garfield,Nebraska,2008,212,800,18,1030,0.2058252427184466,0.7766990291262136,0.017475728155339806,16,3,-6,13,0.013101545569970702,0.0027264656184666503,-0.015828011188437352,-588,22,-0.570873786407767,0.028929556758408026
8302,31071,Garfield,Nebraska,2012,149,769,22,940,0.15851063829787235,0.8180851063829787,0.023404255319148935,-63,4,-31,-90,-0.04731460442057425,0.005928527163809129,0.04138607725676513,-620,-32,-0.6595744680851063,-0.08870068167733935
8303,31071,Garfield,Nebraska,2016,121,821,38,980,0.12346938775510204,0.8377551020408164,0.03877551020408163,-28,16,52,40,-0.03504125054277031,0.015371254884932697,0.01966999565783767,-700,-80,-0.7142857142857143,-0.054711246200607966
8304,31073,Gosper,Nebraska,2000,228,757,29,1014,0.22485207100591717,0.7465483234714004,0.028599605522682446,0,0,0,0,0.0,0.0,0.0,-529,0,-0.5216962524654832,0.0
8305,31073,Gosper,Nebraska,2004,222,890,7,1119,0.19839142091152814,0.7953529937444147,0.006255585344057194,-6,-22,133,105,-0.026460650094389027,-0.022344020178625253,0.04880467027301427,-668,-139,-0.5969615728328865,-0.0752653203674033
8306,31073,Gosper,Nebraska,2008,260,776,12,1048,0.2480916030534351,0.7404580152671756,0.011450381679389313,38,5,-114,-71,0.04970018214190697,0.005194796335332119,-0.05489497847723912,-516,152,-0.49236641221374045,0.10459516061914609
8307,31073,Gosper,Nebraska,2012,230,734,14,978,0.23517382413087934,0.7505112474437627,0.014314928425357873,-30,2,-42,-70,-0.012917778922555773,0.0028645467459685603,0.010053232176587157,-504,12,-0.5153374233128833,-0.0229710110991429
8308,31073,Gosper,Nebraska,2016,166,794,50,1010,0.16435643564356436,0.7861386138613862,0.04950495049504951,-64,36,60,32,-0.07081738848731498,0.035190022069691636,0.03562736641762343,-628,-124,-0.6217821782178218,-0.10644475490493843
8309,31075,Grant,Nebraska,2000,49,324,12,385,0.12727272727272726,0.8415584415584415,0.03116883116883117,0,0,0,0,0.0,0.0,0.0,-275,0,-0.7142857142857142,0.0
8310,31075,Grant,Nebraska,2004,41,352,3,396,0.10353535353535354,0.8888888888888888,0.007575757575757576,-8,-9,28,11,-0.023737373737373724,-0.023593073593073593,0.047330447330447334,-311,-36,-0.7853535353535352,-0.07106782106782106
8311,31075,Grant,Nebraska,2008,41,318,8,367,0.11171662125340599,0.8664850136239782,0.021798365122615803,0,5,-34,-29,0.008181267718052457,0.014222607546858227,-0.02240387526491061,-277,34,-0.7547683923705722,0.030585142982963
8312,31075,Grant,Nebraska,2012,30,322,11,363,0.08264462809917356,0.8870523415977961,0.030303030303030304,-11,3,4,-4,-0.029071993154232437,0.0085046651804145,0.020567327973817884,-292,-15,-0.8044077134986225,-0.04963932112805025
8313,31075,Grant,Nebraska,2016,20,367,18,405,0.04938271604938271,0.9061728395061729,0.044444444444444446,-10,7,45,42,-0.03326191204979084,0.014141414141414142,0.019120497908376777,-347,-55,-0.8567901234567902,-0.052382409958167675
8314,31077,Greeley,Nebraska,2000,416,839,55,1310,0.31755725190839695,0.6404580152671756,0.04198473282442748,0,0,0,0,0.0,0.0,0.0,-423,0,-0.32290076335877865,0.0
8315,31077,Greeley,Nebraska,2004,361,865,22,1248,0.28926282051282054,0.6931089743589743,0.017628205128205128,-55,-33,26,-62,-0.028294431395576414,-0.024356527696222353,0.05265095909179873,-504,-81,-0.4038461538461538,-0.08094539048737515
8316,31077,Greeley,Nebraska,2008,458,715,26,1199,0.38198498748957466,0.5963302752293578,0.021684737281067557,97,4,-150,-49,0.09272216697675412,0.004056532152862429,-0.09677869912961656,-257,247,-0.21434528773978312,0.18950086610637068
8317,31077,Greeley,Nebraska,2012,340,820,25,1185,0.2869198312236287,0.6919831223628692,0.02109704641350211,-118,-1,105,-14,-0.09506515626594597,-0.0005876908675654484,0.09565284713351141,-480,-223,-0.4050632911392405,-0.19071800339945738
8318,31077,Greeley,Nebraska,2016,210,912,53,1175,0.17872340425531916,0.7761702127659574,0.0451063829787234,-130,28,92,-10,-0.10819642696830953,0.024009336565221293,0.08418709040308825,-702,-222,-0.5974468085106382,-0.19238351737139775
8319,31079,Hall,Nebraska,2000,5952,11803,791,18546,0.32093173730184404,0.636417556346382,0.04265070635177397,0,0,0,0,0.0,0.0,0.0,-5851,0,-0.31548581904453793,0.0
8320,31079,Hall,Nebraska,2004,6228,14592,334,21154,0.29441240427342347,0.6897986196464025,0.01578897608017396,276,-457,2789,2608,-0.026519333028420577,-0.026861730271600007,0.05338106330002057,-8364,-2513,-0.3953862153729791,-0.07990039632844115
8321,31079,Hall,Nebraska,2008,7855,12977,439,21271,0.36928212119787507,0.6100794508955856,0.02063842790653942,1627,105,-1615,117,0.0748697169244516,0.00484945182636546,-0.07971916875081697,-5122,3242,-0.2407973296977105,0.15458888567526857
8322,31079,Hall,Nebraska,2012,7161,12646,422,20229,0.3539967373572594,0.6251421226951407,0.020861139947599982,-694,-17,-331,-1042,-0.015285383840615674,0.0002227120410605611,0.015062671799555116,-5485,-363,-0.2711453853378813,-0.03034805564017079
8323,31079,Hall,Nebraska,2016,6282,14408,1370,22060,0.28476881233000906,0.6531278331822303,0.06210335448776065,-879,948,1762,1831,-0.06922792502725034,0.041242214540160665,0.027985710487089643,-8126,-2641,-0.3683590208522213,-0.09721363551433998
8324,31081,Hamilton,Nebraska,2000,1066,3251,174,4491,0.23736361612113116,0.7238922289022489,0.038744154976619906,0,0,0,0,0.0,0.0,0.0,-2185,0,-0.48652861278111775,0.0
8325,31081,Hamilton,Nebraska,2004,1012,3785,69,4866,0.20797369502671598,0.7778462803123716,0.014180024660912454,-54,-105,534,375,-0.029389921094415183,-0.02456413031570745,0.05395405141012266,-2773,-588,-0.5698725852856557,-0.0833439725045379
8326,31081,Hamilton,Nebraska,2008,1332,3389,78,4799,0.2775578245467806,0.7061887893311106,0.016253386122108773,320,9,-396,-67,0.0695841295200646,0.0020733614611963182,-0.07165749098126095,-2057,716,-0.42863096478433005,0.1412416205013256
8327,31081,Hamilton,Nebraska,2012,1146,3600,125,4871,0.23526996509956888,0.739067953192363,0.02566208170806816,-186,47,211,72,-0.042287859447211695,0.009408695585959387,0.032879163861252336,-2454,-397,-0.5037979880927941,-0.07516702330846403
8328,31081,Hamilton,Nebraska,2016,878,3783,343,5004,0.17545963229416467,0.7559952038369304,0.06854516386890487,-268,218,183,133,-0.05981033280540421,0.04288308216083671,0.01692725064456746,-2905,-451,-0.5805355715427658,-0.07673758344997172
8329,31083,Harlan,Nebraska,2000,438,1358,56,1852,0.23650107991360692,0.7332613390928726,0.03023758099352052,0,0,0,0,0.0,0.0,0.0,-920,0,-0.4967602591792657,0.0
8330,31083,Harlan,Nebraska,2004,398,1467,32,1897,0.20980495519240908,0.7733263046916183,0.01686874011597259,-40,-24,109,45,-0.02669612472119784,-0.01336884087754793,0.04006496559874573,-1069,-149,-0.5635213494992093,-0.0667610903199436
8331,31083,Harlan,Nebraska,2008,402,1329,35,1766,0.2276330690826727,0.7525481313703284,0.019818799546998868,4,3,-138,-131,0.01782811389026362,0.0029500594310262786,-0.02077817332128995,-927,142,-0.5249150622876557,0.03860628721155357
8332,31083,Harlan,Nebraska,2012,354,1395,29,1778,0.19910011248593926,0.7845894263217098,0.016310461192350956,-48,-6,66,12,-0.02853295659673344,-0.0035083383546479115,0.032041294951381416,-1041,-114,-0.5854893138357705,-0.0605742515481148
8333,31083,Harlan,Nebraska,2016,254,1496,82,1832,0.13864628820960698,0.8165938864628821,0.04475982532751092,-100,53,101,54,-0.06045382427633228,0.02844936413515996,0.03200446014117231,-1242,-201,-0.6779475982532751,-0.09245828441750459
8334,31085,Hayes,Nebraska,2000,66,486,19,571,0.11558669001751314,0.851138353765324,0.03327495621716287,0,0,0,0,0.0,0.0,0.0,-420,0,-0.7355516637478109,0.0
8335,31085,Hayes,Nebraska,2004,66,524,8,598,0.11036789297658862,0.8762541806020067,0.013377926421404682,0,-11,38,27,-0.005218797040924511,-0.019897029795758192,0.025115826836682675,-458,-38,-0.765886287625418,-0.030334623877607103
8336,31085,Hayes,Nebraska,2008,85,461,7,553,0.15370705244122965,0.833634719710669,0.012658227848101266,19,-1,-63,-45,0.04333915946464102,-0.0007196985733034164,-0.04261946089133761,-376,82,-0.6799276672694394,0.08595862035597857
8337,31085,Hayes,Nebraska,2012,51,476,12,539,0.09461966604823747,0.8831168831168831,0.022263450834879406,-34,5,15,-14,-0.05908738639299217,0.00960522298677814,0.04948216340621403,-425,-49,-0.7884972170686456,-0.10856954979920619
8338,31085,Hayes,Nebraska,2016,30,472,12,514,0.058365758754863814,0.9182879377431906,0.023346303501945526,-21,0,-4,-25,-0.03625390729337366,0.0010828526670661198,0.03517105462630754,-442,-17,-0.8599221789883268,-0.07142496191968117
8339,31087,Hitchcock,Nebraska,2000,312,1126,42,1480,0.21081081081081082,0.7608108108108108,0.02837837837837838,0,0,0,0,0.0,0.0,0.0,-814,0,-0.55,0.0
8340,31087,Hitchcock,Nebraska,2004,296,1171,19,1486,0.19919246298788695,0.7880215343203231,0.01278600269179004,-16,-23,45,6,-0.011618347822923869,-0.01559237568658834,0.027210723509512258,-875,-61,-0.5888290713324361,-0.03882907133243607
8341,31087,Hitchcock,Nebraska,2008,346,1001,32,1379,0.25090645395213923,0.7258883248730964,0.023205221174764323,50,13,-170,-107,0.05171399096425228,0.010419218482974283,-0.06213320944722667,-655,220,-0.47498187092095717,0.11384720041147894
8342,31087,Hitchcock,Nebraska,2012,274,1178,43,1495,0.18327759197324414,0.7879598662207358,0.028762541806020066,-72,11,177,116,-0.06762886197889509,0.005557320631255743,0.06207154134763937,-904,-249,-0.6046822742474917,-0.12970040332653449
8343,31087,Hitchcock,Nebraska,2016,161,1232,75,1468,0.10967302452316076,0.8392370572207084,0.05108991825613079,-113,32,54,-27,-0.07360456745008338,0.022327376450110722,0.05127719099997263,-1071,-167,-0.7295640326975477,-0.124881758450056
8344,31089,Holt,Nebraska,2000,846,3954,159,4959,0.1705989110707804,0.7973381730187538,0.03206291591046582,0,0,0,0,0.0,0.0,0.0,-3108,0,-0.6267392619479734,0.0
8345,31089,Holt,Nebraska,2004,894,4217,63,5174,0.17278701198299187,0.8150367220718979,0.012176265945110166,48,-96,263,215,0.0021881009122114714,-0.019886649965355652,0.017698549053144164,-3323,-215,-0.6422497100889061,-0.01551044814093272
8346,31089,Holt,Nebraska,2008,1089,3746,139,4974,0.2189384800965018,0.7531162042621633,0.027945315641334942,195,76,-471,-200,0.046151468113509925,0.015769049696224776,-0.06192051780973462,-2657,666,-0.5341777241656616,0.10807198592324452
8347,31089,Holt,Nebraska,2012,882,3922,135,4939,0.17857865964770198,0.7940878720388743,0.02733346831342377,-207,-4,176,-35,-0.04035982044879982,-0.0006118473279111726,0.04097166777671102,-3040,-383,-0.6155092123911723,-0.08133148822551073
8348,31089,Holt,Nebraska,2016,531,4354,233,5118,0.10375146541617819,0.8507229386479094,0.04552559593591247,-351,98,432,179,-0.07482719423152379,0.0181921276224887,0.056635066609035056,-3823,-783,-0.7469714732317312,-0.1314622608405589
8349,31091,Hooker,Nebraska,2000,74,317,18,409,0.18092909535452323,0.7750611246943765,0.044009779951100246,0,0,0,0,0.0,0.0,0.0,-243,0,-0.5941320293398533,0.0
8350,31091,Hooker,Nebraska,2004,64,392,5,461,0.13882863340563992,0.8503253796095445,0.010845986984815618,-10,-13,75,52,-0.04210046194888331,-0.033163792966284626,0.07526425491516797,-328,-85,-0.7114967462039046,-0.11736471686405126
8351,31091,Hooker,Nebraska,2008,75,355,8,438,0.17123287671232876,0.8105022831050228,0.0182648401826484,11,3,-37,-23,0.03240424330668884,0.007418853197832783,-0.03982309650452165,-280,48,-0.639269406392694,0.07222733981121054
8352,31091,Hooker,Nebraska,2012,59,330,6,395,0.14936708860759493,0.8354430379746836,0.015189873417721518,-16,-2,-25,-43,-0.02186578810473383,-0.0030749667649268824,0.02494075486966074,-271,9,-0.6860759493670886,-0.04680654297439457
8353,31091,Hooker,Nebraska,2016,40,355,22,417,0.09592326139088729,0.8513189448441247,0.05275779376498801,-19,16,25,22,-0.05344382721670764,0.03756792034726649,0.01587590686944118,-315,-44,-0.7553956834532375,-0.06931973408614889
8354,31093,Howard,Nebraska,2000,955,1760,112,2827,0.33781393703572693,0.622568093385214,0.039617969579059074,0,0,0,0,0.0,0.0,0.0,-805,0,-0.2847541563494871,0.0
8355,31093,Howard,Nebraska,2004,900,2020,59,2979,0.3021148036253776,0.6780798925814031,0.019805303793219202,-55,-53,260,152,-0.035699133410349304,-0.019812665785839872,0.05551179919618909,-1120,-315,-0.3759650889560255,-0.0912109326065384
8356,31093,Howard,Nebraska,2008,1083,1847,66,2996,0.3614819759679573,0.6164886515353805,0.022029372496662217,183,7,-173,17,0.059367172342579655,0.002224068703443015,-0.06159124104602265,-764,356,-0.2550066755674232,0.1209584133886023
8357,31093,Howard,Nebraska,2012,914,1890,66,2870,0.3184668989547038,0.6585365853658537,0.022996515679442508,-169,0,43,-126,-0.04301507701325347,0.0009671431827802911,0.04204793383047323,-976,-212,-0.3400696864111499,-0.0850630108437267
8358,31093,Howard,Nebraska,2016,544,2284,166,2994,0.18169672678690715,0.7628590514362057,0.055444221776887105,-370,100,394,124,-0.13677017216779666,0.0324477060974446,0.104322466070352,-1740,-764,-0.5811623246492985,-0.24109263823814864
8359,31095,Jefferson,Nebraska,2000,1361,2351,135,3847,0.35378216792305694,0.6111255523784768,0.03509227969846634,0,0,0,0,0.0,0.0,0.0,-990,0,-0.2573433844554198,0.0
8360,31095,Jefferson,Nebraska,2004,1352,2600,59,4011,0.3370730491149339,0.6482174021441037,0.014709548740962353,-9,-76,249,164,-0.016709118808123036,-0.020382730957503984,0.03709184976562696,-1248,-258,-0.3111443530291698,-0.053800968573749997
8361,31095,Jefferson,Nebraska,2008,1520,2103,74,3697,0.41114417094941846,0.5688395996754125,0.020016229375169056,168,15,-497,-314,0.07407112183448455,0.005306680634206702,-0.0793778024686912,-583,665,-0.15769542872599407,0.15344892430317575
8362,31095,Jefferson,Nebraska,2012,1195,2166,85,3446,0.3467788740568775,0.628554846198491,0.024666279744631456,-325,11,63,-251,-0.06436529689254095,0.004650050369462401,0.05971524652307847,-971,-388,-0.2817759721416135,-0.12408054341561942
8363,31095,Jefferson,Nebraska,2016,837,2399,258,3494,0.23955352032054952,0.6866056096164854,0.07384087006296508,-358,173,233,48,-0.107225353736328,0.04917459031833363,0.05805076341799442,-1562,-591,-0.4470520892959359,-0.1652761171543224
8364,31097,Johnson,Nebraska,2000,794,1210,108,2112,0.3759469696969697,0.5729166666666666,0.05113636363636364,0,0,0,0,0.0,0.0,0.0,-416,0,-0.1969696969696969,0.0
8365,31097,Johnson,Nebraska,2004,885,1470,39,2394,0.36967418546365916,0.6140350877192983,0.016290726817042606,91,-69,260,282,-0.006272784233310569,-0.034845636819321034,0.04111842105263164,-585,-169,-0.2443609022556391,-0.047391205285942206
8366,31097,Johnson,Nebraska,2008,914,1142,54,2110,0.43317535545023694,0.5412322274881517,0.025592417061611375,29,15,-328,-284,0.06350116998657779,0.00930169024456877,-0.07280286023114657,-228,357,-0.10805687203791475,0.13630403021772436
8367,31097,Johnson,Nebraska,2012,790,1225,48,2063,0.3829374697043141,0.5937954435288415,0.0232670867668444,-124,-6,83,-47,-0.05023788574592286,-0.002325330294766975,0.05256321604068981,-435,-207,-0.21085797382452742,-0.10280110178661267
8368,31097,Johnson,Nebraska,2016,563,1355,171,2089,0.26950694112015317,0.6486357108664432,0.08185734801340354,-227,123,130,26,-0.11343052858416092,0.05859026124655914,0.05484026733760172,-792,-357,-0.37912876974629006,-0.16827079592176264
8369,31099,Kearney,Nebraska,2000,680,2333,109,3122,0.21780909673286356,0.7472773862908392,0.03491351697629724,0,0,0,0,0.0,0.0,0.0,-1653,0,-0.5294682895579756,0.0
8370,31099,Kearney,Nebraska,2004,707,2621,51,3379,0.2092335010358094,0.7756732761171944,0.015093222846996152,27,-58,288,257,-0.008575595697054156,-0.019820294129301093,0.028395889826355214,-1914,-261,-0.566439775081385,-0.03697148552340934
8371,31099,Kearney,Nebraska,2008,876,2224,50,3150,0.2780952380952381,0.706031746031746,0.015873015873015872,169,-1,-397,-229,0.06886173705942872,0.0007797930260197202,-0.06964153008544838,-1348,566,-0.4279365079365079,0.1385032671448771
8372,31099,Kearney,Nebraska,2012,773,2349,58,3180,0.2430817610062893,0.7386792452830189,0.018238993710691823,-103,8,125,30,-0.03501347708894881,0.002365977837675951,0.03264749925127286,-1576,-228,-0.49559748427672956,-0.06766097634022167
8373,31099,Kearney,Nebraska,2016,550,2531,215,3296,0.16686893203883496,0.7679004854368932,0.06523058252427184,-223,157,182,116,-0.07621282896745435,0.046991588813580024,0.029221240153874284,-1981,-405,-0.6010315533980581,-0.10543406912132858
8374,31101,Keith,Nebraska,2000,778,2953,118,3849,0.20213042348661991,0.7672122629254352,0.03065731358794492,0,0,0,0,0.0,0.0,0.0,-2175,0,-0.5650818394388153,0.0
8375,31101,Keith,Nebraska,2004,743,3356,38,4137,0.1795987430505197,0.8112158569011361,0.00918540004834421,-35,-80,403,288,-0.02253168043610021,-0.02147191353960071,0.04400359397570086,-2613,-438,-0.6316171138506164,-0.06653527441180107
8376,31101,Keith,Nebraska,2008,974,2942,52,3968,0.24546370967741934,0.7414314516129032,0.01310483870967742,231,14,-414,-169,0.06586496662689964,0.0039194386613332095,-0.06978440528823282,-1968,645,-0.4959677419354839,0.1356493719151325
8377,31101,Keith,Nebraska,2012,928,3044,86,4058,0.22868408082799407,0.7501232134056185,0.021192705766387383,-46,34,102,90,-0.01677962884942527,0.008087867056709963,0.008691761792715247,-2116,-148,-0.5214391325776244,-0.025471390642140546
8378,31101,Keith,Nebraska,2016,571,3235,228,4034,0.14154685176003967,0.8019335647000496,0.05651958353991076,-357,142,191,-24,-0.0871372290679544,0.03532687777352338,0.05181035129443112,-2664,-548,-0.66038671294001,-0.13894758036238553
8379,31103,Keya Paha,Nebraska,2000,78,422,13,513,0.15204678362573099,0.8226120857699805,0.025341130604288498,0,0,0,0,0.0,0.0,0.0,-344,0,-0.6705653021442495,0.0
8380,31103,Keya Paha,Nebraska,2004,98,442,9,549,0.1785063752276867,0.8051001821493625,0.01639344262295082,20,-4,20,36,0.026459591601955712,-0.008947687981337677,-0.01751190362061794,-344,0,-0.6265938069216759,0.0439714952225736
8381,31103,Keya Paha,Nebraska,2008,115,409,9,533,0.21575984990619138,0.7673545966228893,0.016885553470919325,17,0,-33,-16,0.03725347467850468,0.0004921108479685049,-0.037745585526473224,-294,50,-0.551594746716698,0.07499906020497793
8382,31103,Keya Paha,Nebraska,2012,80,393,11,484,0.1652892561983471,0.8119834710743802,0.022727272727272728,-35,2,-16,-49,-0.05047059370784426,0.0058417192563534025,0.044628874451490885,-313,-19,-0.6466942148760331,-0.09509946815933512
8383,31103,Keya Paha,Nebraska,2016,40,460,19,519,0.07707129094412331,0.8863198458574181,0.036608863198458574,-40,8,67,35,-0.0882179652542238,0.013881590471185846,0.0743363747830379,-420,-107,-0.8092485549132947,-0.16255434003726166
8384,31105,Kimball,Nebraska,2000,379,1379,62,1820,0.20824175824175825,0.7576923076923077,0.03406593406593406,0,0,0,0,0.0,0.0,0.0,-1000,0,-0.5494505494505494,0.0
8385,31105,Kimball,Nebraska,2004,366,1491,20,1877,0.1949920085242408,0.7943526904635055,0.010655301012253596,-13,-42,112,57,-0.01324974971751744,-0.023410633053680466,0.036660382771197875,-1125,-125,-0.5993606819392647,-0.04991013248871534
8386,31105,Kimball,Nebraska,2008,439,1346,26,1811,0.2424075096631695,0.7432357813362783,0.01435670900055218,73,6,-145,-66,0.0474155011389287,0.003701407988298584,-0.05111690912722722,-907,218,-0.5008282716731088,0.09853241026615589
8387,31105,Kimball,Nebraska,2012,395,1235,57,1687,0.23414344991108477,0.7320687611144042,0.033787788974510964,-44,31,-111,-124,-0.008264059752084746,0.019431079973958786,-0.011167020221874102,-840,67,-0.49792531120331945,0.002902960469789384
8388,31105,Kimball,Nebraska,2016,230,1330,117,1677,0.13714967203339296,0.793082886106142,0.06976744186046512,-165,60,95,-10,-0.09699377787769181,0.03597965288595415,0.06101412499173775,-1100,-260,-0.655933214072749,-0.1580079028694295
8389,31107,Knox,Nebraska,2000,1037,2784,157,3978,0.2606837606837607,0.6998491704374057,0.03946706887883358,0,0,0,0,0.0,0.0,0.0,-1747,0,-0.439165409753645,0.0
8390,31107,Knox,Nebraska,2004,1086,3062,65,4213,0.2577735580346546,0.7267980061713744,0.015428435793971042,49,-92,278,235,-0.002910202649106075,-0.02403863308486254,0.026948835733968668,-1976,-229,-0.46902444813671973,-0.029859038383074743
8391,31107,Knox,Nebraska,2008,1255,2728,101,4084,0.3072967678746327,0.6679725759059746,0.02473065621939275,169,36,-334,-129,0.0495232098399781,0.009302220425421708,-0.05882543026539977,-1473,503,-0.36067580803134186,0.10834864010537787
8392,31107,Knox,Nebraska,2012,1059,2885,92,4036,0.26238850346878095,0.714816650148662,0.022794846382556987,-196,-9,157,-48,-0.04490826440585177,-0.001935809836835764,0.04684407424268744,-1826,-353,-0.45242814667988107,-0.09175233864853921
8393,31107,Knox,Nebraska,2016,720,3188,207,4115,0.17496962332928312,0.774726609963548,0.05030376670716889,-339,115,303,79,-0.08741888013949783,0.027508920324611906,0.059909959814886005,-2468,-642,-0.5997569866342649,-0.14732883995438384
8394,31109,Lancaster,Nebraska,2000,44650,55514,6968,107132,0.4167755665907479,0.5181831758951574,0.06504125751409476,0,0,0,0,0.0,0.0,0.0,-10864,0,-0.10140760930440951,0.0
8395,31109,Lancaster,Nebraska,2004,52747,69764,1998,124509,0.42364005814840694,0.5603129091069722,0.01604703274462087,8097,-4970,14250,17377,0.006864491557659058,-0.04899422476947389,0.04212973321181479,-17017,-6153,-0.13667285095856524,-0.03526524165415573
8396,31109,Lancaster,Nebraska,2008,65734,59398,2358,127490,0.5156012236253824,0.46590320809475255,0.018495568279865086,12987,360,-10366,2981,0.09196116547697547,0.002448535535244215,-0.09440970101221963,6336,23353,0.04969801553062986,0.1863708664891951
8397,31109,Lancaster,Nebraska,2012,62015,62434,2906,127355,0.48694593851831497,0.4902359546150524,0.022818106866632642,-3719,548,3036,-135,-0.02865528510706744,0.0043225385867675555,0.024332746520299875,-419,-6755,-0.003290016096737458,-0.052988031627367316
8398,31109,Lancaster,Nebraska,2016,61898,61588,12737,136223,0.4543872914265579,0.4521116111082563,0.09350109746518576,-117,9831,-846,8868,-0.03255864709175704,0.07068299059855311,-0.03812434350679611,310,729,0.0022756803183016094,0.0055656964150390675
8399,31111,Lincoln,Nebraska,2000,5205,9220,689,15114,0.3443826915442636,0.6100304353579463,0.04558687309779013,0,0,0,0,0.0,0.0,0.0,-4015,0,-0.2656477438136827,0.0
8400,31111,Lincoln,Nebraska,2004,4905,11056,238,16199,0.30279646891783446,0.6825112661275388,0.014692264954626829,-300,-451,1836,1085,-0.04158622262642914,-0.0308946081431633,0.07248083076959244,-6151,-2136,-0.3797147972097043,-0.11406705339602158
8401,31111,Lincoln,Nebraska,2008,5046,10817,414,16277,0.31000798672974134,0.6645573508631811,0.025434662407077473,141,176,-239,78,0.007211517811906876,0.010742397452450644,-0.017953915264357634,-5771,380,-0.3545493641334398,0.02516543307626451
8402,31111,Lincoln,Nebraska,2012,4450,10728,477,15655,0.28425423187480037,0.6852762695624401,0.030469498562759503,-596,63,-89,-622,-0.02575375485494097,0.005034836155682031,0.020718918699259015,-6278,-507,-0.4010220376876398,-0.046472673554199984
8403,31111,Lincoln,Nebraska,2016,2913,12164,1054,16131,0.18058396875581179,0.7540760027276672,0.06534002851652099,-1537,577,1436,476,-0.10367026311898858,0.034870529953761484,0.06879973316522703,-9251,-2973,-0.5734920339718554,-0.17246999628421567
8404,31113,Logan,Nebraska,2000,60,336,16,412,0.14563106796116504,0.8155339805825242,0.038834951456310676,0,0,0,0,0.0,0.0,0.0,-276,0,-0.6699029126213591,0.0
8405,31113,Logan,Nebraska,2004,67,357,5,429,0.1561771561771562,0.8321678321678322,0.011655011655011656,7,-11,21,17,0.01054608821599115,-0.02717993980129902,0.016633851585307946,-290,-14,-0.675990675990676,-0.006087763369316823
8406,31113,Logan,Nebraska,2008,81,327,8,416,0.19471153846153846,0.7860576923076923,0.019230769230769232,14,3,-30,-13,0.038534382284382274,0.007575757575757576,-0.0461101398601399,-246,44,-0.5913461538461539,0.08464452214452212
8407,31113,Logan,Nebraska,2012,68,356,7,431,0.15777262180974477,0.8259860788863109,0.016241299303944315,-13,-1,29,15,-0.03693891665179369,-0.002989469926824917,0.039928386578618635,-288,-42,-0.6682134570765661,-0.07686730323041224
8408,31113,Logan,Nebraska,2016,32,400,21,453,0.0706401766004415,0.8830022075055187,0.046357615894039736,-36,14,44,22,-0.08713244520930327,0.03011631659009542,0.057016128619207795,-368,-80,-0.8123620309050772,-0.1441485738285111
8409,31115,Loup,Nebraska,2000,84,284,10,378,0.2222222222222222,0.7513227513227513,0.026455026455026454,0,0,0,0,0.0,0.0,0.0,-200,0,-0.5291005291005291,0.0
8410,31115,Loup,Nebraska,2004,68,314,4,386,0.17616580310880828,0.8134715025906736,0.010362694300518135,-16,-6,30,8,-0.04605641911341393,-0.016092332154508317,0.0621487512679223,-246,-46,-0.6373056994818653,-0.10820517038133626
8411,31115,Loup,Nebraska,2008,86,302,5,393,0.21882951653944022,0.7684478371501272,0.01272264631043257,18,1,-12,7,0.04266371343063194,0.002359952009914434,-0.04502366544054637,-216,30,-0.549618320610687,0.08768737887117828
8412,31115,Loup,Nebraska,2012,62,290,6,358,0.17318435754189945,0.8100558659217877,0.01675977653631285,-24,1,-12,-35,-0.04564515899754076,0.00403713022588028,0.04160802877166048,-228,-12,-0.6368715083798883,-0.08725318776920121
8413,31115,Loup,Nebraska,2016,48,323,14,385,0.12467532467532468,0.8389610389610389,0.03636363636363636,-14,8,33,27,-0.04850903286657478,0.019603859827323513,0.02890517303925122,-275,-47,-0.7142857142857142,-0.07741420590582593
8414,31117,McPherson,Nebraska,2000,48,244,9,301,0.15946843853820597,0.8106312292358804,0.029900332225913623,0,0,0,0,0.0,0.0,0.0,-196,0,-0.6511627906976745,0.0
8415,31117,McPherson,Nebraska,2004,49,259,4,312,0.15705128205128205,0.8301282051282052,0.01282051282051282,1,-5,15,11,-0.0024171564869239215,-0.017079819405400803,0.019496975892324797,-210,-14,-0.6730769230769231,-0.021914132379248663
8416,31117,McPherson,Nebraska,2008,45,240,8,293,0.15358361774744028,0.8191126279863481,0.027303754266211604,-4,4,-19,-19,-0.0034676643038417665,0.014483241445698784,-0.01101557714185708,-195,15,-0.6655290102389078,0.007547912838015369
8417,31117,McPherson,Nebraska,2012,41,237,13,291,0.140893470790378,0.8144329896907216,0.044673539518900345,-4,5,-3,-2,-0.012690146957062276,0.01736978525268874,-0.004679638295626454,-196,-1,-0.6735395189003437,-0.008010508661435933
8418,31117,McPherson,Nebraska,2016,14,257,16,287,0.04878048780487805,0.8954703832752613,0.05574912891986063,-27,3,20,-4,-0.09211298298549996,0.011075589400960283,0.08103739358453965,-243,-47,-0.8466898954703832,-0.1731503765700395
8419,31119,Madison,Nebraska,2000,2772,9636,445,12853,0.21566949350346223,0.7497082393215592,0.034622267174978606,0,0,0,0,0.0,0.0,0.0,-6864,0,-0.534038745818097,0.0
8420,31119,Madison,Nebraska,2004,2934,10981,174,14089,0.20824756902548086,0.7794023706437646,0.01235006033075449,162,-271,1345,1236,-0.007421924477981373,-0.022272206844224117,0.02969413132220544,-8047,-1183,-0.5711548016182837,-0.03711605580018673
8421,31119,Madison,Nebraska,2008,4142,9655,248,14045,0.29490922036311856,0.687433250266999,0.017657529369882522,1208,74,-1326,-44,0.0866616513376377,0.005307469039128033,-0.09196912037676563,-5513,2534,-0.3925240299038804,0.17863077171440328
8422,31119,Madison,Nebraska,2012,3485,10062,338,13885,0.25099027727763773,0.7246669067338855,0.024342815988476773,-657,90,407,-160,-0.04391894308548083,0.006685286618594251,0.03723365646688648,-6577,-1064,-0.4736766294562477,-0.08115259955236731
8423,31119,Madison,Nebraska,2016,2711,10628,1004,14343,0.18901206163285225,0.7409886355713589,0.06999930279578889,-774,666,566,458,-0.06197821564478548,0.045656486807312116,0.016321728837473404,-7917,-1340,-0.5519765739385066,-0.07829994448225891
8424,31121,Merrick,Nebraska,2000,848,2380,112,3340,0.25389221556886227,0.7125748502994012,0.033532934131736525,0,0,0,0,0.0,0.0,0.0,-1532,0,-0.4586826347305389,0.0
8425,31121,Merrick,Nebraska,2004,833,2771,53,3657,0.2277823352474706,0.757724911129341,0.014492753623188406,-15,-59,391,317,-0.026109880321391665,-0.019040180508548117,0.045150060829939886,-1938,-406,-0.5299425758818704,-0.07125994115133155
8426,31121,Merrick,Nebraska,2008,986,2375,70,3431,0.28737977266103176,0.6922180122413291,0.020402215097639172,153,17,-396,-226,0.05959743741356116,0.005909461474450766,-0.06550689888801198,-1389,549,-0.4048382395802973,0.12510433630157314
8427,31121,Merrick,Nebraska,2012,925,2490,74,3489,0.26511894525652047,0.7136715391229579,0.02120951562052164,-61,4,115,58,-0.022260827404511296,0.0008073005228824669,0.021453526881628826,-1565,-176,-0.4485525938664374,-0.04371435428614012
8428,31121,Merrick,Nebraska,2016,602,2926,260,3788,0.15892291446673706,0.7724392819429778,0.06863780359028511,-323,186,436,299,-0.1061960307897834,0.04742828796976347,0.05876774282001995,-2324,-759,-0.6135163674762407,-0.1649637736098033
8429,31123,Morrill,Nebraska,2000,460,1597,81,2138,0.21515434985968196,0.7469597754911131,0.03788587464920486,0,0,0,0,0.0,0.0,0.0,-1137,0,-0.5318054256314312,0.0
8430,31123,Morrill,Nebraska,2004,495,1755,43,2293,0.2158744003488879,0.765372873964239,0.01875272568687309,35,-38,158,155,0.0007200504892059534,-0.019133148962331772,0.01841309847312589,-1260,-123,-0.5494984736153511,-0.017693047983919907
8431,31123,Morrill,Nebraska,2008,557,1725,69,2351,0.23692045937898767,0.7337303275202042,0.029349213100808166,62,26,-30,58,0.021046059030099762,0.010596487413935075,-0.03164254644403486,-1168,92,-0.4968098681412165,0.052688605474134564
8432,31123,Morrill,Nebraska,2012,455,1681,54,2190,0.20776255707762556,0.7675799086757991,0.024657534246575342,-102,-15,-44,-161,-0.029157902301362115,-0.004691678854232825,0.03384958115559489,-1226,-58,-0.5598173515981735,-0.06300748345695695
8433,31123,Morrill,Nebraska,2016,284,1802,123,2209,0.12856496152105024,0.8157537347215935,0.05568130375735627,-171,69,121,19,-0.07919759555657532,0.031023769510780928,0.048173826045794454,-1518,-292,-0.6871887732005433,-0.1273714216023698
8434,31125,Nance,Nebraska,2000,497,1105,63,1665,0.2984984984984985,0.6636636636636637,0.03783783783783784,0,0,0,0,0.0,0.0,0.0,-608,0,-0.3651651651651652,0.0
8435,31125,Nance,Nebraska,2004,459,1237,35,1731,0.2651646447140381,0.7146158290005777,0.020219526285384173,-38,-28,132,66,-0.03333385378446041,-0.017618311552453667,0.050952165336914046,-778,-170,-0.44945118428653963,-0.08428601912137446
8436,31125,Nance,Nebraska,2008,549,1116,42,1707,0.3216168717047452,0.6537785588752196,0.02460456942003515,90,7,-121,-24,0.056452226990707066,0.004385043134650976,-0.06083727012535811,-567,211,-0.33216168717047445,0.11728949711606518
8437,31125,Nance,Nebraska,2012,481,1106,34,1621,0.29673041332510797,0.6822948797038865,0.020974706971005553,-68,-8,-10,-86,-0.02488645837963721,-0.003629862449029596,0.02851632082866684,-625,-58,-0.3855644663787785,-0.05340277920830405
8438,31125,Nance,Nebraska,2016,281,1261,79,1621,0.17334978408389884,0.7779148673658236,0.048735348550277606,-200,45,155,0,-0.12338062924120913,0.027760641579272053,0.09561998766193713,-980,-355,-0.6045650832819247,-0.2190006169031462
8439,31127,Nemaha,Nebraska,2000,1063,2177,129,3369,0.3155238943306619,0.6461858118135946,0.03829029385574354,0,0,0,0,0.0,0.0,0.0,-1114,0,-0.33066191748293267,0.0
8440,31127,Nemaha,Nebraska,2004,1066,2595,54,3715,0.2869448183041723,0.6985195154777928,0.014535666218034994,3,-75,418,346,-0.028579076026489625,-0.023754627637708546,0.052333703664198206,-1529,-415,-0.4115746971736205,-0.08091277969068783
8441,31127,Nemaha,Nebraska,2008,1240,2134,100,3474,0.356937248128958,0.6142774899251583,0.028785261945883708,174,46,-461,-241,0.0699924298247857,0.014249595727848714,-0.08424202555263449,-894,635,-0.2573402417962003,0.1542344553774202
8442,31127,Nemaha,Nebraska,2012,1128,2012,74,3214,0.3509645301804605,0.6260112009956441,0.023024268823895456,-112,-26,-122,-260,-0.005972717948497519,-0.005760993121988252,0.01173371107048582,-884,10,-0.27504667081518364,-0.01770642901898334
8443,31127,Nemaha,Nebraska,2016,785,2116,260,3161,0.24833913318570072,0.6694084150585258,0.08225245175577349,-343,186,104,-53,-0.10262539699475975,0.05922818293187804,0.04339721406288166,-1331,-447,-0.42106928187282505,-0.14602261105764142
8444,31129,Nuckolls,Nebraska,2000,644,1701,98,2443,0.2636103151862464,0.6962750716332379,0.04011461318051576,0,0,0,0,0.0,0.0,0.0,-1057,0,-0.4326647564469915,0.0
8445,31129,Nuckolls,Nebraska,2004,541,1884,46,2471,0.2189397005261028,0.7624443545123432,0.018615944961554026,-103,-52,183,28,-0.044670614660143604,-0.021498668218961736,0.06616928287910528,-1343,-286,-0.5435046539862404,-0.11083989753924889
8446,31129,Nuckolls,Nebraska,2008,657,1498,66,2221,0.29581269698334084,0.6744709590274651,0.029716343989194056,116,20,-386,-250,0.07687299645723805,0.01110039902764003,-0.08797339548487804,-841,502,-0.3786582620441243,0.1648463919421161
8447,31129,Nuckolls,Nebraska,2012,568,1574,49,2191,0.25924235508900045,0.7183934276586034,0.022364217252396165,-89,-17,76,-30,-0.036570341894340386,-0.0073521267367978906,0.043922468631138245,-1006,-165,-0.4591510725696029,-0.08049281052547863
8448,31129,Nuckolls,Nebraska,2016,353,1726,126,2205,0.1600907029478458,0.7827664399092971,0.05714285714285714,-215,77,152,14,-0.09915165214115465,0.034778639890460976,0.0643730122506937,-1373,-367,-0.6226757369614513,-0.16352466439184837
8449,31131,Otoe,Nebraska,2000,2208,4178,276,6662,0.3314320024016812,0.6271389972981086,0.04142900030021015,0,0,0,0,0.0,0.0,0.0,-1970,0,-0.29570699489642743,0.0
8450,31131,Otoe,Nebraska,2004,2275,5018,93,7386,0.3080151638234498,0.6793934470620092,0.012591389114541024,67,-183,840,724,-0.023416838578231403,-0.028837611185669125,0.05225444976390059,-2743,-773,-0.3713782832385594,-0.07567128834213199
8451,31131,Otoe,Nebraska,2008,2915,4033,144,7092,0.4110265087422448,0.5686689227298365,0.02030456852791878,640,51,-985,-294,0.10301134491879499,0.007713179413377756,-0.11072452433217272,-1118,1625,-0.1576424139875917,0.2137358692509677
8452,31131,Otoe,Nebraska,2012,2561,4258,163,6982,0.3668003437410484,0.6098539100544257,0.023345746204525925,-354,19,225,-110,-0.04422616500119636,0.0030411776766071444,0.041184987324589195,-1697,-579,-0.24305356631337727,-0.08541115232578556
8453,31131,Otoe,Nebraska,2016,2025,4860,572,7457,0.27155692637789997,0.6517366233069599,0.07670645031514013,-536,409,602,475,-0.09524341736314845,0.05336070411061421,0.04188271325253423,-2835,-1138,-0.38017969692905995,-0.13712613061568268
8454,31133,Pawnee,Nebraska,2000,522,937,60,1519,0.3436471362738644,0.6168531928900592,0.03949967083607637,0,0,0,0,0.0,0.0,0.0,-415,0,-0.27320605661619485,0.0
8455,31133,Pawnee,Nebraska,2004,481,986,16,1483,0.32434254888739045,0.6648685097774781,0.01078894133513149,-41,-44,49,-36,-0.019304587386473948,-0.02871072950094488,0.04801531688741889,-505,-90,-0.3405259608900877,-0.06731990427389284
8456,31133,Pawnee,Nebraska,2008,483,859,42,1384,0.34898843930635837,0.6206647398843931,0.030346820809248554,2,26,-127,-99,0.02464589041896792,0.019557879474117065,-0.044203769893085054,-376,129,-0.2716763005780347,0.06884966031205297
8457,31133,Pawnee,Nebraska,2012,400,899,42,1341,0.29828486204325133,0.6703952274422073,0.03131991051454139,-83,0,40,-43,-0.050703577263107036,0.0009730897052928345,0.049730487557814174,-499,-123,-0.3721103653989559,-0.10043406482092121
8458,31133,Pawnee,Nebraska,2016,279,974,74,1327,0.21024868123587037,0.7339864355689525,0.05576488319517709,-121,32,75,-14,-0.08803618080738096,0.024444972680635703,0.06359120812674524,-695,-196,-0.5237377543330821,-0.1516273889341262
8459,31135,Perkins,Nebraska,2000,243,1170,39,1452,0.16735537190082644,0.8057851239669421,0.026859504132231406,0,0,0,0,0.0,0.0,0.0,-927,0,-0.6384297520661157,0.0
8460,31135,Perkins,Nebraska,2004,262,1285,11,1558,0.1681643132220796,0.824775353016688,0.007060333761232349,19,-28,115,106,0.0008089413212531427,-0.019799170370999056,0.0189902290497459,-1023,-96,-0.6566110397946084,-0.0181812877284927
8461,31135,Perkins,Nebraska,2008,310,1092,18,1420,0.21830985915492956,0.7690140845070422,0.01267605633802817,48,7,-193,-138,0.05014554593284998,0.00561572257679582,-0.0557612685096458,-782,241,-0.5507042253521126,0.10590681444249583
8462,31135,Perkins,Nebraska,2012,238,1135,21,1394,0.17073170731707318,0.8142037302725968,0.015064562410329985,-72,3,43,-26,-0.04757815183785638,0.002388506072301816,0.04518964576555462,-897,-115,-0.6434720229555236,-0.09276779760341103
8463,31135,Perkins,Nebraska,2016,161,1217,77,1455,0.11065292096219931,0.836426116838488,0.052920962199312714,-77,56,82,61,-0.060078786354873875,0.037856399788982725,0.02222238656589115,-1056,-159,-0.7257731958762887,-0.08230117292076511
8464,31137,Phelps,Nebraska,2000,934,3575,118,4627,0.20185865571644696,0.7726388588718393,0.025502485411713852,0,0,0,0,0.0,0.0,0.0,-2641,0,-0.5707802031553924,0.0
8465,31137,Phelps,Nebraska,2004,830,3872,41,4743,0.17499472907442548,0.8163609529833439,0.008644317942230655,-104,-77,297,116,-0.026863926642021474,-0.016858167469483196,0.04372209411150463,-3042,-401,-0.6413662239089184,-0.07058602075352605
8466,31137,Phelps,Nebraska,2008,1050,3360,63,4473,0.2347417840375587,0.7511737089201878,0.014084507042253521,220,22,-512,-270,0.059747054963133206,0.0054401891000228665,-0.06518724406315612,-2310,732,-0.516431924882629,0.12493429902628939
8467,31137,Phelps,Nebraska,2012,880,3400,100,4380,0.2009132420091324,0.776255707762557,0.0228310502283105,-170,37,40,-93,-0.03382854202842628,0.00874654318605698,0.02508199884236928,-2520,-210,-0.5753424657534246,-0.058910540870795614
8468,31137,Phelps,Nebraska,2016,572,3849,274,4695,0.12183173588924387,0.8198083067092652,0.05835995740149095,-308,174,449,315,-0.07908150611988854,0.03552890717318045,0.043552598946708154,-3277,-757,-0.6979765708200213,-0.12263410506659667
8469,31139,Pierce,Nebraska,2000,570,2534,104,3208,0.17768079800498754,0.7899002493765586,0.032418952618453865,0,0,0,0,0.0,0.0,0.0,-1964,0,-0.6122194513715711,0.0
8470,31139,Pierce,Nebraska,2004,546,2824,28,3398,0.16068275456150677,0.8310771041789288,0.00824014125956445,-24,-76,290,190,-0.01699804344348077,-0.024178811358889416,0.04117685480237021,-2278,-314,-0.6703943496174221,-0.05817489824585098
8471,31139,Pierce,Nebraska,2008,783,2385,58,3226,0.24271543707377558,0.7393056416615003,0.017978921264724116,237,30,-439,-172,0.0820326825122688,0.009738780005159667,-0.09177146251742851,-1602,676,-0.4965902045877247,0.17380414502969738
8472,31139,Pierce,Nebraska,2012,637,2707,87,3431,0.18566015738851646,0.7889828038472748,0.025357038764208684,-146,29,322,205,-0.057055279685259114,0.007378117499484568,0.04967716218577456,-2070,-468,-0.6033226464587583,-0.10673244187103365
8473,31139,Pierce,Nebraska,2016,382,3052,196,3630,0.10523415977961433,0.840771349862259,0.05399449035812672,-255,109,345,199,-0.08042599760890214,0.028637451593918038,0.05178854601498417,-2670,-600,-0.7355371900826446,-0.1322145436238863
8474,31141,Platte,Nebraska,2000,2612,9861,386,12859,0.203126215102263,0.7668558985924255,0.030017886305311454,0,0,0,0,0.0,0.0,0.0,-7249,0,-0.5637296834901625,0.0
8475,31141,Platte,Nebraska,2004,2657,11130,200,13987,0.18996210767140917,0.7957389004075213,0.014298991921069565,45,-186,1269,1128,-0.013164107430853833,-0.01571889438424189,0.028883001815095732,-8473,-1224,-0.6057767927361121,-0.042047109245949565
8476,31141,Platte,Nebraska,2008,3796,9373,251,13420,0.28286140089418776,0.6984351713859911,0.018703427719821163,1139,51,-1757,-567,0.0928992932227786,0.004404435798751598,-0.09730372902153017,-5577,2896,-0.41557377049180333,0.19020302224430874
8477,31141,Platte,Nebraska,2012,3148,10061,264,13473,0.23365249016551623,0.7467527647888369,0.019594745045646848,-648,13,688,53,-0.049208910728671534,0.000891317325825685,0.048317593402845804,-6913,-1336,-0.5131002746233206,-0.09752650413151731
8478,31141,Platte,Nebraska,2016,2646,10965,822,14433,0.18332986905009355,0.7597173144876325,0.05695281646227396,-502,558,904,960,-0.05032262111542268,0.037358071416627114,0.012964549698795569,-8319,-1406,-0.576387445437539,-0.06328717081421831
8479,31143,Polk,Nebraska,2000,610,1925,78,2613,0.2334481438959051,0.7367011098354382,0.029850746268656716,0,0,0,0,0.0,0.0,0.0,-1315,0,-0.5032529659395332,0.0
8480,31143,Polk,Nebraska,2004,549,2146,32,2727,0.20132013201320131,0.7869453612027869,0.011734506784011734,-61,-46,221,114,-0.03212801188270378,-0.018116239484644983,0.05024425136734867,-1597,-282,-0.5856252291895856,-0.08237226325005242
8481,31143,Polk,Nebraska,2008,668,1822,53,2543,0.2626818718049548,0.7164766024380653,0.020841525756979944,119,21,-324,-184,0.06136173979175347,0.00910701897296821,-0.07046875876472158,-1154,443,-0.45379473063311054,0.13183049855647505
8482,31143,Polk,Nebraska,2012,528,1890,39,2457,0.2148962148962149,0.7692307692307693,0.015873015873015872,-140,-14,68,-86,-0.04778565690873987,-0.0049685098839640715,0.05275416679270395,-1362,-208,-0.5543345543345544,-0.10053982370144382
8483,31143,Polk,Nebraska,2016,413,2028,141,2582,0.15995352439969016,0.7854376452362509,0.05460883036405887,-115,102,138,125,-0.054942690496524754,0.038735814491043,0.016206876005481652,-1615,-253,-0.6254841208365608,-0.07114956650200643
8484,31145,Red Willow,Nebraska,2000,1188,3680,157,5025,0.2364179104477612,0.7323383084577114,0.031243781094527363,0,0,0,0,0.0,0.0,0.0,-2492,0,-0.49592039800995025,0.0
8485,31145,Red Willow,Nebraska,2004,1055,4129,74,5258,0.200646633701027,0.7852795739825028,0.01407379231647014,-133,-83,449,233,-0.03577127674673419,-0.017169988778057223,0.05294126552479139,-3074,-582,-0.5846329402814758,-0.08871254227152559
8486,31145,Red Willow,Nebraska,2008,1216,3735,93,5044,0.24107850911974624,0.7404837430610627,0.01843774781919112,161,19,-394,-214,0.04043187541871923,0.004363955502720979,-0.04479583092144013,-2519,555,-0.4994052339413164,0.08522770634015941
8487,31145,Red Willow,Nebraska,2012,952,3891,93,4936,0.19286871961102106,0.788290113452188,0.018841166936790926,-264,0,156,-108,-0.048209789508725176,0.000403419117599807,0.04780637039112534,-2939,-420,-0.595421393841167,-0.09601615989985057
8488,31145,Red Willow,Nebraska,2016,645,4258,267,5170,0.12475822050290135,0.8235976789168279,0.051644100580270795,-307,174,367,234,-0.06811049910811971,0.03280293364347987,0.03530756546463987,-3613,-674,-0.6988394584139266,-0.1034180645727596
8489,31147,Richardson,Nebraska,2000,1382,2623,145,4150,0.3330120481927711,0.6320481927710844,0.03493975903614458,0,0,0,0,0.0,0.0,0.0,-1241,0,-0.2990361445783133,0.0
8490,31147,Richardson,Nebraska,2004,1297,2924,57,4278,0.3031790556334736,0.6834969611968209,0.01332398316970547,-85,-88,301,128,-0.0298329925592975,-0.02161577586643911,0.051448768425736535,-1627,-386,-0.3803179055633473,-0.08128176098503404
8491,31147,Richardson,Nebraska,2008,1513,2342,113,3968,0.38130040322580644,0.5902217741935484,0.02847782258064516,216,56,-582,-310,0.07812134759233286,0.01515383941093969,-0.09327518700327253,-829,798,-0.20892137096774194,0.1713965345956054
8492,31147,Richardson,Nebraska,2012,1191,2443,105,3739,0.3185343674779353,0.6533832575554961,0.0280823749665686,-322,-8,101,-229,-0.06276603574787115,-0.0003954476140765606,0.06316148336194771,-1252,-423,-0.3348488900775608,-0.12592751910981886
8493,31147,Richardson,Nebraska,2016,818,2769,218,3805,0.2149802890932983,0.7277266754270696,0.05729303547963206,-373,113,326,66,-0.10355407838463698,0.029210660513063463,0.0743434178715735,-1951,-699,-0.5127463863337713,-0.17789749625621054
8494,31149,Rock,Nebraska,2000,141,725,28,894,0.15771812080536912,0.8109619686800895,0.03131991051454139,0,0,0,0,0.0,0.0,0.0,-584,0,-0.6532438478747205,0.0
8495,31149,Rock,Nebraska,2004,130,740,13,883,0.14722536806342015,0.8380520951302378,0.014722536806342015,-11,-15,15,-11,-0.010492752741948969,-0.016597373708199373,0.0270901264501483,-610,-26,-0.6908267270668177,-0.03758287919209724
8496,31149,Rock,Nebraska,2008,139,640,22,801,0.1735330836454432,0.7990012484394506,0.02746566791510612,9,9,-100,-82,0.02630771558202305,0.012743131108764103,-0.03905084669078718,-501,109,-0.6254681647940075,0.06535856227281023
8497,31149,Rock,Nebraska,2012,103,672,14,789,0.13054499366286437,0.8517110266159695,0.017743979721166033,-36,-8,32,-12,-0.04298808998257883,-0.009721688193940085,0.052709778176518896,-569,-68,-0.7211660329531051,-0.09569786815909764
8498,31149,Rock,Nebraska,2016,70,687,41,798,0.08771929824561403,0.8609022556390977,0.05137844611528822,-33,27,15,9,-0.04282569541725034,0.03363446639412218,0.009191229023128189,-617,-48,-0.7731829573934836,-0.05201692444037853
8499,31151,Saline,Nebraska,2000,2321,2581,243,5145,0.4511175898931001,0.5016520894071914,0.04723032069970846,0,0,0,0,0.0,0.0,0.0,-260,0,-0.050534499514091336,0.0
8500,31151,Saline,Nebraska,2004,2420,3071,75,5566,0.43478260869565216,0.5517427236794826,0.013474667624865252,99,-168,490,421,-0.016334981197447918,-0.033755653074843205,0.05009063427229121,-651,-391,-0.11696011498383047,-0.06642561546973913
8501,31151,Saline,Nebraska,2008,2674,2434,143,5251,0.5092363359360121,0.4635307560464673,0.02723290801752047,254,68,-637,-315,0.07445372724035998,0.013758240392655219,-0.08821196763301531,240,891,0.04570557988954482,0.1626656948733753
8502,31151,Saline,Nebraska,2012,2289,2557,112,4958,0.4616780960064542,0.5157321500605083,0.022589753933037516,-385,-31,123,-293,-0.04755823992955793,-0.004643154084482955,0.052201394014041,-268,-508,-0.05405405405405411,-0.09975963394359894
8503,31151,Saline,Nebraska,2016,1733,3004,399,5136,0.3374221183800623,0.5848909657320872,0.07768691588785047,-556,287,447,178,-0.1242559776263919,0.055097161954812957,0.06915881567157889,-1271,-1003,-0.2474688473520249,-0.1934147932979708
8504,31153,Sarpy,Nebraska,2000,14637,28979,1662,45278,0.3232695790450108,0.640023852643668,0.03670656831132117,0,0,0,0,0.0,0.0,0.0,-14342,0,-0.3167542735986572,0.0
8505,31153,Sarpy,Nebraska,2004,17455,40163,716,58334,0.2992251517125519,0.6885007028491102,0.012274145438337847,2818,-946,11184,13056,-0.02404442733245893,-0.024432422872983327,0.048476850205442235,-22708,-8366,-0.3892755511365584,-0.07252127753790116
8506,31153,Sarpy,Nebraska,2008,28010,38816,1196,68022,0.4117785422363353,0.5706389109405781,0.01758254682308665,10555,480,-1347,9688,0.11255339052378344,0.005308401384748801,-0.11786179190853219,-10806,11902,-0.15886036870424275,0.23041518243231562
8507,31153,Sarpy,Nebraska,2012,26671,43213,1606,71490,0.37307315708490696,0.6044621625402155,0.022464680374877605,-1339,410,4397,3468,-0.03870538515142835,0.004882133551790957,0.033823251599637394,-16542,-5736,-0.2313890054553085,-0.07252863675106574
8508,31153,Sarpy,Nebraska,2016,28033,45143,7404,80580,0.3478902953586498,0.5602258624968975,0.09188384214445272,1362,5798,1930,9090,-0.025182861726257166,0.06941916176957512,-0.04423630004331791,-17110,-568,-0.21233556713824775,0.019053438317060745
8509,31155,Saunders,Nebraska,2000,2852,5688,379,8919,0.3197667899988788,0.6377396569122099,0.04249355308891131,0,0,0,0,0.0,0.0,0.0,-2836,0,-0.3179728669133311,0.0
8510,31155,Saunders,Nebraska,2004,2884,6441,164,9489,0.3039308673200548,0.6787859626936453,0.017283169986299925,32,-215,753,570,-0.015835922678824,-0.025210383102611388,0.04104630578143542,-3557,-721,-0.3748550953735905,-0.05688222846025942
8511,31155,Saunders,Nebraska,2008,3767,6188,257,10212,0.36887974931453194,0.6059537798668233,0.02516647081864473,883,93,-253,723,0.06494888199447713,0.007883300832344807,-0.07283218282682202,-2421,1136,-0.23707403055229137,0.13778106482129915
8512,31155,Saunders,Nebraska,2012,3307,6770,235,10312,0.3206943366951125,0.6565166795965865,0.022788983708301007,-460,-22,582,100,-0.04818541261941944,-0.002377487110343725,0.050562899729763244,-3463,-1042,-0.33582234290147406,-0.09874831234918269
8513,31155,Saunders,Nebraska,2016,2523,7555,782,10860,0.23232044198895027,0.6956721915285451,0.07200736648250461,-784,547,785,548,-0.08837389470616222,0.0492183827742036,0.03915551193195854,-5032,-1569,-0.4633517495395948,-0.12752940663812073
8514,31157,Scotts Bluff,Nebraska,2000,3937,9397,505,13839,0.2844858732567382,0.6790230507984681,0.0364910759447937,0,0,0,0,0.0,0.0,0.0,-5460,0,-0.39453717754172996,0.0
8515,31157,Scotts Bluff,Nebraska,2004,3843,10378,169,14390,0.2670604586518416,0.7211952744961779,0.011744266851980541,-94,-336,981,551,-0.017425414604896605,-0.024746809092813158,0.04217222369770979,-6535,-1075,-0.45413481584433635,-0.05959763830260639
8516,31157,Scotts Bluff,Nebraska,2008,4745,9708,277,14730,0.3221317040054311,0.6590631364562118,0.018805159538357093,902,108,-670,340,0.05507124535358954,0.007060892686376552,-0.06213213803996609,-4963,1572,-0.3369314324507807,0.11720338339355563
8517,31157,Scotts Bluff,Nebraska,2012,4327,9648,312,14287,0.3028627423531882,0.6752992230699237,0.02183803457688808,-418,35,-60,-443,-0.0192689616522429,0.0030328750385309883,0.016236086613711898,-5321,-358,-0.3724364807167355,-0.0355050482659548
8518,31157,Scotts Bluff,Nebraska,2016,3207,10076,1034,14317,0.22399944122372006,0.7037787245931411,0.07222183418313892,-1120,722,428,30,-0.07886330112946816,0.050383799606250834,0.02847950152321732,-6869,-1548,-0.479779283369421,-0.10734280265268548
8519,31159,Seward,Nebraska,2000,2250,4457,309,7016,0.32069555302166475,0.6352622576966933,0.04404218928164196,0,0,0,0,0.0,0.0,0.0,-2207,0,-0.31456670467502856,0.0
8520,31159,Seward,Nebraska,2004,2114,5353,98,7565,0.27944481163251816,0.7076007931262392,0.012954395241242565,-136,-211,896,549,-0.041250741389146584,-0.031087794040399398,0.07233853542954594,-3239,-1032,-0.4281559814937211,-0.11358927681869252
8521,31159,Seward,Nebraska,2008,2703,4647,179,7529,0.35901182095895867,0.6172134413600744,0.02377473768096693,589,81,-706,-36,0.07956700932644051,0.010820342439724365,-0.09038735176616486,-1944,1295,-0.2582016204011157,0.16995436109260537
8522,31159,Seward,Nebraska,2012,2386,5003,184,7573,0.3150666842730754,0.66063647167569,0.02429684405123465,-317,5,356,44,-0.04394513668588329,0.0005221063702677206,0.04342303031561556,-2617,-673,-0.34556978740261457,-0.08736816700149885
8523,31159,Seward,Nebraska,2016,1875,5454,593,7922,0.23668265589497603,0.6884625094673062,0.07485483463771775,-511,409,451,349,-0.07838402837809935,0.050557990586483095,0.027826037791616298,-3579,-962,-0.4517798535723302,-0.10621006616971562
8524,31161,Sheridan,Nebraska,2000,392,2105,79,2576,0.15217391304347827,0.8171583850931677,0.030667701863354036,0,0,0,0,0.0,0.0,0.0,-1713,0,-0.6649844720496895,0.0
8525,31161,Sheridan,Nebraska,2004,430,2136,33,2599,0.1654482493266641,0.8218545594459408,0.012697191227395151,38,-46,31,23,0.013274336283185834,-0.017970510635958885,0.00469617435277303,-1706,7,-0.6564063101192766,0.008578161930412831
8526,31161,Sheridan,Nebraska,2008,454,1941,67,2462,0.1844029244516653,0.7883834281072299,0.027213647441104792,24,34,-195,-137,0.018954675125001208,0.01451645621370964,-0.033471131338710824,-1487,219,-0.6039805036555647,0.05242580646371198
8527,31161,Sheridan,Nebraska,2012,390,2021,61,2472,0.15776699029126215,0.8175566343042071,0.024676375404530743,-64,-6,80,10,-0.026635934160403163,-0.0025372720365740495,0.029173206196977164,-1631,-144,-0.6597896440129449,-0.05580914035738027
8528,31161,Sheridan,Nebraska,2016,287,2211,110,2608,0.11004601226993865,0.8477760736196319,0.04217791411042945,-103,49,190,136,-0.047720978021323496,0.017501538705898705,0.030219439315424812,-1924,-293,-0.7377300613496933,-0.07794041733674839
8529,31163,Sherman,Nebraska,2000,564,1072,69,1705,0.330791788856305,0.6287390029325514,0.04046920821114369,0,0,0,0,0.0,0.0,0.0,-508,0,-0.29794721407624636,0.0
8530,31163,Sherman,Nebraska,2004,541,1072,30,1643,0.3292757151552039,0.6524650030432136,0.018259281801582473,-23,-39,0,-62,-0.0015160737011011283,-0.02220992640956122,0.023726000110662282,-531,-23,-0.32318928788800977,-0.02524207381176341
8531,31163,Sherman,Nebraska,2008,585,950,37,1572,0.37213740458015265,0.6043256997455471,0.023536895674300253,44,7,-122,-71,0.04286168942494878,0.00527761387271778,-0.04813930329766658,-365,166,-0.2321882951653944,0.09100099272261536
8532,31163,Sherman,Nebraska,2012,552,927,51,1530,0.3607843137254902,0.6058823529411764,0.03333333333333333,-33,14,-23,-42,-0.011353090854662462,0.00979643765903308,0.001556653195629365,-375,-10,-0.24509803921568624,-0.012909744050291827
8533,31163,Sherman,Nebraska,2016,340,1150,83,1573,0.2161474888747616,0.7310870947234583,0.052765416401780035,-212,32,223,43,-0.1446368248507286,0.019432083068446702,0.12520474178228191,-810,-435,-0.5149396058486968,-0.26984156663301057
8534,31165,Sioux,Nebraska,2000,98,629,25,752,0.13031914893617022,0.836436170212766,0.03324468085106383,0,0,0,0,0.0,0.0,0.0,-531,0,-0.7061170212765957,0.0
8535,31165,Sioux,Nebraska,2004,123,677,9,809,0.15203955500618047,0.8368355995055624,0.011124845488257108,25,-16,48,57,0.021720406070010245,-0.02211983536280672,0.00039942929279646044,-554,-23,-0.6847960444993819,0.021320976777213785
8536,31165,Sioux,Nebraska,2008,117,603,12,732,0.1598360655737705,0.8237704918032787,0.01639344262295082,-6,3,-74,-77,0.007796510567590037,0.005268597134693713,-0.013065107702283751,-486,68,-0.6639344262295082,0.02086161826987376
8537,31165,Sioux,Nebraska,2012,101,624,14,739,0.13667117726657646,0.8443843031123139,0.018944519621109608,-16,2,21,7,-0.023164888307194043,0.0025510769981587876,0.02061381130903528,-523,-37,-0.7077131258457374,-0.043778699616229266
8538,31165,Sioux,Nebraska,2016,81,616,39,736,0.11005434782608696,0.8369565217391305,0.05298913043478261,-20,25,-8,-3,-0.0266168294404895,0.034044610813673,-0.007427781373183451,-535,-12,-0.7269021739130436,-0.019189048067306147
8539,31167,Stanton,Nebraska,2000,500,1895,91,2486,0.2011263073209976,0.7622687047465808,0.03660498793242156,0,0,0,0,0.0,0.0,0.0,-1395,0,-0.5611423974255833,0.0
8540,31167,Stanton,Nebraska,2004,559,2159,27,2745,0.20364298724954463,0.7865209471766849,0.009836065573770493,59,-64,264,259,0.0025166799285470387,-0.026768922358651068,0.024252242430104043,-1600,-205,-0.5828779599271402,-0.02173556250155695
8541,31167,Stanton,Nebraska,2008,664,1781,50,2495,0.26613226452905814,0.7138276553106212,0.02004008016032064,105,23,-378,-250,0.062489277279513505,0.010204014586550148,-0.07269329186606366,-1117,483,-0.44769539078156306,0.13518256914557714
8542,31167,Stanton,Nebraska,2012,614,1949,81,2644,0.23222390317700453,0.7371406959152799,0.030635400907715583,-50,31,168,149,-0.033908361352053606,0.010595320747394943,0.023313040604658664,-1335,-218,-0.5049167927382754,-0.057221401956712326
8543,31167,Stanton,Nebraska,2016,417,2187,197,2801,0.14887540164227062,0.7807925740806855,0.07033202427704391,-197,116,238,157,-0.08334850153473392,0.039696623369328325,0.04365187816540561,-1770,-435,-0.6319171724384148,-0.12700037970013944
8544,31169,Thayer,Nebraska,2000,821,2096,89,3006,0.2731204258150366,0.697272122421823,0.029607451763140388,0,0,0,0,0.0,0.0,0.0,-1275,0,-0.4241516966067864,0.0
8545,31169,Thayer,Nebraska,2004,764,2075,39,2878,0.26546212647671996,0.7209867963863794,0.013551077136900626,-57,-50,-21,-128,-0.007658299338316632,-0.01605637462623976,0.0237146739645564,-1311,-36,-0.45552466990965945,-0.03137297330287303
8546,31169,Thayer,Nebraska,2008,860,1749,50,2659,0.3234298608499436,0.6577660774727341,0.018804061677322303,96,11,-326,-219,0.05796773437322361,0.005252984540421677,-0.06322071891364534,-889,422,-0.3343362166227905,0.12118845328686895
8547,31169,Thayer,Nebraska,2012,728,1874,57,2659,0.2737871380218127,0.7047762316660399,0.021436630312147424,-132,7,125,0,-0.04964272282813087,0.0026325686348251214,0.047010154193305786,-1146,-257,-0.43098909364422716,-0.09665287702143666
8548,31169,Thayer,Nebraska,2016,499,2051,140,2690,0.18550185873605948,0.762453531598513,0.05204460966542751,-229,83,177,31,-0.08828527928575322,0.030607979353280086,0.05767729993247317,-1552,-406,-0.5769516728624535,-0.14596257921822636
8549,31171,Thomas,Nebraska,2000,55,329,11,395,0.13924050632911392,0.8329113924050633,0.027848101265822784,0,0,0,0,0.0,0.0,0.0,-274,0,-0.6936708860759494,0.0
8550,31171,Thomas,Nebraska,2004,60,378,6,444,0.13513513513513514,0.8513513513513513,0.013513513513513514,5,-5,49,49,-0.004105371193978774,-0.01433458775230927,0.018439958946288026,-318,-44,-0.7162162162162162,-0.022545330140266828
8551,31171,Thomas,Nebraska,2008,51,331,8,390,0.13076923076923078,0.8487179487179487,0.020512820512820513,-9,2,-47,-54,-0.004365904365904366,0.0069993069993069985,-0.002633402633402615,-280,38,-0.717948717948718,-0.0017325017325017233
8552,31171,Thomas,Nebraska,2012,42,360,6,408,0.10294117647058823,0.8823529411764706,0.014705882352941176,-9,-2,29,18,-0.027828054298642546,-0.0058069381598793365,0.03363499245852186,-318,-38,-0.7794117647058824,-0.06146304675716441
8553,31171,Thomas,Nebraska,2016,30,344,19,393,0.07633587786259542,0.8753180661577609,0.04834605597964377,-12,13,-16,-15,-0.02660529860799281,0.03364017362670259,-0.0070348750187096964,-314,4,-0.7989821882951654,-0.01957042358928307
8554,31173,Thurston,Nebraska,2000,924,1040,118,2082,0.4438040345821326,0.49951969260326606,0.056676272814601344,0,0,0,0,0.0,0.0,0.0,-116,0,-0.055715658021133485,0.0
8555,31173,Thurston,Nebraska,2004,1212,1154,21,2387,0.5077503142019271,0.4834520318391286,0.008797653958944282,288,-97,114,305,0.06394627961979449,-0.047878618855657064,-0.01606766076413746,58,174,0.024298282362798462,0.08001394038393195
8556,31173,Thurston,Nebraska,2008,1120,972,34,2126,0.5268109125117592,0.45719661335841955,0.01599247412982126,-92,13,-182,-261,0.01906059830983209,0.007194820170876979,-0.02625541848070906,148,90,0.06961429915333961,0.04531601679054115
8557,31173,Thurston,Nebraska,2012,1247,939,29,2215,0.562979683972912,0.4239277652370203,0.01309255079006772,127,-5,-33,89,0.03616877146115283,-0.0028999233397535417,-0.03326884812139924,308,160,0.13905191873589168,0.06943761958255207
8558,31173,Thurston,Nebraska,2016,919,1043,126,2088,0.44013409961685823,0.49952107279693486,0.0603448275862069,-328,97,104,-127,-0.12284558435605375,0.04725227679613918,0.07559330755991456,-124,-432,-0.05938697318007663,-0.1984388919159683
8559,31175,Valley,Nebraska,2000,583,1610,70,2263,0.25762262483429077,0.7114449845338047,0.03093239063190455,0,0,0,0,0.0,0.0,0.0,-1027,0,-0.4538223596995139,0.0
8560,31175,Valley,Nebraska,2004,564,1801,26,2391,0.23588456712672523,0.753241321622752,0.010874111250522794,-19,-44,191,128,-0.02173805770756554,-0.020058279381381758,0.041796337088947366,-1237,-210,-0.5173567544960268,-0.0635343947965129
8561,31175,Valley,Nebraska,2008,706,1657,60,2423,0.2913743293437887,0.6838629797771357,0.024762690879075525,142,34,-144,32,0.055489762217063476,0.01388857962855273,-0.06937834184561631,-951,286,-0.392488650433347,0.12486810406267979
8562,31175,Valley,Nebraska,2012,498,1657,40,2195,0.22687927107061504,0.7548974943052392,0.018223234624145785,-208,-20,0,-228,-0.06449505827317367,-0.0065394562549297396,0.0710345145281035,-1159,-208,-0.5280182232346242,-0.1355295728012772
8563,31175,Valley,Nebraska,2016,339,1780,86,2205,0.15374149659863945,0.8072562358276644,0.039002267573696146,-159,46,123,10,-0.07313777447197559,0.02077903294955036,0.052358741522425145,-1441,-282,-0.6535147392290249,-0.1254965159944007
8564,31177,Washington,Nebraska,2000,2550,5758,318,8626,0.29561789937398564,0.6675168096452585,0.036865290980755853,0,0,0,0,0.0,0.0,0.0,-3208,0,-0.37189891027127286,0.0
8565,31177,Washington,Nebraska,2004,2754,7083,113,9950,0.2767839195979899,0.7118592964824121,0.01135678391959799,204,-205,1325,1324,-0.018833979775995713,-0.025508507061157863,0.04434248683715358,-4329,-1121,-0.43507537688442216,-0.0631764666131493
8566,31177,Washington,Nebraska,2008,3711,6425,184,10320,0.35959302325581394,0.622577519379845,0.017829457364341085,957,71,-658,370,0.08280910365782401,0.006472673444743095,-0.08928177710256713,-2714,1615,-0.262984496124031,0.17209088076039114
8567,31177,Washington,Nebraska,2012,3132,6899,215,10246,0.3056802654694515,0.6733359359750146,0.020983798555533867,-579,31,474,-74,-0.05391275778636245,0.003154341191192782,0.050758416595169664,-3767,-1053,-0.36765567050556314,-0.10467117438153212
8568,31177,Washington,Nebraska,2016,2623,7424,785,10832,0.24215288035450516,0.6853766617429837,0.07247045790251108,-509,570,525,586,-0.06352738511494632,0.051486659346977215,0.012040725767969107,-4801,-1034,-0.44322378138847857,-0.07556811088291543
8569,31179,Wayne,Nebraska,2000,1001,2774,165,3940,0.25406091370558376,0.7040609137055838,0.04187817258883249,0,0,0,0,0.0,0.0,0.0,-1773,0,-0.45,0.0
8570,31179,Wayne,Nebraska,2004,1059,2971,55,4085,0.2592411260709914,0.7272949816401468,0.01346389228886169,58,-110,197,145,0.005180212365407666,-0.0284142802999708,0.023234067934563063,-1912,-139,-0.4680538555691554,-0.018053855569155397
8571,31179,Wayne,Nebraska,2008,1249,2503,56,3808,0.3279936974789916,0.6573004201680672,0.014705882352941176,190,1,-468,-277,0.06875257140800017,0.0012419900640794866,-0.06999456147207961,-1254,658,-0.3293067226890756,0.13874713288007978
8572,31179,Wayne,Nebraska,2012,1074,2493,115,3682,0.29168929929386206,0.6770776751765345,0.031233025529603477,-175,59,-10,-126,-0.03630439818512954,0.0165271431766623,0.019777255008467276,-1419,-165,-0.38538837588267244,-0.056081653193596814
8573,31179,Wayne,Nebraska,2016,835,2693,248,3776,0.2211334745762712,0.7131885593220338,0.06567796610169492,-239,133,200,94,-0.07055582471759086,0.034444940572091444,0.036110884145499345,-1858,-439,-0.49205508474576265,-0.10666670886309021
8574,31181,Webster,Nebraska,2000,584,1302,59,1945,0.30025706940874036,0.6694087403598972,0.030334190231362468,0,0,0,0,0.0,0.0,0.0,-718,0,-0.3691516709511568,0.0
8575,31181,Webster,Nebraska,2004,557,1403,42,2002,0.27822177822177824,0.7007992007992008,0.02097902097902098,-27,-17,101,57,-0.022035291186962125,-0.009355169252341488,0.0313904604393036,-846,-128,-0.42257742257742253,-0.05342575162626573
8576,31181,Webster,Nebraska,2008,552,1233,32,1817,0.3037974683544304,0.6785910842047331,0.017611447440836543,-5,-10,-170,-185,0.02557569013265215,-0.0033675735381844367,-0.022208116594467642,-681,165,-0.37479361585030274,0.04778380672711979
8577,31181,Webster,Nebraska,2012,442,1258,42,1742,0.2537313432835821,0.722158438576349,0.024110218140068886,-110,10,25,-75,-0.05006612507084829,0.006498770699232343,0.04356735437161585,-816,-135,-0.4684270952927669,-0.09363347944246414
8578,31181,Webster,Nebraska,2016,306,1330,72,1708,0.1791569086651054,0.7786885245901639,0.04215456674473068,-136,30,72,-34,-0.07457443461847671,0.01804434860466179,0.05653008601381493,-1024,-208,-0.5995316159250585,-0.13110452063229167
8579,31183,Wheeler,Nebraska,2000,85,351,17,453,0.18763796909492272,0.7748344370860927,0.037527593818984545,0,0,0,0,0.0,0.0,0.0,-266,0,-0.58719646799117,0.0
8580,31183,Wheeler,Nebraska,2004,81,366,6,453,0.17880794701986755,0.8079470198675497,0.013245033112582781,-4,-11,15,0,-0.008830022075055177,-0.024282560706401765,0.03311258278145701,-285,-19,-0.6291390728476821,-0.04194260485651213
8581,31183,Wheeler,Nebraska,2008,96,334,10,440,0.21818181818181817,0.759090909090909,0.022727272727272728,15,4,-32,-13,0.039373871161950624,0.009482239614689946,-0.04885611077664065,-238,47,-0.5409090909090909,0.08822998193859122
8582,31183,Wheeler,Nebraska,2012,93,345,10,448,0.20758928571428573,0.7700892857142857,0.022321428571428572,-3,0,11,8,-0.010592532467532445,-0.000405844155844156,0.01099837662337666,-252,-14,-0.5625,-0.021590909090909105
8583,31183,Wheeler,Nebraska,2016,62,377,26,465,0.13333333333333333,0.810752688172043,0.05591397849462366,-31,16,32,17,-0.0742559523809524,0.03359254992319509,0.04066340245775735,-315,-63,-0.6774193548387097,-0.11491935483870974
8584,31185,York,Nebraska,2000,1407,4816,237,6460,0.2178018575851393,0.7455108359133127,0.03668730650154799,0,0,0,0,0.0,0.0,0.0,-3409,0,-0.5277089783281734,0.0
8585,31185,York,Nebraska,2004,1304,5393,100,6797,0.1918493452993968,0.7934382815948212,0.014712373105781962,-103,-137,577,337,-0.025952512285742524,-0.021974933395766026,0.04792744568150853,-4089,-680,-0.6015889362954244,-0.073879957967251
8586,31185,York,Nebraska,2008,1607,4848,113,6568,0.24467113276492083,0.7381242387332522,0.01720462850182704,303,13,-545,-229,0.052821787465524045,0.002492255396045079,-0.055314042861569046,-3241,848,-0.49345310596833136,0.10813583032709306
8587,31185,York,Nebraska,2012,1373,4874,108,6355,0.21605035405192763,0.766955153422502,0.016994492525570417,-234,-5,26,-213,-0.028620778712993206,-0.00021013597625662433,0.02883091468924981,-3501,-260,-0.5509047993705743,-0.05745169340224299
8588,31185,York,Nebraska,2016,1186,4700,495,6381,0.18586428459489107,0.7365616674502429,0.07757404795486601,-187,387,-174,26,-0.030186069457036557,0.06057955542929559,-0.030393485972259104,-3514,-13,-0.5506973828553519,0.0002074165152224916
8589,32001,Churchill,Nevada,2000,2191,6237,395,8823,0.24832823302731497,0.7069024141448487,0.04476935282783634,0,0,0,0,0.0,0.0,0.0,-4046,0,-0.4585741811175337,0.0
8590,32001,Churchill,Nevada,2004,2705,7335,197,10237,0.2642375696004689,0.7165185112826024,0.019243919116928788,514,-198,1098,1414,0.015909336573153937,-0.02552543371090755,0.009616097137753687,-4630,-584,-0.45228094168213345,0.006293239435400222
8591,32001,Churchill,Nevada,2008,3494,6832,279,10605,0.32946723243752946,0.6442244224422442,0.02630834512022631,789,82,-503,368,0.06522966283706055,0.007064426003297521,-0.07229408884035815,-3338,1292,-0.31475719000471475,0.1375237516774187
8592,32001,Churchill,Nevada,2012,2961,7061,160,10182,0.2908073070123748,0.6934786878805735,0.01571400510705166,-533,-119,229,-423,-0.03865992542515467,-0.01059434001317465,0.04925426543832934,-4100,-762,-0.40267138086819876,-0.08791419086348401
8593,32001,Churchill,Nevada,2016,2210,7830,898,10938,0.20204790638142256,0.7158529895776193,0.08209910404095813,-751,738,769,756,-0.08875940063095222,0.06638509893390647,0.022374301697045795,-5620,-1520,-0.5138050831961968,-0.11113370232799802
8594,32003,Clark,Nevada,2000,196100,170932,15166,382198,0.513084840841658,0.4472341561180331,0.03968100304030895,0,0,0,0,0.0,0.0,0.0,25168,0,0.06585068472362487,0.0
8595,32003,Clark,Nevada,2004,281767,255337,8293,545397,0.5166273375174414,0.46816722497556823,0.01520543750699032,85667,-6873,84405,163199,0.0035424966757834353,-0.02447556553331863,0.020933068857535153,26430,1262,0.04846011254187316,-0.017390572181751718
8596,32003,Clark,Nevada,2008,380765,257078,13329,651172,0.5847379801342809,0.39479277364505844,0.020469246220660594,98998,5036,1741,105775,0.06811064261683952,0.005263808713670274,-0.0733744513305098,123687,97257,0.18994520648922247,0.14148509394734932
8597,32003,Clark,Nevada,2012,389936,289053,8754,687743,0.5669792349758558,0.42029217309372835,0.012728591930415867,9171,-4575,31975,36571,-0.017758745158425127,-0.007740654290244727,0.025499399448669913,100883,-22804,0.14668706188212743,-0.04325814460709504
8598,32003,Clark,Nevada,2016,402227,320057,44872,767156,0.5243092669548306,0.4171993701411447,0.058491362904024735,12291,36118,31004,79413,-0.042669968021025184,0.04576277097360887,-0.0030928029525836287,82170,-18713,0.10710989681368588,-0.039577165068441555
8599,32005,Douglas,Nevada,2000,5837,11193,944,17974,0.324746856570602,0.6227328363191277,0.05252030711027039,0,0,0,0,0.0,0.0,0.0,-5356,0,-0.2979859797485257,0.0
8600,32005,Douglas,Nevada,2004,8275,15192,431,23898,0.3462632856305967,0.6357017323625408,0.018034982006862498,2438,-513,3999,5924,0.021516429059994735,-0.03448532510340789,0.012968896043413114,-6917,-1561,-0.2894384467319441,0.008547533016581621
8601,32005,Douglas,Nevada,2008,10672,14648,584,25904,0.4119827053736875,0.5654725138974676,0.022544780728844967,2397,153,-544,2006,0.06571941974309076,0.004509798721982469,-0.07022921846507324,-3976,2941,-0.15348980852378008,0.135948638208164
8602,32005,Douglas,Nevada,2012,9297,16276,348,25921,0.3586667181050114,0.6279078739246171,0.013425407970371513,-1375,-236,1628,17,-0.05331598726867609,-0.009119372758473455,0.062435360027149556,-6979,-3003,-0.2692411558196057,-0.11575134729582565
8603,32005,Douglas,Nevada,2016,8454,17415,2016,27885,0.3031737493275955,0.6245293168370092,0.07229693383539537,-843,1668,1139,1964,-0.055492968777415885,0.05887152586502386,-0.003378557087607925,-8961,-1982,-0.3213555675094137,-0.05211441168980796
8604,32007,Elko,Nevada,2000,2542,11025,613,14180,0.17926657263751763,0.7775035260930888,0.04322990126939351,0,0,0,0,0.0,0.0,0.0,-8483,0,-0.5982369534555712,0.0
8605,32007,Elko,Nevada,2004,3050,11938,321,15309,0.1992292115748906,0.7798027304200144,0.020968058005095044,508,-292,913,1129,0.019962638937372962,-0.022261843264298465,0.0022992043269255413,-8888,-405,-0.5805735188451238,0.017663434610447393
8606,32007,Elko,Nevada,2008,4541,10969,509,16019,0.28347587240152317,0.6847493601348399,0.03177476746363693,1491,188,-969,710,0.08424666082663257,0.010806709458541886,-0.09505337028517447,-6428,2460,-0.4012734877333167,0.17930003111180703
8607,32007,Elko,Nevada,2012,3511,12014,321,15846,0.22157011233118767,0.7581724094408684,0.02025747822794396,-1030,-188,1045,-173,-0.06190576007033549,-0.011517289235692969,0.0734230493060285,-8503,-2075,-0.5366022971096807,-0.13532880937636393
8608,32007,Elko,Nevada,2016,3401,13551,1607,18559,0.1832534080500027,0.7301578748855003,0.08658871706449701,-110,1286,1537,2713,-0.03831670428118497,0.06633123883655305,-0.028014534555368065,-10150,-1647,-0.5469044668354976,-0.01030216972581699
8609,32009,Esmeralda,Nevada,2000,116,333,42,491,0.23625254582484725,0.6782077393075356,0.0855397148676171,0,0,0,0,0.0,0.0,0.0,-217,0,-0.4419551934826884,0.0
8610,32009,Esmeralda,Nevada,2004,99,367,15,481,0.20582120582120583,0.762993762993763,0.031185031185031187,-17,-27,34,-10,-0.03043134000364142,-0.05435468368258592,0.08478602368622734,-268,-51,-0.5571725571725572,-0.11521736368986879
8611,32009,Esmeralda,Nevada,2008,104,303,32,439,0.23690205011389523,0.6902050113895216,0.07289293849658314,5,17,-64,-42,0.031080844292689397,0.04170790731155195,-0.07278875160424136,-199,69,-0.4533029612756264,0.10386959589693079
8612,32009,Esmeralda,Nevada,2012,92,317,23,432,0.21296296296296297,0.7337962962962963,0.05324074074074074,-12,-9,14,-7,-0.023939087150932264,-0.0196521977558424,0.04359128490677466,-225,-26,-0.5208333333333333,-0.06753037205770684
8613,32009,Esmeralda,Nevada,2016,65,329,29,423,0.1536643026004728,0.7777777777777778,0.06855791962174941,-27,6,12,-9,-0.05929866036249015,0.01531717888100867,0.04398148148148151,-264,-39,-0.624113475177305,-0.10328014184397172
8614,32011,Eureka,Nevada,2000,150,632,55,837,0.17921146953405018,0.7550776583034647,0.06571087216248507,0,0,0,0,0.0,0.0,0.0,-482,0,-0.5758661887694145,0.0
8615,32011,Eureka,Nevada,2004,144,571,23,738,0.1951219512195122,0.7737127371273713,0.03116531165311653,-6,-32,-61,-99,0.015910481685462025,-0.034545560509368536,0.01863507882390658,-427,55,-0.5785907859078592,-0.00272459713844464
8616,32011,Eureka,Nevada,2008,144,564,37,745,0.19328859060402684,0.7570469798657719,0.049664429530201344,0,14,-7,7,-0.0018333606154853632,0.018499117877084813,-0.016665757261599468,-420,7,-0.563758389261745,0.014832396646114132
8617,32011,Eureka,Nevada,2012,107,663,19,789,0.13561470215462612,0.8403041825095057,0.024081115335868188,-37,-18,99,44,-0.05767388844940072,-0.025583314194333157,0.08325720264373382,-556,-136,-0.7046894803548795,-0.1409310910931345
8618,32011,Eureka,Nevada,2016,74,723,57,854,0.08665105386416862,0.8466042154566745,0.06674473067915691,-33,38,60,65,-0.048963648290457504,0.042663615343288726,0.006300032947168854,-649,-93,-0.7599531615925059,-0.05526368123762637
8619,32013,Humboldt,Nevada,2000,1128,3638,264,5030,0.2242544731610338,0.7232604373757455,0.052485089463220676,0,0,0,0,0.0,0.0,0.0,-2510,0,-0.4990059642147117,0.0
8620,32013,Humboldt,Nevada,2004,1361,3896,110,5367,0.25358673374324575,0.7259176448667785,0.02049562138997578,233,-154,258,337,0.029332260582211944,-0.031989468073244896,0.0026572074910329313,-2535,-25,-0.4723309111235327,0.026675053091179013
8621,32013,Humboldt,Nevada,2008,1909,3586,169,5664,0.3370409604519774,0.6331214689265536,0.029837570621468926,548,59,-310,297,0.08345422670873165,0.009341949231493146,-0.09279617594022482,-1677,858,-0.29608050847457623,0.17625040264895647
8622,32013,Humboldt,Nevada,2012,1737,3810,117,5664,0.3066737288135593,0.6726694915254238,0.02065677966101695,-172,-52,224,0,-0.03036723163841809,-0.009180790960451976,0.039548022598870136,-2073,-396,-0.36599576271186446,-0.06991525423728823
8623,32013,Humboldt,Nevada,2016,1386,4521,526,6433,0.21545157780195864,0.7027825275921032,0.08176589460593812,-351,409,711,769,-0.09122215101160067,0.061109114944921175,0.030113036066679477,-3135,-1062,-0.4873309497901446,-0.12133518707828012
8624,32015,Lander,Nevada,2000,395,1619,105,2119,0.18640868334119867,0.7640396413402548,0.049551675318546484,0,0,0,0,0.0,0.0,0.0,-1224,0,-0.5776309579990562,0.0
8625,32015,Lander,Nevada,2004,414,1602,37,2053,0.20165611300535802,0.7803214807598636,0.01802240623477837,19,-68,-17,-66,0.015247429664159345,-0.031529269083768116,0.016281839419608812,-1188,36,-0.5786653677545056,-0.0010344097554494391
8626,32015,Lander,Nevada,2008,577,1466,59,2102,0.27450047573739295,0.6974310180780209,0.028068506184586107,163,22,-136,49,0.07284436273203493,0.010046099949807735,-0.08289046268184275,-889,299,-0.42293054234062794,0.15573482541387768
8627,32015,Lander,Nevada,2012,534,1580,34,2148,0.24860335195530725,0.7355679702048417,0.015828677839851025,-43,-25,114,46,-0.025897123782085696,-0.012239828344735082,0.03813695212682078,-1046,-157,-0.4869646182495344,-0.06403407590890647
8628,32015,Lander,Nevada,2016,403,1828,182,2413,0.1670120182345628,0.757563199336925,0.07542478242851222,-131,148,248,265,-0.08159133372074445,0.0595961045886612,0.021995229132083294,-1425,-379,-0.5905511811023622,-0.10358656285282775
8629,32017,Lincoln,Nevada,2000,461,1372,123,1956,0.23568507157464214,0.7014314928425358,0.06288343558282208,0,0,0,0,0.0,0.0,0.0,-911,0,-0.4657464212678937,0.0
8630,32017,Lincoln,Nevada,2004,418,1579,50,2047,0.20420127015144113,0.7713727405959941,0.024425989252564728,-43,-73,207,91,-0.03148380142320101,-0.038457446330257355,0.06994124775345834,-1161,-250,-0.567171470444553,-0.10142504917665929
8631,32017,Lincoln,Nevada,2008,518,1498,91,2107,0.24584717607973422,0.7109634551495017,0.04318936877076412,100,41,-81,60,0.04164590592829309,0.01876337951819939,-0.06040928544649249,-980,181,-0.46511627906976744,0.10205519137478553
8632,32017,Lincoln,Nevada,2012,400,1691,47,2138,0.18709073900841908,0.7909260991580916,0.021983161833489244,-118,-44,193,31,-0.05875643707131514,-0.021206206937274874,0.07996264400858999,-1291,-311,-0.6038353601496725,-0.1387190810799051
8633,32017,Lincoln,Nevada,2016,285,1671,176,2132,0.13367729831144465,0.7837711069418386,0.0825515947467167,-115,129,-20,-6,-0.05341344069697443,0.06056843291322745,-0.007154992216253042,-1386,-95,-0.650093808630394,-0.04625844848072147
8634,32019,Lyon,Nevada,2000,3955,7270,767,11992,0.3298032021347565,0.6062374916611074,0.06395930620413609,0,0,0,0,0.0,0.0,0.0,-3315,0,-0.2764342895263509,0.0
8635,32019,Lyon,Nevada,2004,5637,11136,378,17151,0.32866888228091656,0.6492915864964142,0.02203953122266923,1682,-389,3866,5159,-0.001134319853839938,-0.04191977498146686,0.043054094835306755,-5499,-2184,-0.3206227042154976,-0.04418841468914669
8636,32019,Lyon,Nevada,2008,8405,12154,544,21103,0.39828460408472727,0.5759370705586884,0.02577832535658437,2768,166,1018,3952,0.0696157218038107,0.0037387941339151395,-0.0733545159377258,-3749,1750,-0.1776524664739611,0.1429702377415365
8637,32019,Lyon,Nevada,2012,7380,13520,397,21297,0.34652767995492323,0.63483119688219,0.01864112316288679,-1025,-147,1366,194,-0.05175692412980404,-0.007137202193697581,0.05889412632350166,-6140,-2391,-0.2883035169272668,-0.1106510504533057
8638,32019,Lyon,Nevada,2016,6146,16005,1611,23762,0.2586482619308139,0.6735544146115647,0.0677973234576214,-1234,1214,2485,2465,-0.08787941802410931,0.049156200294734616,0.038723217729374704,-9859,-3719,-0.4149061526807508,-0.12660263575348402
8639,32021,Mineral,Nevada,2000,916,1227,150,2293,0.3994766681203663,0.5351068469254252,0.06541648495420846,0,0,0,0,0.0,0.0,0.0,-311,0,-0.1356301788050589,0.0
8640,32021,Mineral,Nevada,2004,931,1336,60,2327,0.40008594757198107,0.5741297808336915,0.02578427159432746,15,-90,109,34,0.0006092794516147637,-0.039632213359881,0.03902293390826628,-405,-94,-0.1740438332617104,-0.038413654456651514
8641,32021,Mineral,Nevada,2008,1082,1131,94,2307,0.46900736887732986,0.49024707412223667,0.04074555700043346,151,34,-205,-20,0.06892142130534878,0.014961285406106,-0.08388270671145481,-49,356,-0.021239705244906815,0.1528041280168036
8642,32021,Mineral,Nevada,2012,863,1080,53,1996,0.43236472945891785,0.5410821643286573,0.02655310621242485,-219,-41,-51,-311,-0.036642639418412004,-0.014192450788008612,0.05083509020642063,-217,-168,-0.10871743486973945,-0.08747772962483263
8643,32021,Mineral,Nevada,2016,637,1179,181,1997,0.3189784677015523,0.5903855783675513,0.09063595393089635,-226,128,99,1,-0.11338626175736555,0.0640828477184715,0.049303414038894045,-542,-325,-0.27140711066599904,-0.1626896757962596
8644,32023,Nye,Nevada,2000,4525,6904,752,12181,0.3714801740415401,0.5667843362613907,0.061735489697069205,0,0,0,0,0.0,0.0,0.0,-2379,0,-0.19530416221985059,0.0
8645,32023,Nye,Nevada,2004,5616,8487,407,14510,0.3870434183321847,0.5849069607167471,0.02804962095106823,1091,-345,1583,2329,0.015563244290644596,-0.03368586874600098,0.018122624455356395,-2871,-492,-0.19786354238456239,-0.0025593801647117997
8646,32023,Nye,Nevada,2008,7226,9537,728,17491,0.4131267509004631,0.5452518438053856,0.04162140529415128,1610,321,1050,2981,0.026083332568278383,0.013571784343083051,-0.03965511691136148,-2311,560,-0.13212509290492253,0.06573844947963986
8647,32023,Nye,Nevada,2012,6320,10566,451,17337,0.36453827075041817,0.6094480013843225,0.02601372786525927,-906,-277,1029,-154,-0.04858848015004491,-0.015607677428892009,0.06419615757893693,-4246,-1935,-0.24490973063390437,-0.11278463772898184
8648,32023,Nye,Nevada,2016,5094,13324,1177,19595,0.25996427660117377,0.6799693799438632,0.060066343454963,-1226,726,2758,2258,-0.1045739941492444,0.034052615589703725,0.07052137855954066,-8230,-3984,-0.4200051033426894,-0.17509537270878506
8649,32027,Pershing,Nevada,2000,476,1221,105,1802,0.2641509433962264,0.6775804661487237,0.058268590455049944,0,0,0,0,0.0,0.0,0.0,-745,0,-0.4134295227524973,0.0
8650,32027,Pershing,Nevada,2004,538,1341,38,1917,0.2806468440271257,0.6995305164319249,0.0198226395409494,62,-67,120,115,0.016495900630899285,-0.038445950914100545,0.021950050283201183,-803,-58,-0.4188836724047992,-0.005454149652301898
8651,32027,Pershing,Nevada,2008,673,1075,88,1836,0.36655773420479304,0.585511982570806,0.04793028322440087,135,50,-266,-81,0.08591089017766734,0.02810764368345147,-0.11401853386111882,-402,401,-0.21895424836601302,0.19992942403878616
8652,32027,Pershing,Nevada,2012,632,1167,55,1854,0.3408845738942826,0.6294498381877023,0.0296655879180151,-41,-33,92,18,-0.025673160310510423,-0.01826469530638577,0.043937855616896226,-535,-133,-0.28856526429341967,-0.06961101592740665
8653,32027,Pershing,Nevada,2016,430,1403,149,1982,0.21695257315842584,0.7078708375378405,0.0751765893037336,-202,94,236,128,-0.12393200073585678,0.045511001385718494,0.07842099935013824,-973,-438,-0.49091826437941466,-0.202353000085995
8654,32029,Storey,Nevada,2000,666,1014,118,1798,0.3704115684093437,0.5639599555061179,0.06562847608453838,0,0,0,0,0.0,0.0,0.0,-348,0,-0.1935483870967742,0.0
8655,32029,Storey,Nevada,2004,871,1253,44,2168,0.4017527675276753,0.5779520295202952,0.02029520295202952,205,-74,239,370,0.03134119911833161,-0.04533327313250886,0.013992074014177347,-382,-34,-0.17619926199261993,0.01734912510415426
8656,32029,Storey,Nevada,2008,1102,1247,69,2418,0.4557485525227461,0.5157154673283706,0.028535980148883373,231,25,-6,250,0.053995784995070795,0.008240777196853854,-0.06223656219192464,-145,237,-0.059966914805624494,0.11623234718699543
8657,32029,Storey,Nevada,2012,920,1321,58,2299,0.4001739886907351,0.574597651152675,0.025228360156589823,-182,-11,74,-119,-0.05557456383201098,-0.0033076199922935506,0.058882183824304435,-401,-256,-0.1744236624619399,-0.11445674765631542
8658,32029,Storey,Nevada,2016,752,1616,190,2558,0.2939796716184519,0.6317435496481626,0.07427677873338545,-168,132,295,259,-0.10619431707228322,0.04904841857679563,0.05714589849548757,-864,-463,-0.3377638780297107,-0.16334021556777079
8659,32031,Washoe,Nevada,2000,52097,63640,6564,122301,0.4259736224560715,0.520355516308125,0.05367086123580347,0,0,0,0,0.0,0.0,0.0,-11543,0,-0.09438189385205353,0.0
8660,32031,Washoe,Nevada,2004,74841,81545,2693,159079,0.47046436047498413,0.512606943719787,0.01692869580522885,22744,-3871,17905,36778,0.04449073801891262,-0.03674216543057462,-0.007748572588338054,-6704,4839,-0.042142583244802856,0.05223931060725068
8661,32031,Washoe,Nevada,2008,99671,76880,3863,180414,0.5524571263870874,0.42613100978859736,0.021411863824315185,24830,1170,-4665,21335,0.0819927659121033,0.004483168019086336,-0.08647593393118963,22791,29495,0.12632611659849008,0.16846869984329294
8662,32031,Washoe,Nevada,2012,95409,88453,2872,186734,0.5109353411805028,0.4736844923795345,0.015380166439962728,-4262,-991,11573,6320,-0.04152178520658467,-0.006031697384352457,0.04755348259093717,6956,-15835,0.03725084880096824,-0.08907526779752184
8663,32031,Washoe,Nevada,2016,97379,94758,17772,209909,0.46391055171526707,0.45142418857695477,0.08466525970777813,1970,14900,6305,23175,-0.047024789465235695,0.0692850932678154,-0.02226030380257976,2621,-4335,0.012486363138312306,-0.024764485662655933
8664,32033,White Pine,Nevada,2000,1069,2234,240,3543,0.30172170476996896,0.6305390911656789,0.06773920406435224,0,0,0,0,0.0,0.0,0.0,-1165,0,-0.3288173863957099,0.0
8665,32033,White Pine,Nevada,2004,1082,2604,116,3802,0.28458705944239876,0.6849026827985271,0.03051025775907417,13,-124,370,259,-0.017134645327570197,-0.03722894630527807,0.05436359163284821,-1522,-357,-0.4003156233561283,-0.0714982369604184
8666,32033,White Pine,Nevada,2008,1230,2440,172,3842,0.32014575741801143,0.6350858927641854,0.04476834981780323,148,56,-164,40,0.035558697975612674,0.014258092058729056,-0.049816790034341696,-1210,312,-0.31494013534617393,0.08537548800995437
8667,32033,White Pine,Nevada,2012,983,2601,77,3661,0.2685058727123737,0.7104616225075117,0.021032504780114723,-247,-95,161,-181,-0.05163988470563774,-0.023735845037688504,0.07537572974332629,-1618,-408,-0.44195574979513796,-0.12701561444896403
8668,32033,White Pine,Nevada,2016,707,2723,343,3773,0.18738404452690166,0.7217068645640075,0.09090909090909091,-276,266,122,112,-0.08112182818547203,0.06987658612897618,0.011245242056495797,-2016,-398,-0.5343228200371057,-0.09236707024196777
8669,32510,Carson City,Nevada,2000,7354,11084,1014,19452,0.37805881143327164,0.5698128727123175,0.052128315854410856,0,0,0,0,0.0,0.0,0.0,-3730,0,-0.19175406127904587,0.0
8670,32510,Carson City,Nevada,2004,9441,13171,494,23106,0.408595170085692,0.5700251017051848,0.02137972820912317,2087,-520,2087,3654,0.03053635865242038,-0.030748587645287685,0.00021222899286732488,-3730,0,-0.16142993161949282,0.030324129659553056
8671,32510,Carson City,Nevada,2008,11623,11419,638,23680,0.49083614864864866,0.48222128378378376,0.026942567567567566,2182,144,-1752,574,0.08224097856295665,0.005562839358444396,-0.08780381792140107,204,3934,0.008614864864864902,0.17004479648435772
8672,32510,Carson City,Nevada,2012,10291,12394,422,23107,0.4453628770502445,0.5363742588825897,0.018262864067165794,-1332,-216,975,-573,-0.04547327159840414,-0.008679703500401773,0.054152975098805956,-2103,-2307,-0.0910113818323452,-0.0996262466972101
8673,32510,Carson City,Nevada,2016,9610,13125,2281,25016,0.3841541413495363,0.5246642149024624,0.09118164374800128,-681,1859,731,1909,-0.06120873570070823,0.07291877968083549,-0.011710043980127316,-3515,-1412,-0.1405100735529261,-0.04949869172058091
8674,33001,Belknap,New Hampshire,2000,10719,14799,1277,26795,0.4000373203955962,0.5523045344280649,0.047658145176338866,0,0,0,0,0.0,0.0,0.0,-4080,0,-0.15226721403246873,0.0
8675,33001,Belknap,New Hampshire,2004,14080,17920,298,32298,0.4359403059012942,0.5548331166016471,0.009226577497058642,3361,-979,3121,5503,0.03590298550569798,-0.03843156767928022,0.0025285821735822056,-3840,240,-0.11889281070035296,0.033374403332115776
8676,33001,Belknap,New Hampshire,2008,16796,16402,416,33614,0.49967275539953593,0.48795144880109476,0.01237579579936931,2716,118,-1518,1316,0.06373244949824175,0.0031492183023106683,-0.06688166780055238,394,4234,0.011721306598441172,0.13061411729879413
8677,33001,Belknap,New Hampshire,2012,15890,17571,411,33872,0.46911903637222485,0.5187470477090222,0.012133915918752953,-906,-5,1169,258,-0.030553719027311077,-0.000241879880616358,0.03079559890792749,-1681,-2075,-0.049628011336797395,-0.06134931793523857
8678,33001,Belknap,New Hampshire,2016,13517,19315,2213,35045,0.3857040947353403,0.5511485233271508,0.06314738193750892,-2373,1802,1744,1173,-0.08341494163688457,0.05101346601875597,0.03240147561812856,-5798,-4117,-0.16544442859181052,-0.11581641725501313
8679,33003,Carroll,New Hampshire,2000,9852,12597,1430,23879,0.41258009129360523,0.5275346538799782,0.05988525482641652,0,0,0,0,0.0,0.0,0.0,-2745,0,-0.11495456258637299,0.0
8680,33003,Carroll,New Hampshire,2004,13319,14614,289,28222,0.4719367869038339,0.5178229749840549,0.01024023811211112,3467,-1141,2017,4343,0.05935669561022866,-0.0496450167143054,-0.009711678895923281,-1295,1450,-0.045886188080221046,0.06906837450615194
8681,33003,Carroll,New Hampshire,2008,15221,13387,448,29056,0.5238504955947136,0.4607310022026432,0.015418502202643172,1902,159,-1227,834,0.051913708690879745,0.0051782640905320525,-0.05709197278141176,1834,3129,0.06311949339207046,0.1090056814722915
8682,33003,Carroll,New Hampshire,2012,13977,14207,402,28586,0.48894563772476035,0.4969915343174981,0.014062827957741551,-1244,-46,820,-470,-0.03490485786995329,-0.001355674244901621,0.036260532114854915,-230,-2064,-0.008045896592737745,-0.0711653899848082
8683,33003,Carroll,New Hampshire,2016,12987,14635,1994,29616,0.4385129659643436,0.49415856293895194,0.06732847109670448,-990,1592,428,1030,-0.05043267176041677,0.053265643138962926,-0.0028329713785461563,-1648,-1418,-0.05564559697460836,-0.04759970038187061
8684,33005,Cheshire,New Hampshire,2000,17382,13793,2220,33395,0.5204970804012576,0.41302590208114986,0.06647701751759245,0,0,0,0,0.0,0.0,0.0,3589,0,0.10747117832010777,0.0
8685,33005,Cheshire,New Hampshire,2004,24438,16463,446,41347,0.5910465088156336,0.39816673519239604,0.010786755991970397,7056,-1774,2670,7952,0.07054942841437595,-0.05569026152562206,-0.014859166888753828,7975,4386,0.19287977362323755,0.08540859530312978
8686,33005,Cheshire,New Hampshire,2008,26971,15205,647,42823,0.6298250939915466,0.3550662027415174,0.015108703266935992,2533,201,-1258,1476,0.03877858517591304,0.004321947274965595,-0.04310053245087864,11766,3791,0.2747588912500292,0.08187911762679168
8687,33005,Cheshire,New Hampshire,2012,25380,15156,793,41329,0.6140966391637833,0.3667158653729827,0.019187495463234047,-1591,146,-49,-1494,-0.015728454827763305,0.004078792196298055,0.011649662631465274,10224,-1542,0.24738077379080065,-0.02737811745922858
8688,33005,Cheshire,New Hampshire,2016,22064,16876,2955,41895,0.5266499582289056,0.40281656522258025,0.07053347654851415,-3316,2162,1720,566,-0.08744668093487773,0.0513459810852801,0.03610069984959757,5188,-5036,0.12383339300632534,-0.1235473807844753
8689,33007,Coos,New Hampshire,2000,6570,7329,701,14600,0.45,0.501986301369863,0.048013698630136985,0,0,0,0,0.0,0.0,0.0,-759,0,-0.051986301369862986,0.0
8690,33007,Coos,New Hampshire,2004,8585,8143,197,16925,0.5072378138847858,0.48112259970457905,0.011639586410635155,2015,-504,814,2325,0.057237813884785826,-0.036374112219501833,-0.02086370166528395,442,1201,0.02611521418020679,0.07810151555006978
8691,33007,Coos,New Hampshire,2008,9532,6558,258,16348,0.5830682652312209,0.40114998776608757,0.01578174700269146,947,61,-1585,-577,0.07583045134643507,0.004142160592056306,-0.07997261193849148,2974,2532,0.18191827746513334,0.15580306328492655
8692,33007,Coos,New Hampshire,2012,9095,6342,258,15695,0.5794839120739089,0.4040777317617075,0.01643835616438356,-437,0,-216,-653,-0.0035843531573119813,0.0006566091616920997,0.002927743995619958,2753,-221,0.1754061803122014,-0.006512097152931939
8693,33007,Coos,New Hampshire,2016,6563,7952,1112,15627,0.4199782427849235,0.5088628655532091,0.07115889166186729,-2532,854,1610,-68,-0.1595056692889854,0.05472053549748372,0.10478513379150162,-1389,-4142,-0.08888462276828563,-0.264290803080487
8694,33009,Grafton,New Hampshire,2000,18326,18092,2315,38733,0.4731366018640436,0.4670952417834921,0.059768156352464304,0,0,0,0,0.0,0.0,0.0,234,0,0.0060413600805515055,0.0
8695,33009,Grafton,New Hampshire,2004,26180,20277,514,46971,0.5573651827723489,0.431691894999042,0.010942922228609141,7854,-1801,2185,8238,0.08422858090830532,-0.048825234123855164,-0.03540334678445012,5903,5669,0.12567328777330694,0.11963192769275544
8696,33009,Grafton,New Hampshire,2008,31446,17687,757,49890,0.6303066746843055,0.35451994387652835,0.015173381439166165,5266,243,-2590,2919,0.07294149191195654,0.004230459210557024,-0.07717195112251363,13759,7856,0.2757867308077771,0.15011344303447016
8697,33009,Grafton,New Hampshire,2012,29826,18208,933,48967,0.6091040905099353,0.3718422611146282,0.019053648375436518,-1620,176,521,-923,-0.021202584174370154,0.003880266936270353,0.01732231723809985,11618,-2141,0.2372618293953071,-0.03852490141247
8698,33009,Grafton,New Hampshire,2016,28510,19010,3671,51191,0.5569338360258639,0.3713543396300131,0.07171182434412299,-1316,2738,802,2224,-0.05217025448407142,0.052658175968686466,-0.0004879214846151281,9500,-2118,0.1855794963958508,-0.05168233299945629
8699,33011,Hillsborough,New Hampshire,2000,77625,80649,7487,165761,0.4682947134730123,0.4865378466587436,0.045167439868244036,0,0,0,0,0.0,0.0,0.0,-3024,0,-0.018243133185731286,0.0
8700,33011,Hillsborough,New Hampshire,2004,94121,99724,1582,195427,0.4816171767463042,0.5102877289217969,0.008095094331898868,16496,-5905,19075,29666,0.013322463273291896,-0.03707234553634517,0.023749882263053246,-5603,-2579,-0.028670552175492636,-0.01042741898976135
8701,33011,Hillsborough,New Hampshire,2008,104820,97178,2711,204709,0.5120439257677972,0.47471288511985305,0.013243189112349726,10699,1129,-2546,9282,0.030426749021493005,0.005148094780450857,-0.03557484380194381,7642,13245,0.03733104064794418,0.06600159282343682
8702,33011,Hillsborough,New Hampshire,2012,102303,99991,3291,205585,0.49761898971228447,0.4863730330520223,0.016007977235693267,-2517,580,2813,876,-0.01442493605551276,0.002764788123343541,0.01166014793216924,2312,-5330,0.01124595666026218,-0.026085083987682
8703,33011,Hillsborough,New Hampshire,2016,99589,100013,14555,214157,0.4650279934814178,0.4670078493815285,0.06796415713705366,-2714,11264,22,8572,-0.03259099623086664,0.051956179901360394,-0.01936518367049378,-424,-2736,-0.001979855900110683,-0.013225812560372863
8704,33013,Merrimack,New Hampshire,2000,30622,30028,3034,63684,0.48084291187739464,0.47151560831606054,0.04764147980654482,0,0,0,0,0.0,0.0,0.0,594,0,0.0093273035613341,0.0
8705,33013,Merrimack,New Hampshire,2004,39975,36060,612,76647,0.5215468315785353,0.47046851148772945,0.007984656933735176,9353,-2422,6032,12963,0.04070391970114068,-0.03965682287280964,-0.0010470968283310955,3915,3321,0.05107832009080587,0.041751016529471774
8706,33013,Merrimack,New Hampshire,2008,45078,34010,1018,80106,0.562729383566774,0.42456245474745963,0.01270816168576636,5103,406,-2050,3459,0.041182551988238725,0.004723504752031184,-0.04590605674026982,11068,7153,0.13816692881931442,0.08708860872850854
8707,33013,Merrimack,New Hampshire,2012,44756,34524,1204,80484,0.5560856816261617,0.42895482331892054,0.014959495054917747,-322,186,514,378,-0.006643701940612368,0.0022513333691513877,0.004392368571460914,10232,-836,0.12713085830724113,-0.011036070512073282
8708,33013,Merrimack,New Hampshire,2016,40198,37674,5776,83648,0.4805614001530222,0.450387337413925,0.06905126243305279,-4558,4572,3150,3164,-0.0755242814731395,0.05409176737813504,0.021432514095004462,2524,-7708,0.030174062739097174,-0.09695679556814396
8709,33015,Rockingham,New Hampshire,2000,61628,65860,6685,134173,0.4593174483688969,0.49085881660244607,0.04982373502865703,0,0,0,0,0.0,0.0,0.0,-4232,0,-0.031541368233549194,0.0
8710,33015,Rockingham,New Hampshire,2004,75437,82069,1310,158816,0.4749962220431191,0.5167552387668749,0.008248539190006045,13809,-5375,16209,24643,0.015678773674222213,-0.041575195838650984,0.025896422164428834,-6632,-2400,-0.041759016723755815,-0.010217648490206621
8711,33015,Rockingham,New Hampshire,2008,83723,81917,2182,167822,0.49887976546579116,0.48811836350418897,0.013001871030019901,8286,872,-152,9006,0.02388354342267207,0.004753331840013857,-0.028636875262685935,1806,8438,0.01076140196160219,0.052520418685358006
8712,33015,Rockingham,New Hampshire,2012,80142,87921,2308,170371,0.47039695722863634,0.5160561363142788,0.013546906457084833,-3581,126,6004,2549,-0.028482808237154822,0.0005450354270649313,0.027937772810089856,-7779,-9585,-0.04565917908564249,-0.05642058104724468
8713,33015,Rockingham,New Hampshire,2016,79994,90447,10993,181434,0.4408986187814853,0.4985118555507788,0.06058952566773593,-148,8685,2526,11063,-0.02949833844715105,0.047042619210651095,-0.01754428076350001,-10453,-2674,-0.05761323676929353,-0.011954057683651043
8714,33017,Strafford,New Hampshire,2000,25400,21108,2885,49393,0.5142429089142186,0.427348004778005,0.05840908630777641,0,0,0,0,0.0,0.0,0.0,4292,0,0.08689490413621365,0.0
8715,33017,Strafford,New Hampshire,2004,32942,25825,514,59281,0.5556923803579562,0.4356370506570402,0.008670568985003627,7542,-2371,4717,9888,0.04144947144373756,-0.04973851732277278,0.008289045879035228,7117,2825,0.12005532970091598,0.033160425564702334
8716,33017,Strafford,New Hampshire,2008,37990,25021,837,63848,0.5950068913669966,0.39188384914171154,0.013109259491291818,5048,323,-804,4567,0.039314511009040376,0.0044386905062881905,-0.04375320151532869,12969,5852,0.20312304222528504,0.08306771252436906
8717,33017,Strafford,New Hampshire,2012,36026,26729,1175,63930,0.5635226028468637,0.418097919599562,0.018379477553574223,-1964,338,1708,82,-0.03148428852013285,0.005270218062282405,0.026214070457850458,9297,-3672,0.14542468324730173,-0.05769835897798331
8718,33017,Strafford,New Hampshire,2016,34894,29072,5034,69000,0.5057101449275362,0.42133333333333334,0.07295652173913043,-1132,3859,2343,5070,-0.05781245791932754,0.054577044185556214,0.0032354137337713418,5822,-3475,0.08437681159420285,-0.061047871653098884
8719,33019,Sullivan,New Hampshire,2000,8224,9304,1140,18668,0.44053996143132634,0.4983929719305764,0.06106706663809728,0,0,0,0,0.0,0.0,0.0,-1080,0,-0.05785301049925007,0.0
8720,33019,Sullivan,New Hampshire,2004,11434,10142,228,21804,0.524399192808659,0.46514401027334434,0.010456796917996699,3210,-912,838,3136,0.08385923137733264,-0.05061026972010058,-0.03324896165723207,1292,2372,0.05925518253531464,0.11710819303456471
8721,33019,Sullivan,New Hampshire,2008,13249,9169,336,22754,0.5822712490111629,0.4029621165509361,0.014766634437901029,1815,108,-973,950,0.05787205620250391,0.00430983751990433,-0.06218189372240823,4080,2788,0.17930913246022678,0.12005394992491214
8722,33019,Sullivan,New Hampshire,2012,12166,9269,394,21829,0.5573319895551789,0.4246186265976453,0.018049383847175776,-1083,58,100,-925,-0.024939259455983964,0.0032827494092747475,0.02165651004670921,2897,-1183,0.1327133629575336,-0.046595769502693174
8723,33019,Sullivan,New Hampshire,2016,10210,10796,1677,22683,0.4501168275801261,0.4759511528457435,0.07393201957413041,-1956,1283,1527,854,-0.10721516197505282,0.055882635726954635,0.0513325262480982,-586,-3483,-0.02583432526561741,-0.15854768822315102
8724,34001,Atlantic,New Jersey,2000,52880,35593,2629,91102,0.5804482887313122,0.3906939474435248,0.028857763825163005,0,0,0,0,0.0,0.0,0.0,17287,0,0.18975434128778734,0.0
8725,34001,Atlantic,New Jersey,2004,55746,49487,864,106097,0.525424847073904,0.4664316615926935,0.008143491333402452,2866,-1765,13894,14995,-0.055023441657408134,-0.020714272491760555,0.07573771414916869,6259,-11028,0.05899318548121052,-0.13076115580657682
8726,34001,Atlantic,New Jersey,2008,67830,49902,1517,119249,0.5688098013400532,0.41846891797834784,0.012721280681599008,12084,653,415,13152,0.04338495426614919,0.004577789348196555,-0.04796274361434566,17928,11669,0.15034088336170537,0.09134769788049485
8727,34001,Atlantic,New Jersey,2012,65600,46522,1222,113344,0.5787690570299266,0.410449604743083,0.0107813382269904,-2230,-295,-3380,-5905,0.009959255689873436,-0.0019399424546086078,-0.008019313235264836,19078,1150,0.16831945228684364,0.017978568925138272
8728,34001,Atlantic,New Jersey,2016,60924,52690,4427,118041,0.5161257529163595,0.4463703289534992,0.03750391813014122,-4676,3205,6168,4697,-0.06264330411356711,0.02672257990315082,0.0359207242104162,8234,-10844,0.06975542396286033,-0.09856402832398331
8729,34003,Bergen,New Jersey,2000,202682,152731,11308,366721,0.5526871927159884,0.41647737653420447,0.030835430749807075,0,0,0,0,0.0,0.0,0.0,49951,0,0.13620981618178396,0.0
8730,34003,Bergen,New Jersey,2004,207666,189833,2745,400244,0.5188485024135278,0.4742931811594927,0.006858316426979543,4984,-8563,37102,33523,-0.03383869030246067,-0.023977114322827533,0.057815804625288236,17833,-32118,0.04455532125403505,-0.09165449492774891
8731,34003,Bergen,New Jersey,2008,225367,186118,4424,415909,0.5418661293696457,0.4474969284146292,0.010636942215725075,17701,1679,-3715,15665,0.023017626956117976,0.0037786257887455323,-0.026796252744863525,39249,21416,0.09436920095501655,0.0498138797009815
8732,34003,Bergen,New Jersey,2012,212754,169070,4166,385990,0.5511904453483251,0.4380165289256198,0.010793025726055078,-12613,-258,-17048,-29919,0.009324315978679332,0.00015608351033000352,-0.009480399489009361,43684,4435,0.11317391642270525,0.018804715467688693
8733,34003,Bergen,New Jersey,2016,231211,175529,15473,422213,0.5476169611073084,0.41573565948940466,0.03664737940328697,18457,11307,6459,36223,-0.0035734842410166667,0.02585435367723189,-0.022280869436215156,55682,11998,0.13188130161790373,0.01870738519519849
8734,34005,Burlington,New Jersey,2000,99506,72254,5781,177541,0.560467722948502,0.40697078421322397,0.032561492838273975,0,0,0,0,0.0,0.0,0.0,27252,0,0.15349693873527803,0.0
8735,34005,Burlington,New Jersey,2004,110411,95936,1609,207956,0.5309344284367847,0.4613283579218681,0.007737213641347208,10905,-4172,23682,30415,-0.029533294511717267,-0.024824279196926768,0.054357573708644136,14475,-12777,0.06960607051491663,-0.0838908682203614
8736,34005,Burlington,New Jersey,2008,131219,89626,2930,223775,0.5863881130599933,0.40051837783487876,0.013093509105127918,20808,1321,-6310,15819,0.05545368462320854,0.0053562954637807105,-0.060809980086989346,41593,27118,0.18586973522511452,0.11626366471019789
8737,34005,Burlington,New Jersey,2012,126377,87401,2561,216339,0.5841618940644082,0.40400020338450304,0.0118379025510888,-4842,-369,-2225,-7436,-0.002226218995585061,-0.0012556065540391178,0.0034818255496242845,38976,-2617,0.18016169067990517,-0.005708044545209345
8738,34005,Burlington,New Jersey,2016,121725,89272,10286,221283,0.5500874445845365,0.4034290930618258,0.04648346235363765,-4652,7725,1871,4944,-0.034074449479871705,0.03464555980254885,-0.0005711103226772596,32453,-6523,0.14665835152271073,-0.033503339157194445
8739,34007,Camden,New Jersey,2000,127166,62464,7231,196861,0.6459684752185553,0.3173000238747136,0.03673150090673115,0,0,0,0,0.0,0.0,0.0,64702,0,0.32866845134384165,0.0
8740,34007,Camden,New Jersey,2004,137765,81427,1741,220933,0.6235600838263183,0.36855969909429553,0.007880217079386059,10599,-5490,18963,24072,-0.022408391392236937,-0.02885128382734509,0.05125967521958191,56338,-8364,0.2550003847320228,-0.07366806661181885
8741,34007,Camden,New Jersey,2008,159259,73819,3304,236382,0.6737357328392178,0.3122868915568867,0.01397737560389539,21494,1563,-7608,15449,0.050175649012899504,0.006097158524509332,-0.05627280753740882,85440,29102,0.3614488412823311,0.10644845655030832
8742,34007,Camden,New Jersey,2012,153682,69476,2791,225949,0.6801623375186436,0.30748531748314883,0.01235234499820756,-5577,-513,-4343,-10433,0.006426604679425796,-0.001625030605687831,-0.00480157407373788,84206,-1234,0.3726770200354948,0.011228178753163676
8743,34007,Camden,New Jersey,2016,146717,72631,9699,229047,0.6405541220797478,0.3171008570293433,0.04234502089090885,-6965,6908,3155,3098,-0.03960821543889581,0.02999267589270129,0.009615539546194485,74086,-10120,0.3234532650504045,-0.049223754985090296
8744,34009,Cape May,New Jersey,2000,22189,23794,1611,47594,0.4662142286842879,0.49993696684456024,0.03384880447115183,0,0,0,0,0.0,0.0,0.0,-1605,0,-0.033722738160272325,0.0
8745,34009,Cape May,New Jersey,2004,21475,28832,455,50762,0.4230526771994799,0.5679839249832552,0.008963397817264884,-714,-1156,5038,3168,-0.04316155148480799,-0.024885406653886943,0.06804695813869499,-7357,-5752,-0.1449312477837753,-0.11120850962350298
8746,34009,Cape May,New Jersey,2008,22893,27288,802,50983,0.4490320302846047,0.5352372359413923,0.015730733774003098,1418,347,-1544,221,0.02597935308512478,0.006767335956738214,-0.03274668904186295,-4395,2962,-0.08620520565678758,0.05872604212698773
8747,34009,Cape May,New Jersey,2012,21657,25781,655,48093,0.450315014659098,0.5360655396835299,0.013619445657372175,-1236,-147,-1507,-2890,0.0012829843744933123,-0.002111288116630923,0.0008283037421376038,-4124,271,-0.08575052502443187,0.00045468063235570844
8748,34009,Cape May,New Jersey,2016,18750,28446,2061,49257,0.3806565564285279,0.5775016748888483,0.04184176868262379,-2907,1406,2665,1164,-0.0696584582305701,0.028222323025251617,0.041436135205318414,-9696,-5572,-0.19684511846032038,-0.11109459343588851
8749,34011,Cumberland,New Jersey,2000,28188,18882,1614,48684,0.5789992605373429,0.3878481636677348,0.033152575794922354,0,0,0,0,0.0,0.0,0.0,9306,0,0.19115109686960807,0.0
8750,34011,Cumberland,New Jersey,2004,27875,24362,948,53185,0.5241139419009119,0.45806148350098713,0.017824574598100967,-313,-666,5480,4501,-0.05488531863643098,-0.015328001196821386,0.07021331983325235,3513,-5793,0.06605245839992474,-0.12509863846968333
8751,34011,Cumberland,New Jersey,2008,34919,22360,915,58194,0.6000446781455133,0.38423205141423517,0.015723270440251572,7044,-33,-2002,5009,0.07593073624460145,-0.002101304157849395,-0.07382943208675197,12559,9046,0.21581262673127816,0.14976016833135342
8752,34011,Cumberland,New Jersey,2012,34055,20658,656,55369,0.615055355885062,0.3730968592533728,0.011847784861565135,-864,-259,-1702,-2825,0.015010677739548672,-0.003875485578686437,-0.01113519216086234,13397,838,0.24195849663168917,0.026145869900411012
8753,34011,Cumberland,New Jersey,2016,27771,24453,2107,54331,0.5111446503837588,0.4500745430785371,0.03878080653770407,-6284,1451,3795,-1038,-0.10391070550130321,0.026933021676138934,0.07697768382516429,3318,-10079,0.061070107305221666,-0.1808883893264675
8754,34013,Essex,New Jersey,2000,185505,66842,7226,259573,0.7146544517341943,0.2575075219687718,0.027838026297033976,0,0,0,0,0.0,0.0,0.0,118663,0,0.4571469297654225,0.0
8755,34013,Essex,New Jersey,2004,203681,83374,2293,289348,0.7039309067282303,0.28814437977798363,0.00792471349378603,18176,-4933,16532,29775,-0.010723545005963953,-0.019913312803247946,0.030636857809211826,120307,1644,0.4157865269502467,-0.04136040281517578
8756,34013,Essex,New Jersey,2008,240306,74063,2181,316550,0.7591407360606539,0.2339693571315748,0.006889906807771284,36625,-112,-9311,27202,0.05520982933242358,-0.001034806686014745,-0.05417502264640883,166243,45936,0.5251713789290791,0.10938485197883235
8757,34013,Essex,New Jersey,2012,237035,64767,2269,304071,0.7795383315081017,0.2129995954892114,0.007462073002686872,-3271,88,-9296,-12479,0.02039759544744779,0.0005721661949155878,-0.020969761642363388,172268,6025,0.5665387360188903,0.04136735708981121
8758,34013,Essex,New Jersey,2016,240837,63176,8871,312884,0.7697325526393168,0.20191508674141215,0.02835236061927104,3802,6602,-1591,8813,-0.009805778868784865,0.02089028761658417,-0.01108450874779926,177661,5393,0.5678174658979047,0.0012787298790144508
8759,34015,Gloucester,New Jersey,2000,61095,42315,3888,107298,0.5693955152938545,0.39436895375496284,0.03623553095118269,0,0,0,0,0.0,0.0,0.0,18780,0,0.17502656153889162,0.0
8760,34015,Gloucester,New Jersey,2004,66835,60033,1096,127964,0.5222953330624238,0.4691397580569535,0.008564908880622675,5740,-2792,17718,20666,-0.04710018223143064,-0.027670622070560015,0.07477080430199068,6802,-11978,0.0531555750054703,-0.12187098653342132
8761,34015,Gloucester,New Jersey,2008,77267,60315,2364,139946,0.5521201034684807,0.4309876666714304,0.01689222986008889,10432,1268,282,11982,0.02982477040605691,0.008327320979466216,-0.03815209138552311,16952,10150,0.12113243679705032,0.06797686179158002
8762,34015,Gloucester,New Jersey,2012,74013,59456,2101,135570,0.5459393671166187,0.4385631039315483,0.015497528951833001,-3254,-263,-859,-4376,-0.006180736351862004,-0.0013947009082558894,0.00757543726011789,14557,-2395,0.10737626318507043,-0.013756173611979894
8763,34015,Gloucester,New Jersey,2016,66870,67544,6840,141254,0.4734025231143897,0.47817406940688406,0.04842340747872627,-7143,4739,8088,5684,-0.07253684400222904,0.03292587852689327,0.03961096547533577,-674,-15231,-0.0047715462924943775,-0.11214780947756481
8764,34017,Hudson,New Jersey,2000,118206,43804,5351,167361,0.7062935809417965,0.26173361774845993,0.03197280130974361,0,0,0,0,0.0,0.0,0.0,74402,0,0.44455996319333657,0.0
8765,34017,Hudson,New Jersey,2004,127447,60646,1461,189554,0.6723519419268388,0.31994049189149265,0.007707566181668548,9241,-3890,16842,22193,-0.033941639014957725,-0.02426523512807506,0.058206874143032716,66801,-7601,0.35241145003534613,-0.09214851315799044
8766,34017,Hudson,New Jersey,2008,154140,55360,2116,211616,0.7283948283683653,0.26160592771813096,0.009999243913503705,26693,655,-5286,22062,0.05604288644152655,0.0022916777318351565,-0.05833456417336169,98780,31979,0.4667889006502344,0.11437745061488824
8767,34017,Hudson,New Jersey,2012,153108,42369,2217,197694,0.774469634890285,0.21431606422046193,0.011214300889253088,-1032,101,-12991,-13922,0.04607480652191964,0.0012150569757493832,-0.04728986349766903,110739,11959,0.5601535706698231,0.0933646700195887
8768,34017,Hudson,New Jersey,2016,163917,49043,7582,220542,0.7432461844002503,0.22237487644076864,0.034378939158981055,10809,5365,6674,22848,-0.03122345049003472,0.023164638269727967,0.008058812220306716,114874,4135,0.5208713079594816,-0.03928226271034152
8769,34019,Hunterdon,New Jersey,2000,21387,32210,2858,56455,0.378832698609512,0.5705429102825259,0.050624391107962095,0,0,0,0,0.0,0.0,0.0,-10823,0,-0.19171021167301389,0.0
8770,34019,Hunterdon,New Jersey,2004,26050,39888,742,66680,0.3906718656268746,0.5982003599280143,0.011127774445110978,4663,-2116,7678,10225,0.011839167017362595,-0.03949661666285112,0.02765744964548844,-13838,-3015,-0.20752849430113973,-0.015818282628125846
8771,34019,Hunterdon,New Jersey,2008,29776,39092,1147,70015,0.4252802970791973,0.5583374991073341,0.016382203813468544,3726,405,-796,3335,0.034608431452322674,0.005254429368357566,-0.039862860820680246,-9316,4522,-0.1330572020281368,0.07447129227300292
8772,34019,Hunterdon,New Jersey,2012,26876,38687,1061,66624,0.4033981748318924,0.5806766330451489,0.015925192122958693,-2900,-86,-405,-3391,-0.021882122247304903,-0.0004570116905098509,0.022339133937814837,-11811,-2495,-0.17727845821325655,-0.04422125618511974
8773,34019,Hunterdon,New Jersey,2016,28898,38712,4050,71660,0.4032654200390734,0.5402176946692716,0.056516885291655036,2022,2989,25,5036,-0.00013275479281898983,0.04059169316869635,-0.04045893837587733,-9814,1997,-0.1369522746301982,0.04032618358305834
8774,34021,Mercer,New Jersey,2000,83256,46670,5633,135559,0.6141680006491639,0.34427813719487455,0.04155386215596161,0,0,0,0,0.0,0.0,0.0,36586,0,0.26988986345428934,0.0
8775,34021,Mercer,New Jersey,2004,91580,56604,1326,149510,0.612534278643569,0.37859674938131227,0.008868971975118722,8324,-4307,9934,13951,-0.001633722005594862,-0.03268489018084289,0.034318612186437725,34976,-1610,0.23393752926225675,-0.03595233419203259
8776,34021,Mercer,New Jersey,2008,107926,50223,2229,160378,0.6729476611505318,0.3131539238548928,0.013898414994575316,16346,903,-6381,10868,0.06041338250696282,0.005029443019456594,-0.06544282552641945,57703,22727,0.359793737295639,0.12585620803338227
8777,34021,Mercer,New Jersey,2012,104377,47355,3623,155355,0.6718612210743137,0.3048179974896206,0.023320781436065786,-3549,1394,-2868,-5023,-0.0010864400762181647,0.00942236644149047,-0.00833592636527225,57022,-681,0.3670432235846931,0.007249486289054086
8778,34021,Mercer,New Jersey,2016,104775,46193,7090,158058,0.6628895721823634,0.2922534765718913,0.044856951245745236,398,3467,-1162,2703,-0.008971648891950235,0.02153616980967945,-0.01256452091772925,58582,1560,0.3706360956104721,0.0035928720257790148
8779,34023,Middlesex,New Jersey,2000,154998,93545,10306,258849,0.598796982024269,0.36138829974232084,0.039814718233410214,0,0,0,0,0.0,0.0,0.0,61453,0,0.23740868228194817,0.0
8780,34023,Middlesex,New Jersey,2004,166628,126492,2685,295805,0.5633035276618042,0.4276195466608069,0.00907692567738882,11630,-7621,32947,36956,-0.03549345436246476,-0.030737792556021395,0.06623124691848609,40136,-21317,0.13568398100099732,-0.10172470128095085
8781,34023,Middlesex,New Jersey,2008,193812,123695,4367,321874,0.6021362396465698,0.3842963395614433,0.013567420791986926,27184,1682,-2797,26069,0.03883271198476557,0.004490495114598106,-0.0433232070993636,70117,29981,0.2178399000851265,0.08215591908412917
8782,34023,Middlesex,New Jersey,2012,190555,107310,3995,301860,0.6312694626648115,0.3554959252633671,0.013234612071821375,-3257,-372,-16385,-20014,0.029133223018241727,-0.00033280872016555087,-0.028800414298076227,83245,13128,0.27577353740144445,0.057933637316317954
8783,34023,Middlesex,New Jersey,2016,193044,122953,12560,328557,0.5875510185447274,0.37422121580121565,0.03822776565405698,2489,8565,15643,26697,-0.04371844412008419,0.024993153582235604,0.01872529053784855,70091,-13154,0.2133298027435117,-0.06244373465793274
8784,34025,Monmouth,New Jersey,2000,131476,119291,11374,262141,0.5015468774438184,0.4550642593108289,0.04338886324535269,0,0,0,0,0.0,0.0,0.0,12185,0,0.04648261813298954,0.0
8785,34025,Monmouth,New Jersey,2004,133773,163650,2516,299939,0.44600068680631727,0.5456109408913146,0.008388372302368148,2297,-8858,44359,37798,-0.05554619063750116,-0.03500049094298454,0.09054668158048568,-29877,-42062,-0.0996102540849973,-0.14609287221798684
8786,34025,Monmouth,New Jersey,2008,148737,160433,4244,313414,0.4745703765626296,0.511888428723669,0.013541194713701367,14964,1728,-3217,13475,0.028569689756312355,0.005152822411333219,-0.033722512167645546,-11696,18181,-0.037318052161039394,0.0622922019239579
8787,34025,Monmouth,New Jersey,2012,133820,148000,3847,285667,0.4684475280658949,0.518085743190498,0.013466728743607067,-14917,-397,-12433,-27747,-0.006122848496734723,-7.446597009429928e-05,0.006197314466829029,-14180,-2484,-0.04963821512460315,-0.012320162963563752
8788,34025,Monmouth,New Jersey,2016,137181,166723,13846,317750,0.4317261998426436,0.5246986624704957,0.04357513768686074,3361,9999,18723,32083,-0.036721328223251304,0.030108408943253673,0.006612919279997631,-29542,-15362,-0.09297246262785208,-0.043334247503248935
8789,34027,Morris,New Jersey,2000,88039,111066,7403,206508,0.4263224669262208,0.5378290429426463,0.035848490131132935,0,0,0,0,0.0,0.0,0.0,-23027,0,-0.11150657601642555,0.0
8790,34027,Morris,New Jersey,2004,98066,135241,1847,235154,0.41702884067462176,0.5751167320139143,0.007854427311463977,10027,-5556,24175,28646,-0.009293626251599019,-0.027994062819668958,0.037287689071268004,-37175,-14148,-0.15808789133929257,-0.04658131532286702
8791,34027,Morris,New Jersey,2008,112275,132331,2913,247519,0.4536015416998291,0.5346296647934098,0.011768793506761098,14209,1066,-2910,12365,0.03657270102520732,0.003914366195297121,-0.04048706722050455,-20056,17119,-0.0810281230935807,0.07705976824571187
8792,34027,Morris,New Jersey,2012,100563,125279,2805,228647,0.43981771026954214,0.547914470778099,0.012267818952358876,-11712,-108,-7052,-18872,-0.013783831430286941,0.0004990254455977776,0.013284805984689174,-24716,-4660,-0.10809676050855682,-0.027068637414976116
8793,34027,Morris,New Jersey,2016,115249,126071,12217,253537,0.4545648169695153,0.4972489222480348,0.0481862607824499,14686,9412,792,24890,0.014747106699973145,0.03591844183009102,-0.050665548530064164,-10822,13894,-0.04268410527851951,0.06541265523003731
8794,34029,Ocean,New Jersey,2000,102104,105684,8605,216393,0.47184520756216697,0.48838918079605165,0.03976561164178139,0,0,0,0,0.0,0.0,0.0,-3580,0,-0.01654397323388468,0.0
8795,34029,Ocean,New Jersey,2004,99839,154204,2424,256467,0.3892859510190395,0.6012625405997652,0.009451508381195241,-2265,-6181,48520,40074,-0.08255925654312746,-0.030314103260586152,0.1128733598037136,-54365,-50785,-0.21197658958072574,-0.19543261634684106
8796,34029,Ocean,New Jersey,2008,110189,160677,4111,274977,0.4007207875567775,0.5843288711419501,0.01495034130127247,10350,1687,6473,18510,0.011434836537737969,0.005498832920077228,-0.01693366945781516,-50488,3877,-0.1836080835851726,0.028368505995553128
8797,34029,Ocean,New Jersey,2012,102300,146475,3079,251854,0.4061877119283394,0.5815869511701224,0.012225336901538193,-7889,-1032,-14202,-23123,0.005466924371561932,-0.0027250043997342766,-0.002741919971827711,-44175,6313,-0.17539923924178297,0.008208844343389643
8798,34029,Ocean,New Jersey,2016,87150,179079,10496,276725,0.3149335983376999,0.6471370494172916,0.03792935224500858,-15150,7417,32604,24871,-0.09125411359063951,0.025704015343470388,0.06555009824716918,-91929,-47754,-0.33220345107959165,-0.15680421183780868
8799,34031,Passaic,New Jersey,2000,90324,61043,5206,156573,0.5768810714491004,0.38986926226105395,0.03324966628984563,0,0,0,0,0.0,0.0,0.0,29281,0,0.18701180918804644,0.0
8800,34031,Passaic,New Jersey,2004,94962,75200,1149,171311,0.5543251746823029,0.43896772536497947,0.006707099952717572,4638,-4057,14157,14738,-0.02255589676679748,-0.026542566337128058,0.049098463103925516,19762,-9519,0.11535744931732345,-0.071654359870723
8801,34031,Passaic,New Jersey,2008,113257,72552,1904,187713,0.6033519255459132,0.38650493039906664,0.010143144055020164,18295,755,-2648,16402,0.0490267508636103,0.003436044102302592,-0.05246279496591283,40705,20943,0.21684699514684658,0.10148954582952313
8802,34031,Passaic,New Jersey,2012,115926,64523,1765,182214,0.6362079752379071,0.3541056120824964,0.009686412679596518,2669,-139,-8029,-5499,0.03285604969199385,-0.00045673137542364545,-0.032399318316570225,51403,10698,0.28210236315541065,0.06525536800856407
8803,34031,Passaic,New Jersey,2016,116759,72902,6567,196228,0.5950170210163687,0.37151680697963596,0.033466172003995355,833,4802,8379,14014,-0.0411909542215384,0.02377975932439884,0.017411194897139548,43857,-7546,0.2235002140367327,-0.05860214911867795
8804,34033,Salem,New Jersey,2000,13718,12257,997,26972,0.5086015126798161,0.45443422808838796,0.036964259231795936,0,0,0,0,0.0,0.0,0.0,1461,0,0.054167284591428166,0.0
8805,34033,Salem,New Jersey,2004,13749,15721,311,29781,0.46167019240455326,0.5278869077599811,0.010442899835465565,31,-686,3464,2809,-0.04693132027526287,-0.026521359396330373,0.07345267967159319,-1972,-3433,-0.06621671535542789,-0.12038399994685606
8806,34033,Salem,New Jersey,2008,16044,14816,672,31532,0.5088164404414564,0.46987187618926807,0.021311683369275657,2295,361,-905,1751,0.04714624803690309,0.010868783533810092,-0.05801503157071308,1228,3200,0.038944564252188285,0.10516127960761618
8807,34033,Salem,New Jersey,2012,14719,14334,570,29623,0.49687742632414,0.483880768321912,0.019241805353947945,-1325,-102,-482,-1909,-0.011939014117316349,-0.002069878015327712,0.014008892132643946,385,-843,0.01299665800222799,-0.025947906249960295
8808,34033,Salem,New Jersey,2016,11904,16381,1568,29853,0.3987538940809969,0.548722071483603,0.05252403443540013,-2815,998,2047,230,-0.09812353224314313,0.03328222908145219,0.06484130316169096,-4477,-4862,-0.1499681774026061,-0.16296483540483409
8809,34035,Somerset,New Jersey,2000,56232,59725,4420,120377,0.4671324256294807,0.49614959668375186,0.036717977686767406,0,0,0,0,0.0,0.0,0.0,-3493,0,-0.02901717105427115,0.0
8810,34035,Somerset,New Jersey,2004,66476,72508,1295,140279,0.4738841879397486,0.5168842093257009,0.009231602734550431,10244,-3125,12783,19902,0.006751762310267917,-0.027486374952216973,0.020734612641949035,-6032,-2539,-0.04300002138595227,-0.013982850331681118
8811,34035,Somerset,New Jersey,2008,79321,70085,2024,151430,0.5238129828963878,0.46282110546126926,0.013365911642342996,12845,729,-2423,11151,0.049928794956639155,0.004134308907792565,-0.05406310386443164,9236,15268,0.060991877435118524,0.1039918988210708
8812,34035,Somerset,New Jersey,2012,74592,66603,1985,143180,0.5209666154490851,0.4651697164408437,0.01386366811007124,-4729,-39,-3482,-8250,-0.002846367447302711,0.0004977564677282435,0.0023486109795744503,7989,-1247,0.05579689900824136,-0.0051949784268771615
8813,34035,Somerset,New Jersey,2016,85689,65505,5898,157092,0.5454701703460393,0.41698495149339243,0.037544878160568326,11097,3913,-1098,13912,0.024503554896954216,0.023681210050497087,-0.048184764947451275,20184,12195,0.12848521885264685,0.07268831984440549
8814,34037,Sussex,New Jersey,2000,21353,33277,2860,57490,0.3714211167159506,0.5788311010610541,0.0497477822229953,0,0,0,0,0.0,0.0,0.0,-11924,0,-0.20740998434510344,0.0
8815,34037,Sussex,New Jersey,2004,23990,44506,962,69458,0.3453885801491549,0.6407613233896743,0.01385009646117078,2637,-1898,11229,11968,-0.026032536566795716,-0.03589768576182452,0.06193022232862022,-20516,-8592,-0.2953727432405194,-0.08796275889541594
8816,34037,Sussex,New Jersey,2008,28840,44184,1393,74417,0.38754585645752987,0.5937353024174584,0.018718841125011758,4850,431,-322,4959,0.04215727630837496,0.004868744663840978,-0.047026020972215865,-15344,5172,-0.20618944595992855,0.08918329728059082
8817,34037,Sussex,New Jersey,2012,26104,40625,1465,68194,0.382790274804235,0.5957268967944394,0.02148282840132563,-2736,72,-3559,-6223,-0.004755581653294871,0.0027639872763138736,0.001991594376980932,-14521,823,-0.21293662199020436,-0.006747176030275803
8818,34037,Sussex,New Jersey,2016,24212,46658,4288,75158,0.3221480081960669,0.6207988504217781,0.05705314138215493,-1892,2823,6033,6964,-0.06064226660816807,0.0355703129808293,0.025071953627338717,-22446,-7925,-0.29865084222571114,-0.08571422023550679
8819,34039,Union,New Jersey,2000,112003,68554,5816,186373,0.6009615126654612,0.3678322503796151,0.03120623695492373,0,0,0,0,0.0,0.0,0.0,43449,0,0.23312926228584607,0.0
8820,34039,Union,New Jersey,2004,119372,82517,1613,203502,0.5865888295938123,0.40548495837878745,0.007926212027400223,7369,-4203,13963,17129,-0.01437268307164885,-0.023280024927523506,0.03765270799917236,36855,-6594,0.18110387121502486,-0.052025391070821214
8821,34039,Union,New Jersey,2008,141417,78768,2241,222426,0.6357934773812414,0.35413126163308245,0.010075260985676135,22045,628,-3749,18924,0.04920464778742906,0.0021490489582759124,-0.051353696745705,62649,25794,0.2816622157481589,0.10055834453313406
8822,34039,Union,New Jersey,2012,139752,68314,2022,210088,0.6652069608925784,0.3251685008187045,0.00962453828871711,-1665,-219,-10454,-12338,0.02941348351133699,-0.00045072269695902584,-0.02896276081437793,71438,8789,0.34003846007387384,0.05837624432571492
8823,34039,Union,New Jersey,2016,147414,68114,8042,223570,0.6593639575971731,0.3046652055284698,0.03597083687435702,7662,6020,-200,13482,-0.005843003295405214,0.026346298585639916,-0.020503295290234702,79300,7862,0.3546987520687033,0.014660291994829489
8824,34041,Warren,New Jersey,2000,16543,22172,2086,40801,0.40545574863361195,0.5434180534790813,0.051126197887306685,0,0,0,0,0.0,0.0,0.0,-5629,0,-0.1379623048454694,0.0
8825,34041,Warren,New Jersey,2004,18044,29542,622,48208,0.37429472286757387,0.6128028542980418,0.012902422834384334,1501,-1464,7370,7407,-0.031161025766038075,-0.03822377505292235,0.06938480081896048,-11498,-5869,-0.23850813143046795,-0.10054582658499855
8826,34041,Warren,New Jersey,2008,20628,27500,980,49108,0.42005375906166004,0.5599902256251528,0.01995601531318726,2584,358,-2042,900,0.04575903619408617,0.007053592478802927,-0.05281262867288905,-6872,4626,-0.13993646656349273,0.09857166486697522
8827,34041,Warren,New Jersey,2012,18745,25744,926,45415,0.4127490917097875,0.566861169217219,0.020389739072993504,-1883,-54,-1756,-3693,-0.007304667351872518,0.00043372375980624267,0.006870943592066192,-6999,-127,-0.15411207750743144,-0.01417561094393871
8828,34041,Warren,New Jersey,2016,17281,29858,2544,49683,0.3478252118430852,0.6009701507557917,0.05120463740112312,-1464,1618,4114,4268,-0.06492387986670234,0.030814898328129614,0.03410898153857278,-12577,-5578,-0.25314493891270656,-0.09903286140527512
8829,35001,Bernalillo,New Mexico,2000,99461,95249,9609,204319,0.48679271139737373,0.4661778884978881,0.04702940010473818,0,0,0,0,0.0,0.0,0.0,4212,0,0.02061482289948563,0.0
8830,35001,Bernalillo,New Mexico,2004,132252,121454,3105,256811,0.5149779409760485,0.4729314554283111,0.012090603595640374,32791,-6504,26205,52492,0.02818522957867481,-0.03493879650909781,0.006753566930423005,10798,6586,0.04204648554773743,0.021431662648251804
8831,35001,Bernalillo,New Mexico,2008,171556,110521,3701,285778,0.6003121303949219,0.3867372575915571,0.012950612013520985,39304,596,-10933,28967,0.08533418941887339,0.000860008417880611,-0.08619419783675403,61035,50237,0.21357487280336485,0.1715283872556274
8832,35001,Bernalillo,New Mexico,2012,150739,106408,13822,270969,0.5562961076728334,0.3926943672523425,0.05100952507482406,-20817,10121,-4113,-14809,-0.04401602272208849,0.038058913061303073,0.005957109660785442,44331,-16704,0.16360174042049092,-0.04997313238287393
8833,35001,Bernalillo,New Mexico,2016,143417,94698,36547,274662,0.5221581434636026,0.3447801297594862,0.13306172677691125,-7322,22725,-11710,3693,-0.034137964209230875,0.08205220170208719,-0.04791423749285634,48719,4388,0.17737801370411638,0.013776273283625462
8834,35003,Catron,New Mexico,2000,353,1273,85,1711,0.20631209818819404,0.7440093512565751,0.049678550555230856,0,0,0,0,0.0,0.0,0.0,-920,0,-0.537697253068381,0.0
8835,35003,Catron,New Mexico,2004,551,1427,15,1993,0.2764676367285499,0.7160060210737581,0.007526342197691922,198,-70,154,282,0.07015553854035586,-0.04215220835753893,-0.028003330182816977,-876,44,-0.4395383843452082,0.09815886872317281
8836,35003,Catron,New Mexico,2008,664,1398,50,2112,0.3143939393939394,0.6619318181818182,0.023674242424242424,113,35,-29,119,0.03792630266538949,0.0161479002265505,-0.05407420289193987,-734,142,-0.34753787878787884,0.09200050555732936
8837,35003,Catron,New Mexico,2012,560,1494,69,2123,0.263777673104098,0.7037211493170042,0.03250117757889778,-104,19,96,11,-0.050616266289841394,0.008826935154655359,0.041789331135186014,-934,-200,-0.43994347621290625,-0.09240559742502741
8838,35003,Catron,New Mexico,2016,427,1464,158,2049,0.20839433870180576,0.7144948755490483,0.07711078574914593,-133,89,-30,-74,-0.055383334402292234,0.044609608170248144,0.01077372623204409,-1037,-103,-0.5061005368472425,-0.0661570606343363
8839,35005,Chaves,New Mexico,2000,6340,11378,431,18149,0.3493305416276379,0.6269215934762246,0.02374786489613753,0,0,0,0,0.0,0.0,0.0,-5038,0,-0.2775910518485867,0.0
8840,35005,Chaves,New Mexico,2004,6726,14773,206,21705,0.3098825155494126,0.6806265837364662,0.00949090071412117,386,-225,3395,3556,-0.039448026078225285,-0.014256964182016359,0.05370499026024167,-8047,-3009,-0.37074406818705363,-0.09315301633846695
8841,35005,Chaves,New Mexico,2008,8197,13651,264,22112,0.3707036903039074,0.6173570911722142,0.011939218523878437,1471,58,-1122,407,0.06082117475449478,0.0024483178097572666,-0.06326949256425207,-5454,2593,-0.24665340086830678,0.12409066731874685
8842,35005,Chaves,New Mexico,2012,6604,13088,600,20292,0.32544845259215455,0.644983244628425,0.02956830277942046,-1593,336,-563,-1820,-0.04525523771175283,0.01762908425554202,0.02762615345621089,-6484,-1030,-0.3195347920362705,-0.07288139116796372
8843,35005,Chaves,New Mexico,2016,5534,12872,1865,20271,0.27300083863647573,0.6349958068176212,0.09200335454590301,-1070,1265,-216,-21,-0.05244761395567882,0.06243505176648255,-0.009987437810803801,-7338,-854,-0.3619949681811455,-0.04246017614487502
8844,35006,Cibola,New Mexico,2000,4127,2752,209,7088,0.5822516930022573,0.38826185101580135,0.029486455981941308,0,0,0,0,0.0,0.0,0.0,1375,0,0.19398984198645597,0.0
8845,35006,Cibola,New Mexico,2004,3913,3477,97,7487,0.5226392413516763,0.46440496861226127,0.012955790036062509,-214,-112,725,399,-0.059612451650581044,-0.0165306659458788,0.07614311759645992,436,-939,0.058234272739415005,-0.13575556924704096
8846,35006,Cibola,New Mexico,2008,5827,3131,139,9097,0.640540837638782,0.3441793998021326,0.015279762559085412,1914,42,-346,1610,0.11790159628710573,0.0023239725230229033,-0.12022556881012869,2696,2260,0.2963614378366494,0.23812716509723442
8847,35006,Cibola,New Mexico,2012,4961,2998,284,8243,0.6018439888390149,0.36370253548465364,0.03445347567633143,-866,145,-133,-854,-0.03869684879976709,0.01917371311724602,0.019523135682521064,1963,-733,0.23814145335436127,-0.058219984482288156
8848,35006,Cibola,New Mexico,2016,3741,3195,1127,8063,0.46397122659059903,0.3962544958452189,0.13977427756418206,-1220,843,197,-180,-0.13787276224841588,0.10532080188785063,0.032551960360565235,546,-1417,0.06771673074538015,-0.17042472260898112
8849,35007,Colfax,New Mexico,2000,2653,2600,208,5461,0.485808459989013,0.4761032777879509,0.03808826222303607,0,0,0,0,0.0,0.0,0.0,53,0,0.00970518220106209,0.0
8850,35007,Colfax,New Mexico,2004,2824,3082,62,5968,0.47319034852546915,0.5164209115281502,0.010388739946380697,171,-146,482,507,-0.012618111463543857,-0.027699522276655376,0.040317633740199255,-258,-311,-0.04323056300268102,-0.05293574520374311
8851,35007,Colfax,New Mexico,2008,3490,2805,89,6384,0.5466791979949874,0.4393796992481203,0.01394110275689223,666,27,-277,416,0.07348884946951828,0.0035523628105115328,-0.07704121228002986,685,943,0.10729949874686712,0.15053006174954814
8852,35007,Colfax,New Mexico,2012,2828,2699,237,5764,0.4906315058986815,0.4682512144344205,0.04111727966689799,-662,148,-106,-620,-0.056047692096305946,0.027176176910005758,0.028871515186300212,129,-556,0.02238029146426096,-0.08491920728260616
8853,35007,Colfax,New Mexico,2016,2129,2585,618,5332,0.3992873218304576,0.4848087021755439,0.1159039759939985,-699,381,-114,-432,-0.09134418406822387,0.07478669632710051,0.016557487741123367,-456,-585,-0.08552138034508627,-0.10790167180934723
8854,35009,Curry,New Mexico,2000,3471,8301,197,11969,0.28999916450831315,0.6935416492605898,0.016459186231097,0,0,0,0,0.0,0.0,0.0,-4830,0,-0.40354248475227666,0.0
8855,35009,Curry,New Mexico,2004,3541,10649,96,14286,0.24786504269914603,0.745415091698166,0.006719865602687947,70,-101,2348,2317,-0.04213412180916712,-0.009739320628409053,0.05187344243757619,-7108,-2278,-0.49755004899902,-0.09400756424674334
8856,35009,Curry,New Mexico,2008,4670,9599,169,14438,0.3234520016622801,0.6648427760077573,0.011705222329962598,1129,73,-1050,152,0.07558695896313408,0.004985356727274652,-0.08057231569040868,-4929,2179,-0.3413907743454772,0.1561592746535428
8857,35009,Curry,New Mexico,2012,4022,9251,352,13625,0.29519266055045873,0.6789724770642201,0.0258348623853211,-648,183,-348,-813,-0.02825934111182138,0.014129640055358503,0.014129701056462829,-5229,-300,-0.3837798165137614,-0.04238904216828421
8858,35009,Curry,New Mexico,2016,3121,9035,1214,13370,0.23343305908750936,0.6757666417352282,0.09080029917726253,-901,862,-216,-255,-0.06175960146294937,0.06496543679194142,-0.0032058353289919905,-5914,-685,-0.4423335826477188,-0.05855376613395741
8859,35011,De Baca,New Mexico,2000,349,612,21,982,0.35539714867617106,0.6232179226069247,0.021384928716904276,0,0,0,0,0.0,0.0,0.0,-263,0,-0.2678207739307536,0.0
8860,35011,De Baca,New Mexico,2004,281,706,6,993,0.28298086606243705,0.7109768378650554,0.006042296072507553,-68,-15,94,11,-0.072416282613734,-0.015342632644396724,0.08775891525813073,-425,-162,-0.42799597180261834,-0.16017519787186474
8861,35011,De Baca,New Mexico,2008,359,676,9,1044,0.3438697318007663,0.6475095785440613,0.008620689655172414,78,3,-30,51,0.060888865738329245,0.002578393582664861,-0.06346725932099406,-317,108,-0.303639846743295,0.12435612505932331
8862,35011,De Baca,New Mexico,2012,287,586,29,902,0.3181818181818182,0.6496674057649667,0.03215077605321508,-72,20,-90,-142,-0.02568791361894812,0.023530086398042663,0.002157827220905406,-299,18,-0.33148558758314856,-0.027845740839853528
8863,35011,De Baca,New Mexico,2016,193,620,97,910,0.21208791208791208,0.6813186813186813,0.10659340659340659,-94,68,34,8,-0.10609390609390609,0.07444263054019151,0.03165127555371461,-427,-128,-0.46923076923076923,-0.13774518164762067
8864,35013,Dona Ana,New Mexico,2000,23912,21263,1478,46653,0.5125501039590166,0.45576918954836776,0.031680706492615694,0,0,0,0,0.0,0.0,0.0,2649,0,0.05678091441064881,0.0
8865,35013,Dona Ana,New Mexico,2004,31762,29548,650,61960,0.5126210458360232,0.47688831504196255,0.010490639122014202,7850,-828,8285,15307,7.094187700662502e-05,-0.021190067370601494,0.021119125493594793,2214,-435,0.03573273079406064,-0.021048183616588167
8866,35013,Dona Ana,New Mexico,2008,40282,28068,930,69280,0.5814376443418013,0.40513856812933025,0.01342378752886836,8520,280,-1480,7320,0.06881659850577815,0.002933148406854158,-0.0717497469126323,12214,10000,0.1762990762124711,0.14056634541841045
8867,35013,Dona Ana,New Mexico,2012,37139,27322,1962,66423,0.5591286150881472,0.41133342366349007,0.029537961248362766,-3143,1032,-746,-2857,-0.02230902925365419,0.016114173719494404,0.006194855534159827,9817,-2397,0.14779519142465708,-0.028503884787814016
8868,35013,Dona Ana,New Mexico,2016,37947,25374,7327,70648,0.5371277318536972,0.35916091042917,0.10371135771713283,808,5365,-1948,4225,-0.02200088323444993,0.07417339646877007,-0.052172513234320095,12573,2756,0.17796682142452724,0.030171629999870164
8869,35015,Eddy,New Mexico,2000,7108,10335,344,17787,0.399617698318997,0.5810423342890876,0.019339967391915444,0,0,0,0,0.0,0.0,0.0,-3227,0,-0.18142463597009056,0.0
8870,35015,Eddy,New Mexico,2004,6880,13268,122,20270,0.3394178589047854,0.654563394178589,0.006018746916625555,-228,-222,2933,2483,-0.06019983941421164,-0.013321220475289889,0.07352105988950142,-6388,-3161,-0.3151455352738036,-0.13372089930371306
8871,35015,Eddy,New Mexico,2008,7351,12500,242,20093,0.3658488030657443,0.6221072015129647,0.012043995421290997,471,120,-768,-177,0.026430944160958925,0.006025248504665442,-0.03245619266562427,-5149,1239,-0.2562583984472204,0.0588871368265832
8872,35015,Eddy,New Mexico,2012,6142,12583,544,19269,0.3187503243551819,0.6530178006123826,0.02823187503243552,-1209,302,83,-824,-0.047098478710562386,0.016187879611144523,0.030910599099417846,-6441,-1292,-0.33426747625720066,-0.07800907780998023
8873,35015,Eddy,New Mexico,2016,5033,13147,1487,19667,0.25591091676412264,0.6684801952509279,0.07560888798494941,-1109,943,564,398,-0.06283940759105927,0.0473770129525139,0.015462394638545374,-8114,-1673,-0.4125692784868053,-0.07830180222960464
8874,35017,Grant,New Mexico,2000,5673,4961,607,11241,0.504670402989058,0.44133084245173915,0.053998754559202916,0,0,0,0,0.0,0.0,0.0,712,0,0.06333956053731882,0.0
8875,35017,Grant,New Mexico,2004,7095,6135,162,13392,0.5297939068100358,0.45810931899641577,0.012096774193548387,1422,-445,1174,2151,0.025123503820977833,-0.041901980365654526,0.016778476544676624,960,248,0.07168458781362003,0.008345027276301209
8876,35017,Grant,New Mexico,2008,8142,5406,207,13755,0.5919302071973828,0.393020719738277,0.01504907306434024,1047,45,-729,363,0.062136300387346965,0.0029522988707918526,-0.06508859925813876,2736,1776,0.19890948745910575,0.12722489964548572
8877,35017,Grant,New Mexico,2012,7090,5358,454,12902,0.549527205084483,0.4152844520229422,0.035188342892574796,-1052,247,-48,-853,-0.04240300211289971,0.02013926982823456,0.02226373228466516,1732,-1004,0.13424275306154088,-0.06466673439756487
8878,35017,Grant,New Mexico,2016,6276,5288,1247,12811,0.4898914994926235,0.412770275544454,0.09733822496292249,-814,793,-70,-91,-0.059635705591859545,0.062149882070347696,-0.0025141764784881726,988,-744,0.0771212239481695,-0.05712152911337137
8879,35019,Guadalupe,New Mexico,2000,1076,548,27,1651,0.6517262265293762,0.3319200484554815,0.01635372501514234,0,0,0,0,0.0,0.0,0.0,528,0,0.31980617807389466,0.0
8880,35019,Guadalupe,New Mexico,2004,1340,914,13,2267,0.5910895456550507,0.4031760035288928,0.005734450816056462,264,-14,366,616,-0.0606366808743255,-0.010619274199085876,0.07125595507341131,426,-102,0.18791354212615785,-0.1318926359477368
8881,35019,Guadalupe,New Mexico,2008,1557,620,19,2196,0.7090163934426229,0.28233151183970856,0.008652094717668488,217,6,-294,-71,0.11792684778757223,0.0029176439016120256,-0.12084449168918426,937,511,0.42668488160291435,0.2387713394767565
8882,35019,Guadalupe,New Mexico,2012,1488,557,90,2135,0.6969555035128806,0.2608899297423888,0.04215456674473068,-69,71,-63,-61,-0.012060889929742302,0.03350247202706219,-0.021441582097319778,931,-6,0.4360655737704918,0.009380692167577476
8883,35019,Guadalupe,New Mexico,2016,970,595,262,1827,0.5309250136836344,0.32567049808429116,0.14340448823207444,-518,172,38,-308,-0.16603048982924618,0.10124992148734377,0.06478056834190238,375,-556,0.20525451559934327,-0.23081105817114855
8884,35021,Harding,New Mexico,2000,214,366,13,593,0.3608768971332209,0.6172006745362564,0.021922428330522766,0,0,0,0,0.0,0.0,0.0,-152,0,-0.25632377740303547,0.0
8885,35021,Harding,New Mexico,2004,259,380,5,644,0.40217391304347827,0.5900621118012422,0.007763975155279503,45,-8,14,51,0.04129701591025736,-0.014158453175243262,-0.027138562735014138,-121,31,-0.18788819875776397,0.0684355786452715
8886,35021,Harding,New Mexico,2008,260,358,8,626,0.41533546325878595,0.5718849840255591,0.012779552715654952,1,3,-22,-18,0.013161550215307682,0.0050155775603754485,-0.018177127775683144,-98,23,-0.15654952076677314,0.031338677990990826
8887,35021,Harding,New Mexico,2012,260,327,14,601,0.43261231281198004,0.5440931780366056,0.02329450915141431,0,6,-31,-25,0.017276849553194085,0.010514956435759358,-0.027791805988953477,-67,31,-0.11148086522462558,0.04506865554214756
8888,35021,Harding,New Mexico,2016,156,311,60,527,0.29601518026565465,0.5901328273244781,0.11385199240986717,-104,46,-16,-74,-0.13659713254632538,0.09055748325845286,0.04603964928787252,-155,-88,-0.2941176470588235,-0.1826367818341979
8889,35023,Hidalgo,New Mexico,2000,839,954,41,1834,0.4574700109051254,0.520174482006543,0.022355507088331516,0,0,0,0,0.0,0.0,0.0,-115,0,-0.06270447110141764,0.0
8890,35023,Hidalgo,New Mexico,2004,861,1081,22,1964,0.43839103869653767,0.5504073319755601,0.01120162932790224,22,-19,127,130,-0.01907897220858773,-0.011153877760429276,0.030232849969017095,-220,-105,-0.11201629327902246,-0.049311822177604825
8891,35023,Hidalgo,New Mexico,2008,993,936,22,1951,0.5089697590978985,0.4797539723218862,0.011276268580215274,132,0,-145,-13,0.07057872040136087,7.463925231303466e-05,-0.07065335965367392,57,277,0.02921578677601233,0.1412320800550348
8892,35023,Hidalgo,New Mexico,2012,995,899,41,1935,0.5142118863049095,0.46459948320413436,0.02118863049095607,2,19,-37,-16,0.005242127207011005,0.009912361910740797,-0.015154489117751857,96,39,0.04961240310077519,0.020396616324762862
8893,35023,Hidalgo,New Mexico,2016,784,910,178,1872,0.4188034188034188,0.4861111111111111,0.09508547008547008,-211,137,11,-63,-0.09540846750149073,0.07389683959451401,0.02151162790697675,-126,-222,-0.06730769230769229,-0.11692009540846748
8894,35025,Lea,New Mexico,2000,3855,10157,244,14256,0.27041245791245794,0.7124719416386083,0.01711560044893378,0,0,0,0,0.0,0.0,0.0,-6302,0,-0.44205948372615034,0.0
8895,35025,Lea,New Mexico,2004,3646,14430,105,18181,0.20053902425609152,0.7936857158572136,0.005775259886694901,-209,-139,4273,3925,-0.06987343365636642,-0.01134034056223888,0.08121377421860532,-10784,-4482,-0.5931466916011221,-0.15108720787497176
8896,35025,Lea,New Mexico,2008,5108,13347,190,18645,0.27396084741217486,0.7158487530168947,0.010190399570930545,1462,85,-1083,464,0.07342182315608334,0.004415139684235644,-0.07783696284031894,-8239,2545,-0.4418879056047198,0.1512587859964023
8897,35025,Lea,New Mexico,2012,4080,12548,387,17015,0.23978842198060535,0.7374669409344696,0.022744637084925065,-1028,197,-799,-1630,-0.03417242543156951,0.01255423751399452,0.02161818791757497,-8468,-229,-0.4976785189538643,-0.05579061334914448
8898,35025,Lea,New Mexico,2016,3930,12495,1287,17712,0.22188346883468835,0.7054539295392954,0.07266260162601626,-150,900,-53,697,-0.017904953145917002,0.049917964541091195,-0.03201301139517421,-8565,-97,-0.4835704607046071,0.014108058249257205
8899,35027,Lincoln,New Mexico,2000,2027,4458,287,6772,0.29932073242764323,0.6582988777318369,0.04238038984051979,0,0,0,0,0.0,0.0,0.0,-2431,0,-0.3589781453041937,0.0
8900,35027,Lincoln,New Mexico,2004,2822,6070,122,9014,0.3130685600177502,0.6733969380962946,0.013534501885955182,795,-165,1612,2242,0.013747827590106954,-0.02884588795456461,0.01509806036445771,-3248,-817,-0.36032837807854445,-0.001350232774350757
8901,35027,Lincoln,New Mexico,2008,3535,6001,160,9696,0.3645833333333333,0.6189150165016502,0.0165016501650165,713,38,-69,682,0.05151477331558313,0.0029671482790613185,-0.05448192159464449,-2466,782,-0.25433168316831684,0.10599669491022762
8902,35027,Lincoln,New Mexico,2012,2942,5961,339,9242,0.3183293659381086,0.6449902618480848,0.03668037221380654,-593,179,-40,-454,-0.04625396739522469,0.020178722048790038,0.026075245346434683,-3019,-553,-0.3266608959099762,-0.07232921274165938
8903,35027,Lincoln,New Mexico,2016,2331,5896,675,8902,0.26185126937766795,0.6623230734666367,0.07582565715569535,-611,336,-65,-340,-0.05647809656044067,0.03914528494188881,0.017332811618551824,-3565,-546,-0.4004718040889687,-0.0738109081789925
8904,35028,Los Alamos,New Mexico,2000,4149,5623,446,10218,0.4060481503229595,0.5503033861812487,0.04364846349579174,0,0,0,0,0.0,0.0,0.0,-1474,0,-0.14425523585828925,0.0
8905,35028,Los Alamos,New Mexico,2004,5206,5810,181,11197,0.4649459676699116,0.5188889881218184,0.01616504420827007,1057,-265,187,979,0.0588978173469521,-0.027483419287521668,-0.03141439805943036,-604,870,-0.0539430204519068,0.09031221540638246
8906,35028,Los Alamos,New Mexico,2008,5824,5064,181,11069,0.5261541241304544,0.4574939018881561,0.016351973981389465,618,0,-746,-128,0.061208156460542784,0.00018692977311939377,-0.0613950862336623,760,1364,0.06866022224229829,0.12260324269420508
8907,35028,Los Alamos,New Mexico,2012,5191,4796,667,10654,0.48723484137413176,0.45015956448282335,0.06260559414304487,-633,486,-268,-415,-0.038919282756322615,0.04625362016165541,-0.007334337405332736,395,-365,0.037075276891308406,-0.03158494535098988
8908,35028,Los Alamos,New Mexico,2016,5562,3359,1964,10885,0.5109784106568672,0.30858980248047774,0.18043178686265504,371,1297,-1437,231,0.023743569282735466,0.11782619271961017,-0.1415697620023456,2203,1808,0.20238860817638948,0.16531333128508108
8909,35029,Luna,New Mexico,2000,2975,3395,242,6612,0.4499395039322444,0.51346037507562,0.03660012099213551,0,0,0,0,0.0,0.0,0.0,-420,0,-0.06352087114337562,0.0
8910,35029,Luna,New Mexico,2004,3340,4164,89,7593,0.439878835769788,0.5483998419596997,0.011721322270512313,365,-153,769,981,-0.010060668162456432,-0.0248787987216232,0.03493946688407967,-824,-404,-0.10852100618991173,-0.045000135046536105
8911,35029,Luna,New Mexico,2008,4311,3870,159,8340,0.5169064748201438,0.46402877697841727,0.019064748201438848,971,70,-294,747,0.07702763905035587,0.007343425930926534,-0.08437106498128244,441,1265,0.05287769784172658,0.1613987040316383
8912,35029,Luna,New Mexico,2012,3583,3670,247,7500,0.47773333333333334,0.48933333333333334,0.032933333333333335,-728,88,-200,-840,-0.0391731414868105,0.013868585131894488,0.025304556354916075,-87,-528,-0.0116,-0.06447769784172658
8913,35029,Luna,New Mexico,2016,3195,3478,622,7295,0.43797121315969845,0.47676490747087047,0.08526387936943111,-388,375,-192,-205,-0.039762120173634896,0.052330546036097776,-0.012568425862462873,-283,-196,-0.03879369431117202,-0.027193694311172023
8914,35031,McKinley,New Mexico,2000,10281,5070,528,15879,0.6474589079916871,0.3192896278103155,0.033251464197997356,0,0,0,0,0.0,0.0,0.0,5211,0,0.32816928018137165,0.0
8915,35031,McKinley,New Mexico,2004,13051,7351,221,20623,0.6328371235998642,0.3564466857392232,0.010716190660912573,2770,-307,2281,4744,-0.014621784391822934,-0.02253527353708478,0.03715705792890772,5700,489,0.276390437860641,-0.051778842320730656
8916,35031,McKinley,New Mexico,2008,16572,6382,253,23207,0.7140948851639591,0.2750032317835136,0.010901883052527254,3521,32,-969,2584,0.08125776156409492,0.0001856923916146811,-0.08144345395570962,10190,4490,0.43909165338044553,0.16270121551980454
8917,35031,McKinley,New Mexico,2012,15841,5546,542,21929,0.7223767613662274,0.25290710930731,0.024716129326462676,-731,289,-836,-1278,0.008281876202268279,0.013814246273935422,-0.022096122476203628,10295,105,0.46946965205891744,0.030377998678471907
8918,35031,McKinley,New Mexico,2016,13576,5104,3023,21703,0.625535640234069,0.2351748606183477,0.1392894991475833,-2265,2481,-442,-226,-0.09684112113215837,0.11457336982112061,-0.017732248688962282,8472,-1823,0.39036077961572135,-0.07910887244319609
8919,35033,Mora,New Mexico,2000,1456,668,67,2191,0.6645367412140575,0.30488361478776815,0.03057964399817435,0,0,0,0,0.0,0.0,0.0,788,0,0.3596531264262893,0.0
8920,35033,Mora,New Mexico,2004,1876,928,22,2826,0.6638358103326256,0.3283793347487615,0.00778485491861288,420,-45,260,635,-0.0007009308814318604,-0.022794789079561468,0.023495719960993366,948,160,0.3354564755838641,-0.024196650842425227
8921,35033,Mora,New Mexico,2008,2168,569,23,2760,0.7855072463768116,0.20615942028985507,0.008333333333333333,292,1,-359,-66,0.12167143604418595,0.0005484784147204531,-0.12221991445890645,1599,651,0.5793478260869565,0.24389135050309235
8922,35033,Mora,New Mexico,2012,1955,595,61,2611,0.7487552661815396,0.22788203753351208,0.023362696284948296,-213,38,26,-149,-0.03675198019527193,0.015029362951614963,0.02172261724365701,1360,-239,0.5208732286480275,-0.05847459743892891
8923,35033,Mora,New Mexico,2016,1536,665,240,2441,0.6292503072511266,0.2724293322408849,0.09832036050798854,-419,179,70,-170,-0.11950495893041302,0.07495766422304023,0.044547294707372814,871,-489,0.35682097501024174,-0.1640522536377858
8924,35035,Otero,New Mexico,2000,5465,10258,481,16204,0.33726240434460625,0.6330535670204888,0.029684028634904963,0,0,0,0,0.0,0.0,0.0,-4793,0,-0.2957911626758825,0.0
8925,35035,Otero,New Mexico,2004,6433,14066,265,20764,0.3098150645347717,0.6774224619533809,0.012762473511847429,968,-216,3808,4560,-0.027447339809834548,-0.016921555123057534,0.04436889493289209,-7633,-2840,-0.36760739741860915,-0.07181623474272664
8926,35035,Otero,New Mexico,2008,8610,12806,350,21766,0.3955710741523477,0.5883488008821097,0.016080124965542588,2177,85,-1260,1002,0.08575600961757601,0.003317651453695159,-0.08907366107127113,-4196,3437,-0.192777726729762,0.17482967068884714
8927,35035,Otero,New Mexico,2012,6829,12451,732,20012,0.34124525284829105,0.6221766939836099,0.03657805316809914,-1781,382,-355,-1754,-0.054325821304056665,0.02049792820255655,0.03382789310150014,-5622,-1426,-0.2809314411353188,-0.0881537144055568
8928,35035,Otero,New Mexico,2016,6124,11887,2049,20060,0.305284147557328,0.5925722831505483,0.10214356929212363,-705,1317,-564,48,-0.035961105290963025,0.0655655161240245,-0.029604410833061534,-5763,-141,-0.2872881355932203,-0.006356694457901491
8929,35037,Quay,New Mexico,2000,1471,2292,81,3844,0.3826742976066597,0.5962539021852237,0.021071800208116546,0,0,0,0,0.0,0.0,0.0,-821,0,-0.21357960457856395,0.0
8930,35037,Quay,New Mexico,2004,1422,2661,34,4117,0.345397133835317,0.6463444255525869,0.008258440612096187,-49,-47,369,273,-0.037277163771342714,-0.01281335959602036,0.05009052336736319,-1239,-418,-0.30094729171726986,-0.08736768713870591
8931,35037,Quay,New Mexico,2008,1547,2367,82,3996,0.38713713713713716,0.5923423423423423,0.02052052052052052,125,48,-294,-121,0.04174000330182015,0.012262079908424333,-0.05400208321024458,-820,419,-0.20520520520520513,0.09574208651206473
8932,35037,Quay,New Mexico,2012,1383,2202,122,3707,0.3730779606150526,0.5940113299163744,0.03291070946857297,-164,40,-165,-289,-0.014059176522084549,0.012390188948052449,0.0016689875740321103,-819,1,-0.2209333693013218,-0.01572816409611666
8933,35037,Quay,New Mexico,2016,1017,2212,343,3572,0.2847144456886898,0.6192609182530795,0.09602463605823068,-366,221,10,-135,-0.0883635149263628,0.06311392658965771,0.025249588336705098,-1195,-376,-0.3345464725643897,-0.1136131032630679
8934,35039,Rio Arriba,New Mexico,2000,8169,3495,433,12097,0.6752913945606349,0.28891460692733734,0.035793998512027775,0,0,0,0,0.0,0.0,0.0,4674,0,0.3863767876332976,0.0
8935,35039,Rio Arriba,New Mexico,2004,9753,5149,97,14999,0.6502433495566371,0.34328955263684247,0.006467097806520434,1584,-336,1654,2902,-0.02504804500399782,-0.02932690070550734,0.05437494570950513,4604,-70,0.30695379691979463,-0.07942299071350295
8936,35039,Rio Arriba,New Mexico,2008,12703,4086,151,16940,0.7498819362455726,0.24120425029515938,0.008913813459268005,2950,54,-1063,1941,0.09963858668893555,0.0024467156527475708,-0.10208530234168309,8617,4013,0.5086776859504133,0.20172388903061866
8937,35039,Rio Arriba,New Mexico,2012,11465,3397,481,15343,0.7472463012448674,0.22140389754285342,0.03134980121227922,-1238,330,-689,-1597,-0.0026356350007052942,0.022435987753011213,-0.01980035275230596,8068,-549,0.525842403702014,0.017164717751600667
8938,35039,Rio Arriba,New Mexico,2016,9592,3599,1687,14878,0.6447103105256082,0.2419007931173545,0.11338889635703724,-1873,1206,202,-465,-0.10253599071925912,0.08203909514475802,0.020496895574501073,5993,-2075,0.40280951740825377,-0.12303288629376019
8939,35041,Roosevelt,New Mexico,2000,1762,3762,127,5651,0.31180322066890814,0.6657228809060344,0.022473898425057513,0,0,0,0,0.0,0.0,0.0,-2000,0,-0.35391966023712623,0.0
8940,35041,Roosevelt,New Mexico,2004,2082,4997,65,7144,0.2914333706606943,0.699468085106383,0.009098544232922732,320,-62,1235,1493,-0.02036985000821384,-0.013375354192134781,0.033745204200348655,-2915,-915,-0.40803471444568873,-0.054115054208562496
8941,35041,Roosevelt,New Mexico,2008,2303,4311,106,6720,0.34270833333333334,0.6415178571428571,0.015773809523809523,221,41,-686,-424,0.051274962672639035,0.006675265290886792,-0.05795022796352589,-2008,907,-0.2988095238095238,0.10922519063616493
8942,35041,Roosevelt,New Mexico,2012,1727,4043,199,5969,0.28932819567766793,0.6773328865806668,0.033338917741665273,-576,93,-268,-751,-0.053380137655665405,0.01756510821785575,0.035815029437809676,-2316,-308,-0.3880046909029989,-0.08919516709347508
8943,35041,Roosevelt,New Mexico,2016,1454,3884,612,5950,0.24436974789915966,0.6527731092436975,0.10285714285714286,-273,413,-159,-19,-0.04495844777850827,0.06951822511547759,-0.024559777336969346,-2430,-114,-0.4084033613445378,-0.020398670441538924
8944,35043,Sandoval,New Mexico,2000,14899,15423,1433,31755,0.46918595496772164,0.48568729333963157,0.04512675169264683,0,0,0,0,0.0,0.0,0.0,-524,0,-0.016501338371909924,0.0
8945,35043,Sandoval,New Mexico,2004,21421,22628,492,44541,0.4809276846051952,0.5080263128353651,0.011046002559439617,6522,-941,7205,12786,0.011741729637473552,-0.03408074913320721,0.02233901949573358,-1207,-683,-0.027098628230169952,-0.010597289858260028
8946,35043,Sandoval,New Mexico,2008,32669,25193,768,58630,0.5572062084257207,0.4296946955483541,0.013099096025925294,11248,276,2565,14089,0.07627852382052547,0.002053093466485677,-0.07833161728701105,7476,8683,0.12751151287736656,0.15461014110753651
8947,35043,Sandoval,New Mexico,2012,27236,24387,2455,54078,0.5036428862014127,0.45095972484189506,0.04539738895669219,-5433,1687,-806,-4552,-0.05356332222430793,0.03229829293076689,0.02126502929354096,2849,-4627,0.05268316135951767,-0.07482835151784889
8948,35043,Sandoval,New Mexico,2016,27707,25905,8078,61690,0.44913276057707896,0.4199221916031772,0.1309450478197439,471,5623,1518,7612,-0.05451012562433377,0.08554765886305171,-0.031037533238717885,1802,-1047,0.029210568973901785,-0.023472592385615887
8949,35045,San Juan,New Mexico,2000,11980,21434,1243,34657,0.34567331275067087,0.6184609169864674,0.03586577026286176,0,0,0,0,0.0,0.0,0.0,-9454,0,-0.27278760423579657,0.0
8950,35045,San Juan,New Mexico,2004,14843,29525,638,45006,0.3298004710483047,0.6560236412922721,0.014175887659423188,2863,-605,8091,10349,-0.01587284170236619,-0.02168988260343857,0.03756272430580465,-14682,-5228,-0.3262231702439674,-0.05343556600817084
8951,35045,San Juan,New Mexico,2008,18028,27869,614,46511,0.3876072326976414,0.5991915890864526,0.013201178215905916,3185,-24,-1656,1505,0.057806761649336735,-0.0009747094435172722,-0.05683205220581944,-9841,4841,-0.21158435638881123,0.11463881385515617
8952,35045,San Juan,New Mexico,2012,15855,28849,1533,46237,0.34290719553604254,0.6239375392002077,0.03315526526374981,-2173,919,980,-274,-0.04470003716159887,0.019954087047843894,0.024745950113755022,-12994,-3153,-0.2810303436641651,-0.0694459872753539
8953,35045,San Juan,New Mexico,2016,12865,27946,5299,46110,0.27900672305356755,0.606072435480373,0.11492084146605942,-2990,3766,-903,-127,-0.06390047248247499,0.08176557620230962,-0.01786510371983463,-15081,-2087,-0.3270657124268055,-0.04603536876264036
8954,35047,San Miguel,New Mexico,2000,6540,2215,406,9161,0.7138958628970636,0.24178583124113087,0.044318305861805476,0,0,0,0,0.0,0.0,0.0,4325,0,0.4721100316559328,0.0
8955,35047,San Miguel,New Mexico,2004,8683,3313,120,12116,0.7166556619346319,0.27344007923407065,0.009904258831297457,2143,-286,1098,2955,0.002759799037568289,-0.034414047030508016,0.03165424799293978,5370,1045,0.4432155827005613,-0.02889444895537152
8956,35047,San Miguel,New Mexico,2008,10320,2478,143,12941,0.7974654199829998,0.19148442933312726,0.011050150683872962,1637,23,-835,825,0.08080975804836787,0.0011458918525755046,-0.0819556499009434,7842,2472,0.6059809906498725,0.16276540794931127
8957,35047,San Miguel,New Mexico,2012,8850,2303,356,11509,0.7689634199322269,0.2001042662264315,0.03093231384134156,-1470,213,-175,-1432,-0.028502000050772858,0.019882163157468595,0.008619836893304228,6547,-1295,0.5688591537057954,-0.03712183694407711
8958,35047,San Miguel,New Mexico,2016,7285,2313,1153,10751,0.677611384987443,0.2151427774160543,0.10724583759650265,-1565,797,10,-758,-0.09135203494478394,0.0763135237551611,0.015038511189622822,4972,-1575,0.4624686075713887,-0.10639054613440674
8959,35049,Santa Fe,New Mexico,2000,32017,13974,3480,49471,0.6471872410098846,0.28246851690889613,0.0703442420812193,0,0,0,0,0.0,0.0,0.0,18043,0,0.36471872410098843,0.0
8960,35049,Santa Fe,New Mexico,2004,47074,18466,660,66200,0.7110876132930514,0.27894259818731115,0.009969788519637462,15057,-2820,4492,16729,0.0639003722831668,-0.06037445356158183,-0.003525918721584975,28608,10565,0.4321450151057402,0.06742629100475178
8961,35049,Santa Fe,New Mexico,2008,55567,15807,849,72223,0.7693809451282833,0.21886379685141852,0.011755258020298243,8493,189,-2659,6023,0.05829333183523189,0.0017854695006607815,-0.060078801335892634,39760,11152,0.5505171482768647,0.1183721331711245
8962,35049,Santa Fe,New Mexico,2012,50872,15500,2873,69245,0.7346667629431728,0.22384287674200304,0.04149036031482418,-4695,2024,-307,-2978,-0.034714182185110465,0.029735102294525934,0.00497907989058452,35372,-4388,0.5108238862011698,-0.0396932620756949
8963,35049,Santa Fe,New Mexico,2016,50793,14332,6309,71434,0.711047960355013,0.20063275191085478,0.08831928773413221,-79,3436,-1168,2189,-0.023618802588159737,0.04682892741930803,-0.02321012483114826,36461,1089,0.5104152084441582,-0.0004086777570115885
8964,35051,Sierra,New Mexico,2000,1689,2721,176,4586,0.36829481029219363,0.5933275185346707,0.03837767117313563,0,0,0,0,0.0,0.0,0.0,-1032,0,-0.22503270824247706,0.0
8965,35051,Sierra,New Mexico,2004,1926,3162,69,5157,0.37347294938917974,0.6131471785922048,0.013379872018615475,237,-107,441,571,0.005178139096986112,-0.024997799154520158,0.019819660057534105,-1236,-204,-0.23967422920302506,-0.014641520960547993
8966,35051,Sierra,New Mexico,2008,2352,3017,116,5485,0.42880583409298084,0.5500455788514129,0.0211485870556062,426,47,-145,328,0.0553328847038011,0.007768715036990725,-0.06310159974079188,-665,571,-0.12123974475843208,0.11843448444459298
8967,35051,Sierra,New Mexico,2012,1964,2928,210,5102,0.3849470795766366,0.5738925911407291,0.04116032928263426,-388,94,-89,-383,-0.043858754516344245,0.02001174222702806,0.023847012289316183,-964,-299,-0.1889455115640925,-0.06770576680566043
8968,35051,Sierra,New Mexico,2016,1612,3010,559,5181,0.3111368461686933,0.5809689249179695,0.10789422891333719,-352,349,82,79,-0.0738102334079433,0.06673389963070293,0.007076333777240373,-1398,-434,-0.26983207874927617,-0.08088656718518367
8969,35053,Socorro,New Mexico,2000,3294,3173,359,6826,0.4825666569000879,0.46484031643715207,0.052593026662760035,0,0,0,0,0.0,0.0,0.0,121,0,0.017726340462935808,0.0
8970,35053,Socorro,New Mexico,2004,4025,3696,130,7851,0.5126735447713667,0.4707680550248376,0.016558400203795696,731,-229,523,1025,0.030106887871278853,-0.03603462645896434,0.005927738587685527,329,208,0.041905489746529134,0.024179149283593326
8971,35053,Socorro,New Mexico,2008,4696,3032,167,7895,0.5948068397720075,0.38404053198226723,0.02115262824572514,671,37,-664,44,0.08213329500064082,0.004594228041929445,-0.08672752304257036,1664,1335,0.21076630778974031,0.16886081804321118
8972,35053,Socorro,New Mexico,2012,4058,2722,413,7193,0.5641595996107327,0.37842346725983594,0.05741693312943139,-638,246,-310,-702,-0.030647240161274847,0.03626430488370625,-0.005617064722431286,1336,-328,0.18573613235089675,-0.02503017543884356
8973,35053,Socorro,New Mexico,2016,3313,2616,939,6868,0.48238206173558534,0.3808969132207338,0.13672102504368083,-745,526,-106,-325,-0.08177753787514735,0.07930409191424945,0.00247344596089788,697,-639,0.10148514851485152,-0.08425098383604523
8974,35055,Taos,New Mexico,2000,7039,2744,1112,10895,0.6460761817347407,0.2518586507572281,0.10206516750803121,0,0,0,0,0.0,0.0,0.0,4295,0,0.3942175309775126,0.0
8975,35055,Taos,New Mexico,2004,10987,3666,182,14835,0.740613414223121,0.24711830131445905,0.012268284462419952,3948,-930,922,3940,0.09453723248838031,-0.08979688304561126,-0.004740349442769021,7321,3026,0.49349511290866194,0.09927758193114933
8976,35055,Taos,New Mexico,2008,13816,2866,204,16886,0.8181925855738481,0.1697264005685183,0.012081013857633542,2829,22,-800,2051,0.07757917135072712,-0.00018727060478640999,-0.07739190074594077,10950,3629,0.6484661850053298,0.15497107209666788
8977,35055,Taos,New Mexico,2012,11978,2730,631,15339,0.7808853249885912,0.1779777038920399,0.041136971119368926,-1838,427,-136,-1547,-0.03730726058525691,0.029055957261735384,0.008251303323521614,9248,-1702,0.6029076210965513,-0.04555856390877855
8978,35055,Taos,New Mexico,2016,10668,2727,1865,15260,0.6990825688073394,0.1787024901703801,0.12221494102228048,-1310,1234,-3,-79,-0.08180275618125177,0.08107796990291155,0.0007247862783401893,7941,-1307,0.5203800786369593,-0.08252754245959193
8979,35057,Torrance,New Mexico,2000,1868,2891,201,4960,0.37661290322580643,0.5828629032258065,0.0405241935483871,0,0,0,0,0.0,0.0,0.0,-1023,0,-0.20625000000000004,0.0
8980,35057,Torrance,New Mexico,2004,2386,4026,95,6507,0.36668203473182726,0.6187183033656063,0.014599661902566468,518,-106,1135,1547,-0.009930868493979172,-0.025924531645820634,0.03585540013979982,-1640,-617,-0.25203626863377904,-0.04578626863377899
8981,35057,Torrance,New Mexico,2008,3087,3735,119,6941,0.44474859530327043,0.5381069010229074,0.017144503673822215,701,24,-291,434,0.07806656057144318,0.0025448417712557476,-0.08061140234269892,-648,992,-0.09335830571963694,0.1586779629141421
8982,35057,Torrance,New Mexico,2012,2428,3529,445,6402,0.37925648234926584,0.5512339893783192,0.06950952827241487,-659,326,-206,-539,-0.06549211295400459,0.05236502459859266,0.013127088355411876,-1101,-453,-0.1719775070290534,-0.07861920130941646
8983,35057,Torrance,New Mexico,2016,1785,3714,825,6324,0.28225806451612906,0.5872865275142315,0.13045540796963948,-643,380,185,-78,-0.09699841783313679,0.060945879697224606,0.03605253813591225,-1929,-828,-0.30502846299810243,-0.13305095596904903
8984,35059,Union,New Mexico,2000,452,1269,34,1755,0.25754985754985754,0.7230769230769231,0.019373219373219373,0,0,0,0,0.0,0.0,0.0,-817,0,-0.4655270655270655,0.0
8985,35059,Union,New Mexico,2004,411,1454,16,1881,0.21850079744816586,0.7729930887825625,0.008506113769271665,-41,-18,185,126,-0.03904906010169168,-0.010867105603947708,0.04991616570563939,-1043,-226,-0.5544922913343966,-0.08896522580733107
8986,35059,Union,New Mexico,2008,492,1227,23,1742,0.28243398392652125,0.7043628013777268,0.01320321469575201,81,7,-227,-139,0.06393318647835539,0.004697100926480345,-0.06863028740483568,-735,308,-0.42192881745120553,0.13256347388319106
8987,35059,Union,New Mexico,2012,472,1236,51,1759,0.26833428084138716,0.7026719727117681,0.028993746446844798,-20,28,9,17,-0.014099703085134085,0.01579053175109279,-0.0016908286659587102,-764,-29,-0.4343376918703809,-0.012408874419175375
8988,35059,Union,New Mexico,2016,320,1216,166,1702,0.18801410105757932,0.7144535840188014,0.09753231492361927,-152,115,-20,-57,-0.08032017978380784,0.06853856847677448,0.011781611307033368,-896,-132,-0.5264394829612221,-0.09210179109084121
8989,35061,Valencia,New Mexico,2000,9819,10803,755,21377,0.45932544323338165,0.5053562239790429,0.03531833278757543,0,0,0,0,0.0,0.0,0.0,-984,0,-0.04603078074566125,0.0
8990,35061,Valencia,New Mexico,2004,11270,14474,268,26012,0.4332615715823466,0.5564354913117023,0.0103029371059511,1451,-487,3671,4635,-0.02606387165103502,-0.02501539568162433,0.05107926733265944,-3204,-2220,-0.12317391972935571,-0.07714313898369446
8991,35061,Valencia,New Mexico,2008,15366,13136,397,28899,0.5317139001349528,0.45454860029758815,0.013737499567459082,4096,129,-1338,2887,0.09845232855260616,0.0034345624615079815,-0.10188689101411419,2230,5434,0.07716529983736464,0.20033921956672035
8992,35061,Valencia,New Mexico,2012,13511,12825,1392,27728,0.4872691863819965,0.46252885170225044,0.05020196191575303,-1855,995,-311,-1171,-0.04444471375295628,0.03646446234829395,0.007980251404662297,686,-1544,0.024740334679746068,-0.052424965157618575
8993,35061,Valencia,New Mexico,2016,10841,13215,3536,27592,0.39290374021455493,0.4789431719338939,0.12815308785155116,-2670,2144,390,-136,-0.09436544616744158,0.07795112593579813,0.016414320231643464,-2374,-3060,-0.08603943171933898,-0.11077976639908504
8994,36001,Albany,New York,2000,85644,47624,8765,142033,0.6029866298677068,0.3353023593108644,0.061711010821428824,0,0,0,0,0.0,0.0,0.0,38020,0,0.2676842705568424,0.0
8995,36001,Albany,New York,2004,89323,54872,3004,147199,0.6068179811004151,0.37277427156434484,0.020407747335240048,3679,-5761,7248,5166,0.00383135123270828,-0.041303263486188777,0.037471912253480455,34451,-3569,0.23404370953607023,-0.033640561020772175
8996,36001,Albany,New York,2008,93937,50586,2743,147266,0.6378729645675173,0.3435008759659392,0.018626159466543533,4614,-261,-4286,67,0.031054983467102226,-0.0017815878686965152,-0.029273395598405638,43351,8900,0.2943720886015781,0.060328379065507864
8997,36001,Albany,New York,2012,87556,45064,3147,135767,0.6448989813430362,0.3319216009781464,0.023179417678817385,-6381,404,-5522,-11499,0.007026016775518951,0.004553258212273852,-0.01157927498779282,42492,-859,0.31297738036488987,0.01860529176331177
8998,36001,Albany,New York,2016,83077,47810,8943,139830,0.594128584710005,0.34191518272187654,0.06395623256811843,-4479,5796,2746,4063,-0.05077039663303129,0.040776814889301044,0.009993581743730162,35267,-7225,0.2522134019881284,-0.06076397837676145
8999,36003,Allegany,New York,2000,6336,11436,918,18690,0.33900481540930977,0.6118780096308186,0.04911717495987159,0,0,0,0,0.0,0.0,0.0,-5100,0,-0.27287319422150885,0.0
9000,36003,Allegany,New York,2004,6566,12310,394,19270,0.3407368967306694,0.6388168137000519,0.020446289569278672,230,-524,874,580,0.0017320813213596575,-0.02867088539059292,0.026938804069233324,-5744,-644,-0.2980799169693825,-0.025206722747873667
9001,36003,Allegany,New York,2008,7016,11013,377,18406,0.381180049983701,0.5983374986417472,0.020482451374551777,450,-17,-1297,-864,0.04044315325303155,3.6161805273104974e-05,-0.04047931505830471,-3997,1747,-0.21715744865804626,0.08092246831133626
9002,36003,Allegany,New York,2012,6139,10390,424,16953,0.3621187990326196,0.6128708783106235,0.025010322656756918,-877,47,-623,-1453,-0.019061250951081354,0.0045278712822051405,0.014533379668876245,-4251,-254,-0.25075207927800386,-0.0335946306199576
9003,36003,Allegany,New York,2016,4882,12525,1285,18692,0.2611812540124117,0.6700727583993152,0.06874598758827306,-1257,861,2135,1739,-0.10093754502020791,0.04373566493151615,0.05720188008869176,-7643,-3392,-0.4088915043869035,-0.15813942510889967
9004,36005,Bronx,New York,2000,265801,36245,6017,308063,0.8628137751044429,0.11765450573421671,0.019531719161340375,0,0,0,0,0.0,0.0,0.0,229556,0,0.7451592693702263,0.0
9005,36005,Bronx,New York,2004,283994,56701,2284,342979,0.8280215406774176,0.1653191594820674,0.0066592998405150166,18193,-3733,20456,34916,-0.03479223442702528,-0.012872419320825359,0.0476646537478507,227293,-2263,0.6627023811953502,-0.08245688817487606
9006,36005,Bronx,New York,2008,338261,41683,1378,381322,0.8870744410235969,0.10931181521129124,0.0036137437651119,54267,-906,-15018,38343,0.05905290034617927,-0.0030455560754031165,-0.056007344270776166,296578,69285,0.7777626258123056,0.11506024461695541
9007,36005,Bronx,New York,2012,339211,29967,1760,370938,0.9144681860580475,0.08078708571243712,0.004744728229515445,950,382,-11716,-10384,0.02739374503445058,0.001130984464403545,-0.028524729498854123,309244,12666,0.8336811003456104,0.055918474533304785
9008,36005,Bronx,New York,2016,353646,37797,8079,399522,0.8851727814738612,0.09460555363659573,0.020221664889543006,14435,6319,7830,28584,-0.029295404584186224,0.01547693666002756,0.013818467924158612,315849,6605,0.7905672278372655,-0.043113872508344864
9009,36007,Broome,New York,2000,45381,36946,4757,87084,0.5211175416838915,0.4242570391805613,0.05462541913554729,0,0,0,0,0.0,0.0,0.0,8435,0,0.09686050250333017,0.0
9010,36007,Broome,New York,2004,46281,43568,2041,91890,0.503656545870062,0.47413211448471,0.02221133964522799,900,-2716,6622,4806,-0.017460995813829427,-0.0324140794903193,0.0498750753041487,2713,-5722,0.029524431385352046,-0.06733607111797812
9011,36007,Broome,New York,2008,47204,40077,1556,88837,0.5313551785854993,0.4511295969021917,0.01751522451230906,923,-485,-3491,-3053,0.027698632715437266,-0.00469611513291893,-0.02300251758251831,7127,4414,0.08022558168330762,0.05070115029795558
9012,36007,Broome,New York,2012,41970,37641,1954,81565,0.5145589407221235,0.4614847054496414,0.02395635382823515,-5234,398,-2436,-7272,-0.016796237863375807,0.006441129315926091,0.010355108547449698,4329,-2798,0.05307423527248212,-0.027151346410825505
9013,36007,Broome,New York,2016,39212,40943,5917,86072,0.45557207918951576,0.47568314899154196,0.06874477181894229,-2758,3963,3302,4507,-0.05898686153260774,0.04478841799070714,0.014198443541900585,-1731,-6060,-0.020111069802026205,-0.07318530507450832
9014,36009,Cattaraugus,New York,2000,13816,18382,1535,33733,0.40956926451842407,0.5449263332641627,0.04550440221741322,0,0,0,0,0.0,0.0,0.0,-4566,0,-0.13535706874573866,0.0
9015,36009,Cattaraugus,New York,2004,13514,20051,701,34266,0.39438510476857525,0.5851572987801319,0.020457596451292828,-302,-834,1669,533,-0.015184159749848825,-0.02504680576612039,0.040230965515969164,-6537,-1971,-0.19077219401155665,-0.05541512526581799
9016,36009,Cattaraugus,New York,2008,14307,17770,540,32617,0.43863629395713893,0.5448079222491339,0.016555783793727196,793,-161,-2281,-1649,0.04425118918856369,-0.0039018126575656314,-0.040349376530998016,-3463,3074,-0.10617162829199495,0.0846005657195617
9017,36009,Cattaraugus,New York,2012,12649,16569,549,29767,0.42493365135888733,0.5566231061242315,0.01844324251688111,-1658,9,-1201,-2850,-0.013702642598251602,0.0018874587231539133,0.011815183875097612,-3920,-457,-0.13168945476534416,-0.025517826473349214
9018,36009,Cattaraugus,New York,2016,9497,19692,1972,31161,0.30477199062931226,0.6319437758736882,0.06328423349699945,-3152,1423,3123,1394,-0.12016166072957507,0.044840990980118345,0.07532066974945673,-10195,-6275,-0.32717178524437596,-0.1954823304790318
9019,36011,Cayuga,New York,2000,17031,14988,1959,33978,0.5012360939431397,0.4411089528518453,0.05765495320501501,0,0,0,0,0.0,0.0,0.0,2043,0,0.06012714109129441,0.0
9020,36011,Cayuga,New York,2004,17534,17743,775,36052,0.48635304560079884,0.49215022744924,0.021496726949961166,503,-1184,2755,2074,-0.014883048342340888,-0.03615822625505384,0.05104127459739466,-209,-2252,-0.005797181848441135,-0.06592432293973555
9021,36011,Cayuga,New York,2008,18128,15243,651,34022,0.5328316971371465,0.44803362530127566,0.0191346775615778,594,-124,-2500,-2030,0.04647865153634767,-0.002362049388383365,-0.04411660214796431,2885,3094,0.08479807183587085,0.09059525368431198
9022,36011,Cayuga,New York,2012,17007,13454,700,31161,0.5457783768171753,0.4317576457751677,0.02246397740765701,-1121,49,-1789,-2861,0.012946679680028828,0.0033292998460792075,-0.016275979526107986,3553,668,0.11402073104200766,0.029222659206136814
9023,36011,Cayuga,New York,2016,13522,17384,2266,33172,0.40763294344628,0.5240564331363801,0.06831062341733993,-3485,1566,3930,2011,-0.13814543337089535,0.04584664600968292,0.09229878736121239,-3862,-7415,-0.11642348969010008,-0.23044422073210774
9024,36013,Chautauqua,New York,2000,27016,29064,2642,58722,0.4600660740437996,0.494942270358639,0.04499165559756139,0,0,0,0,0.0,0.0,0.0,-2048,0,-0.0348761963148394,0.0
9025,36013,Chautauqua,New York,2004,27257,32434,1253,60944,0.4472466526647414,0.532193489104752,0.020559858230506694,241,-1389,3370,2222,-0.012819421379058227,-0.024431797367054694,0.037251218746112924,-5177,-3129,-0.08494683644001055,-0.05007064012517115
9026,36013,Chautauqua,New York,2008,29129,28579,1094,58802,0.49537430699636065,0.4860208836434135,0.018604809360225842,1872,-159,-3855,-2142,0.04812765433161925,-0.0019550488702808518,-0.046172605461338445,550,5727,0.009353423352947143,0.0943002597929577
9027,36013,Chautauqua,New York,2012,23812,27971,1069,52852,0.45054113373193067,0.5292325739801711,0.02022629228789828,-5317,-25,-608,-5950,-0.04483317326442998,0.0016214829276724393,0.04321169033675759,-4159,-4709,-0.07869144024824043,-0.08804486360118757
9028,36013,Chautauqua,New York,2016,19091,31594,3549,54234,0.35201165320647565,0.582549692075082,0.0654386547184423,-4721,2480,3623,1382,-0.09852948052545502,0.04521236243054402,0.05331711809491091,-12503,-8344,-0.23053803886860635,-0.15184659862036592
9029,36015,Chemung,New York,2000,17424,18779,1507,37710,0.4620525059665871,0.4979846194643331,0.03996287456907982,0,0,0,0,0.0,0.0,0.0,-1355,0,-0.035932113497746,0.0
9030,36015,Chemung,New York,2004,17080,21321,674,39075,0.43710812539987204,0.5456429942418426,0.017248880358285347,-344,-833,2542,1365,-0.024944380566715052,-0.022713994210794473,0.047658374777509505,-4241,-2886,-0.10853486884197056,-0.07260275534422456
9031,36015,Chemung,New York,2008,18888,19364,443,38695,0.4881250807597881,0.5004264116810957,0.011448507559116165,1808,-231,-1957,-380,0.05101695535991607,-0.005800372799169182,-0.0452165825607469,-476,3765,-0.012301330921307585,0.09623353792066297
9032,36015,Chemung,New York,2012,16797,17612,601,35010,0.479777206512425,0.5030562696372465,0.017166523850328477,-2091,158,-1752,-3685,-0.008347874247363107,0.005718016291212312,0.002629857956150783,-815,-339,-0.023279063124821475,-0.01097773220351389
9033,36015,Chemung,New York,2016,13757,20097,2265,36119,0.38087986932085605,0.5564107533431158,0.06270937733602813,-3040,1664,2485,1109,-0.09889733719156896,0.045542853485699655,0.05335448370586937,-6340,-5525,-0.1755308840222598,-0.15225182089743833
9034,36017,Chenango,New York,2000,9112,10033,1105,20250,0.4499753086419753,0.4954567901234568,0.0545679012345679,0,0,0,0,0.0,0.0,0.0,-921,0,-0.045481481481481456,0.0
9035,36017,Chenango,New York,2004,9277,11582,482,21341,0.4347031535541915,0.5427112131577714,0.022585633288037112,165,-623,1549,1091,-0.015272155087783845,-0.03198226794653079,0.0472544230343146,-2305,-1384,-0.1080080596035799,-0.06252657812209844
9036,36017,Chenango,New York,2008,10100,10337,410,20847,0.4844821796901233,0.49585072192641627,0.01966709838346045,823,-72,-1245,-494,0.049779026135931825,-0.002918534904576664,-0.046860491231355106,-237,2068,-0.011368542236292967,0.09663951736728693
9037,36017,Chenango,New York,2012,9116,9713,485,19314,0.47198923060992026,0.5028994511753132,0.02511131821476649,-984,75,-624,-1533,-0.012492949080203042,0.0054442198313060415,0.007048729248896934,-597,-360,-0.030910220565392943,-0.019541678329099976
9038,36017,Chenango,New York,2016,6775,11921,1464,20160,0.33606150793650796,0.5913194444444444,0.07261904761904762,-2341,979,2208,846,-0.1359277226734123,0.047507729404281135,0.08841999326913119,-5146,-4549,-0.25525793650793643,-0.2243477159425435
9039,36019,Clinton,New York,2000,15542,13274,1743,30559,0.5085899407703132,0.4343728525148074,0.05703720671487941,0,0,0,0,0.0,0.0,0.0,2268,0,0.07421708825550577,0.0
9040,36019,Clinton,New York,2004,17624,15330,782,33736,0.5224092957078492,0.4544107185202751,0.02317998577187574,2082,-961,2056,3177,0.013819354937536055,-0.03385722094300367,0.020037866005467697,2294,26,0.06799857718757413,-0.006218511067931642
9041,36019,Clinton,New York,2008,20216,12579,542,33337,0.6064132945376008,0.3773284938656748,0.01625821159672436,2592,-240,-2751,-399,0.08400399882975162,-0.006921774175151382,-0.0770822246546003,7637,5343,0.22908480067192605,0.16108622348435192
9042,36019,Clinton,New York,2012,18961,11115,580,30656,0.618508611691023,0.36257176409185804,0.018919624217119,-1255,38,-1464,-2681,0.012095317153422158,0.0026614126203946403,-0.014756729773816757,7846,209,0.25593684759916496,0.026852046927238915
9043,36019,Clinton,New York,2016,15059,14449,2597,32105,0.46905466438249493,0.4500545086435135,0.0808908269739916,-3902,2017,3334,1449,-0.14945394730852807,0.061971202756872595,0.08748274455165544,610,-7236,0.01900015573898145,-0.2369366918601835
9044,36021,Columbia,New York,2000,13489,13153,2056,28698,0.47003275489581153,0.45832462192487283,0.07164262317931563,0,0,0,0,0.0,0.0,0.0,336,0,0.0117081329709387,0.0
9045,36021,Columbia,New York,2004,15929,14457,717,31103,0.5121370928849307,0.4648104684435585,0.023052438671510786,2440,-1339,1304,2405,0.04210433798911917,-0.04859018450780485,0.006485846518685667,1472,1136,0.0473266244413722,0.0356184914704335
9046,36021,Columbia,New York,2008,17556,13337,540,31433,0.5585212992714663,0.4242993032799924,0.017179397448541342,1627,-177,-1120,330,0.04638420638653562,-0.005873041222969444,-0.04051116516356612,4219,2747,0.13422199599147394,0.08689537155010174
9047,36021,Columbia,New York,2012,16221,12225,683,29129,0.5568677263208487,0.4196848501493357,0.023447423529815648,-1335,143,-1112,-2304,-0.0016535729506176322,0.006268026081274306,-0.0046144531306566705,3996,-223,0.13718287617151298,0.0029608801800390383
9048,36021,Columbia,New York,2016,15284,13756,1862,30902,0.49459581904083877,0.44514918128276487,0.06025499967639635,-937,1179,1531,1773,-0.06227190728000992,0.0368075761465807,0.025464331133429163,1528,-2468,0.0494466377580739,-0.08773623841343908
9049,36023,Cortland,New York,2000,9691,9857,1178,20726,0.46757695647978387,0.47558622020650393,0.056836823313712245,0,0,0,0,0.0,0.0,0.0,-166,0,-0.008009263726720062,0.0
9050,36023,Cortland,New York,2004,10670,11613,477,22760,0.468804920913884,0.510237258347979,0.02095782073813708,979,-701,1756,2034,0.001227964434100115,-0.035879002575575164,0.03465103814147502,-943,-777,-0.04143233743409497,-0.033423073707374906
9051,36023,Cortland,New York,2008,11861,9678,381,21920,0.5411040145985402,0.44151459854014596,0.01738138686131387,1191,-96,-1935,-840,0.0722990936846562,-0.0035764338768232116,-0.06872265980783299,2183,3126,0.09958941605839422,0.1410217534924892
9052,36023,Cortland,New York,2012,10482,8695,447,19624,0.5341418671015083,0.44307990216061965,0.022778230737871993,-1379,66,-983,-2296,-0.006962147497031834,0.005396843876558123,0.0015653036204736903,1787,-396,0.0910619649408887,-0.008527451117505525
9053,36023,Cortland,New York,2016,8771,9900,1573,20244,0.43326417704011067,0.4890337877889745,0.07770203517091484,-1711,1126,1205,620,-0.10087769006139768,0.054923804433042844,0.04595388562835484,-1129,-2916,-0.05576961074886383,-0.14683157568975252
9054,36025,Delaware,New York,2000,8450,10662,1064,20176,0.41881443298969073,0.5284496431403648,0.05273592386994449,0,0,0,0,0.0,0.0,0.0,-2212,0,-0.10963521015067407,0.0
9055,36025,Delaware,New York,2004,8724,11958,485,21167,0.4121509897481929,0.5649359852600746,0.022913024991732412,274,-579,1296,991,-0.006663443241497813,-0.029822898878212076,0.0364863421197098,-3234,-1022,-0.15278499551188168,-0.043149785361207615
9056,36025,Delaware,New York,2008,9462,10524,403,20389,0.46407376526558436,0.5161606748737064,0.019765559860709207,738,-82,-1434,-778,0.05192277551739144,-0.0031474651310232048,-0.048775310386368176,-1062,2172,-0.05208690960812207,0.10069808590375962
9057,36025,Delaware,New York,2012,8304,9938,396,18638,0.4455413670994742,0.533211717995493,0.021246914905032728,-1158,-7,-586,-1751,-0.018532398166110187,0.0014813550443235207,0.017051043121786624,-1634,-572,-0.08767035089601888,-0.03558344128789681
9058,36025,Delaware,New York,2016,6627,11942,1223,19792,0.3348322554567502,0.6033751010509296,0.06179264349232013,-1677,827,2004,1154,-0.11070911164272396,0.0405457285872874,0.07016338305543657,-5315,-3681,-0.2685428455941794,-0.18087249469816052
9059,36027,Dutchess,New York,2000,52390,52669,6712,111771,0.4687262348909825,0.4712224101063782,0.06005135500263933,0,0,0,0,0.0,0.0,0.0,-279,0,-0.002496175215395746,0.0
9060,36027,Dutchess,New York,2004,58232,63372,2277,123881,0.47006401304477685,0.5115554443377112,0.01838054261751197,5842,-4435,10703,12110,0.0013377781537943778,-0.04167081238512736,0.04033303423133294,-5140,-4861,-0.04149143129293431,-0.038995256077538565
9061,36027,Dutchess,New York,2008,71060,59628,1614,132302,0.537104503333283,0.45069613460113983,0.01219936206557724,12828,-663,-3744,8421,0.06704049028850612,-0.0061811805519347285,-0.06085930973657133,11432,16572,0.08640836873214314,0.12789980002507745
9062,36027,Dutchess,New York,2012,65312,56025,2368,123705,0.5279657249100683,0.45289196071298654,0.019142314376945153,-5748,754,-3603,-8597,-0.009138778423214644,0.006942952311367913,0.0021958261118467104,9287,-2145,0.07507376419708178,-0.011334604535061354
9063,36027,Dutchess,New York,2016,62261,61797,6876,130934,0.4755143812913376,0.4719706111476011,0.0525150075610613,-3051,4508,5772,7229,-0.05245134361873072,0.03337269318411615,0.01907865043461454,464,-8823,0.0035437701437365243,-0.07152999405334526
9064,36029,Erie,New York,2000,240176,160176,24302,424654,0.5655804490243822,0.37719178437033446,0.05722776660528336,0,0,0,0,0.0,0.0,0.0,80000,0,0.18838866465404774,0.0
9065,36029,Erie,New York,2004,251090,184423,9625,445138,0.5640722652301084,0.4143052266937444,0.021622508076147174,10914,-14677,24247,20484,-0.0015081837942737542,-0.03560525852913618,0.03711344232340996,66667,-13333,0.14976703853636403,-0.038621626117683716
9066,36029,Erie,New York,2008,256299,178815,6871,441985,0.5798816701924273,0.4045725533671957,0.015545776440376935,5209,-2754,-5608,-3153,0.015809404962318863,-0.006076731635770239,-0.009732673326548702,77484,10817,0.1753091168252316,0.025542078288867565
9067,36029,Erie,New York,2012,237356,169675,7164,414195,0.5730537548739121,0.40965004406137207,0.017296201064715893,-18943,293,-9140,-27790,-0.006827915318515232,0.0017504246243389577,0.005077490694176345,67681,-9803,0.16340371081254002,-0.011905406012691577
9068,36029,Erie,New York,2016,215456,188303,19866,423625,0.5086007671879611,0.4445039834759516,0.04689524933608734,-21900,12702,18628,9430,-0.06445298768595098,0.029599048271371445,0.03485393941457954,27153,-40528,0.0640967837120095,-0.09930692710053052
9069,36031,Essex,New York,2000,7927,8822,1189,17938,0.4419110268703311,0.49180510647786824,0.06628386665180065,0,0,0,0,0.0,0.0,0.0,-895,0,-0.04989407960753711,0.0
9070,36031,Essex,New York,2004,8768,9869,445,19082,0.4594906194319254,0.5171889739021067,0.02332040666596793,841,-744,1047,1144,0.01757959256159425,-0.04296345998583272,0.025383867424238482,-1101,-206,-0.057698354470181346,-0.007804274862644234
9071,36031,Essex,New York,2008,10390,7913,292,18595,0.5587523527830062,0.4255445012100027,0.015703146006991128,1622,-153,-1956,-487,0.0992617333510808,-0.007617260658976801,-0.09164447269210402,2477,3578,0.13320785157300347,0.1909062060431848
9072,36031,Essex,New York,2012,9784,6647,286,16717,0.5852724771191004,0.3976191900460609,0.017108332834838785,-606,-6,-1266,-1878,0.026520124336094186,0.0014051868278476577,-0.027925311163941813,3137,660,0.18765328707303947,0.054445435500036
9073,36031,Essex,New York,2016,7762,7958,1498,17218,0.4508072946916018,0.4621907306307353,0.08700197467766291,-2022,1212,1311,501,-0.13446518242749855,0.06989364184282412,0.0645715405846744,-196,-3333,-0.01138343593913349,-0.19903672301217296
9074,36033,Franklin,New York,2000,8870,7643,938,17451,0.5082803277749126,0.4379691708211564,0.053750501403931006,0,0,0,0,0.0,0.0,0.0,1227,0,0.07031115695375623,0.0
9075,36033,Franklin,New York,2004,9543,8383,390,18316,0.5210198733347893,0.4576872679624372,0.02129285870277353,673,-548,740,865,0.012739545559876664,-0.032457642701157474,0.01971809714128081,1160,-67,0.06333260537235208,-0.0069785515814041466
9076,36033,Franklin,New York,2008,10571,6676,273,17520,0.6033675799086758,0.3810502283105023,0.015582191780821918,1028,-117,-1707,-796,0.08234770657388657,-0.005710666921951614,-0.07663703965193491,3895,2735,0.22231735159817356,0.15898474622582148
9077,36033,Franklin,New York,2012,9894,5740,300,15934,0.620936362495293,0.3602359733902347,0.018827664114472197,-677,27,-936,-1586,0.017568782586617204,0.0032454723336502785,-0.02081425492026756,4154,259,0.2607003891050583,0.038383037506884765
9078,36033,Franklin,New York,2016,7297,8221,1434,16952,0.43045068428504013,0.48495752713544127,0.08459178857951864,-2597,1134,2481,1018,-0.19048567821025292,0.06576412446504645,0.12472155374520655,-924,-5078,-0.05450684285040114,-0.31520723195545947
9079,36035,Fulton,New York,2000,9314,11434,927,21675,0.4297116493656286,0.527520184544406,0.0427681660899654,0,0,0,0,0.0,0.0,0.0,-2120,0,-0.09780853517877736,0.0
9080,36035,Fulton,New York,2004,9202,12570,443,22215,0.4142246230024758,0.5658338960162053,0.01994148098131893,-112,-484,1136,540,-0.0154870263631528,-0.02282668510864647,0.038313711471799294,-3368,-1248,-0.15160927301372945,-0.053800737834952095
9081,36035,Fulton,New York,2008,9695,11709,420,21824,0.4442357038123167,0.5365194281524927,0.019244868035190616,493,-23,-861,-391,0.030011080809840884,-0.0006966129461283138,-0.029314467863712612,-2014,1354,-0.09228372434017595,0.059325548673553496
9082,36035,Fulton,New York,2012,8607,10814,378,19799,0.43471892519824235,0.546189201474822,0.019091873326935703,-1088,-42,-895,-2025,-0.00951677861407435,-0.0001529947082549131,0.009669773322329323,-2207,-193,-0.11147027627657963,-0.019186551936403673
9083,36035,Fulton,New York,2016,6496,13462,1256,21214,0.3062128782879231,0.6345809371169983,0.059206184595078724,-2111,878,2648,1415,-0.12850604691031925,0.04011431126814302,0.08839173564217628,-6966,-4759,-0.32836805882907516,-0.21689778255249553
9084,36037,Genesee,New York,2000,10191,14459,1424,26074,0.39084912173045944,0.5545370867530873,0.054613791516453174,0,0,0,0,0.0,0.0,0.0,-4268,0,-0.1636879650226279,0.0
9085,36037,Genesee,New York,2004,10331,16725,524,27580,0.37458303118201597,0.6064176939811458,0.01899927483683829,140,-900,2266,1506,-0.016266090548443468,-0.035614516679614884,0.05188060722805843,-6394,-2126,-0.2318346627991298,-0.0681466977765019
9086,36037,Genesee,New York,2008,10762,15705,423,26890,0.40022313127556713,0.5840461137969506,0.015730754927482337,431,-101,-1020,-690,0.025640100093551166,-0.0032685199093559526,-0.02237158018419516,-4943,1451,-0.18382298252138346,0.04801168027774633
9087,36037,Genesee,New York,2012,9601,14607,538,24746,0.38798189606401035,0.5902772165198416,0.021740887416148064,-1161,115,-1098,-2144,-0.012241235211556789,0.006010132488665727,0.006231102722890958,-5006,-63,-0.2022953204558312,-0.018472337934447747
9088,36037,Genesee,New York,2016,7650,16915,1867,26432,0.2894219128329298,0.6399440072639225,0.0706340799031477,-1951,1329,2308,1686,-0.09855998323108056,0.04889319248699964,0.04966679074408098,-9265,-4259,-0.35052209443099275,-0.14822677397516154
9089,36039,Greene,New York,2000,8480,11332,1283,21095,0.40199099312633324,0.5371889073240105,0.060820099549656316,0,0,0,0,0.0,0.0,0.0,-2852,0,-0.13519791419767724,0.0
9090,36039,Greene,New York,2004,8933,12996,469,22398,0.39883025270113404,0.5802303777122957,0.02093936958657023,453,-814,1664,1303,-0.0031607404251992044,-0.03988072996308609,0.04304147038828521,-4063,-1211,-0.18140012501116165,-0.04620221081348441
9091,36039,Greene,New York,2008,9850,12059,426,22335,0.44101186478620996,0.5399149317215133,0.019073203492276695,917,-43,-937,-63,0.042181612085075926,-0.0018661660942935338,-0.040315445990782406,-2209,1854,-0.09890306693530332,0.08249705807585833
9092,36039,Greene,New York,2012,9030,11174,464,20668,0.4369072963034643,0.5406425391910199,0.022450164505515773,-820,38,-885,-1667,-0.004104568482745652,0.0033769610132390777,0.0007276074695066193,-2144,65,-0.10373524288755559,-0.004832175952252271
9093,36039,Greene,New York,2016,7405,13073,1572,22050,0.33582766439909295,0.5928798185941043,0.07129251700680272,-1625,1108,1899,1382,-0.10107963190437136,0.04884235250128695,0.052237279403084425,-5668,-3524,-0.2570521541950114,-0.15331691130745578
9094,36041,Hamilton,New York,2000,1114,2388,180,3682,0.3025529603476372,0.6485605649103748,0.04888647474198805,0,0,0,0,0.0,0.0,0.0,-1274,0,-0.34600760456273766,0.0
9095,36041,Hamilton,New York,2004,1145,2475,75,3695,0.30987821380243574,0.6698240866035182,0.02029769959404601,31,-105,87,13,0.007325253454798564,-0.028588775147942037,0.021263521693143383,-1330,-56,-0.3599458728010825,-0.01393826823834482
9096,36041,Hamilton,New York,2008,1225,2141,45,3411,0.35913221929053063,0.6276751685722662,0.013192612137203167,80,-30,-334,-284,0.04925400548809489,-0.007105087456842843,-0.04214891803125198,-916,414,-0.2685429492817356,0.09140292351934687
9097,36041,Hamilton,New York,2012,1128,1932,53,3113,0.36235142948923865,0.6206231930613556,0.01702537744940572,-97,8,-209,-298,0.0032192101987080224,0.003832765312202552,-0.007051975510910635,-804,112,-0.25827176357211695,0.010271185709618658
9098,36041,Hamilton,New York,2016,949,2064,212,3225,0.29426356589147284,0.64,0.06573643410852713,-179,159,132,112,-0.06808786359776581,0.04871105665912141,0.01937680693864441,-1115,-311,-0.34573643410852717,-0.08746467053641022
9099,36043,Herkimer,New York,2000,12224,14147,1334,27705,0.4412199963905432,0.5106298502075438,0.04815015340191301,0,0,0,0,0.0,0.0,0.0,-1923,0,-0.0694098538170006,0.0
9100,36043,Herkimer,New York,2004,11675,16024,611,28310,0.41239844577887674,0.5660190745319675,0.021582479689155776,-549,-723,1877,605,-0.02882155061166647,-0.026567673712757235,0.055389224324423725,-4349,-2426,-0.1536206287530908,-0.0842107749360902
9101,36043,Herkimer,New York,2008,12094,14619,471,27184,0.44489405532666276,0.5377795762213067,0.017326368452030606,419,-140,-1405,-1126,0.03249560954778602,-0.00425611123712517,-0.02823949831066086,-2525,1824,-0.09288552089464391,0.06073510785844688
9102,36043,Herkimer,New York,2012,11273,13282,485,25040,0.4501996805111821,0.5304313099041533,0.019369009584664535,-821,14,-1337,-2144,0.005305625184519325,0.0020426411326339294,-0.007348266317153351,-2009,516,-0.08023162939297124,0.012653891501672676
9103,36043,Herkimer,New York,2016,8083,16699,1473,26255,0.30786516853932583,0.6360312321462579,0.0561035993144163,-3190,988,3417,1215,-0.14233451197185626,0.03673458972975177,0.10559992224210457,-8616,-6607,-0.32816606360693207,-0.24793443421396083
9104,36045,Jefferson,New York,2000,16799,18192,1432,36423,0.46121955906981854,0.49946462400131786,0.03931581692886363,0,0,0,0,0.0,0.0,0.0,-1393,0,-0.03824506493149932,0.0
9105,36045,Jefferson,New York,2004,16860,21231,709,38800,0.4345360824742268,0.5471907216494846,0.01827319587628866,61,-723,3039,2377,-0.026683476595591726,-0.02104262105257497,0.04772609764816671,-4371,-2978,-0.11265463917525775,-0.07440957424375844
9106,36045,Jefferson,New York,2008,18166,20220,500,38886,0.467160417631024,0.5199814843388366,0.012858098030139382,1306,-209,-1011,86,0.03262433515679719,-0.005415097846149276,-0.02720923731064795,-2054,2317,-0.052821066707812614,0.05983357246744514
9107,36045,Jefferson,New York,2012,17099,18122,487,35708,0.4788562787050521,0.5075053209364848,0.01363840035846309,-1067,-13,-2098,-3178,0.011695861074028091,0.0007803023283237068,-0.012476163402351803,-1023,1031,-0.02864904223143272,0.024172024476379894
9108,36045,Jefferson,New York,2016,13809,21763,2664,38236,0.3611517941207239,0.569175645988074,0.06967255989120201,-3290,2177,3641,2528,-0.1177044845843282,0.05603415953273892,0.0616703250515892,-7954,-6931,-0.20802385186735012,-0.1793748096359174
9109,36047,Kings,New York,2000,497513,96609,23115,617237,0.8060323668218204,0.1565184847959536,0.037449148382225954,0,0,0,0,0.0,0.0,0.0,400904,0,0.6495138820258668,0.0
9110,36047,Kings,New York,2004,514973,167149,5762,687884,0.7486334905303801,0.2429900971675457,0.008376412302074187,17460,-17353,70540,70647,-0.05739887629144036,-0.02907273608015177,0.0864716123715921,347824,-53080,0.5056433933628344,-0.14387048866303243
9111,36047,Kings,New York,2008,603525,151872,4451,759848,0.7942706962445121,0.19987155325802003,0.005857750497467915,88552,-1311,-15277,71964,0.04563720571413199,-0.0025186618046062715,-0.04311854390952566,451653,103829,0.5943991429864921,0.08875574962365773
9112,36047,Kings,New York,2012,604443,124551,7988,736982,0.8201597868061906,0.169001413874423,0.010838799319386362,918,3537,-27321,-22866,0.02588909056167854,0.0049810488219184474,-0.030870139383597034,479892,28239,0.6511583729317676,0.05675922994527549
9113,36047,Kings,New York,2016,640553,141044,24008,805605,0.7951204374352195,0.17507835725945098,0.029801205305329533,36110,16020,16493,68623,-0.025039349370971076,0.01896240598594317,0.006076943385027983,499509,19617,0.6200420801757686,-0.03111629275599903
9114,36049,Lewis,New York,2000,4333,6103,496,10932,0.3963593121112331,0.5582693011342846,0.045371386754482254,0,0,0,0,0.0,0.0,0.0,-1770,0,-0.16190998902305154,0.0
9115,36049,Lewis,New York,2004,4546,6624,227,11397,0.398876897429148,0.5812055804158989,0.019917522154953057,213,-269,521,465,0.0025175853179149055,-0.025453864599529197,0.022936279281614236,-2078,-308,-0.18232868298675087,-0.02041869396369933
9116,36049,Lewis,New York,2008,4986,5969,183,11138,0.4476566708565272,0.5359130903214222,0.01643023882205064,440,-44,-655,-259,0.048779773427379214,-0.003487283332902418,-0.04529249009447667,-983,1095,-0.08825641946489499,0.09407226352185588
9117,36049,Lewis,New York,2012,4724,5651,147,10522,0.4489640752708611,0.5370651967306596,0.013970727998479376,-262,-36,-318,-616,0.001307404414333857,-0.002459510823571263,0.0011521064092373523,-927,56,-0.08810112145979848,0.0001552980050965047
9118,36049,Lewis,New York,2016,3146,7400,779,11325,0.2777924944812362,0.6534216335540839,0.06878587196467992,-1578,632,1749,803,-0.17117158078962486,0.05481514396620054,0.11635643682342434,-4254,-3327,-0.3756291390728477,-0.2875280176130492
9119,36051,Livingston,New York,2000,10476,15244,1503,27223,0.3848216581567057,0.5599676743929766,0.055210667450317746,0,0,0,0,0.0,0.0,0.0,-4768,0,-0.17514601623627085,0.0
9120,36051,Livingston,New York,2004,11504,17729,715,29948,0.3841324963269667,0.5919927874983304,0.02387471617470282,1028,-788,2485,2725,-0.0006891618297389934,-0.03133595127561493,0.03202511310535383,-6225,-1457,-0.20786029117136368,-0.032714274935092824
9121,36051,Livingston,New York,2008,13655,16030,464,30149,0.45291717801585457,0.5316925934525192,0.015390228531626256,2151,-251,-1699,201,0.06878468168888785,-0.008484487643076563,-0.06030019404581122,-2375,3850,-0.07877541543666461,0.12908487573469907
9122,36051,Livingston,New York,2012,11705,14448,617,26770,0.4372431826671647,0.5397086290623833,0.023048188270452,-1950,153,-1582,-3379,-0.01567399534868985,0.0076579597388257425,0.00801603560986408,-2743,-368,-0.10246544639521854,-0.02369003095855393
9123,36051,Livingston,New York,2016,10697,17290,2044,30031,0.35619859478538846,0.5757384036495621,0.06806300156504945,-1008,1427,2842,3261,-0.08104458788177626,0.04501481329459745,0.03602977458717882,-6593,-3850,-0.21953980886417362,-0.11707436246895508
9124,36053,Madison,New York,2000,12017,14879,1470,28366,0.42364097863639566,0.5245364168370584,0.051822604526545864,0,0,0,0,0.0,0.0,0.0,-2862,0,-0.10089543820066277,0.0
9125,36053,Madison,New York,2004,13121,16537,629,30287,0.4332221745303265,0.5460098392049394,0.020767986264734046,1104,-841,1658,1921,0.00958119589393086,-0.031054618261811818,0.021473422367880968,-3416,-554,-0.11278766467461288,-0.011892226473950107
9126,36053,Madison,New York,2008,14692,14434,676,29802,0.49298704784913766,0.48432991074424536,0.022683041406617005,1571,47,-2103,-485,0.05976487331881114,0.001915055141882959,-0.06167992846069403,258,3674,0.008657137104892298,0.12144480177950517
9127,36053,Madison,New York,2012,13871,13622,601,28094,0.4937353171495693,0.48487221470776676,0.021392468142663913,-821,-75,-812,-1708,0.0007482693004316476,-0.0012905732639530917,0.0005423039635213955,249,-9,0.00886310244180255,0.0002059653369102521
9128,36053,Madison,New York,2016,11667,15936,2461,30064,0.38807211282597126,0.5300691857370942,0.08185870143693454,-2204,1860,2314,1970,-0.10566320432359805,0.06046623329427062,0.045196971029327404,-4269,-4518,-0.1419970729111229,-0.15086017535292545
9129,36055,Monroe,New York,2000,161743,141266,14816,317825,0.5089058444112325,0.4444773066939353,0.046616848894832065,0,0,0,0,0.0,0.0,0.0,20477,0,0.06442853771729723,0.0
9130,36055,Monroe,New York,2004,173497,163545,6022,343064,0.505727794230814,0.47671862976004475,0.01755357600914115,11754,-8794,22279,25239,-0.0031780501804185013,-0.029063272885690914,0.03224132306610944,9952,-10525,0.02900916447076929,-0.03541937324652794
9131,36055,Monroe,New York,2008,207371,144262,4791,356424,0.5818098669000965,0.4047482773326151,0.013441855767288399,33874,-1231,-19283,13360,0.07608207266928246,-0.004111720241852752,-0.07197035242742966,63109,53157,0.17706158956748141,0.14805242509671213
9132,36055,Monroe,New York,2012,193501,133362,6950,333813,0.5796688565154743,0.3995111035220318,0.020820039962493972,-13870,2159,-10900,-22611,-0.0021410103846222217,0.007378184195205573,-0.0052371738105833066,60139,-2970,0.1801577529934425,0.003096163425961085
9133,36055,Monroe,New York,2016,188592,136582,22616,347790,0.5422582592944017,0.39271399407688545,0.06502774662871273,-4909,15666,3220,13977,-0.03741059722107254,0.04420770666621876,-0.006797109445146332,52010,-8129,0.1495442652175163,-0.030613487775926207
9134,36057,Montgomery,New York,2000,10249,9765,795,20809,0.4925272718535249,0.4692681051468115,0.03820462299966361,0,0,0,0,0.0,0.0,0.0,484,0,0.023259166706713408,0.0
9135,36057,Montgomery,New York,2004,9449,11338,434,21221,0.44526648131567786,0.5342820790726167,0.020451439611705386,-800,-361,1573,412,-0.04726079053784704,-0.017753183387958223,0.06501397392580521,-1889,-2373,-0.08901559775693885,-0.11227476446365225
9136,36057,Montgomery,New York,2008,9080,10711,384,20175,0.45006195786864933,0.5309045848822801,0.019033457249070632,-369,-50,-627,-1046,0.004795476552971467,-0.0014179823626347537,-0.0033774941903366162,-1631,258,-0.08084262701363076,0.008172970743308083
9137,36057,Montgomery,New York,2012,8493,9334,359,18186,0.4670075882547014,0.5132519520510282,0.019740459694270317,-587,-25,-1377,-1989,0.01694563038605207,0.0007070024451996844,-0.017652632831251847,-841,790,-0.04624436379632685,0.034598263217303915
9138,36057,Montgomery,New York,2016,6595,11301,1158,19054,0.34612154928099087,0.5931038102235751,0.06077464049543403,-1898,799,1967,868,-0.12088603897371053,0.041034180801163715,0.07985185817254681,-4706,-3865,-0.2469822609425842,-0.20073789714625734
9139,36059,Nassau,New York,2000,342226,227060,21153,590439,0.5796127965801717,0.3845613179346215,0.03582588548520677,0,0,0,0,0.0,0.0,0.0,115166,0,0.19505147864555022,0.0
9140,36059,Nassau,New York,2004,323070,288355,6918,618343,0.5224770070980023,0.46633502764646806,0.011187965255529697,-19156,-14235,61295,27904,-0.05713578948216946,-0.024637920229677077,0.08177370971184655,34715,-80451,0.05614197945153421,-0.13890949919401602
9141,36059,Nassau,New York,2008,342185,288776,4657,635618,0.5383500781916183,0.4543231941197386,0.007326727688643179,19115,-2261,421,17275,0.01587307109361602,-0.0038612375668865186,-0.012011833526729465,53409,18694,0.08402688407187969,0.027884904620345485
9142,36059,Nassau,New York,2012,302695,259308,6148,568151,0.5327720975585716,0.45640683550675787,0.010821066934670536,-39490,1491,-29468,-67467,-0.0055779806330467085,0.0034943392460273573,0.002083641387019275,43387,-10022,0.07636526205181371,-0.0076616220200659835
9143,36059,Nassau,New York,2016,332154,292025,22943,647122,0.5132787944158906,0.45126730353781824,0.03545390204629112,29459,16795,32717,78971,-0.01949330314268094,0.024632835111620583,-0.005139531968939626,40129,-3258,0.062011490878072395,-0.014353771173741314
9144,36061,New York,New York,2000,454523,82113,34370,571006,0.7960038948802639,0.14380409312686732,0.06019201199286873,0,0,0,0,0.0,0.0,0.0,372410,0,0.6521998017533965,0.0
9145,36061,New York,New York,2004,526765,107405,7781,641951,0.8205688596170113,0.16731027757570283,0.012120862807285915,72242,-26589,25292,70945,0.024564964736747408,-0.048071149185582814,0.02350618444883551,419360,46950,0.6532585820413085,0.0010587802879119534
9146,36061,New York,New York,2008,572370,89949,5566,667885,0.8569888528713776,0.1346773770933619,0.00833377003526056,45605,-2215,-17456,25934,0.03641999325436629,-0.003787092772025354,-0.03263290048234094,482421,63061,0.7223114757780157,0.0690528937367072
9147,36061,New York,New York,2012,502674,89559,8058,600291,0.8373838688236206,0.1491926415688391,0.013423489607540343,-69696,2492,-390,-67594,-0.019604984047757013,0.005089719572279782,0.014515264475477213,413115,-69306,0.6881912272547814,-0.03412024852323425
9148,36061,New York,New York,2016,579013,64929,24997,668939,0.8655692073567246,0.09706266191685639,0.037368130726419,76339,16939,-24630,68648,0.02818533853310401,0.02394464111887866,-0.05212997965198271,514084,100969,0.7685065454398682,0.08031531818508675
9149,36063,Niagara,New York,2000,47781,40952,4537,93270,0.5122869089739466,0.4390693685000536,0.048643722525999786,0,0,0,0,0.0,0.0,0.0,6829,0,0.07321754047389295,0.0
9150,36063,Niagara,New York,2004,47602,47111,1867,96580,0.4928763719196521,0.4877925036239387,0.019331124456409193,-179,-2670,6159,3310,-0.019410537054294463,-0.029312598069590592,0.0487231351238851,491,-6338,0.00508386829571339,-0.06813367217817956
9151,36063,Niagara,New York,2008,47303,46348,1621,95272,0.49650474431102526,0.48648081283063227,0.01701444285834243,-299,-246,-763,-1308,0.003628372391373147,-0.0023166815980667638,-0.0013116907933064526,955,464,0.010023931480392989,0.0049400631846795995
9152,36063,Niagara,New York,2012,43986,43240,1787,89013,0.4941525395166998,0.48577174120634065,0.020075719276959544,-3317,166,-3108,-6259,-0.002352204794325463,0.003061276418617115,-0.000709071624291624,746,-209,0.00838079831035915,-0.0016431331700338392
9153,36063,Niagara,New York,2016,35559,51961,4882,92402,0.38482933269842645,0.5623363130668168,0.052834354234756825,-8427,3095,8721,3389,-0.10932320681827334,0.03275863495779728,0.0765645718604761,-16402,-17148,-0.1775069803683903,-0.18588777867874945
9154,36065,Oneida,New York,2000,43933,47603,4474,96010,0.4575877512759088,0.4958129361524841,0.04659931257160713,0,0,0,0,0.0,0.0,0.0,-3670,0,-0.038225184876575335,0.0
9155,36065,Oneida,New York,2004,40792,52392,2197,95381,0.4276742747507365,0.5492917876725972,0.023033937576666212,-3141,-2277,4789,-629,-0.02991347652517229,-0.023565374994940914,0.05347885152011311,-11600,-7930,-0.12161751292186074,-0.0833923280452854
9156,36065,Oneida,New York,2008,43506,49256,1603,94365,0.46103958035288506,0.5219731892121019,0.016987230435012983,2714,-594,-3136,-1016,0.033365305602148565,-0.006046707141653229,-0.027318598460495336,-5750,5850,-0.06093360885921684,0.0606839040626439
9157,36065,Oneida,New York,2012,40468,44530,1702,86700,0.4667589388696655,0.5136101499423299,0.019630911188004613,-3038,99,-4726,-7665,0.0057193585167804595,0.00264368075299163,-0.008363039269771999,-4062,1688,-0.04685121107266438,0.014082397786552459
9158,36065,Oneida,New York,2016,33743,51437,5829,91009,0.37076552868397633,0.5651858607390478,0.0640486105769759,-6725,4127,6907,4309,-0.09599341018568919,0.04441769938897129,0.051575710796717855,-17694,-13632,-0.19442033205507142,-0.14756912098240704
9159,36067,Onondaga,New York,2000,109896,83678,10069,203643,0.5396502703260116,0.4109053588878577,0.04944437078613063,0,0,0,0,0.0,0.0,0.0,26218,0,0.12874491143815397,0.0
9160,36067,Onondaga,New York,2004,116381,94006,4238,214625,0.5422527664531159,0.43800116482236456,0.019746068724519512,6485,-5831,10328,10982,0.0026024961271042812,-0.029698302061611115,0.02709580593450689,22375,-3843,0.10425160163075137,-0.024493309807402608
9161,36067,Onondaga,New York,2008,129317,84972,3950,218239,0.5925476198113078,0.3893529570791655,0.01809942310952671,12936,-288,-9034,3614,0.05029485335819184,-0.0016466456149928019,-0.04864820774319906,44345,21970,0.20319466273214226,0.0989430611013909
9162,36067,Onondaga,New York,2012,122254,78831,3632,204717,0.597185382747891,0.3850730520669998,0.0177415651851092,-7063,-318,-6141,-13522,0.004637762936583245,-0.0003578579244175109,-0.004279905012165686,43423,-922,0.2121123306808912,0.00891766794874893
9163,36067,Onondaga,New York,2016,112337,83649,12454,208440,0.538941661869123,0.4013097294185377,0.05974860871233928,-9917,8822,4818,3723,-0.05824372087876806,0.04200704352723008,0.016236677351537887,28688,-14735,0.13763193245058525,-0.07448039823030594
9164,36069,Ontario,New York,2000,19761,23885,2303,45949,0.43006376634964855,0.5198154475614268,0.05012078608892468,0,0,0,0,0.0,0.0,0.0,-4124,0,-0.08975168121177829,0.0
9165,36069,Ontario,New York,2004,21166,27999,945,50110,0.4223907403711834,0.558750748353622,0.018858511275194573,1405,-1358,4114,4161,-0.007673025978465142,-0.031262274813730104,0.038935300792195204,-6833,-2709,-0.13636000798243864,-0.04660832677066035
9166,36069,Ontario,New York,2008,25103,25171,746,51020,0.49202273618188946,0.49335554684437477,0.01462171697373579,3937,-199,-2828,910,0.06963199581070606,-0.004236794301458784,-0.06539520150924727,-68,6765,-0.0013328106624853064,0.13502719731995333
9167,36069,Ontario,New York,2012,23087,23820,946,47853,0.48245669028065113,0.49777443420475204,0.019768875514596787,-2016,200,-1351,-3167,-0.00956604590123833,0.005147158540860997,0.004418887360377266,-733,-665,-0.015317743924100902,-0.013984933261615595
9168,36069,Ontario,New York,2016,22233,26029,3996,52258,0.42544682153928587,0.49808641739063875,0.0764667610700754,-854,3050,2209,4405,-0.057009868741365266,0.05669788555547861,0.0003119831858867106,-3796,-3063,-0.07263959585135288,-0.05732185192725198
9169,36071,Orange,New York,2000,58170,62852,5535,126557,0.45963478906737676,0.49662997700640815,0.04373523392621507,0,0,0,0,0.0,0.0,0.0,-4682,0,-0.03699518793903139,0.0
9170,36071,Orange,New York,2004,63394,79089,2190,144673,0.4381881899179529,0.5466742239395049,0.015137586142542146,5224,-3345,16237,18116,-0.021446599149423873,-0.028597647783672922,0.05004424693309678,-15695,-11013,-0.10848603402155205,-0.07149084608252065
9171,36071,Orange,New York,2008,78326,72042,1614,151982,0.5153636614862286,0.4740166598676159,0.010619678646155466,14932,-576,-7047,7309,0.0771754715682757,-0.00451790749638668,-0.07265756407188906,6284,21979,0.04134700161861271,0.14983303564016476
9172,36071,Orange,New York,2012,73315,65367,1946,140628,0.5213399891913417,0.4648220837955457,0.01383792701311261,-5011,332,-6675,-11354,0.005976327705113138,0.0032182483669571434,-0.009194576072070193,7948,1664,0.05651790539579604,0.015170903777183331
9173,36071,Orange,New York,2016,68278,76645,7098,152021,0.44913531683122726,0.5041737654666132,0.04669091770215957,-5037,5152,11278,11393,-0.07220467236011446,0.032852990689046964,0.03935168167106751,-8367,-16315,-0.05503844863538593,-0.11155635403118197
9174,36073,Orleans,New York,2000,5991,9202,651,15844,0.3781242110578137,0.5807876798788185,0.041088109063367836,0,0,0,0,0.0,0.0,0.0,-3211,0,-0.20266346882100483,0.0
9175,36073,Orleans,New York,2004,5959,10317,301,16577,0.35947396995837605,0.6223683416782289,0.018157688363395066,-32,-350,1115,733,-0.018650241099437637,-0.02293042069997277,0.041580661799410334,-4358,-1147,-0.2628943717198528,-0.06023090289884797
9176,36073,Orleans,New York,2008,6614,9708,262,16584,0.39881813796430293,0.585383502170767,0.015798359864930053,655,-39,-609,7,0.03934416800592688,-0.002359328498465013,-0.0369848395074619,-3094,1264,-0.18656536420646402,0.07632900751338878
9177,36073,Orleans,New York,2012,5787,8594,325,14706,0.3935128518971848,0.5843873249014008,0.02209982320141439,-827,63,-1114,-1878,-0.005305286067118109,0.006301463336484337,-0.000996177269366183,-2807,287,-0.19087447300421595,-0.004309108797751926
9178,36073,Orleans,New York,2016,4470,10936,974,16380,0.27289377289377287,0.6676434676434676,0.05946275946275946,-1317,649,2342,1674,-0.12061907900341196,0.03736293626134507,0.08325614274206683,-6466,-3659,-0.39474969474969474,-0.20387522174547879
9179,36075,Oswego,New York,2000,22857,23249,2373,48479,0.47148249757627014,0.47956847294704924,0.048949029476680624,0,0,0,0,0.0,0.0,0.0,-392,0,-0.008085975370779097,0.0
9180,36075,Oswego,New York,2004,24133,26325,1149,51607,0.46763036022245047,0.5101052182843413,0.022264421493208286,1276,-1224,3076,3128,-0.0038521373538196735,-0.026684607983472337,0.03053674533729206,-2192,-1800,-0.04247485806189083,-0.03438888269111173
9181,36075,Oswego,New York,2008,24777,23571,1001,49349,0.5020770431011773,0.4776388579302519,0.020284098968570793,644,-148,-2754,-2258,0.03444668287872682,-0.001980322524637493,-0.032466360354089396,1206,3398,0.024438185170925386,0.06691304323281622
9182,36075,Oswego,New York,2012,23515,19980,1096,44591,0.5273485680967012,0.44807248099392255,0.02457895090937633,-1262,95,-3591,-4758,0.025271524995523875,0.0042948519408055365,-0.029566376936329353,3535,2329,0.07927608710277861,0.05483790193185323
9183,36075,Oswego,New York,2016,17095,27688,3397,48180,0.3548152760481528,0.5746782897467829,0.07050643420506435,-6420,2301,7708,3589,-0.1725332920485484,0.04592748329568802,0.12660580875286037,-10593,-14128,-0.21986301369863015,-0.29913910080140876
9184,36077,Otsego,New York,2000,11460,12219,1679,25358,0.4519283855193627,0.48185976812051423,0.06621184636012303,0,0,0,0,0.0,0.0,0.0,-759,0,-0.029931382601151524,0.0
9185,36077,Otsego,New York,2004,12723,13342,587,26652,0.4773750562809545,0.5006003301815999,0.022024613537445593,1263,-1092,1123,1294,0.025446670761591794,-0.04418723282267744,0.018740562061085653,-619,140,-0.023225273900645382,0.0067061087005061415
9186,36077,Otsego,New York,2008,13570,12026,525,26121,0.5195053788139811,0.46039585008230927,0.02009877110370966,847,-62,-1316,-531,0.042130322533026565,-0.0019258424337359331,-0.04020448009929062,1544,2163,0.0591095287316718,0.08233480263231718
9187,36077,Otsego,New York,2012,12117,11461,561,24139,0.5019677699987573,0.4747918306474999,0.023240399353742905,-1453,36,-565,-1982,-0.017537608815223815,0.0031416282500332446,0.014395980565190647,656,-888,0.02717593935125734,-0.03193358938041446
9188,36077,Otsego,New York,2016,10451,13308,1909,25668,0.4071606669783388,0.5184665731650304,0.07437275985663082,-1666,1348,1847,1529,-0.09480710302041845,0.051132360502887914,0.04367474251753051,-2857,-3513,-0.11130590618669162,-0.13848184553794896
9189,36079,Putnam,New York,2000,18525,21853,2176,42554,0.43532922874465385,0.5135357428208864,0.051135028434459745,0,0,0,0,0.0,0.0,0.0,-3328,0,-0.07820651407623258,0.0
9190,36079,Putnam,New York,2004,19575,26356,640,46571,0.42032595391982136,0.5659315883274999,0.013742457752678705,1050,-1536,4503,4017,-0.015003274824832491,-0.03739257068178104,0.05239584550661347,-6781,-3453,-0.14560563440767854,-0.06739912033144596
9191,36079,Putnam,New York,2008,21613,25145,486,47244,0.4574760816188299,0.5322368978071289,0.010287020574041149,2038,-154,-1211,673,0.03715012769900855,-0.0034554371786375566,-0.033694690520370996,-3532,3249,-0.074760816188299,0.07084481821937955
9192,36079,Putnam,New York,2012,19512,24083,750,44345,0.44000451009132935,0.5430826474236103,0.016912842485060323,-2101,264,-1062,-2899,-0.017471571527500562,0.006625821911019174,0.010845749616481437,-4571,-1039,-0.103078137332281,-0.028317321143982
9193,36079,Putnam,New York,2016,19366,27024,2173,48563,0.39878096493215,0.5564730350266663,0.04474600004118362,-146,1423,2941,4218,-0.041223545159179364,0.027833157556123297,0.013390387603055998,-7658,-3087,-0.15769207009451636,-0.05461393276223536
9194,36081,Queens,New York,2000,416967,122052,16972,555991,0.749952787005545,0.21952153901771793,0.030525673976737035,0,0,0,0,0.0,0.0,0.0,294915,0,0.530431247987827,0.0
9195,36081,Queens,New York,2004,433835,165954,5603,605392,0.7166183233343024,0.27412651637286256,0.009255160292835055,16868,-11369,43902,49401,-0.0333344636712426,-0.02127051368390198,0.054604977355144635,267881,-27034,0.44249180696143986,-0.08793944102638718
9196,36081,Queens,New York,2008,480692,155221,4224,640137,0.7509205060791674,0.24248090643096712,0.006598587489865451,46857,-1379,-10733,34745,0.03430218274486496,-0.0026565728029696043,-0.03164560994189544,325471,57590,0.5084395996482003,0.06594779268676043
9197,36081,Queens,New York,2012,470732,118589,5924,595245,0.7908205864811968,0.199227208964376,0.009952204554427168,-9960,1700,-36632,-44892,0.039900080402029414,0.0033536170645617177,-0.04325369746659111,352143,26672,0.5915933775168207,0.08315377786862044
9198,36081,Queens,New York,2016,517220,149341,19832,686393,0.7535333256603725,0.21757360579143437,0.028893068548193235,46488,13908,30752,91148,-0.03728726082082434,0.018940863993766065,0.018346396827058353,367879,15736,0.5359597198689381,-0.05563365764788264
9199,36083,Rensselaer,New York,2000,34808,29562,4066,68436,0.5086211935238764,0.4319656321234438,0.05941317435267988,0,0,0,0,0.0,0.0,0.0,5246,0,0.07665556140043256,0.0
9200,36083,Rensselaer,New York,2004,36075,34734,1705,72514,0.49749013983506635,0.4789971591692639,0.0235127009956698,1267,-2361,5172,4078,-0.011131053688810011,-0.035900473357010076,0.04703152704582009,1341,-3905,0.01849298066580246,-0.0581625807346301
9201,36083,Rensselaer,New York,2008,39753,32840,1393,73986,0.5373043548779499,0.4438677587651718,0.018827886356878328,3678,-312,-1894,1472,0.03981421504288357,-0.0046848146387914735,-0.03512940040409207,6913,5572,0.0934365961127781,0.07494361544697564
9202,36083,Rensselaer,New York,2012,37408,29113,1540,68061,0.5496246014604546,0.427748637251877,0.022626761287668416,-2345,147,-3727,-5925,0.012320246582504635,0.003798874930790088,-0.01611912151329481,8295,1382,0.12187596420857755,0.028439368095799444
9203,36083,Rensselaer,New York,2016,32717,33726,5119,71562,0.4571839803247534,0.47128364215645174,0.07153237751879489,-4691,3579,4613,3501,-0.09244062113570117,0.04890561623112648,0.04353500490457474,-1009,-9304,-0.014099661831698362,-0.1359756260402759
9204,36085,Richmond,New York,2000,73828,63903,4398,142129,0.519443604049842,0.44961267580859643,0.030943720141561538,0,0,0,0,0.0,0.0,0.0,9925,0,0.0698309282412456,0.0
9205,36085,Richmond,New York,2004,68448,90325,1370,160143,0.42741799516681966,0.5640271507340314,0.008554854099148886,-5380,-3028,26422,18014,-0.09202560888302236,-0.02238886604241265,0.114414474925435,-21877,-31802,-0.13660915556721176,-0.20644008380845735
9206,36085,Richmond,New York,2008,79311,86062,1205,166578,0.4761192954651875,0.5166468561274599,0.007233848407352712,10863,-165,-4263,6435,0.04870130029836783,-0.0013210056917961743,-0.04738029460657156,-6751,15126,-0.040527560662272366,0.0960815949049394
9207,36085,Richmond,New York,2012,78181,74223,1776,154180,0.507076144765858,0.4814048514723051,0.011519003761836814,-1130,571,-11839,-12398,0.030956849300670553,0.004285155354484102,-0.03524200465515476,3958,10709,0.025671293293552944,0.06619885395582531
9208,36085,Richmond,New York,2016,74143,101437,5380,180960,0.4097203801945181,0.5605492926613617,0.029730327144120248,-4038,3604,27214,26780,-0.09735576457133993,0.018211323382283436,0.07914444118905656,-27294,-31252,-0.15082891246684355,-0.1765002057603965
9209,36087,Rockland,New York,2000,69530,48441,4619,122590,0.5671751366343095,0.39514642303613673,0.037678440329553795,0,0,0,0,0.0,0.0,0.0,21089,0,0.1720287135981728,0.0
9210,36087,Rockland,New York,2004,64191,65130,1910,131231,0.48914509528998484,0.49630041682224474,0.01455448788777042,-5339,-2709,16689,8641,-0.07803004134432467,-0.023123952441783377,0.10115399378610801,-939,-22028,-0.007155321532259895,-0.17918403513043268
9211,36087,Rockland,New York,2008,69543,61752,898,132193,0.526071728457634,0.4671351735719743,0.006793097970391775,5352,-1012,-3378,962,0.0369266331676491,-0.007761389917378644,-0.029165243250270423,7791,8730,0.05893655488565963,0.06609187641791953
9212,36087,Rockland,New York,2012,65793,57428,1424,124645,0.5278430743311003,0.46073248024389263,0.01142444542500702,-3750,526,-4324,-7548,0.00177134587346639,0.004631347454615244,-0.006402693328081688,8365,574,0.06711059408720771,0.008174039201548078
9213,36087,Rockland,New York,2016,69342,60911,4834,135087,0.5133136423193941,0.45090201129642377,0.03578434638418205,3549,3410,3483,10442,-0.0145294320117062,0.024359900959175028,-0.009830468947468862,8431,66,0.06241163102297037,-0.004698963064237338
9214,36089,St. Lawrence,New York,2000,21386,16449,1951,39786,0.5375257628311466,0.4134368873473081,0.04903734982154527,0,0,0,0,0.0,0.0,0.0,4937,0,0.12408887548383851,0.0
9215,36089,St. Lawrence,New York,2004,22857,18029,875,41761,0.5473288474892842,0.4317185891142453,0.02095256339647039,1471,-1076,1580,1975,0.009803084658137617,-0.02808478642507488,0.01828170176693722,4828,-109,0.11561025837503891,-0.008478617108799602
9216,36089,St. Lawrence,New York,2008,23706,16956,664,41326,0.5736340318443595,0.41029860136475826,0.01606736679088225,849,-211,-1073,-435,0.02630518435507523,-0.00488519660558814,-0.021419987749487057,6750,1922,0.1633354304796012,0.047725172104562286
9217,36089,St. Lawrence,New York,2012,21353,15138,700,37191,0.5741442822188164,0.4070339598289909,0.018821757952192736,-2353,36,-1818,-4135,0.0005102503744569553,0.002754391161310484,-0.0032646415357673875,6215,-535,0.16711032238982554,0.003774891910224343
9218,36089,St. Lawrence,New York,2016,16488,19942,2728,39158,0.42106338423821443,0.5092701363706011,0.06966647939118444,-4865,2028,4804,1967,-0.15308089798060198,0.0508447214389917,0.10223617654161027,-3454,-9669,-0.08820675213238671,-0.25531707452221225
9219,36091,Saratoga,New York,2000,43359,46623,5075,95057,0.4561368442092639,0.49047413657068917,0.05338901922004692,0,0,0,0,0.0,0.0,0.0,-3264,0,-0.03433729236142524,0.0
9220,36091,Saratoga,New York,2004,48730,56158,1985,106873,0.455961748991794,0.5254648040197244,0.018573446988481655,5371,-3090,9535,11816,-0.00017509521746994494,-0.03481557223156527,0.03499066744903523,-7428,-4164,-0.06950305502793042,-0.035165762666505174
9221,36091,Saratoga,New York,2008,56645,52855,1887,111387,0.5085422894951834,0.47451677484805227,0.016940935656764255,7915,-98,-3303,4514,0.05258054050338945,-0.0016325113317173998,-0.05094802917167213,3790,11218,0.03402551464713116,0.10352856967506158
9222,36091,Saratoga,New York,2012,52957,50382,2171,105510,0.501914510472941,0.47750924083025303,0.02057624869680599,-3688,284,-2473,-5877,-0.00662777902224243,0.003635313040041735,0.002992465982200765,2575,-1215,0.024405269642687966,-0.009620245004443195
9223,36091,Saratoga,New York,2016,50913,54575,8606,114094,0.44623731309271303,0.47833365470576894,0.07542903220151805,-2044,6435,4193,8584,-0.05567719738022797,0.05485278350471205,0.0008244138755159058,-3662,-6237,-0.03209634161305591,-0.05650161125574388
9224,36093,Schenectady,New York,2000,35534,27961,3459,66954,0.5307225856558234,0.4176150790094692,0.05166233533470741,0,0,0,0,0.0,0.0,0.0,7573,0,0.11310750664635422,0.0
9225,36093,Schenectady,New York,2004,35971,32066,1432,69469,0.51779930616534,0.46158718277217176,0.020613511062488304,437,-2027,4105,2515,-0.012923279490483441,-0.031048824272219108,0.04397210376270255,3905,-3668,0.05621212339316822,-0.056895383253185994
9226,36093,Schenectady,New York,2008,38611,29758,1473,69842,0.5528335385584605,0.4260760001145443,0.021090461326995217,2640,41,-2308,373,0.035034232393120535,0.0004769502645069132,-0.03551118265762748,8853,4948,0.12675753844391624,0.07054541505074802
9227,36093,Schenectady,New York,2012,36844,26568,1521,64933,0.5674156438174734,0.4091602112947192,0.023424144887807433,-1767,48,-3190,-4909,0.014582105259012934,0.0023336835608122157,-0.016915788819825084,10276,1423,0.15825543252275426,0.03149789407883802
9228,36093,Schenectady,New York,2016,33747,28953,4580,67280,0.501590368608799,0.4303359096313912,0.06807372175980975,-3097,3059,2385,2347,-0.06582527520867443,0.044649576872002314,0.02117569833667199,4794,-5482,0.07125445897740784,-0.08700097354534642
9229,36095,Schoharie,New York,2000,5390,7459,705,13554,0.39766858491958096,0.5503172495204368,0.05201416555998229,0,0,0,0,0.0,0.0,0.0,-2069,0,-0.15264866460085585,0.0
9230,36095,Schoharie,New York,2004,5630,8591,338,14559,0.38670238340545365,0.5900817363829933,0.02321588021155299,240,-367,1132,1005,-0.010966201514127305,-0.0287982853484293,0.039764486862556514,-2961,-892,-0.20337935297753967,-0.05073068837668382
9231,36095,Schoharie,New York,2008,6009,8071,322,14402,0.41723371753923066,0.5604082766282461,0.022358005832523262,379,-16,-520,-157,0.03053133413377701,-0.0008578743790297293,-0.029673459754747222,-2062,899,-0.14317455908901544,0.06020479388852423
9232,36095,Schoharie,New York,2012,5427,7467,313,13207,0.4109184523358825,0.5653819943969107,0.023699553267206783,-582,-9,-604,-1195,-0.006315265203348186,0.0013415474346835203,0.0049737177686646206,-2040,22,-0.15446354206102825,-0.011288982972012807
9233,36095,Schoharie,New York,2016,4240,8831,979,14050,0.30177935943060497,0.6285409252669039,0.0696797153024911,-1187,666,1364,843,-0.10913909290527751,0.04598016203528432,0.06315893086999314,-4591,-2551,-0.3267615658362989,-0.17229802377527065
9234,36097,Schuyler,New York,2000,3301,4381,471,8153,0.4048816386606157,0.5373482153808414,0.057770145958542865,0,0,0,0,0.0,0.0,0.0,-1080,0,-0.13246657672022571,0.0
9235,36097,Schuyler,New York,2004,3445,4960,185,8590,0.4010477299185099,0.5774155995343423,0.021536670547147845,144,-286,579,437,-0.0038339087421058182,-0.036233475411395016,0.04006738415350086,-1515,-435,-0.1763678696158324,-0.04390129289560668
9236,36097,Schuyler,New York,2008,3933,4542,125,8600,0.45732558139534885,0.5281395348837209,0.014534883720930232,488,-60,-418,10,0.05627785147683895,-0.007001786826217613,-0.0492760646506214,-609,906,-0.07081395348837205,0.10555391612746035
9237,36097,Schuyler,New York,2012,3674,4281,191,8146,0.45101890498404124,0.525534004419347,0.023447090596611833,-259,66,-261,-454,-0.00630667641130761,0.0089122068756816,-0.0026055304643739507,-607,2,-0.07451509943530571,-0.0037011459469336594
9238,36097,Schuyler,New York,2016,3091,5050,631,8772,0.35237118103055176,0.5756953944368445,0.07193342453260373,-583,440,769,626,-0.09864772395348947,0.0484863339359919,0.05016139001749753,-1959,-1352,-0.22332421340629272,-0.148809113970987
9239,36099,Seneca,New York,2000,6841,6734,763,14338,0.4771237271585995,0.4696610405914353,0.053215232249965126,0,0,0,0,0.0,0.0,0.0,107,0,0.007462686567164201,0.0
9240,36099,Seneca,New York,2004,6979,7981,365,15325,0.45539967373572593,0.5207830342577487,0.023817292006525284,138,-398,1247,987,-0.02172405342287359,-0.029397940243439842,0.051121993666313426,-1002,-1109,-0.06538336052202282,-0.07284604708918702
9241,36099,Seneca,New York,2008,7422,7038,281,14741,0.5034936571467336,0.4774438640526423,0.01906247880062411,443,-84,-943,-584,0.048093983411007624,-0.004754813205901175,-0.04333917020510647,384,1386,0.026049793094091278,0.0914331536161141
9242,36099,Seneca,New York,2012,7094,5889,283,13266,0.5347504899743706,0.44391677973767524,0.02133273028795417,-328,2,-1149,-1475,0.03125683282763703,0.002270251487330059,-0.03352708431496704,1205,821,0.09083371023669534,0.06478391714260406
9243,36099,Seneca,New York,2016,5697,7236,1047,13980,0.4075107296137339,0.5175965665236052,0.07489270386266095,-1397,764,1347,714,-0.12723976036063667,0.05355997357470678,0.07367978678592996,-1539,-2744,-0.11008583690987128,-0.20091954714656662
9244,36101,Steuben,New York,2000,14600,24200,1763,40563,0.3599339299361487,0.5966028153736164,0.043463254690234945,0,0,0,0,0.0,0.0,0.0,-9600,0,-0.23666888543746767,0.0
9245,36101,Steuben,New York,2004,14523,26980,781,42284,0.34346324851007476,0.6380664080976256,0.01847034339229969,-77,-982,2780,1721,-0.01647068142607394,-0.024992911297935256,0.041463592724009235,-12457,-2857,-0.29460315958755084,-0.057934274150083176
9246,36101,Steuben,New York,2008,17148,24203,560,41911,0.4091527284006585,0.57748562429911,0.013361647300231443,2625,-221,-2777,-373,0.06568947989058377,-0.0051086960920682465,-0.060580783798515614,-7055,5402,-0.16833289589845146,0.12627026368909938
9247,36101,Steuben,New York,2012,15787,21954,790,38531,0.40972204199216217,0.5697749863746074,0.020502971633230387,-1361,230,-2249,-3380,0.0005693135915036396,0.007141324332998944,-0.00771063792450255,-6167,888,-0.16005294438244527,0.00827995151600619
9248,36101,Steuben,New York,2016,12526,26831,2645,42002,0.29822389410028094,0.6388029141469453,0.06297319175277367,-3261,1855,4877,3471,-0.11149814789188123,0.04247022011954329,0.0690279277723379,-14305,-8138,-0.3405790200466644,-0.18052607566421913
9249,36103,Suffolk,New York,2000,306306,240992,26646,573944,0.5336862132891014,0.41988765454469423,0.04642613216620437,0,0,0,0,0.0,0.0,0.0,65314,0,0.11379855874440714,0.0
9250,36103,Suffolk,New York,2004,315909,309949,12854,638712,0.4946032014429038,0.48527192224351506,0.02012487631358108,9603,-13792,68957,64768,-0.03908301184619756,-0.02630125585262329,0.06538426769882083,5960,-59354,0.009331279199388753,-0.10446727954501839
9251,36103,Suffolk,New York,2008,346549,307021,6209,659779,0.5252501216316373,0.46533915144313476,0.009410726925227993,30640,-6645,-2928,21067,0.030646920188733495,-0.010714149388353088,-0.019932770800380306,39528,33568,0.059910970188502555,0.0505796909891138
9252,36103,Suffolk,New York,2012,304079,282131,8056,594266,0.5116883685083784,0.47475541255935894,0.013556218932262656,-42470,1847,-24890,-65513,-0.013561753123258913,0.004145492007034663,0.009416261116224178,21948,-17580,0.036932955949019464,-0.02297801423948309
9253,36103,Suffolk,New York,2016,303951,350570,26733,681254,0.44616398582613825,0.5145951436615418,0.03924087051231993,-128,18677,68439,86988,-0.06552438268224015,0.02568465158005727,0.03983973110218286,-46619,-68567,-0.06843115783540354,-0.10536411378442301
9254,36105,Sullivan,New York,2000,14348,12703,1477,28528,0.5029444756029164,0.44528182837913627,0.05177369601794728,0,0,0,0,0.0,0.0,0.0,1645,0,0.05766264722378017,0.0
9255,36105,Sullivan,New York,2004,15034,15319,613,30966,0.4855002260543822,0.49470386875928435,0.0197959051863334,686,-864,2616,2438,-0.01744424954853424,-0.03197779083161388,0.04942204038014808,-285,-1930,-0.009203642704902149,-0.06686628992868232
9256,36105,Sullivan,New York,2008,16850,13900,433,31183,0.5403585286855017,0.4457557002212744,0.013885771093223871,1816,-180,-1419,217,0.054858302631119515,-0.005910134093109528,-0.04894816853800993,2950,3235,0.0946028284642273,0.10380647116912944
9257,36105,Sullivan,New York,2012,15268,12705,442,28415,0.5373218370578919,0.4471229984163294,0.015555164525778637,-1582,9,-1195,-2768,-0.0030366916276097777,0.0016693934325547662,0.001367298195054989,2563,-387,0.09019883864156253,-0.004403989822664767
9258,36105,Sullivan,New York,2016,12568,15931,1456,29955,0.41956267734935737,0.5318310799532632,0.048606242697379405,-2700,1014,3226,1540,-0.11775915970853457,0.033051078171600766,0.08470808153693377,-3363,-5926,-0.1122684026039058,-0.20246724124546833
9259,36107,Tioga,New York,2000,9170,12239,1048,22457,0.40833593089014564,0.544997105579552,0.046666963530302356,0,0,0,0,0.0,0.0,0.0,-3069,0,-0.13666117468940642,0.0
9260,36107,Tioga,New York,2004,9694,13762,446,23902,0.4055727554179567,0.5757677181825789,0.01865952639946448,524,-602,1523,1445,-0.002763175472188961,-0.028007437130837875,0.030770612603026826,-4068,-999,-0.1701949627646222,-0.03353378807521579
9261,36107,Tioga,New York,2008,10172,12536,423,23131,0.4397561713717522,0.5419566815096624,0.018287147118585447,478,-23,-1226,-771,0.03418341595379554,-0.0003723792808790344,-0.03381103667291652,-2364,1704,-0.10220051013791015,0.06799445262671205
9262,36107,Tioga,New York,2012,8930,12117,542,21589,0.413636574181296,0.5612580480800408,0.02510537773866321,-1242,119,-419,-1542,-0.0261195971904562,0.0068182306200777615,0.019301366570378398,-3187,-823,-0.14762147389874475,-0.0454209637608346
9263,36107,Tioga,New York,2016,7526,13260,1513,22299,0.33750392394277773,0.5946454997981973,0.06785057625902507,-1404,971,1143,710,-0.07613265023851828,0.04274519852036186,0.03338745171815649,-5734,-2547,-0.2571415758554195,-0.10952010195667478
9264,36109,Tompkins,New York,2000,21807,13351,4902,40060,0.5443584623065402,0.33327508736894657,0.12236645032451322,0,0,0,0,0.0,0.0,0.0,8456,0,0.2110833749375936,0.0
9265,36109,Tompkins,New York,2004,27229,13994,1198,42421,0.6418754861978737,0.3298837839749181,0.02824072982720822,5422,-3704,643,2361,0.09751702389133354,-0.094125720497305,-0.0033913033940284887,13235,4779,0.31199170222295564,0.10090832728536203
9266,36109,Tompkins,New York,2008,29826,11927,799,42552,0.7009306260575296,0.2802923481857492,0.01877702575672119,2597,-399,-2067,131,0.059055139859655936,-0.009463704070487033,-0.04959143578916886,17899,4664,0.42063827787178043,0.1086465756488248
9267,36109,Tompkins,New York,2012,27244,11107,1430,39781,0.684849551293331,0.27920363992860914,0.03594680877805988,-2582,631,-820,-2771,-0.016081074764198622,0.01716978302133869,-0.0010887082571400808,16137,-1762,0.4056459113647219,-0.014992366507058541
9268,36109,Tompkins,New York,2016,28890,10371,3417,42678,0.6769295655841417,0.24300576409391256,0.08006467032194574,1646,1987,-736,2897,-0.007919985709189281,0.04411786154388586,-0.03619787583469658,18519,2382,0.4339238014902292,0.0282778901255073
9269,36111,Ulster,New York,2000,38162,33447,6628,78237,0.48777432672520676,0.427508723493999,0.08471694978079425,0,0,0,0,0.0,0.0,0.0,4715,0,0.060265603231207776,0.0
9270,36111,Ulster,New York,2004,47602,37821,2289,87712,0.5427079533017147,0.43119527544691716,0.026096771251368115,9440,-4339,4374,9475,0.054933626576507966,-0.05862017852942614,0.003686551952918171,9781,5066,0.11151267785479757,0.051247074623589794
9271,36111,Ulster,New York,2008,54320,33300,1529,89149,0.6093169861692224,0.37353195212509394,0.017151061705683743,6718,-760,-4521,1437,0.06660903286750763,-0.008945709545684372,-0.05766332332182322,21020,11239,0.23578503404412843,0.12427235618933086
9272,36111,Ulster,New York,2012,47752,29759,2115,79626,0.5997036143973075,0.3737347097681662,0.02656167583452641,-6568,586,-3541,-9523,-0.009613371771914903,0.009410614128842667,0.00020275764307225996,17993,-3027,0.22596890462914127,-0.009816129414987163
9273,36111,Ulster,New York,2016,44597,35239,5454,85290,0.5228866221127917,0.4131668425372259,0.06394653534998242,-3155,3339,5480,5664,-0.07681699228451577,0.037384859515456004,0.03943213276905971,9358,-8635,0.10971977957556578,-0.11624912505357549
9274,36113,Warren,New York,2000,12193,14993,1435,28621,0.4260158624785996,0.5238461269697076,0.05013801055169281,0,0,0,0,0.0,0.0,0.0,-2800,0,-0.09783026449110793,0.0
9275,36113,Warren,New York,2004,13405,16969,685,31059,0.43159792652693263,0.5463472745420007,0.02205479893106668,1212,-750,1976,2438,0.005582064048333002,-0.028083211620626134,0.022501147572293156,-3564,-764,-0.11474934801506809,-0.016919083523960154
9276,36113,Warren,New York,2008,16281,15429,535,32245,0.5049154907737634,0.4784927895797798,0.016591719646456816,2876,-150,-1540,1186,0.07331756424683078,-0.005463079284609863,-0.0678544849622209,852,4416,0.0264227011939836,0.1411720492090517
9277,36113,Warren,New York,2012,14806,14119,653,29578,0.5005747515044966,0.4773480289404287,0.022077219555074717,-1475,118,-1310,-2667,-0.004340739269266813,0.005485499908617901,-0.0011447606393510945,687,-165,0.02322672256406788,-0.003195978629915719
9278,36113,Warren,New York,2016,13091,15751,2566,31408,0.4168046357615894,0.5014964340295466,0.08169893020886398,-1715,1913,1632,1830,-0.08377011574290721,0.05962171065378927,0.024148405089117864,-2660,-3347,-0.0846917982679572,-0.10791852083202508
9279,36115,Washington,New York,2000,9641,12596,1318,23555,0.4092973890893653,0.5347484610486096,0.05595414986202505,0,0,0,0,0.0,0.0,0.0,-2955,0,-0.12545107195924432,0.0
9280,36115,Washington,New York,2004,10624,13827,652,25103,0.4232163486435884,0.5508106600804684,0.025972991275943113,983,-666,1231,1548,0.01391895955422312,-0.029981158586081937,0.016062199031858793,-3203,-248,-0.12759431143688,-0.0021432394776356722
9281,36115,Washington,New York,2008,12741,12533,456,25730,0.4951807228915663,0.4870967741935484,0.01772250291488535,2117,-196,-1294,627,0.07196437424797786,-0.008250488361057764,-0.06371388588692001,208,3411,0.008083948698017873,0.13567826013489787
9282,36115,Washington,New York,2012,11523,11085,485,23093,0.4989823756116572,0.4800155891395661,0.021002035248776686,-1218,29,-1448,-2637,0.00380165272009092,0.0032795323338913364,-0.0070811850539823085,438,230,0.0189667864720911,0.010882837774073228
9283,36115,Washington,New York,2016,9098,13610,1820,24528,0.37092302674494454,0.5548760600130463,0.07420091324200913,-2425,1335,2525,1435,-0.12805934886671266,0.053198877993232446,0.07486047087348024,-4512,-4950,-0.1839530332681018,-0.2029198197401929
9284,36117,Wayne,New York,2000,14977,21701,1651,38329,0.390748519397845,0.5661770461008636,0.04307443450129145,0,0,0,0,0.0,0.0,0.0,-6724,0,-0.17542852670301862,0.0
9285,36117,Wayne,New York,2004,15709,24709,802,41220,0.38110140708393986,0.5994420184376517,0.01945657447840854,732,-849,3008,2891,-0.009647112313905137,-0.02361786002288291,0.033264972336788046,-9000,-2276,-0.2183406113537118,-0.04291208465069318
9286,36117,Wayne,New York,2008,18184,22239,622,41045,0.4430259471311975,0.5418199537093434,0.01515409915945913,2475,-180,-2470,-175,0.061924540047257615,-0.004302475318949409,-0.05762206472830822,-4055,4945,-0.09879400657814597,0.11954660477556583
9287,36117,Wayne,New York,2012,16635,20060,852,37547,0.44304471728766615,0.5342637228007564,0.02269155991157749,-1549,230,-2179,-3498,1.877015646867264e-05,0.00753746075211836,-0.007556230908587036,-3425,630,-0.09121900551309026,0.007575001065055709
9288,36117,Wayne,New York,2016,13473,23380,2834,39687,0.33948144228588706,0.5891097840602716,0.07140877365384131,-3162,1982,3320,2140,-0.10356327500177909,0.048717213742263815,0.05484606125951519,-9907,-6482,-0.24962834177438453,-0.15840933626129428
9289,36119,Westchester,New York,2000,218010,139278,14525,371813,0.5863431348554247,0.3745915285371948,0.03906533660738059,0,0,0,0,0.0,0.0,0.0,78732,0,0.21175160631822987,0.0
9290,36119,Westchester,New York,2004,229849,159628,6293,395770,0.5807640801475604,0.4033352704853829,0.015900649367056624,11839,-8232,20350,23957,-0.005579054707864239,-0.023164687240323965,0.02874374194818813,70221,-8511,0.1774288096621775,-0.03432279665605237
9291,36119,Westchester,New York,2008,261810,147824,3410,413044,0.633854988814751,0.3578892321399173,0.008255779045331733,31961,-2883,-11804,17274,0.05309090866719057,-0.007644870321724891,-0.04544603834546562,113986,43765,0.2759657566748337,0.0985369470126562
9292,36119,Westchester,New York,2012,240785,143122,4540,388447,0.6198657731942839,0.36844666067700355,0.01168756612871254,-21025,1130,-4702,-24597,-0.013989215620467066,0.003431787083380808,0.010557428537086244,97663,-16323,0.2514191125172804,-0.02454664415755331
9293,36119,Westchester,New York,2016,272926,131238,16491,420655,0.6488119718058741,0.3119848807217316,0.03920314747239424,32141,11951,-11884,32208,0.0289461986115902,0.027515581343681702,-0.05646177995527196,141688,44025,0.33682709108414255,0.08540797856686216
9294,36121,Wyoming,New York,2000,5999,10809,825,17633,0.34021437078205635,0.612998355356434,0.046787273861509666,0,0,0,0,0.0,0.0,0.0,-4810,0,-0.27278398457437764,0.0
9295,36121,Wyoming,New York,2004,6134,11745,290,18169,0.337608013649623,0.6464307336672354,0.015961252683141615,135,-535,936,536,-0.0026063571324333457,-0.03082602117836805,0.03343237831080137,-5611,-801,-0.30882272001761235,-0.036038735443234715
9296,36121,Wyoming,New York,2008,6379,10998,290,17667,0.3610686590819041,0.6225165562913907,0.016414784626705158,245,0,-747,-502,0.023460645432281102,0.00045353194356354334,-0.02391417737584467,-4619,992,-0.2614478972094866,0.04737482280812577
9297,36121,Wyoming,New York,2012,5661,10348,326,16335,0.34655647382920113,0.6334863789409244,0.019957147229874503,-718,36,-650,-1332,-0.01451218525270298,0.0035423626031693446,0.010969822649533723,-4687,-68,-0.2869299051117233,-0.025482007902236703
9298,36121,Wyoming,New York,2016,3904,12442,952,17298,0.22569083130997802,0.7192739044976297,0.055035264192392186,-1757,626,2094,963,-0.1208656425192231,0.03507811696251768,0.08578752555670532,-8538,-3851,-0.4935830731876517,-0.20665316807592843
9299,36123,Yates,New York,2000,3962,5565,532,10059,0.3938761308281141,0.5532359081419624,0.05288796102992345,0,0,0,0,0.0,0.0,0.0,-1603,0,-0.15935977731384832,0.0
9300,36123,Yates,New York,2004,4205,6309,197,10711,0.39258706003174304,0.5890206329941182,0.018392306974138736,243,-335,744,652,-0.0012890707963710835,-0.03449565405578471,0.03578472485215578,-2104,-501,-0.19643357296237518,-0.037073795648526864
9301,36123,Yates,New York,2008,4890,5269,121,10280,0.47568093385214005,0.5125486381322957,0.011770428015564202,685,-76,-1040,-431,0.08309387382039701,-0.006621878958574533,-0.07647199486182255,-379,1725,-0.03686770428015562,0.15956586868221956
9302,36123,Yates,New York,2012,4488,4798,156,9442,0.47532302478288496,0.5081550518957848,0.016521923321330227,-402,35,-471,-838,-0.00035790906925509125,0.004751495305766025,-0.004393586236510871,-310,69,-0.03283202711289984,0.00403567716725578
9303,36123,Yates,New York,2016,3659,5660,747,10066,0.3635008940989469,0.5622888933041923,0.07421021259686073,-829,591,862,624,-0.11182213068393804,0.0576882892755305,0.05413384140840749,-2001,-1691,-0.19878799920524537,-0.16595597209234553
9304,37001,Alamance,North Carolina,2000,17459,29305,327,47091,0.37075024951689284,0.622305748444501,0.006944002038606103,0,0,0,0,0.0,0.0,0.0,-11846,0,-0.2515554989276082,0.0
9305,37001,Alamance,North Carolina,2004,20686,33302,187,54175,0.3818366405168436,0.6147115828334102,0.0034517766497461928,3227,-140,3997,7084,0.011086390999950735,-0.0034922253888599103,-0.007594165611090831,-12616,-770,-0.23287494231656664,0.018680556611041566
9306,37001,Alamance,North Carolina,2008,28918,34859,576,64353,0.44936521995866546,0.5416841483691514,0.008950631672183115,8232,389,1557,10178,0.06752857944182189,0.0054988550224369225,-0.07302743446425886,-5941,6675,-0.09231892841048589,0.14055601390608075
9307,37001,Alamance,North Carolina,2012,28875,38170,731,67776,0.42603576487252126,0.5631787063267233,0.01078552880075543,-43,155,3311,3423,-0.023329455086144202,0.0018348971285723145,0.021494557957571936,-9295,-3354,-0.13714294145420203,-0.04482401304371614
9308,37001,Alamance,North Carolina,2016,29833,38815,2509,71157,0.4192560113551724,0.5454839299014854,0.03526005874334219,958,1778,645,3381,-0.006779753517348885,0.02447452994258676,-0.017694776425237868,-8982,313,-0.12622791854631304,0.010915022907888983
9309,37003,Alexander,North Carolina,2000,4166,9242,84,13492,0.30877557070856804,0.684998517640083,0.006225911651348948,0,0,0,0,0.0,0.0,0.0,-5076,0,-0.376222946931515,0.0
9310,37003,Alexander,North Carolina,2004,4618,10928,54,15600,0.29602564102564105,0.7005128205128205,0.0034615384615384616,452,-30,1686,2108,-0.012749929682926986,-0.002764373189810486,0.015514302872737473,-6310,-1234,-0.40448717948717944,-0.02826423255566446
9311,37003,Alexander,North Carolina,2008,5167,11790,297,17254,0.29946679030949347,0.6833198098991539,0.01721339979135273,549,243,862,1654,0.0034411492838524183,0.013751861329814269,-0.017193010613666626,-6623,-313,-0.3838530195896604,0.020634159897519044
9312,37003,Alexander,North Carolina,2012,4611,12253,332,17196,0.2681437543614794,0.7125494301000233,0.019306815538497325,-556,35,463,-58,-0.031323035948014055,0.002093415747144594,0.02922962020086939,-7642,-1019,-0.44440567573854384,-0.060552656148883444
9313,37003,Alexander,North Carolina,2016,3767,13893,611,18271,0.20617371791363362,0.7603853100541842,0.033440972032182145,-844,279,1640,1075,-0.061970036447845794,0.01413415649368482,0.04783587995416094,-10126,-2484,-0.5542115921405506,-0.10980591640200676
9314,37005,Alleghany,North Carolina,2000,1715,2531,67,4313,0.3976350568050081,0.5868305124043589,0.01553443079063297,0,0,0,0,0.0,0.0,0.0,-816,0,-0.1891954555993508,0.0
9315,37005,Alleghany,North Carolina,2004,1922,2883,22,4827,0.39817692148332295,0.5972653822249845,0.0045576962916925624,207,-45,352,514,0.0005418646783148517,-0.010976734498940408,0.01043486982062558,-961,-145,-0.19908846074166153,-0.009893005142310729
9316,37005,Alleghany,North Carolina,2008,2021,3124,118,5263,0.38400152004560134,0.59357780733422,0.022420672620178606,99,96,241,436,-0.014175401437721613,0.017862976328486043,-0.0036875748907644335,-1103,-142,-0.2095762872886187,-0.01048782654695718
9317,37005,Alleghany,North Carolina,2012,1583,3390,94,5067,0.31241365699625023,0.6690349319123742,0.018551411091375567,-438,-24,266,-196,-0.07158786304935111,-0.0038692615288030384,0.07545712457815412,-1807,-704,-0.35662127491612394,-0.14704498762750523
9318,37005,Alleghany,North Carolina,2016,1306,3814,195,5315,0.24571966133584194,0.7175917215428034,0.036688617121354655,-277,101,424,248,-0.06669399566040829,0.018137206029979088,0.0485567896304292,-2508,-701,-0.47187206020696143,-0.11525078529083749
9319,37007,Anson,North Carolina,2000,4792,3161,32,7985,0.6001252348152787,0.3958672510958046,0.004007514088916719,0,0,0,0,0.0,0.0,0.0,1631,0,0.20425798371947407,0.0
9320,37007,Anson,North Carolina,2004,5413,3796,16,9225,0.5867750677506776,0.41149051490514904,0.0017344173441734417,621,-16,635,1240,-0.013350167064601126,-0.002273096744743277,0.015623263809344423,1617,-14,0.17528455284552852,-0.02897343087394555
9321,37007,Anson,North Carolina,2008,6456,4207,70,10733,0.6015093636448337,0.391968694679959,0.006521941675207305,1043,54,411,1508,0.01473429589415609,0.004787524331033863,-0.019521820225190056,2249,632,0.20954066896487467,0.03425611611934615
9322,37007,Anson,North Carolina,2012,7019,4166,71,11256,0.6235785358919688,0.3701137171286425,0.00630774697938877,563,1,-41,523,0.022069172247135116,-0.00021419469581853475,-0.02185497755131649,2853,604,0.25346481876332627,0.043924149798451606
9323,37007,Anson,North Carolina,2016,5859,4506,180,10545,0.5556187766714082,0.42731152204836415,0.017069701280227598,-1160,109,340,-711,-0.06795975922056052,0.010761954300838827,0.05719780491972165,1353,-1500,0.1283072546230441,-0.12515756414028217
9324,37009,Ashe,North Carolina,2000,4011,6226,79,10316,0.3888134936021714,0.6035284994183793,0.007658006979449399,0,0,0,0,0.0,0.0,0.0,-2215,0,-0.2147150058162079,0.0
9325,37009,Ashe,North Carolina,2004,4477,7292,54,11823,0.3786686966083058,0.616763934703544,0.004567368688150216,466,-25,1066,1507,-0.010144796993865557,-0.0030906382912991833,0.013235435285164687,-2815,-600,-0.23809523809523814,-0.023380232279030244
9326,37009,Ashe,North Carolina,2008,4872,7916,281,13069,0.3727905731119443,0.6057081643584054,0.021501262529650317,395,227,624,1246,-0.00587812349636152,0.0169338938415001,-0.011055770345138605,-3044,-229,-0.23291759124646105,0.005177646848777084
9327,37009,Ashe,North Carolina,2012,4116,8242,252,12610,0.32640761300555116,0.6536082474226804,0.019984139571768436,-756,-29,326,-459,-0.046382960106393145,-0.0015171229578818807,0.04790008306427507,-4126,-1082,-0.32720063441712927,-0.09428304317066821
9328,37009,Ashe,North Carolina,2016,3500,9412,512,13424,0.2607270560190703,0.7011323003575686,0.03814064362336114,-616,260,1170,814,-0.06568055698648084,0.018156504051592706,0.04752405293488815,-5912,-1786,-0.44040524433849826,-0.11320460992136899
9329,37011,Avery,North Carolina,2000,1686,4956,52,6694,0.2518673438900508,0.7403645055273379,0.007768150582611294,0,0,0,0,0.0,0.0,0.0,-3270,0,-0.4884971616372871,0.0
9330,37011,Avery,North Carolina,2004,1805,5678,41,7524,0.2398989898989899,0.7546517809675705,0.005449229133439659,119,-11,722,830,-0.011968353991060887,-0.0023189214491716346,0.01428727544023256,-3873,-603,-0.5147527910685805,-0.026255629431293392
9331,37011,Avery,North Carolina,2008,2178,5681,84,7943,0.27420370137227745,0.7152209492635024,0.010575349364220069,373,43,3,419,0.034304711473287564,0.005126120230780409,-0.039430831704068026,-3503,370,-0.441017247891225,0.07373554317735553
9332,37011,Avery,North Carolina,2012,1882,5766,111,7759,0.24255703054517336,0.743137002191004,0.014305967263822657,-296,27,85,-184,-0.031646670827104095,0.003730617899602589,0.027916052927501545,-3884,-381,-0.5005799716458306,-0.059562723754605584
9333,37011,Avery,North Carolina,2016,1689,6298,262,8249,0.20475209116256515,0.763486483210086,0.03176142562734877,-193,151,532,490,-0.037804939382608205,0.017455458363526116,0.020349481019082072,-4609,-725,-0.558734392047521,-0.05815442040169039
9334,37013,Beaufort,North Carolina,2000,6634,10531,148,17313,0.38318026916190145,0.6082712412637902,0.008548489574308323,0,0,0,0,0.0,0.0,0.0,-3897,0,-0.22509097210188872,0.0
9335,37013,Beaufort,North Carolina,2004,7025,12432,65,19522,0.3598504251613564,0.6368199979510296,0.003329576887613974,391,-83,1901,2209,-0.023329844000545052,-0.005218912686694348,0.02854875668723944,-5407,-1510,-0.2769695727896732,-0.05187860068778449
9336,37013,Beaufort,North Carolina,2008,9454,13460,96,23010,0.41086484137331597,0.5849630595393307,0.0041720990873533245,2429,31,1028,3488,0.05101441621195957,0.0008425221997393506,-0.051856938411698916,-4006,1401,-0.17409821816601473,0.10287135462365848
9337,37013,Beaufort,North Carolina,2012,9435,13977,208,23620,0.3994496189669771,0.5917442845046571,0.008806096528365791,-19,112,517,610,-0.011415222406338854,0.004633997441012467,0.0067812249653264045,-4542,-536,-0.19229466553768,-0.01819644737166526
9338,37013,Beaufort,North Carolina,2016,8764,14543,631,23938,0.36611245718105107,0.607527780098588,0.026359762720360932,-671,423,566,318,-0.03333716178592605,0.01755366619199514,0.015783495593930885,-5779,-1237,-0.24141532291753692,-0.049120657379856936
9339,37015,Bertie,North Carolina,2000,4660,2488,28,7176,0.649386845039019,0.346711259754738,0.0039018952062430325,0,0,0,0,0.0,0.0,0.0,2172,0,0.302675585284281,0.0
9340,37015,Bertie,North Carolina,2004,4938,3057,37,8032,0.6147908366533864,0.3806025896414343,0.004606573705179283,278,9,569,856,-0.03459600838563259,0.0007046784989362506,0.0338913298866963,1881,-291,0.23418824701195212,-0.06848733827232889
9341,37015,Bertie,North Carolina,2008,6365,3376,22,9763,0.6519512444945201,0.3457953497900236,0.002253405715456315,1427,-15,319,1731,0.037160407841133725,-0.0023531679897229683,-0.03480723985141071,2989,1108,0.30615589470449656,0.07196764769254443
9342,37015,Bertie,North Carolina,2012,6695,3387,41,10123,0.6613652079423096,0.33458460930554185,0.004050182752148573,330,19,11,360,0.009413963447789442,0.001796777036692258,-0.01121074048448173,3308,319,0.3267805986367677,0.02062470393227117
9343,37015,Bertie,North Carolina,2016,5778,3456,113,9347,0.6181662565529047,0.36974430298491495,0.012089440462180379,-917,72,69,-776,-0.04319895138940488,0.008039257710031805,0.035159693679373105,2322,-986,0.24842195356798974,-0.07835864506877799
9344,37017,Bladen,North Carolina,2000,5889,4977,42,10908,0.5398789878987899,0.45627062706270627,0.0038503850385038503,0,0,0,0,0.0,0.0,0.0,912,0,0.08360836083608358,0.0
9345,37017,Bladen,North Carolina,2004,6109,6174,30,12313,0.49614228863802484,0.5014212620807277,0.002436449281247462,220,-12,1197,1405,-0.04373669926076501,-0.001413935757256388,0.04515063501802141,-65,-977,-0.005278973442702839,-0.08888733427878642
9346,37017,Bladen,North Carolina,2008,7853,7532,95,15480,0.5072997416020671,0.48656330749354004,0.006136950904392765,1744,65,1358,3167,0.011157452964042303,0.003700501623145303,-0.014857954587187638,321,386,0.020736434108527102,0.02601540755122994
9347,37017,Bladen,North Carolina,2012,8062,7748,147,15957,0.5052328131854359,0.4855549288713417,0.00921225794322241,209,52,216,477,-0.002066928416631253,0.0030753070388296446,-0.0010083786221983249,314,-7,0.019677884314094174,-0.001058549794432928
9348,37017,Bladen,North Carolina,2016,7058,8550,289,15897,0.4439831414732339,0.5378373277976977,0.018179530729068378,-1004,142,802,-60,-0.06124967171220197,0.008967272785845968,0.052282398926355944,-1492,-1806,-0.09385418632446374,-0.11353207063855791
9349,37019,Brunswick,North Carolina,2000,13118,15427,294,28839,0.4548701411283332,0.5349353306286626,0.010194528243004266,0,0,0,0,0.0,0.0,0.0,-2309,0,-0.08006518950032943,0.0
9350,37019,Brunswick,North Carolina,2004,14903,22925,149,37977,0.39242172894120125,0.6036548437211997,0.003923427337599073,1785,-145,7498,9138,-0.06244841218713193,-0.006271100905405193,0.0687195130925371,-8022,-5713,-0.21123311477999845,-0.13116792527966903
9351,37019,Brunswick,North Carolina,2008,21331,30753,524,52608,0.4054706508515815,0.5845688868613139,0.009960462287104623,6428,375,7828,14631,0.013048921910380262,0.00603703494950555,-0.01908595685988579,-9422,-1400,-0.1790982360097324,0.03213487877026605
9352,37019,Brunswick,North Carolina,2012,22038,34743,581,57362,0.38419162511767374,0.6056797182803947,0.010128656601931593,707,57,3990,4754,-0.021279025733907775,0.00016819431482697003,0.021110831419080767,-12705,-3283,-0.22148809316272094,-0.04238985715298854
9353,37019,Brunswick,North Carolina,2016,23282,42720,2349,68351,0.340624131322146,0.6250091439774107,0.0343667247004433,1244,1768,7977,10989,-0.04356749379552777,0.024238068098511707,0.01932942569701601,-19438,-6733,-0.2843850126552647,-0.06289691949254378
9354,37021,Buncombe,North Carolina,2000,38545,46101,830,85476,0.45094529458561466,0.539344377369086,0.009710328045299265,0,0,0,0,0.0,0.0,0.0,-7556,0,-0.08839908278347136,0.0
9355,37021,Buncombe,North Carolina,2004,51868,52491,654,105013,0.4939198004056641,0.4998523992267624,0.006227800367573539,13323,-176,6390,19537,0.04297450582004941,-0.0034825276777257263,-0.039491978142323636,-623,6933,-0.005932598821098312,0.08246648396237305
9356,37021,Buncombe,North Carolina,2008,69716,52494,1585,123795,0.5631568318591219,0.42403974312371256,0.012803425017165476,17848,931,3,18782,0.06923703145345783,0.006575624649591937,-0.07581265610304982,17222,17845,0.13911708873540934,0.14504968755650766
9357,37021,Buncombe,North Carolina,2012,70625,54701,2370,127696,0.5530713569728104,0.4283689387294825,0.018559704297707053,909,785,2207,3901,-0.010085474886311507,0.005756279280541577,0.004329195605769942,15924,-1298,0.1247024182433279,-0.01441467049208145
9358,37021,Buncombe,North Carolina,2016,75452,55716,7779,138947,0.5430271974205992,0.4009874268606015,0.05598537571879925,4827,5409,1015,11251,-0.010044159552211163,0.037425671421092196,-0.027381511868880992,19736,3812,0.14203977055999772,0.01733735231666983
9359,37023,Burke,North Carolina,2000,11924,18466,268,30658,0.38893600365320635,0.6023223954595864,0.008741600887207254,0,0,0,0,0.0,0.0,0.0,-6542,0,-0.21338639180638008,0.0
9360,37023,Burke,North Carolina,2004,11728,18922,112,30762,0.38124959365450883,0.615109550744425,0.0036408556010662507,-196,-156,456,104,-0.007686409998697519,-0.0051007452861410035,0.012787155284838536,-7194,-652,-0.23385995708991614,-0.020473565283536055
9361,37023,Burke,North Carolina,2008,14901,22102,440,37443,0.39796490665812034,0.5902838981919184,0.011751195149961275,3173,328,3180,6681,0.01671531300361151,0.008110339548895024,-0.024825652552506572,-7201,-7,-0.19231899153379806,0.04154096555611808
9362,37023,Burke,North Carolina,2012,13701,22267,576,36544,0.3749179071803853,0.6093202714535902,0.01576182136602452,-1200,136,165,-899,-0.02304699947773503,0.0040106262160632435,0.019036373261671846,-8566,-1365,-0.23440236427320493,-0.04208337273940688
9363,37023,Burke,North Carolina,2016,11251,26238,1431,38920,0.28908016443987666,0.6741521068859199,0.03676772867420349,-2450,855,3971,2376,-0.08583774274050865,0.021005907308178973,0.06483183543232962,-14987,-6421,-0.3850719424460432,-0.15066957817283827
9364,37025,Cabarrus,North Carolina,2000,16284,32704,393,49381,0.32976245924545877,0.6622790141957433,0.007958526558797918,0,0,0,0,0.0,0.0,0.0,-16420,0,-0.33251655495028454,0.0
9365,37025,Cabarrus,North Carolina,2004,19803,40780,241,60824,0.32557871892673945,0.6704590293305275,0.003962251742733132,3519,-152,8076,11443,-0.00418374031871932,-0.003996274816064786,0.008180015134784169,-20977,-4557,-0.344880310403788,-0.012363755453503489
9366,37025,Cabarrus,North Carolina,2008,31546,45924,524,77994,0.40446701028284227,0.5888145241941688,0.006718465522988948,11743,283,5144,17170,0.07888829135610281,0.002756213780255816,-0.08164450513635868,-14378,6599,-0.18434751391132653,0.1605327964924615
9367,37025,Cabarrus,North Carolina,2012,32849,49557,1160,83566,0.39309049134815593,0.5930282650838858,0.01388124356795826,1303,636,3633,5572,-0.01137651893468633,0.007162778044969312,0.004213740889717044,-16708,-2330,-0.1999377737357299,-0.015590259824403374
9368,37025,Cabarrus,North Carolina,2016,35521,53819,3949,93289,0.38076300528465307,0.5769061732894554,0.042330821425891584,2672,2789,4262,9723,-0.012327486063502868,0.028449577857933325,-0.01612209179443047,-18298,-1590,-0.1961431680048023,0.0037946057309276027
9369,37027,Caldwell,North Carolina,2000,8588,17337,190,26115,0.32885314953092093,0.6638713383113153,0.0072755121577637374,0,0,0,0,0.0,0.0,0.0,-8749,0,-0.33501818878039435,0.0
9370,37027,Caldwell,North Carolina,2004,9999,21186,163,31348,0.3189677172387393,0.6758325890008932,0.005199693760367488,1411,-27,3849,5233,-0.00988543229218164,-0.0020758183973962497,0.011961250689577874,-11187,-2438,-0.35686487176215387,-0.021846682981759513
9371,37027,Caldwell,North Carolina,2008,12081,22526,548,35155,0.34364955198407054,0.6407623382164699,0.015588109799459536,2082,385,1340,3807,0.024681834745331255,0.010388416039092048,-0.035070250784423274,-10445,742,-0.29711278623239934,0.05975208552975453
9372,37027,Caldwell,North Carolina,2012,10898,23229,605,34732,0.31377404122998964,0.6688068639871012,0.017419094782909133,-1183,57,703,-423,-0.029875510754080903,0.0018309849834495968,0.028044525770631323,-12331,-1886,-0.35503282275711157,-0.057920036524712226
9373,37027,Caldwell,North Carolina,2016,8425,26621,1274,36320,0.231965859030837,0.7329570484581498,0.035077092511013215,-2473,669,3392,1588,-0.08180818219915265,0.017657997728104082,0.06415018447104859,-18196,-5865,-0.5009911894273128,-0.14595836667020123
9374,37029,Camden,North Carolina,2000,1187,1628,16,2831,0.419286471211586,0.5750618156128576,0.00565171317555634,0,0,0,0,0.0,0.0,0.0,-441,0,-0.1557753444012716,0.0
9375,37029,Camden,North Carolina,2004,1339,2480,11,3830,0.3496083550913838,0.6475195822454308,0.0028720626631853785,152,-5,852,999,-0.0696781161202022,-0.002779650512370962,0.0724577666325732,-1141,-700,-0.297911227154047,-0.1421358827527754
9376,37029,Camden,North Carolina,2008,1597,3140,84,4821,0.33125907488073014,0.651317154117403,0.017423771001866834,258,73,660,991,-0.018349280210653685,0.014551708338681456,0.0037975718719721607,-1543,-402,-0.32005807923667284,-0.022146852082625845
9377,37029,Camden,North Carolina,2012,1508,3109,87,4704,0.320578231292517,0.6609268707482994,0.018494897959183673,-89,3,-31,-117,-0.01068084358821314,0.001071126957316839,0.009609716630896381,-1601,-58,-0.34034863945578236,-0.02029056021910952
9378,37029,Camden,North Carolina,2016,1274,3546,186,5006,0.2544946064722333,0.7083499800239712,0.03715541350379545,-234,99,437,302,-0.06608362482028368,0.018660515544611775,0.04742310927567184,-2272,-671,-0.4538553735517379,-0.11350673409595552
9379,37031,Carteret,North Carolina,2000,8839,17381,241,26461,0.3340387740448207,0.6568534824836552,0.00910774347152413,0,0,0,0,0.0,0.0,0.0,-8542,0,-0.3228147084388345,0.0
9380,37031,Carteret,North Carolina,2004,7732,17716,127,25575,0.30232649071358747,0.6927077223851418,0.004965786901270772,-1107,-114,335,-886,-0.031712283331233215,-0.004141956570253358,0.03585423990148662,-9984,-1442,-0.3903812316715543,-0.06756652323271983
9381,37031,Carteret,North Carolina,2008,11130,23131,336,34597,0.32170419400526057,0.6685839812700524,0.009711824724687112,3398,209,5415,9022,0.0193777032916731,0.004746037823416339,-0.024123741115089414,-12001,-2017,-0.3468797872647918,0.04350144440676251
9382,37031,Carteret,North Carolina,2012,10301,24775,441,35517,0.29003012641833487,0.6975532843427091,0.012416589238955993,-829,105,1644,920,-0.0316740675869257,0.002704764514268881,0.02896930307265677,-14474,-2473,-0.40752315792437427,-0.060643370659582474
9383,37031,Carteret,North Carolina,2016,9939,26569,1273,37781,0.2630687382546783,0.7032370768375639,0.03369418490775787,-362,832,1794,2264,-0.026961388163656563,0.02127759566880188,0.005683792494854734,-16630,-2156,-0.44016833858288557,-0.0326451806585113
9384,37033,Caswell,North Carolina,2000,4091,4270,61,8422,0.48575160294466874,0.5070054618855379,0.007242935169793398,0,0,0,0,0.0,0.0,0.0,-179,0,-0.02125385894086912,0.0
9385,37033,Caswell,North Carolina,2004,4539,4868,30,9437,0.48097912472183957,0.5158418989085515,0.003178976369608986,448,-31,598,1015,-0.0047724782228291684,-0.004063958800184412,0.008836437023013621,-329,-150,-0.03486277418671191,-0.01360891524584279
9386,37033,Caswell,North Carolina,2008,5545,5208,109,10862,0.5104953047320936,0.4794697109187995,0.010034984349106978,1006,79,340,1425,0.029516180010254023,0.006856007979497992,-0.036372187989752,337,666,0.031025593813294117,0.06588836800000603
9387,37033,Caswell,North Carolina,2012,5348,5594,97,11039,0.4844641724793913,0.5067487997101187,0.00878702781049008,-197,-12,386,177,-0.026031132252702316,-0.0012479565386168973,0.027279088791319184,-246,-583,-0.022284627230727383,-0.0533102210440215
9388,37033,Caswell,North Carolina,2016,4792,6026,252,11070,0.4328816621499548,0.5443541102077687,0.022764227642276424,-556,155,432,31,-0.05158251032943645,0.013977199831786344,0.037605310497650035,-1234,-988,-0.11147244805781387,-0.08918782082708648
9389,37035,Catawba,North Carolina,2000,16246,34244,351,50841,0.3195452489132787,0.6735508742943688,0.006903876792352629,0,0,0,0,0.0,0.0,0.0,-17998,0,-0.3540056253810901,0.0
9390,37035,Catawba,North Carolina,2004,18858,39602,228,58688,0.3213263358778626,0.6747887131952017,0.0038849509269356596,2612,-123,5358,7847,0.0017810869645839,-0.003018925865416969,0.0012378389008329549,-20744,-2746,-0.35346237731733915,0.0005432480637509451
9391,37035,Catawba,North Carolina,2008,25656,42993,802,69451,0.3694115275517991,0.6190407625520151,0.0115477098961858,6798,574,3391,10763,0.048085191673936545,0.007662758969250141,-0.055747950643186606,-17337,3407,-0.249629235000216,0.10383314231712315
9392,37035,Catawba,North Carolina,2012,24069,44538,994,69601,0.34581399692533155,0.6399045990718524,0.014281404002816052,-1587,192,1545,150,-0.023597530626467578,0.0027336941066302516,0.020863836519837253,-20469,-3132,-0.29409060214652083,-0.04446136714630483
9393,37035,Catawba,North Carolina,2016,21216,48324,2811,72351,0.29323713563046816,0.6679106024795787,0.038852261889953145,-2853,1817,3786,2750,-0.052576861294863386,0.024570857887137094,0.0280060034077263,-27108,-6639,-0.3746734668491105,-0.08058286470258968
9394,37037,Chatham,North Carolina,2000,10461,10248,222,20931,0.4997850078830443,0.4896087143471406,0.010606277769815107,0,0,0,0,0.0,0.0,0.0,213,0,0.010176293535903713,0.0
9395,37037,Chatham,North Carolina,2004,12897,12892,133,25922,0.49753105470256925,0.4973381683512075,0.005130776946223286,2436,-89,2644,4991,-0.0022539531804750546,-0.005475500823591821,0.007729454004066882,5,-208,0.00019288635136177623,-0.009983407184541937
9396,37037,Chatham,North Carolina,2008,17862,14668,350,32880,0.5432481751824818,0.4461070559610706,0.010644768856447688,4965,217,1776,6958,0.045717120479912554,0.005513991910224402,-0.05123111239013689,3194,3189,0.09714111922141122,0.09694823287004944
9397,37037,Chatham,North Carolina,2012,18361,16665,408,35434,0.5181746345318056,0.47031100073375853,0.011514364734435853,499,58,1997,2554,-0.02507354065067624,0.0008695958779881656,0.024203944772687946,1696,-1498,0.047863633798047034,-0.04927748542336419
9398,37037,Chatham,North Carolina,2016,21065,17105,1679,39849,0.5286205425481192,0.4292454013902482,0.04213405606163266,2704,1271,440,4415,0.010445908016313621,0.03061969132719681,-0.04106559934351034,3960,2264,0.099375141157871,0.05151150735982396
9399,37039,Cherokee,North Carolina,2000,3239,6305,130,9674,0.3348149679553442,0.6517469505892082,0.013438081455447592,0,0,0,0,0.0,0.0,0.0,-3066,0,-0.31693198263386396,0.0
9400,37039,Cherokee,North Carolina,2004,3635,7517,47,11199,0.32458255201357267,0.6712206447004196,0.004196803286007679,396,-83,1212,1525,-0.010232415941771544,-0.009241278169439912,0.01947369411121147,-3882,-816,-0.346638092686847,-0.029706110052983015
9401,37039,Cherokee,North Carolina,2008,3785,8643,158,12586,0.3007309709200699,0.686715398061338,0.012553631018592087,150,111,1126,1387,-0.02385158109350277,0.008356827732584407,0.015494753360918323,-4858,-976,-0.38598442714126807,-0.039346334454421095
9402,37039,Cherokee,North Carolina,2012,3378,9278,211,12867,0.26253205875495456,0.7210694023470895,0.016398538897956012,-407,53,635,281,-0.03819891216511534,0.0038449078793639253,0.03435400428575153,-5900,-1042,-0.45853734359213494,-0.07255291645086687
9403,37039,Cherokee,North Carolina,2016,2860,10844,477,14181,0.20167830195331782,0.7646851420915309,0.03363655595515126,-518,266,1566,1314,-0.06085375680163674,0.01723801705719525,0.04361573974444144,-7984,-2084,-0.5630068401382131,-0.10446949654607818
9404,37041,Chowan,North Carolina,2000,2430,2415,45,4890,0.49693251533742333,0.4938650306748466,0.009202453987730062,0,0,0,0,0.0,0.0,0.0,15,0,0.003067484662576725,0.0
9405,37041,Chowan,North Carolina,2004,2406,2967,13,5386,0.4467137021908652,0.5508726327515782,0.0024136650575566285,-24,-32,552,496,-0.05021881314655813,-0.0067887889301734335,0.057007602076731556,-561,-576,-0.10415893056071296,-0.10722641522328968
9406,37041,Chowan,North Carolina,2008,3688,3773,51,7512,0.4909478168264111,0.5022630457933972,0.006789137380191693,1282,38,806,2126,0.044234114635545885,0.0043754723226350645,-0.04860958695818096,-85,476,-0.011315228966986113,0.09284370159372685
9407,37041,Chowan,North Carolina,2012,3556,3891,58,7505,0.47381745502998,0.518454363757495,0.0077281812125249835,-132,7,118,-7,-0.01713036179643107,0.0009390438323332905,0.016191317964097784,-335,-250,-0.04463690872751497,-0.033321679760528855
9408,37041,Chowan,North Carolina,2016,2992,4014,222,7228,0.4139457664637521,0.5553403431101273,0.030713890426120643,-564,164,123,-277,-0.05987168856622793,0.02298570921359566,0.03688597935263227,-1022,-687,-0.14139457664637517,-0.0967576679188602
9409,37043,Clay,North Carolina,2000,1361,2416,75,3852,0.35332294911734163,0.6272066458982347,0.019470404984423675,0,0,0,0,0.0,0.0,0.0,-1055,0,-0.2738836967808931,0.0
9410,37043,Clay,North Carolina,2004,1628,3209,29,4866,0.33456637895602137,0.6594739005343198,0.005959720509658858,267,-46,793,1014,-0.018756570161320263,-0.013510684474764816,0.03226725463608504,-1581,-526,-0.3249075215782984,-0.051023824797405304
9411,37043,Clay,North Carolina,2008,1734,3707,102,5543,0.312826988995129,0.6687714234169222,0.018401587587948763,106,73,498,677,-0.021739389960892364,0.012441867078289905,0.009297522882602438,-1973,-392,-0.3559444344217932,-0.0310369128434948
9412,37043,Clay,North Carolina,2012,1579,3973,90,5642,0.27986529599432824,0.7041829138603333,0.015951790145338533,-155,-12,266,99,-0.03296169300080076,-0.00244979744261023,0.035411490443411076,-2394,-421,-0.424317617866005,-0.06837318344421184
9413,37043,Clay,North Carolina,2016,1367,4437,206,6010,0.22745424292845257,0.7382695507487521,0.03427620632279534,-212,116,464,368,-0.05241105306587568,0.01832441617745681,0.03408663688841884,-3070,-676,-0.5108153078202995,-0.08649768995429447
9414,37045,Cleveland,North Carolina,2000,13455,19064,227,32746,0.41088987967996093,0.5821779759359922,0.006932144384046907,0,0,0,0,0.0,0.0,0.0,-5609,0,-0.17128809625603125,0.0
9415,37045,Cleveland,North Carolina,2004,14215,22750,114,37079,0.38337064106367486,0.613554842363602,0.003074516572723105,760,-113,3686,4333,-0.02751923861628608,-0.0038576278113238017,0.03137686642760984,-8535,-2926,-0.23018420129992717,-0.05889610504389592
9416,37045,Cleveland,North Carolina,2008,17363,26078,394,43835,0.39609900764229494,0.5949127409604198,0.008988251397285275,3148,280,3328,6756,0.012728366578620087,0.005913734824562171,-0.018642101403182232,-8715,-180,-0.19881373331812485,0.03137046798180232
9417,37045,Cleveland,North Carolina,2012,17062,25793,485,43340,0.39367789570835254,0.595131518227965,0.01119058606368251,-301,91,-285,-495,-0.002421111933942399,0.0022023346663972345,0.00021877726754515603,-8731,-16,-0.2014536225196124,-0.0026398892014875552
9418,37045,Cleveland,North Carolina,2016,14964,28479,1230,44673,0.3349674299912699,0.6374991605667854,0.0275334094419448,-2098,745,2686,1333,-0.05871046571708266,0.01634282337826229,0.0423676423388204,-13515,-4784,-0.30253173057551547,-0.10107810805590306
9419,37047,Columbus,North Carolina,2000,9986,8342,97,18425,0.5419810040705563,0.4527544097693351,0.005264586160108548,0,0,0,0,0.0,0.0,0.0,1644,0,0.08922659430122115,0.0
9420,37047,Columbus,North Carolina,2004,10343,10773,75,21191,0.48808456420178375,0.5083761974423104,0.0035392383559058093,357,-22,2431,2766,-0.05389643986877252,-0.0017253478042027386,0.05562178767297532,-430,-2074,-0.020291633240526685,-0.10951822754174784
9421,37047,Columbus,North Carolina,2008,11076,12994,212,24282,0.45614035087719296,0.535128902067375,0.008730747055432007,733,137,2221,3091,-0.0319442133245908,0.0051915086995261974,0.026752704625064516,-1918,-1488,-0.078988551190182,-0.058696917949655314
9422,37047,Columbus,North Carolina,2012,11050,12941,252,24243,0.45580167471022565,0.533803572165161,0.01039475312461329,-26,40,-53,-39,-0.00033867616696731107,0.001664006069181283,-0.001325329902213901,-1891,27,-0.07800189745493541,0.0009866537352465898
9423,37047,Columbus,North Carolina,2016,9063,14272,397,23732,0.38188943199056125,0.6013821001179842,0.016728467891454577,-1987,145,1331,-511,-0.0739122427196644,0.006333714766841287,0.06757852795282315,-5209,-3318,-0.21949266812742296,-0.14149077067248755
9424,37049,Craven,North Carolina,2000,12213,19494,278,31985,0.3818352352665312,0.6094731905580741,0.008691574175394717,0,0,0,0,0.0,0.0,0.0,-7281,0,-0.22763795529154296,0.0
9425,37049,Craven,North Carolina,2004,14019,23575,162,37756,0.3713052230109122,0.6244040682275664,0.0042907087615213476,1806,-116,4081,5771,-0.010530012255619003,-0.004400865413873369,0.014930877669492304,-9556,-2275,-0.25309884521665427,-0.025460889925111307
9426,37049,Craven,North Carolina,2008,19352,24901,345,44598,0.4339208036234809,0.5583434234719046,0.007735772904614557,5333,183,1326,6842,0.06261558061256872,0.0034450641430932094,-0.06606064475566187,-5549,4007,-0.12442261984842368,0.1286762253682306
9427,37049,Craven,North Carolina,2012,18763,26928,479,46170,0.40638943036603853,0.5832358674463938,0.010374702187567685,-589,134,2027,1572,-0.02753137325744237,0.002638929282953128,0.024892443974489198,-8165,-2616,-0.17684643708035525,-0.05242381723193157
9428,37049,Craven,North Carolina,2016,17630,27731,1640,47001,0.37509840216165613,0.5900087232186549,0.03489287461968894,-1133,1161,803,831,-0.0312910282043824,0.02451817243212126,0.006772855772261166,-10101,-1936,-0.2149103210569988,-0.038063883976643564
9429,37051,Cumberland,North Carolina,2000,38626,38129,396,77151,0.5006545605371285,0.4942126479242006,0.005132791538670918,0,0,0,0,0.0,0.0,0.0,497,0,0.006441912612927925,0.0
9430,37051,Cumberland,North Carolina,2004,45788,49139,299,95226,0.48083506605338877,0.5160250351794677,0.0031398987671434272,7162,-97,11010,18075,-0.019819494483739764,-0.0019928927715274908,0.02181238725526713,-3351,-3848,-0.03518996912607897,-0.04163188173900689
9431,37051,Cumberland,North Carolina,2008,74693,52151,731,127575,0.5854830491867529,0.4087869880462473,0.005729962766999804,28905,432,3012,32349,0.1046479831333641,0.0025900639998563766,-0.10723804713322044,22542,25893,0.17669606114050557,0.21188603026658454
9432,37051,Cumberland,North Carolina,2012,75792,50666,1183,127641,0.5937903965026912,0.3969414216435158,0.009268181853793061,1099,452,-1485,66,0.008307347315938296,0.003538219086793257,-0.011845566402731489,25126,2584,0.19684897485917535,0.020152913718669785
9433,37051,Cumberland,North Carolina,2016,71605,51265,4636,127506,0.5615814157765124,0.4020595109249761,0.03635907329851144,-4187,3453,599,-135,-0.032208980726178726,0.027090891444718383,0.005118089281460292,20340,-4786,0.15952190485153633,-0.03732707000763902
9434,37053,Currituck,North Carolina,2000,2595,4095,49,6739,0.3850719691348865,0.6076569223920463,0.007271108473067221,0,0,0,0,0.0,0.0,0.0,-1500,0,-0.22258495325715977,0.0
9435,37053,Currituck,North Carolina,2004,2909,6013,54,8976,0.32408645276292336,0.669897504456328,0.006016042780748663,314,5,1918,2237,-0.060985516371963144,-0.001255065692318558,0.062240582064281735,-3104,-1604,-0.34581105169340465,-0.12322609843624488
9436,37053,Currituck,North Carolina,2008,3737,7234,131,11102,0.3366060169338858,0.6515943073320123,0.011799675734101964,828,77,1221,2126,0.01251956417096245,0.005783632953353301,-0.018303197124315718,-3497,-393,-0.3149882903981265,0.030822761295278167
9437,37053,Currituck,North Carolina,2012,3562,7496,246,11304,0.3151096956829441,0.6631280962491154,0.02176220806794055,-175,115,262,202,-0.021496321250941697,0.009962532333838587,0.011533788917103105,-3934,-437,-0.3480184005661713,-0.0330301101680448
9438,37053,Currituck,North Carolina,2016,2913,9163,593,12669,0.22993132843949798,0.7232615044597048,0.04680716710079722,-649,347,1667,1365,-0.08517836724344613,0.02504495903285667,0.060133408210589434,-6250,-2316,-0.49333017602020685,-0.14531177545403556
9439,37055,Dare,North Carolina,2000,5589,7301,112,13002,0.4298569450853715,0.5615289955391478,0.008614059375480695,0,0,0,0,0.0,0.0,0.0,-1712,0,-0.13167205045377633,0.0
9440,37055,Dare,North Carolina,2004,6136,9345,67,15548,0.39464882943143814,0.6010419346539748,0.0043092359145870856,547,-45,2044,2546,-0.035208115653933336,-0.00430482346089361,0.039512939114827006,-3209,-1497,-0.20639310522253668,-0.07472105476876034
9441,37055,Dare,North Carolina,2008,8074,9745,229,18048,0.4473625886524823,0.539949024822695,0.012688386524822695,1938,162,400,2500,0.052713759221044154,0.00837915061023561,-0.061092909831279796,-1671,1538,-0.09258643617021273,0.11380666905232395
9442,37055,Dare,North Carolina,2012,7393,10248,333,17974,0.4113163458328697,0.5701568932903083,0.018526760876822077,-681,104,503,-74,-0.036046242819612606,0.005838374351999381,0.030207868467613253,-2855,-1184,-0.15884054745743859,-0.06625411128722586
9443,37055,Dare,North Carolina,2016,7222,11460,927,19609,0.36830027028405327,0.5844255188943852,0.04727421082156153,-171,594,1212,1635,-0.043016075548816424,0.028747449944739455,0.014268625604076934,-4238,-1383,-0.21612524861033194,-0.05728470115289336
9444,37057,Davidson,North Carolina,2000,16199,35387,461,52047,0.3112379195726939,0.6799047015197802,0.00885737890752589,0,0,0,0,0.0,0.0,0.0,-19188,0,-0.3686667819470863,0.0
9445,37057,Davidson,North Carolina,2004,17191,42075,230,59496,0.2889437945408095,0.7071903993545785,0.003865806104612075,992,-231,6688,7449,-0.022294125031884438,-0.004991572802913815,0.027285697834798284,-24884,-5696,-0.418246604813769,-0.04957982286668272
9446,37057,Davidson,North Carolina,2008,22433,45419,729,68581,0.3271022586430644,0.662267975095143,0.010629766261792625,5242,499,3344,9085,0.03815846410225493,0.006763960157180549,-0.04492242425943549,-22986,1898,-0.3351657164520786,0.08308088836169042
9447,37057,Davidson,North Carolina,2012,20624,49383,928,70935,0.29074504828363995,0.6961725523366462,0.013082399379713823,-1809,199,3964,2354,-0.03635721035942446,0.002452633117921198,0.0339045772415032,-28759,-5773,-0.40542750405300626,-0.07026178760092766
9448,37057,Davidson,North Carolina,2016,18109,54317,2430,74856,0.24191781553916852,0.7256198567917067,0.03246232766912472,-2515,1502,4934,3921,-0.04882723274447143,0.019379928289410896,0.029447304455060497,-36208,-7449,-0.4837020412525382,-0.07827453719953192
9449,37059,Davie,North Carolina,2000,3651,10184,163,13998,0.26082297471067295,0.7275325046435205,0.011644520645806544,0,0,0,0,0.0,0.0,0.0,-6533,0,-0.46670952993284753,0.0
9450,37059,Davie,North Carolina,2004,4233,12372,75,16680,0.2537769784172662,0.741726618705036,0.0044964028776978415,582,-88,2188,2682,-0.007045996293406742,-0.007148117768108702,0.014194114061515495,-8139,-1606,-0.48794964028776977,-0.021240110354922237
9451,37059,Davie,North Carolina,2008,6178,13981,209,20368,0.30331893165750196,0.6864198743126473,0.010261194029850746,1945,134,1609,3688,0.04954195324023575,0.005764791152152905,-0.055306744392388696,-7803,336,-0.3831009426551453,0.10484869763262444
9452,37059,Davie,North Carolina,2012,5735,14687,248,20670,0.27745524915336234,0.7105466860183841,0.011998064828253507,-443,39,706,302,-0.025863682504139618,0.0017368707984027603,0.024126811705736828,-8952,-1149,-0.4330914368650218,-0.049990494209876446
9453,37059,Davie,North Carolina,2016,5270,15602,884,21756,0.24223202794631365,0.7171355028497886,0.04063246920389778,-465,636,915,1086,-0.03522322120704868,0.02863440437564427,0.006588816831404443,-10332,-1380,-0.4749034749034749,-0.041812038038453125
9454,37061,Duplin,North Carolina,2000,6475,7840,75,14390,0.4499652536483669,0.5448227936066713,0.005211952744961779,0,0,0,0,0.0,0.0,0.0,-1365,0,-0.09485753995830437,0.0
9455,37061,Duplin,North Carolina,2004,6923,9611,49,16583,0.4174757281553398,0.5795694385816801,0.0029548332629801602,448,-26,1771,2193,-0.03248952549302714,-0.0022571194819816184,0.03474664497500879,-2688,-1323,-0.1620937104263403,-0.06723617046803593
9456,37061,Duplin,North Carolina,2008,8958,10834,112,19904,0.4500602893890675,0.5443127009646302,0.005627009646302251,2035,63,1223,3321,0.032584561233727716,0.0026721763833220907,-0.03525673761704984,-1876,812,-0.09425241157556274,0.06784129885077755
9457,37061,Duplin,North Carolina,2012,9033,11416,143,20592,0.4386655011655012,0.5543900543900544,0.006944444444444444,75,31,582,688,-0.011394788223566321,0.001317434798142193,0.010077353425424151,-2383,-507,-0.11572455322455322,-0.021472141648990473
9458,37061,Duplin,North Carolina,2016,8283,12217,356,20856,0.3971518987341772,0.5857786728039892,0.017069428461833524,-750,213,801,264,-0.04151360243132396,0.01012498401738908,0.03138861841393481,-3934,-1551,-0.188626774069812,-0.07290222084525877
9459,37063,Durham,North Carolina,2000,53907,30150,547,84604,0.63716845539218,0.35636612926102784,0.006465415346792114,0,0,0,0,0.0,0.0,0.0,23757,0,0.2808023261311522,0.0
9460,37063,Durham,North Carolina,2004,74524,34614,513,109651,0.6796472444391752,0.31567427565640077,0.004678479904424037,20617,-34,4464,25047,0.0424787890469952,-0.001786935442368077,-0.04069185360462707,39910,16153,0.36397296878277446,0.08317064265162227
9461,37063,Durham,North Carolina,2008,103456,32353,1088,136897,0.7557214548163949,0.23633096415553298,0.0079475810280722,28932,575,-2261,27246,0.07607421037721962,0.003269101123648163,-0.07934331150086779,71103,31193,0.5193904906608618,0.15541752187808738
9462,37063,Durham,North Carolina,2012,111224,33769,1742,146735,0.7579922990424915,0.2301359593825604,0.011871741574948035,7768,654,1416,9838,0.002270844226096691,0.003924160546875836,-0.006195004772972579,77455,6352,0.5278563396599312,0.008465848999069325
9463,37063,Durham,North Carolina,2016,121250,28350,6534,156134,0.776576530416181,0.18157480113236066,0.04184866845145836,10026,4792,-5419,9399,0.018584231373689475,0.029976926876510327,-0.04856115825019974,92900,15445,0.5950017292838203,0.06714538962388916
9464,37065,Edgecombe,North Carolina,2000,11315,6836,51,18202,0.6216349851664652,0.3755631249313262,0.0028018899022085484,0,0,0,0,0.0,0.0,0.0,4479,0,0.246071860235139,0.0
9465,37065,Edgecombe,North Carolina,2004,12877,8163,39,21079,0.6108923573224536,0.3872574600313108,0.00185018264623559,1562,-12,1327,2877,-0.010742627844011587,-0.0009517072559729585,0.011694335099984576,4714,235,0.22363489729114283,-0.022436962943996164
9466,37065,Edgecombe,North Carolina,2008,17403,8445,82,25930,0.671153104512148,0.325684535287312,0.0031623602005399153,4526,43,282,4851,0.06026074718969443,0.0013121775543043254,-0.06157292474399878,8958,4244,0.34546856922483604,0.12183367193369321
9467,37065,Edgecombe,North Carolina,2012,18310,8546,116,26972,0.6788521429630728,0.31684710069701916,0.004300756339908052,907,34,101,1042,0.007699038450924789,0.0011383961393681371,-0.008837434590292848,9764,806,0.3620050422660537,0.016536473041217636
9468,37065,Edgecombe,North Carolina,2016,16224,8261,401,24886,0.6519328136301535,0.33195370891264164,0.016113477457204855,-2086,285,-285,-2086,-0.026919329332919295,0.011812721117296802,0.015106608215622486,7963,-1801,0.3199791047175119,-0.04202593754854178
9469,37067,Forsyth,North Carolina,2000,52457,67700,785,120942,0.43373683253129597,0.5597724529113128,0.006490714557391146,0,0,0,0,0.0,0.0,0.0,-15243,0,-0.12603562038001687,0.0
9470,37067,Forsyth,North Carolina,2004,63340,75294,491,139125,0.45527403414195866,0.5411967654986523,0.0035292003593890386,10883,-294,7594,18183,0.021537201610662693,-0.0029615141980021075,-0.01857568741266058,-11954,3289,-0.0859227313566936,0.04011288902332327
9471,37067,Forsyth,North Carolina,2008,91085,73674,1374,166133,0.548265546279186,0.44346397163718226,0.008270482083631788,27745,883,-1620,27008,0.09299151213722734,0.004741281724242749,-0.09773279386146999,17411,29365,0.10480157464200374,0.19072430599869733
9472,37067,Forsyth,North Carolina,2012,92323,79768,1978,174069,0.5303816302730526,0.45825505977514663,0.011363309951800724,1238,604,6094,7936,-0.01788391600613337,0.0030928278681689354,0.01479108813796437,12555,-4856,0.072126570497906,-0.03267500414409774
9473,37067,Forsyth,North Carolina,2016,94464,75975,7873,178312,0.5297680470187088,0.42607900758221545,0.04415294539907578,2141,5895,-3793,4243,-0.0006135832543437969,0.032789635447275055,-0.03217605219293118,18489,5934,0.10368903943649338,0.031562468938587385
9474,37069,Franklin,North Carolina,2000,7454,8501,96,16051,0.46439474176063794,0.5296243224721201,0.005980935767241916,0,0,0,0,0.0,0.0,0.0,-1047,0,-0.06522958071148216,0.0
9475,37069,Franklin,North Carolina,2004,9286,11540,92,20918,0.4439238932976384,0.5516779806864901,0.004398126015871498,1832,-4,3039,4867,-0.02047084846299957,-0.0015828097513704183,0.022053658214369998,-2254,-1207,-0.10775408738885173,-0.04252450667736957
9476,37069,Franklin,North Carolina,2008,13085,13273,281,26639,0.49119711700889673,0.4982544389804422,0.010548444010661061,3799,189,1733,5721,0.04727322371125836,0.006150317994789563,-0.053423541706047906,-188,2066,-0.0070573219715454605,0.10069676541730627
9477,37069,Franklin,North Carolina,2012,13436,14603,350,28389,0.47328190496318995,0.5143893761668252,0.012328718869984854,351,69,1330,1750,-0.017915212045706785,0.0017802748593237928,0.016134937186383036,-1167,-979,-0.04110747120363528,-0.03405014923208982
9478,37069,Franklin,North Carolina,2016,12874,16368,1126,30368,0.42393308746048475,0.5389884088514225,0.03707850368809273,-562,776,1765,1979,-0.0493488175027052,0.024749784818107873,0.02459903268459729,-3494,-2327,-0.11505532139093777,-0.07394785018730249
9479,37071,Gaston,North Carolina,2000,19281,39453,445,59179,0.32580814140151065,0.6666722992953582,0.0075195593031311785,0,0,0,0,0.0,0.0,0.0,-20172,0,-0.34086415789384755,0.0
9480,37071,Gaston,North Carolina,2004,20254,43252,249,63755,0.31768488745980705,0.6784095365069406,0.0039055760332522937,973,-196,3799,4576,-0.008123253941703601,-0.0036139832698788847,0.011737237211582374,-22998,-2826,-0.3607246490471335,-0.019860491153285975
9481,37071,Gaston,North Carolina,2008,31384,52507,511,84402,0.37183952986896046,0.6221061112295917,0.006054358901447833,11130,262,9255,20647,0.05415464240915341,0.0021487828681955395,-0.056303425277348884,-21123,1875,-0.25026658136063124,0.11045806768650229
9482,37071,Gaston,North Carolina,2012,33171,56138,1174,90483,0.36659925068797455,0.6204259363637369,0.012974812948288629,1787,663,3631,6081,-0.005240279180985907,0.0069204540468407955,-0.001680174865854811,-22967,-1844,-0.25382668567576233,-0.0035601043151310963
9483,37071,Gaston,North Carolina,2016,31177,61798,3456,96431,0.3233088944426585,0.640852008171646,0.03583909738569547,-1994,2282,5660,5948,-0.043290356245316075,0.02286428443740684,0.02042607180790912,-30621,-7654,-0.3175431137289875,-0.0637164280532252
9484,37073,Gates,North Carolina,2000,1944,1480,22,3446,0.5641323273360418,0.4294834590829948,0.006384213580963436,0,0,0,0,0.0,0.0,0.0,464,0,0.134648868253047,0.0
9485,37073,Gates,North Carolina,2004,2121,1924,8,4053,0.5233160621761658,0.47471009129040215,0.0019738465334320256,177,-14,444,607,-0.04081626515987602,-0.00441036704753141,0.04522663220740736,197,-267,0.04860597088576363,-0.08604289736728338
9486,37073,Gates,North Carolina,2008,2830,2547,43,5420,0.522140221402214,0.46992619926199264,0.007933579335793358,709,35,623,1367,-0.0011758407739517196,0.0059597328023613325,-0.004783892028409509,283,86,0.05221402214022142,0.003608051254457789
9487,37073,Gates,North Carolina,2012,2786,2564,46,5396,0.5163083765752409,0.47516679021497404,0.008524833209785025,-44,3,17,-24,-0.005831844826973187,0.0005912538739916672,0.005240590952981405,222,-61,0.041141586360266824,-0.011072435779954592
9488,37073,Gates,North Carolina,2016,2385,2874,133,5392,0.4423219584569733,0.5330118694362018,0.024666172106824927,-401,87,310,-4,-0.07398641811826756,0.016141338897039902,0.05784507922122778,-489,-711,-0.09068991097922852,-0.13183149733949534
9489,37075,Graham,North Carolina,2000,1006,2304,51,3361,0.2993156798571854,0.6855102648021422,0.01517405534067242,0,0,0,0,0.0,0.0,0.0,-1298,0,-0.3861945849449568,0.0
9490,37075,Graham,North Carolina,2004,1272,2693,22,3987,0.3190368698269376,0.6754451968898921,0.005517933283170303,266,-29,389,626,0.019721189969752195,-0.009656122057502117,-0.010065067912250036,-1421,-123,-0.35640832706295456,0.02978625788200223
9491,37075,Graham,North Carolina,2008,1265,2824,82,4171,0.3032845840326061,0.6770558619036202,0.019659554063773677,-7,60,131,184,-0.015752285794331466,0.014141620780603374,0.0016106650137280853,-1559,-138,-0.3737712778710141,-0.017362950808059552
9492,37075,Graham,North Carolina,2012,1119,2750,78,3947,0.2835064606029896,0.6967316949581961,0.019761844438814288,-146,-4,-74,-224,-0.01977812342961649,0.00010229037504061109,0.019675833054575875,-1631,-72,-0.41322523435520647,-0.039453956484192365
9493,37075,Graham,North Carolina,2016,768,3283,117,4168,0.18426103646833014,0.7876679462571977,0.028071017274472167,-351,39,533,221,-0.09924542413465948,0.00830917283565788,0.09093625129900162,-2515,-884,-0.6034069097888676,-0.1901816754336611
9494,37077,Granville,North Carolina,2000,7733,7364,97,15194,0.5089509016717125,0.4846649993418455,0.006384098986442017,0,0,0,0,0.0,0.0,0.0,369,0,0.02428590232986705,0.0
9495,37077,Granville,North Carolina,2004,9057,9491,53,18601,0.48690930595129295,0.5102413848717811,0.0028493091769259717,1324,-44,2127,3407,-0.022041595720419582,-0.0035347898095160453,0.025576385529935575,-434,-803,-0.02333207892048811,-0.04761798125035516
9496,37077,Granville,North Carolina,2008,13074,11447,204,24725,0.5287765419615773,0.46297269969666327,0.008250758341759352,4017,151,1956,6124,0.04186723601028436,0.0054014491648333805,-0.047268685175117786,1627,2061,0.06580384226491404,0.08913592118540214
9497,37077,Granville,North Carolina,2012,13598,12405,272,26275,0.5175261655566128,0.47212178877259753,0.010352045670789725,524,68,958,1550,-0.011250376404964513,0.0021012873290303727,0.009149089075934258,1193,-434,0.045404376784015266,-0.02039946548089877
9498,37077,Granville,North Carolina,2016,12909,13591,853,27353,0.4719409205571601,0.496874200270537,0.031184879172302855,-689,581,1186,1078,-0.04558524499945271,0.02083283350151313,0.024752411497939497,-682,-1875,-0.024933279713376943,-0.07033765649739221
9499,37079,Greene,North Carolina,2000,2478,3353,39,5870,0.4221465076660988,0.5712095400340715,0.006643952299829642,0,0,0,0,0.0,0.0,0.0,-875,0,-0.14906303236797275,0.0
9500,37079,Greene,North Carolina,2004,2665,3800,7,6472,0.4117737948084054,0.5871446229913473,0.0010815822002472187,187,-32,447,602,-0.010372712857693367,-0.005562370099582423,0.015935082957275748,-1135,-260,-0.17537082818294186,-0.026307795814969115
9501,37079,Greene,North Carolina,2008,3796,4272,35,8103,0.46846846846846846,0.5272121436504998,0.004319387881031716,1131,28,472,1631,0.05669467366006303,0.0032378056807844976,-0.059932479340847444,-476,659,-0.058743675182031385,0.11662715300091048
9502,37079,Greene,North Carolina,2012,3778,4411,47,8236,0.4587178241864983,0.5355755220981059,0.005706653715395823,-18,12,139,133,-0.009750644281970144,0.0013872658343641068,0.00836337844760604,-633,-157,-0.07685769791160757,-0.018114022729576185
9503,37079,Greene,North Carolina,2016,3605,4374,116,8095,0.44533662754786907,0.5403335392217418,0.01432983323038913,-173,69,-37,-141,-0.013381196638629245,0.008623179514993307,0.004758017123635883,-769,-136,-0.0949969116738727,-0.018139213762265127
9504,37081,Guilford,North Carolina,2000,80787,84394,1083,166264,0.48589592455372177,0.5075903382572294,0.006513737189048741,0,0,0,0,0.0,0.0,0.0,-3607,0,-0.021694413703507665,0.0
9505,37081,Guilford,North Carolina,2004,100042,98254,1018,199314,0.5019316254753805,0.4929608557351716,0.005107518789447806,19255,-65,13860,33050,0.016035700921658735,-0.0014062183996009356,-0.014629482522057813,1788,5395,0.008970769740208884,0.030665183443716548
9506,37081,Guilford,North Carolina,2008,142101,97718,1952,241771,0.587750391899773,0.4041758523561552,0.00807375574407187,42059,934,-536,42457,0.08581876642439246,0.0029662369546240644,-0.0887850033790164,44383,42595,0.18357453954361774,0.17460376980340886
9507,37081,Guilford,North Carolina,2012,146365,104789,2698,253852,0.5765761152167405,0.4127956447063643,0.0106282400768952,4264,746,7071,12081,-0.011174276683032502,0.002554484332823329,0.008619792350209099,41576,-2807,0.16378047051037614,-0.0197940690332416
9508,37081,Guilford,North Carolina,2016,149248,98062,10095,257405,0.5798177968570929,0.3809638507410501,0.039218352401857,2883,7397,-6727,3553,0.003241681640352434,0.028590112324961798,-0.031831793965314215,51186,9610,0.1988539461160428,0.03507347560566665
9509,37083,Halifax,North Carolina,2000,10222,6698,50,16970,0.6023571007660578,0.39469652327637006,0.0029463759575721863,0,0,0,0,0.0,0.0,0.0,3524,0,0.2076605774896877,0.0
9510,37083,Halifax,North Carolina,2004,11528,8088,31,19647,0.5867562477731969,0.4116659031913269,0.0015778490354761542,1306,-19,1390,2677,-0.015600852992860847,-0.001368526922096032,0.01696937991495684,3440,-84,0.17509034458187,-0.03257023290781769
9511,37083,Halifax,North Carolina,2008,16047,8961,83,25091,0.6395520306085848,0.3571400103622813,0.0033079590291339523,4519,52,873,5444,0.05279578283538788,0.001730109993657798,-0.054525892829045575,7086,3646,0.28241202024630346,0.10732167566443346
9512,37083,Halifax,North Carolina,2012,17176,8763,140,26079,0.658614210667587,0.33601748533302656,0.0053683039993864794,1129,57,-198,988,0.019062180059002176,0.002060344970252527,-0.02112252502925477,8413,1327,0.3225967253345604,0.040184705088256945
9513,37083,Halifax,North Carolina,2016,15748,9031,388,25167,0.6257400564230937,0.35884292923272537,0.015417014344180871,-1428,248,268,-912,-0.03287415424449325,0.010048710344794392,0.022825443899698816,6717,-1696,0.26689712719036834,-0.055699598144192064
9514,37085,Harnett,North Carolina,2000,9155,14762,250,24167,0.3788223610708818,0.6108329540282204,0.010344684900897919,0,0,0,0,0.0,0.0,0.0,-5607,0,-0.23201059295733856,0.0
9515,37085,Harnett,North Carolina,2004,11563,20922,86,32571,0.3550090571367167,0.6423505572441742,0.0026403856191090235,2408,-164,6160,8404,-0.023813303934165087,-0.0077042992817888956,0.03151760321595387,-9359,-3752,-0.2873415001074575,-0.05533090715011896
9516,37085,Harnett,North Carolina,2008,16785,23579,341,40705,0.4123572042746591,0.5792654465053433,0.008377349219997544,5222,255,2657,8134,0.057348147137942396,0.005736963600888521,-0.06308511073883094,-6794,2565,-0.16690824223068418,0.12043325787677334
9517,37085,Harnett,North Carolina,2012,17331,25565,519,43415,0.39919382701831163,0.5888517793389382,0.011954393642750201,546,178,1986,2710,-0.013163377256347475,0.0035770444227526572,0.00958633283359489,-8234,-1440,-0.18965795232062654,-0.022749710089942365
9518,37085,Harnett,North Carolina,2016,16737,27614,1714,46065,0.3633344187561055,0.5994572886139151,0.03720829262997938,-594,1195,2049,2650,-0.03585940826220613,0.025253898987229177,0.010605509274976943,-10877,-2643,-0.23612286985780961,-0.04646491753718307
9519,37087,Haywood,North Carolina,2000,9793,12118,362,22273,0.4396803304449333,0.5440668073452162,0.01625286220985049,0,0,0,0,0.0,0.0,0.0,-2325,0,-0.10438647690028285,0.0
9520,37087,Haywood,North Carolina,2004,11237,14545,150,25932,0.4333256208545426,0.5608900200524448,0.005784359093012495,1444,-212,2427,3659,-0.006354709590390695,-0.010468503116837996,0.01682321270722864,-3308,-983,-0.1275643991979022,-0.023177922297619336
9521,37087,Haywood,North Carolina,2008,12730,14910,427,28067,0.4535575586988278,0.5312288452631204,0.015213596038051804,1493,277,365,2135,0.020231937844285175,0.00942923694503931,-0.029661174789324396,-2180,1128,-0.07767128656429262,0.04989311263360957
9522,37087,Haywood,North Carolina,2012,11833,15633,508,27974,0.42299992850504037,0.5588403517552013,0.018159719739758346,-897,81,723,-93,-0.030557630193787433,0.002946123701706542,0.027611506492080884,-3800,-1620,-0.13584042325016094,-0.05816913668586832
9523,37087,Haywood,North Carolina,2016,10473,18929,1325,30727,0.3408403033163016,0.6160380121717056,0.04312168451199271,-1360,817,3296,2753,-0.08215962518873876,0.024961964772234366,0.057197660416504315,-8456,-4656,-0.275197708855404,-0.13935728560524308
9524,37089,Henderson,North Carolina,2000,12562,25688,357,38607,0.3253814075167716,0.6653715647421452,0.009247027741083224,0,0,0,0,0.0,0.0,0.0,-13126,0,-0.3399901572253736,0.0
9525,37089,Henderson,North Carolina,2004,15003,28025,206,43234,0.34701855021510847,0.6482166813156313,0.004764768469260304,2441,-151,2337,4627,0.021637142698336886,-0.00448225927182292,-0.017154883426513945,-13022,104,-0.3011981311005228,0.03879202612485083
9526,37089,Henderson,North Carolina,2008,20082,30930,602,51614,0.38908048203975665,0.599256015809664,0.0116635021505793,5079,396,2905,8380,0.04206193182464818,0.006898733681318996,-0.04896066550596723,-10848,2174,-0.21017553376990739,0.0910225973306154
9527,37089,Henderson,North Carolina,2012,18642,32994,756,52392,0.35581768208886855,0.6297526339899221,0.014429683921209345,-1440,154,2064,778,-0.0332627999508881,0.0027661817706300454,0.03049661818025806,-14352,-3504,-0.27393495190105355,-0.06375941813114616
9528,37089,Henderson,North Carolina,2016,19827,35809,2540,58176,0.3408106435643564,0.6155287403740374,0.043660616061606164,1185,1784,2815,5784,-0.015007038524512128,0.02923093214039682,-0.01422389361588472,-15982,-1630,-0.27471809680968096,-0.0007831449086274089
9529,37091,Hertford,North Carolina,2000,5484,2382,31,7897,0.6944409269342788,0.3016335317209067,0.003925541344814486,0,0,0,0,0.0,0.0,0.0,3102,0,0.39280739521337216,0.0
9530,37091,Hertford,North Carolina,2004,5141,2942,49,8132,0.632193802262666,0.3617806197737334,0.006025577963600591,-343,18,560,235,-0.06224712467161286,0.0021000366187861044,0.0601470880528267,2199,-903,0.2704131824889326,-0.12239421272443957
9531,37091,Hertford,North Carolina,2008,7513,3089,48,10650,0.7054460093896714,0.2900469483568075,0.004507042253521127,2372,-1,147,2518,0.07325220712700542,-0.0015185357100794637,-0.07173367141692588,4424,2225,0.4153990610328639,0.1449858785439313
9532,37091,Hertford,North Carolina,2012,7843,3007,68,10918,0.7183550100751054,0.2754167429932222,0.006228246931672467,330,20,-82,268,0.012909000685433991,0.0017212046781513403,-0.01463020536358528,4836,412,0.44293826708188316,0.02753920604901927
9533,37091,Hertford,North Carolina,2016,6910,3099,177,10186,0.6783820930689182,0.30424111525623404,0.01737679167484783,-933,109,92,-732,-0.039972917006187214,0.011148544743175361,0.02882437226301182,3811,-1025,0.37414097781268413,-0.06879728926919904
9534,37093,Hoke,North Carolina,2000,5017,3439,126,8582,0.5845956653460732,0.40072244232113724,0.01468189233278956,0,0,0,0,0.0,0.0,0.0,1578,0,0.18387322302493597,0.0
9535,37093,Hoke,North Carolina,2004,5794,5257,37,11088,0.5225468975468975,0.4741161616161616,0.003336940836940837,777,-89,1818,2506,-0.062048767799175675,-0.011344951495848722,0.07339371929502436,537,-1041,0.048430735930735935,-0.13544248709420004
9536,37093,Hoke,North Carolina,2008,9227,6293,107,15627,0.5904524220899725,0.40270045434184426,0.006847123568183272,3433,70,1036,4539,0.06790552454307497,0.0035101827312424352,-0.07141570727431734,2934,2397,0.18775196774812825,0.1393212318173923
9537,37093,Hoke,North Carolina,2012,10076,6819,194,17089,0.5896190531921118,0.3990286148984727,0.011352331909415413,849,87,526,1462,-0.0008333688978606757,0.004505208341232141,-0.0036718394433715718,3257,323,0.19059043829363914,0.002838470545510896
9538,37093,Hoke,North Carolina,2016,9726,7760,744,18230,0.5335161821173889,0.42567196928140427,0.040811848601206804,-350,550,941,1141,-0.05610287107472289,0.029459516691791393,0.026643354382931583,1966,-1291,0.10784421283598467,-0.08274622545765448
9539,37095,Hyde,North Carolina,2000,1088,1132,17,2237,0.48636566830576666,0.5060348681269558,0.007599463567277604,0,0,0,0,0.0,0.0,0.0,-44,0,-0.019669199821189087,0.0
9540,37095,Hyde,North Carolina,2004,1048,1235,10,2293,0.4570431748800698,0.538595726122983,0.00436109899694723,-40,-7,103,56,-0.02932249342569687,-0.0032383645703303737,0.03256085799602726,-187,-143,-0.08155255124291322,-0.06188335142172413
9541,37095,Hyde,North Carolina,2008,1241,1212,16,2469,0.5026326447954638,0.4908869987849332,0.0064803564196030785,193,6,-23,176,0.045589469915393976,0.002119257422655848,-0.04770872733804982,29,216,0.011745646010530575,0.0932981972534438
9542,37095,Hyde,North Carolina,2012,1163,1193,27,2383,0.48804028535459504,0.5006294586655476,0.011330255979857323,-78,11,-19,-86,-0.01459235944086873,0.0048498995602542444,0.009742459880614451,-30,-59,-0.012589173310952606,-0.02433481932148318
9543,37095,Hyde,North Carolina,2016,965,1288,51,2304,0.4188368055555556,0.5590277777777778,0.022135416666666668,-198,24,95,-79,-0.06920347979903946,0.010805160686809345,0.058398319112230146,-323,-293,-0.1401909722222222,-0.1276017989112696
9544,37097,Iredell,North Carolina,2000,15434,29853,299,45586,0.33856885886017635,0.6548721098582898,0.006559031281533804,0,0,0,0,0.0,0.0,0.0,-14419,0,-0.31630325099811346,0.0
9545,37097,Iredell,North Carolina,2004,18065,38675,233,56973,0.31708002036052163,0.6788303231355204,0.004089656503958016,2631,-66,8822,11387,-0.021488838499654717,-0.0024693747775757884,0.023958213277230578,-20610,-6191,-0.36175030277499876,-0.045447051776885294
9546,37097,Iredell,North Carolina,2008,27318,45148,696,73162,0.37339055793991416,0.6170963068259478,0.00951313523413794,9253,463,6473,16189,0.05631053757939253,0.005423478730179925,-0.06173401630957254,-17830,2780,-0.2437057488860337,0.11804455388896506
9547,37097,Iredell,North Carolina,2012,26076,49299,990,76365,0.34146533097623255,0.6455706148104499,0.01296405421331762,-1242,294,4151,3203,-0.03192522696368161,0.003450918979179679,0.028474307984502012,-23223,-5393,-0.3041052838342173,-0.06039953494818362
9548,37097,Iredell,North Carolina,2016,24734,54754,3079,82567,0.29956277931861397,0.6631462933133092,0.037290927368076834,-1342,2089,5455,6202,-0.04190255165761858,0.024326873154759215,0.01757567850285935,-30020,-6797,-0.36358351399469524,-0.05947823016047793
9549,37099,Jackson,North Carolina,2000,5722,6237,162,12121,0.47207326128207244,0.5145615048263344,0.013365233891593102,0,0,0,0,0.0,0.0,0.0,-515,0,-0.042488243544262005,0.0
9550,37099,Jackson,North Carolina,2004,6737,7351,86,14174,0.47530689995766895,0.5186256526033582,0.006067447438972767,1015,-76,1114,2053,0.0032336386755965063,-0.007297786452620335,0.004064147777023797,-614,-99,-0.043318752645689296,-0.0008305091014272903
9551,37099,Jackson,North Carolina,2008,8766,7854,246,16866,0.5197438633938101,0.4656705798648168,0.014585556741373178,2029,160,503,2692,0.04443696343614112,0.00851810930240041,-0.05295507273854144,912,1526,0.054073283528993266,0.09739203617468256
9552,37099,Jackson,North Carolina,2012,8095,8254,352,16701,0.48470151487934854,0.49422190288006707,0.021076582240584396,-671,106,400,-165,-0.03504234851446153,0.0064910254992112185,0.028551323015250263,-159,-1071,-0.009520388000718527,-0.06359367152971179
9553,37099,Jackson,North Carolina,2016,7713,9870,1130,18713,0.41217335542136485,0.5274408165446481,0.060385828033987066,-382,778,1616,2012,-0.07252815945798369,0.03930924579340267,0.03321891366458107,-2157,-1998,-0.11526746112328329,-0.10574707312256476
9554,37101,Johnston,North Carolina,2000,13704,27212,239,41155,0.33298505649374316,0.6612076296926255,0.005807313813631394,0,0,0,0,0.0,0.0,0.0,-13508,0,-0.3282225731988823,0.0
9555,37101,Johnston,North Carolina,2004,17266,36903,188,54357,0.3176407822359586,0.6789006015784536,0.0034586161855878726,3562,-51,9691,13202,-0.015344274257784563,-0.002348697628043521,0.01769297188582808,-19637,-6129,-0.36125981934249496,-0.03303724614361264
9556,37101,Johnston,North Carolina,2008,26795,43622,600,71017,0.37730402579664024,0.6142472929016995,0.008448681301660165,9529,412,6719,16660,0.059663243560681645,0.0049900651160722925,-0.064653308676754,-16827,2810,-0.2369432671050593,0.12431655223743565
9557,37101,Johnston,North Carolina,2012,27290,48427,974,76691,0.35584358008110467,0.6314561030629409,0.012700316855954415,495,374,4805,5674,-0.02146044571553557,0.0042516355542942495,0.017208810161241317,-21137,-4310,-0.2756125229818362,-0.03866925587677689
9558,37101,Johnston,North Carolina,2016,28362,54372,3175,85909,0.33014003189421365,0.6329022570394255,0.036957711066360914,1072,2201,5945,9218,-0.025703548186891023,0.0242573942104065,0.001446153976484621,-26010,-4873,-0.30276222514521184,-0.027149702163375644
9559,37103,Jones,North Carolina,2000,1822,2114,28,3964,0.45963673057517657,0.5332996972754793,0.007063572149344097,0,0,0,0,0.0,0.0,0.0,-292,0,-0.07366296670030276,0.0
9560,37103,Jones,North Carolina,2004,1893,2607,13,4513,0.4194549080434301,0.5776645247064037,0.0028805672501661865,71,-15,493,549,-0.04018182253174646,-0.00418300489917791,0.0443648274309244,-714,-422,-0.15820961666297362,-0.08454664996267086
9561,37103,Jones,North Carolina,2008,2378,2817,32,5227,0.4549454754161087,0.5389324660417065,0.00612205854218481,485,19,210,714,0.03549056737267858,0.0032414912920186232,-0.0387320586646972,-439,275,-0.08398699062559783,0.07422262603737578
9562,37103,Jones,North Carolina,2012,2352,2837,41,5230,0.4497131931166348,0.5424474187380497,0.007839388145315488,-26,9,20,3,-0.005232282299473867,0.0017173296031306783,0.0035149526963431654,-485,-46,-0.09273422562141487,-0.008747234995817033
9563,37103,Jones,North Carolina,2016,2065,2974,96,5135,0.4021421616358325,0.5791626095423564,0.0186952288218111,-287,55,137,-95,-0.04757103148080233,0.010855840676495612,0.03671519080430674,-909,-424,-0.17702044790652394,-0.08428622228510907
9564,37105,Lee,North Carolina,2000,6785,9406,92,16283,0.41669225572683166,0.5776576797887367,0.005650064484431616,0,0,0,0,0.0,0.0,0.0,-2621,0,-0.16096542406190506,0.0
9565,37105,Lee,North Carolina,2004,7657,11834,52,19543,0.3918026915007931,0.6055365092360436,0.002660799263163281,872,-40,2428,3260,-0.024889564226038552,-0.0029892652212683353,0.027878829447306908,-4177,-1556,-0.21373381773525052,-0.05276839367334546
9566,37105,Lee,North Carolina,2008,10784,12775,229,23788,0.45333781738691775,0.5370354800739869,0.009626702539095342,3127,177,941,4245,0.06153512588612464,0.006965903275932061,-0.06850102916205669,-1991,2186,-0.08369766268706919,0.13003615504818133
9567,37105,Lee,North Carolina,2012,10801,13158,280,24239,0.4456041915920624,0.5428441767399645,0.011551631667973102,17,51,383,451,-0.00773362579485537,0.0019249291288777597,0.0058086966659776085,-2357,-366,-0.09723998514790216,-0.013542322460832978
9568,37105,Lee,North Carolina,2016,10469,13712,903,25084,0.4173576782012438,0.5466432785839579,0.03599904321479828,-332,623,554,845,-0.028246513390818573,0.024447411546825178,0.0037991018439933466,-3243,-886,-0.12928560038271408,-0.03204561523481192
9569,37107,Lenoir,North Carolina,2000,9527,11512,124,21163,0.45017247082171713,0.5439682464678921,0.005859282710390776,0,0,0,0,0.0,0.0,0.0,-1985,0,-0.09379577564617497,0.0
9570,37107,Lenoir,North Carolina,2004,10207,12939,33,23179,0.4403554941973338,0.558220803313344,0.0014237024893222314,680,-91,1427,2016,-0.009816976624383356,-0.004435580221068545,0.014252556845451902,-2732,-747,-0.11786530911601023,-0.024069533469835258
9571,37107,Lenoir,North Carolina,2008,13378,13401,118,26897,0.4973788898390155,0.4982340037922445,0.004387106368740008,3171,85,462,3718,0.05702339564168174,0.0029634038794177768,-0.05998679952109953,-23,2709,-0.0008551139532289587,0.11701019516278127
9572,37107,Lenoir,North Carolina,2012,13948,13980,158,28086,0.49661753186641033,0.4977568895535142,0.0056255785800754824,570,40,579,1189,-0.0007613579726051811,0.0012384722113354743,-0.0004771142387302585,-32,-9,-0.0011393576871038813,-0.00028424373387492263
9573,37107,Lenoir,North Carolina,2016,12634,13613,560,26807,0.47129481105681353,0.5078151229156563,0.020890066027530123,-1314,402,-367,-1279,-0.0253227208095968,0.01526448744745464,0.010058233362142122,-979,-947,-0.0365203118588428,-0.03538095417173892
9574,37109,Lincoln,North Carolina,2000,8412,15951,166,24529,0.3429410086020629,0.6502914917036977,0.006767499694239472,0,0,0,0,0.0,0.0,0.0,-7539,0,-0.3073504831016348,0.0
9575,37109,Lincoln,North Carolina,2004,9434,20052,93,29579,0.3189424929848879,0.6779133844957571,0.0031441225193549476,1022,-73,4101,5050,-0.023998515617174976,-0.0036233771748845245,0.0276218927920594,-10618,-3079,-0.3589708915108692,-0.051620408409234375
9576,37109,Lincoln,North Carolina,2008,11713,23631,454,35798,0.32719705011453154,0.6601206771328008,0.012682272752667747,2279,361,3579,6219,0.008254557129643625,0.0095381502333128,-0.01779270736295635,-11918,-1300,-0.3329236270182692,0.026047264492599975
9577,37109,Lincoln,North Carolina,2012,11024,25267,484,36775,0.299768864717879,0.6870700203942895,0.013161114887831407,-689,30,1636,977,-0.027428185396652538,0.00047884213516365993,0.02694934326148879,-14243,-2325,-0.38730115567641055,-0.05437752865814133
9578,37109,Lincoln,North Carolina,2016,9897,28806,1320,40023,0.24728281238287986,0.7197361517127652,0.03298103590435499,-1127,836,3539,3248,-0.052486052334999145,0.019819921016523585,0.03266613131847562,-18909,-4666,-0.4724533393298853,-0.08515218365347477
9579,37111,McDowell,North Carolina,2000,4747,9109,155,14011,0.33880522446649064,0.6501320391121261,0.0110627364213832,0,0,0,0,0.0,0.0,0.0,-4362,0,-0.3113268146456355,0.0
9580,37111,McDowell,North Carolina,2004,5330,10590,82,16002,0.33308336457942755,0.6617922759655043,0.005124359455068116,583,-73,1481,1991,-0.0057218598870630855,-0.005938376966315083,0.011660236853378136,-5260,-898,-0.3287089113860767,-0.017382096740441222
9581,37111,McDowell,North Carolina,2008,6571,11534,281,18386,0.3573914935276841,0.6273251386924834,0.01528336777983248,1241,199,944,2384,0.02430812894825657,0.010159008324764365,-0.034467137273020865,-4963,297,-0.2699336451647993,0.058775266221277433
9582,37111,McDowell,North Carolina,2012,6031,11775,293,18099,0.3332228299906072,0.6505884303000166,0.016188739709376208,-540,12,241,-287,-0.024168663537076918,0.000905371929543727,0.023263291607533154,-5744,-781,-0.31736560030940936,-0.04743195514461007
9583,37111,McDowell,North Carolina,2016,4667,14568,640,19875,0.2348176100628931,0.7329811320754717,0.03220125786163522,-1364,347,2793,1776,-0.09840521992771412,0.01601251815225901,0.0823927017754551,-9901,-4157,-0.4981635220125786,-0.18079792170316922
9584,37113,Macon,North Carolina,2000,4683,8406,145,13234,0.3538612664349403,0.6351821066948768,0.010956626870182862,0,0,0,0,0.0,0.0,0.0,-3723,0,-0.28132084025993653,0.0
9585,37113,Macon,North Carolina,2004,5489,9448,87,15024,0.36534877529286475,0.6288604898828541,0.00579073482428115,806,-58,1042,1790,0.011487508857924433,-0.005165892045901712,-0.006321616812022701,-3959,-236,-0.2635117145899894,0.017809125669947135
9586,37113,Macon,North Carolina,2008,6620,10317,301,17238,0.38403527091309897,0.598503306648103,0.017461422438798006,1131,214,869,2214,0.018686495620234223,0.011670687614516857,-0.030357183234751117,-3697,262,-0.21446803573500406,0.04904367885498534
9587,37113,Macon,North Carolina,2012,5712,10835,314,16861,0.33876994247079056,0.6426072000474468,0.018622857481762647,-908,13,518,-377,-0.045265328442308406,0.0011614350429646411,0.04410389339934373,-5123,-1426,-0.3038372575766562,-0.08936922184165214
9588,37113,Macon,North Carolina,2016,4876,12127,731,17734,0.27495206947107254,0.6838276756512913,0.04122025487763618,-836,417,1292,873,-0.06381787299971803,0.02259739739587353,0.041220475603844564,-7251,-2128,-0.4088756061802188,-0.10503834860356259
9589,37115,Madison,North Carolina,2000,3505,4676,144,8325,0.421021021021021,0.5616816816816816,0.017297297297297298,0,0,0,0,0.0,0.0,0.0,-1171,0,-0.14066066066066063,0.0
9590,37115,Madison,North Carolina,2004,4234,5175,54,9463,0.44742682024727887,0.546866744161471,0.005706435591250132,729,-90,499,1138,0.026405799226257853,-0.011590861706047166,-0.01481493752021068,-941,230,-0.0994399239141921,0.041220736746468534
9591,37115,Madison,North Carolina,2008,5026,5192,161,10379,0.48424703728682916,0.500240870989498,0.015512091723672801,792,107,17,916,0.036820217039550296,0.00980565613242267,-0.046625873171972976,-166,775,-0.015993833702668825,0.08344609021152327
9592,37115,Madison,North Carolina,2012,4484,5404,225,10113,0.4433896964303372,0.5343617126470879,0.022248590922574904,-542,64,212,-266,-0.04085734085649195,0.006736499198902103,0.034120841657589884,-920,-754,-0.09097201621675066,-0.07497818251408184
9593,37115,Madison,North Carolina,2016,3926,6783,560,11269,0.34838938681338183,0.6019167628006035,0.04969385038601473,-558,335,1379,1156,-0.09500030961695538,0.027445259463439828,0.0675550501535156,-2857,-1937,-0.25352737598722164,-0.16255535977047098
9594,37117,Martin,North Carolina,2000,4929,4420,17,9366,0.5262652146060218,0.47191970958787105,0.0018150758061071962,0,0,0,0,0.0,0.0,0.0,509,0,0.054345505018150775,0.0
9595,37117,Martin,North Carolina,2004,5102,5334,16,10452,0.48813624186758514,0.5103329506314581,0.0015308075009567547,173,-1,914,1086,-0.038128972738436684,-0.00028426830515044144,0.038413241043587065,-232,-741,-0.022196708763872974,-0.07654221378202375
9596,37117,Martin,North Carolina,2008,6539,5957,45,12541,0.5214097759349334,0.47500199346144645,0.003588230603620126,1437,29,623,2089,0.03327353406734829,0.0020574231026633714,-0.03533095717001167,582,814,0.04640778247348698,0.06860449123735995
9597,37117,Martin,North Carolina,2012,6583,5995,74,12652,0.5203129939930445,0.4738381283591527,0.005848877647802719,44,29,38,111,-0.0010967819418888913,0.002260647044182593,-0.0011638651022937707,588,6,0.04647486563389186,6.708316040487938e-05
9598,37117,Martin,North Carolina,2016,5846,5897,221,11964,0.4886325643597459,0.4928953527248412,0.018472082915412906,-737,147,-98,-688,-0.031680429633298646,0.012623205267610186,0.01905722436568852,-51,-639,-0.004262788365095305,-0.050737653998987164
9599,37119,Mecklenburg,North Carolina,2000,126911,134068,2057,263036,0.4824852871850241,0.5096944904879941,0.007820222326981858,0,0,0,0,0.0,0.0,0.0,-7157,0,-0.027209203302969998,0.0
9600,37119,Mecklenburg,North Carolina,2004,166828,155084,1190,323102,0.5163323037307104,0.47998464881059233,0.0036830474586972534,39917,-867,21016,60066,0.03384701654568628,-0.004137174868284604,-0.02970984167740176,11744,18901,0.036347654920118044,0.06355685822308804
9601,37119,Mecklenburg,North Carolina,2008,253958,153848,3011,410817,0.6181779235036525,0.3744927790232634,0.0073292974730841225,87130,1821,-1236,87715,0.10184561977294215,0.003646250014386869,-0.10549186978732894,100110,88366,0.24368514448038914,0.2073374895602711
9602,37119,Mecklenburg,North Carolina,2012,272262,171668,4970,448900,0.6065092448206728,0.3824192470483404,0.011071508130986858,18304,1959,17820,38083,-0.011668678682979716,0.003742210657902735,0.007926468025077016,100594,484,0.2240899977723324,-0.019595146708056732
9603,37119,Mecklenburg,North Carolina,2016,294562,155518,22777,472857,0.6229409736981794,0.3288901295740573,0.04816889672776336,22300,17807,-16150,23957,0.016431728877506546,0.0370973885967765,-0.05352911747428313,139044,38450,0.2940508441241221,0.06996084635178967
9604,37121,Mitchell,North Carolina,2000,1535,4984,81,6600,0.23257575757575757,0.7551515151515151,0.012272727272727272,0,0,0,0,0.0,0.0,0.0,-3449,0,-0.5225757575757576,0.0
9605,37121,Mitchell,North Carolina,2004,2080,5686,32,7798,0.26673506027186455,0.7291613234162606,0.004103616311874839,545,-49,702,1198,0.03415930269610698,-0.008169110960852433,-0.02599019173525452,-3606,-157,-0.46242626314439605,0.06014949443136153
9606,37121,Mitchell,North Carolina,2008,2238,5499,109,7846,0.2852408870762172,0.7008666836604639,0.013892429263318889,158,77,-187,48,0.018505826804352643,0.00978881295144405,-0.028294639755796713,-3261,345,-0.4156257965842467,0.046800466560149356
9607,37121,Mitchell,North Carolina,2012,1838,5806,121,7765,0.23670315518351578,0.7477141017385706,0.015582743077913715,-400,12,307,-81,-0.04853773189270141,0.0016903138145948262,0.04684741807810666,-3968,-707,-0.5110109465550547,-0.09538514997080805
9608,37121,Mitchell,North Carolina,2016,1596,6282,218,8096,0.19713438735177866,0.7759387351778656,0.026926877470355732,-242,97,476,331,-0.03956876783173713,0.011344134392442017,0.028224633439295044,-4686,-718,-0.5788043478260869,-0.06779340127103217
9609,37123,Montgomery,North Carolina,2000,3979,4946,49,8974,0.4433920213951415,0.5511477601961221,0.00546021840873635,0,0,0,0,0.0,0.0,0.0,-967,0,-0.1077557388009806,0.0
9610,37123,Montgomery,North Carolina,2004,4313,5745,22,10080,0.4278769841269841,0.5699404761904762,0.0021825396825396826,334,-27,799,1106,-0.015515037268157394,-0.003277678726196667,0.01879271599435406,-1432,-465,-0.14206349206349206,-0.03430775326251145
9611,37123,Montgomery,North Carolina,2008,4926,6155,129,11210,0.43942908117752005,0.5490633363068689,0.011507582515611061,613,107,410,1130,0.011552097050535948,0.009325042833071378,-0.020877139883607287,-1229,203,-0.10963425512934882,0.032429236934143235
9612,37123,Montgomery,North Carolina,2012,4706,6404,121,11231,0.41901878728519276,0.5702074614905173,0.010773751224289911,-220,-8,249,21,-0.02041029389232729,-0.0007338312913211503,0.021144125183648388,-1698,-469,-0.1511886742053245,-0.04155441907597568
9613,37123,Montgomery,North Carolina,2016,4150,7130,260,11540,0.3596187175043328,0.6178509532062392,0.022530329289428077,-556,139,726,309,-0.05940006978085999,0.011756578065138166,0.04764349171572191,-2980,-1282,-0.2582322357019064,-0.1070435614965819
9614,37125,Moore,North Carolina,2000,11232,19882,187,31301,0.3588383757707421,0.6351873742052969,0.005974250023960896,0,0,0,0,0.0,0.0,0.0,-8650,0,-0.2763489984345548,0.0
9615,37125,Moore,North Carolina,2004,13555,24714,113,38382,0.353160335573967,0.643895576051274,0.0029440883747590017,2323,-74,4832,7081,-0.005678040196775147,-0.0030301616492018945,0.008708201845977093,-11159,-2509,-0.29073524047730703,-0.01438624204275224
9616,37125,Moore,North Carolina,2008,17624,27314,390,45328,0.3888104482880339,0.602585598305683,0.008603953406283091,4069,277,2600,6946,0.03565011271406693,0.00565986503152409,-0.041309977745590976,-9690,1469,-0.21377515001764913,0.0769600904596579
9617,37125,Moore,North Carolina,2012,16505,29495,415,46415,0.3555962512118927,0.6354626737046214,0.008941075083485942,-1119,25,2181,1087,-0.033214197076141205,0.00033712167720285034,0.03287707539893836,-12990,-3300,-0.2798664224927287,-0.06609127247507957
9618,37125,Moore,North Carolina,2016,16329,30490,1873,48692,0.3353528300336811,0.6261808921383389,0.038466277827979956,-176,1458,995,2277,-0.020243421178211596,0.029525202744494015,-0.009281781566282454,-14161,-1171,-0.29082806210465784,-0.010961639611929141
9619,37127,Nash,North Carolina,2000,12376,17995,142,30513,0.4055976141316816,0.5897486317307378,0.004653754137580703,0,0,0,0,0.0,0.0,0.0,-5619,0,-0.18415101759905617,0.0
9620,37127,Nash,North Carolina,2004,15693,21902,78,37673,0.41655827781169535,0.5813712738566081,0.0020704483316964406,3317,-64,3907,7160,0.01096066368001375,-0.0025833058058842627,-0.008377357874129632,-6209,-590,-0.16481299604491279,0.01933802155414338
9621,37127,Nash,North Carolina,2008,23099,23728,291,47118,0.4902372766246445,0.5035867396748589,0.0061759837004966255,7406,213,1826,9445,0.07367899881294915,0.004105535368800185,-0.07778453418174924,-629,5580,-0.013349463050214394,0.1514635329946984
9622,37127,Nash,North Carolina,2012,24313,23842,337,48492,0.5013816712034975,0.4916687288624928,0.006949599934009733,1214,46,114,1374,0.011144394578853023,0.0007736162335131077,-0.011918010812366098,471,1100,0.009712942341004727,0.02306240539121912
9623,37127,Nash,North Carolina,2016,23235,23319,1111,47665,0.48746459666421904,0.4892268960453163,0.0233085072904647,-1078,774,-523,-827,-0.013917074539278484,0.01635890735645497,-0.0024418328171765258,-84,-555,-0.001762299381097232,-0.011475241722101959
9624,37129,New Hanover,North Carolina,2000,29292,36503,524,66319,0.44168337882054914,0.5504154163965078,0.007901204782943047,0,0,0,0,0.0,0.0,0.0,-7211,0,-0.10873203757595867,0.0
9625,37129,New Hanover,North Carolina,2004,35572,45351,324,81247,0.4378253966300294,0.5581867638189718,0.0039878395509988064,6280,-200,8848,14928,-0.0038579821905197487,-0.003913365231944241,0.007771347422463992,-9779,-2568,-0.12036136718894241,-0.011629329612983741
9626,37129,New Hanover,North Carolina,2008,49145,50544,976,100665,0.48820344707693836,0.502101028162718,0.009695524760343714,13573,652,5193,19418,0.05037805044690896,0.005707685209344907,-0.056085735656253854,-1399,8380,-0.013897581085779598,0.10646378610316282
9627,37129,New Hanover,North Carolina,2012,48668,53385,1575,103628,0.46964140965762147,0.5151599953680472,0.015198594974331263,-477,599,2841,2963,-0.01856203741931689,0.005503070213987549,0.013058967205329286,-4717,-3318,-0.045518585710425774,-0.031621004624646176
9628,37129,New Hanover,North Carolina,2016,50979,55344,5582,111905,0.4555560520084,0.49456235199499576,0.049881595996604265,2311,4007,1959,8277,-0.014085357649221475,0.034683001022273,-0.020597643373051477,-4365,352,-0.03900629998659577,0.0065122857238300025
9629,37131,Northampton,North Carolina,2000,5513,2667,20,8200,0.6723170731707317,0.3252439024390244,0.0024390243902439024,0,0,0,0,0.0,0.0,0.0,2846,0,0.34707317073170735,0.0
9630,37131,Northampton,North Carolina,2004,5584,3176,10,8770,0.6367160775370582,0.3621436716077537,0.0011402508551881414,71,-10,509,570,-0.03560099563367358,-0.001298773535055761,0.03689976916872928,2408,-438,0.2745724059293045,-0.07250076480240286
9631,37131,Northampton,North Carolina,2008,6903,3671,44,10618,0.6501224336033151,0.3457336598229422,0.004143906573742701,1319,34,495,1848,0.013406356066256953,0.0030036557185545596,-0.016410011784811496,3232,824,0.30438877378037293,0.029816367851068448
9632,37131,Northampton,North Carolina,2012,7232,3483,41,10756,0.6723689103756043,0.32381926366679065,0.0038118259576050578,329,-3,-188,138,0.022246476772289192,-0.0003320806161376433,-0.02191439615615154,3749,517,0.34854964670881367,0.04416087292844073
9633,37131,Northampton,North Carolina,2016,6144,3582,122,9848,0.6238830219333875,0.3637286758732738,0.012388302193338748,-1088,81,99,-908,-0.048485888442216796,0.00857647623573369,0.03990941220648314,2562,-1187,0.26015434606011373,-0.08839530064869994
9634,37133,Onslow,North Carolina,2000,10269,19657,289,30215,0.33986430580837335,0.650570908489161,0.009564785702465663,0,0,0,0,0.0,0.0,0.0,-9388,0,-0.31070660268078765,0.0
9635,37133,Onslow,North Carolina,2004,11250,25890,137,37277,0.30179467231805135,0.6945301392279422,0.003675188454006492,981,-152,6233,7062,-0.038069633490322,-0.0058895972484591715,0.04395923073878116,-14640,-5252,-0.3927354669098908,-0.08202886422910316
9636,37133,Onslow,North Carolina,2008,19499,30278,426,50203,0.3884030834810669,0.6031113678465431,0.008485548672390096,8249,289,4388,12926,0.08660841116301554,0.004810360218383604,-0.09141877138139909,-10779,3861,-0.21470828436547618,0.17802718254441463
9637,37133,Onslow,North Carolina,2012,18490,32243,702,51435,0.35948284242247497,0.6268688636142704,0.013648293963254593,-1009,276,1965,1232,-0.028920241058591922,0.005162745290864497,0.023757495767727344,-13753,-2974,-0.26738602119179544,-0.052677736826319266
9638,37133,Onslow,North Carolina,2016,17514,37122,2499,57135,0.30653714885796796,0.6497243370963508,0.043738514045681284,-976,1797,4879,5700,-0.05294569356450701,0.03009022008242669,0.02285547348208039,-19608,-5855,-0.34318718823838285,-0.0758011670465874
9639,37135,Orange,North Carolina,2000,30921,17930,493,49344,0.6266415369649806,0.3633673800259403,0.009991083009079117,0,0,0,0,0.0,0.0,0.0,12991,0,0.26327415693904027,0.0
9640,37135,Orange,North Carolina,2004,42910,20771,472,64153,0.6688697332938444,0.323772855517279,0.007357411188876592,11989,-21,2841,14809,0.042228196328863765,-0.0026336718202025254,-0.0395945245086613,22139,9148,0.34509687777656534,0.08182272083752506
9641,37135,Orange,North Carolina,2008,53806,20266,838,74910,0.718275263649713,0.27053797890802295,0.01118675744226405,10896,366,-505,10757,0.04940553035586859,0.0038293462533874585,-0.05323487660925608,33540,11401,0.44773728474169,0.10264040696512466
9642,37135,Orange,North Carolina,2012,53901,21539,1317,76757,0.7022291126542205,0.280612843128314,0.017158044217465508,95,479,1273,1847,-0.016046150995492447,0.005971286775201458,0.01007486422029108,32362,-1178,0.4216162695259065,-0.026121015215783527
9643,37135,Orange,North Carolina,2016,59923,18557,3860,82340,0.7277507894097643,0.22537041535098373,0.04687879523925188,6022,2543,-2982,5583,0.025521676755543843,0.029720751021786375,-0.055242427777330294,41366,9004,0.5023803740587807,0.08076410453287419
9644,37137,Pamlico,North Carolina,2000,2188,2999,55,5242,0.41739793971766503,0.5721098817245326,0.010492178557802366,0,0,0,0,0.0,0.0,0.0,-811,0,-0.15471194200686755,0.0
9645,37137,Pamlico,North Carolina,2004,2335,3679,24,6038,0.38671745611129515,0.6093077177873468,0.003974826101358066,147,-31,680,796,-0.03068048360636988,-0.0065173524564443005,0.03719783606281424,-1344,-533,-0.22259026167605167,-0.06787831966918412
9646,37137,Pamlico,North Carolina,2008,2838,3823,51,6712,0.42282479141835516,0.5695768772348033,0.007598331346841478,503,27,144,674,0.03610733530706001,0.003623505245483412,-0.0397308405525435,-985,359,-0.14675208581644816,0.07583817585960351
9647,37137,Pamlico,North Carolina,2012,2647,4051,64,6762,0.3914522330671399,0.5990831115054718,0.009464655427388346,-191,13,228,50,-0.031372558351215274,0.0018663240805468677,0.029506234270668452,-1404,-419,-0.2076308784383319,-0.060878792621883726
9648,37137,Pamlico,North Carolina,2016,2448,4258,164,6870,0.3563318777292576,0.6197962154294032,0.023871906841339156,-199,100,207,108,-0.03512035533788227,0.01440725141395081,0.020713103923931442,-1810,-406,-0.2634643377001456,-0.05583345926181371
9649,37139,Pasquotank,North Carolina,2000,5874,4943,86,10903,0.5387508025314134,0.453361460148583,0.007887737320003668,0,0,0,0,0.0,0.0,0.0,931,0,0.08538934238283041,0.0
9650,37139,Pasquotank,North Carolina,2004,6984,6609,55,13648,0.5117233294255569,0.48424677608440797,0.00402989449003517,1110,-31,1666,2745,-0.027027473105856514,-0.0038578428299684987,0.030885315935824997,375,-556,0.0274765533411489,-0.05791278904168151
9651,37139,Pasquotank,North Carolina,2008,10272,7778,130,18180,0.565016501650165,0.42783278327832786,0.007150715071507151,3288,75,1169,4532,0.053293172224608165,0.0031208205814719815,-0.056413992806080115,2494,2119,0.13718371837183718,0.10970716503068828
9652,37139,Pasquotank,North Carolina,2012,10282,7633,192,18107,0.5678466891257524,0.42154967692052797,0.010603633953719556,10,62,-145,-73,0.002830187475587387,0.003452918882212405,-0.006283106357799884,2649,155,0.14629701220522445,0.00911329383338727
9653,37139,Pasquotank,North Carolina,2016,8615,8180,596,17391,0.4953711689954574,0.4703582312690472,0.03427059973549537,-1667,404,547,-716,-0.07247552013029501,0.023666965781775816,0.04880855434851922,435,-2214,0.025012937726410223,-0.12128407447881423
9654,37141,Pender,North Carolina,2000,6415,7661,78,14154,0.4532287692525081,0.5412604210823796,0.005510809665112336,0,0,0,0,0.0,0.0,0.0,-1246,0,-0.0880316518298715,0.0
9655,37141,Pender,North Carolina,2004,6999,10037,49,17085,0.409657594381036,0.5874743927421715,0.002868012876792508,584,-29,2376,2931,-0.04357117487147211,-0.002642796788319828,0.04621397165979191,-3038,-1792,-0.1778167983611355,-0.08978514653126402
9656,37141,Pender,North Carolina,2008,9907,13618,224,23749,0.41715440650132635,0.5734136174154701,0.009431976083203503,2908,175,3581,6664,0.007496812120290353,0.006563963206410995,-0.014060775326701358,-3711,-673,-0.1562592109141438,0.02155758744699171
9657,37141,Pender,North Carolina,2012,9632,14617,278,24527,0.39271007461165247,0.5959554776368899,0.011334447751457578,-275,54,999,778,-0.024444331889673876,0.0019024716682540747,0.022541860221419796,-4985,-1274,-0.20324540302523747,-0.04698619211109367
9658,37141,Pender,North Carolina,2016,9354,17639,892,27885,0.335449166218397,0.6325623094853864,0.031988524296216604,-278,614,3022,3358,-0.05726090839325548,0.020654076544759026,0.036606831848496446,-8285,-3300,-0.2971131432669894,-0.09386774024175193
9659,37143,Perquimans,North Carolina,2000,2033,2230,43,4306,0.47213190896423596,0.5178820250812819,0.009986065954482117,0,0,0,0,0.0,0.0,0.0,-197,0,-0.045750116117045936,0.0
9660,37143,Perquimans,North Carolina,2004,1971,2965,22,4958,0.39753933037515127,0.5980233965308592,0.004437273093989512,-62,-21,735,652,-0.07459257858908469,-0.005548792860492605,0.08014137144957734,-994,-797,-0.20048406615570796,-0.15473395003866203
9661,37143,Perquimans,North Carolina,2008,2772,3678,51,6501,0.4263959390862944,0.5657591139824643,0.007844946931241348,801,29,713,1543,0.02885660871114315,0.0034076738372518364,-0.032264282548394974,-906,88,-0.13936317489616984,0.061120891259538124
9662,37143,Perquimans,North Carolina,2012,2759,3822,71,6652,0.41476247745039085,0.5745640408899579,0.010673481659651233,-13,20,144,151,-0.011633461635903564,0.002828534728409885,0.008804926907493682,-1063,-157,-0.15980156343956708,-0.020438388543397246
9663,37143,Perquimans,North Carolina,2016,2319,4177,212,6708,0.34570661896243293,0.6226893261776982,0.031604054859868815,-440,141,355,56,-0.06905585848795792,0.02093057320021758,0.048125285287740294,-1858,-795,-0.2769827072152653,-0.11718114377569822
9664,37145,Person,North Carolina,2000,5042,6722,69,11833,0.42609650976083835,0.5680723400659173,0.005831150173244317,0,0,0,0,0.0,0.0,0.0,-1680,0,-0.141975830305079,0.0
9665,37145,Person,North Carolina,2004,6198,8973,43,15214,0.4073879321677402,0.589785723675562,0.002826344156697778,1156,-26,2251,3381,-0.01870857759309813,-0.0030048060165465385,0.0217133836096447,-2775,-1095,-0.18239779150782182,-0.04042196120274283
9666,37145,Person,North Carolina,2008,8446,10030,156,18632,0.45330613997423785,0.5383211678832117,0.008372692142550452,2248,113,1057,3418,0.045918207806497635,0.005546347985852674,-0.05146455579235032,-1584,1191,-0.08501502790897386,0.09738276359884795
9667,37145,Person,North Carolina,2012,8418,10496,192,19106,0.4405945776195959,0.5493562231759657,0.010049199204438397,-28,36,466,474,-0.012711562354641937,0.0016765070618879451,0.011035055292753948,-2078,-494,-0.10876164555636975,-0.023746617647395885
9668,37145,Person,North Carolina,2016,7833,11185,597,19615,0.39933724190670405,0.5702268671934744,0.030435890899821565,-585,405,689,509,-0.04125733571289186,0.020386691695383166,0.02087064401750871,-3352,-1274,-0.17088962528677032,-0.06212797973040057
9669,37147,Pitt,North Carolina,2000,19685,23192,198,43075,0.45699361578641906,0.5384097504352873,0.004596633778293674,0,0,0,0,0.0,0.0,0.0,-3507,0,-0.08141613464886821,0.0
9670,37147,Pitt,North Carolina,2004,24924,28590,129,53643,0.46462725798333426,0.5329679548123707,0.002404787204295062,5239,-69,5398,10568,0.007633642196915202,-0.0021918465739986116,-0.005441795622916579,-3666,-159,-0.06834069682903643,0.013075437819831781
9671,37147,Pitt,North Carolina,2008,40501,33927,456,74884,0.5408498477645425,0.45306073393515306,0.006089418300304471,15577,327,5337,21241,0.07622258978120822,0.0036846310960094086,-0.07990722087721763,6574,10240,0.08778911382938942,0.15612981065842585
9672,37147,Pitt,North Carolina,2012,41843,36214,799,78856,0.5306254438470123,0.45924216292989756,0.01013239322309019,1342,343,2287,3972,-0.010224403917530211,0.00404297492278572,0.006181428994744498,5629,-945,0.07138328091711471,-0.01640583291227471
9673,37147,Pitt,North Carolina,2016,41824,35691,3012,80527,0.5193785935152185,0.443217802724552,0.03740360376022949,-19,2213,-523,1671,-0.011246850331793734,0.027271210537139302,-0.016024360205345534,6133,504,0.07616079079066651,0.0047775098735518
9674,37149,Polk,North Carolina,2000,3114,5074,115,8303,0.37504516439841024,0.6111044200891245,0.013850415512465374,0,0,0,0,0.0,0.0,0.0,-1960,0,-0.23605925569071423,0.0
9675,37149,Polk,North Carolina,2004,3787,5140,94,9021,0.41979824853120495,0.5697816206628977,0.01042013080589735,673,-21,66,718,0.04475308413279472,-0.0034302847065680233,-0.04132279942622674,-1353,607,-0.14998337213169277,0.08607588355902146
9676,37149,Polk,North Carolina,2008,4396,5990,176,10562,0.41620905131603864,0.56712743798523,0.0166635106987313,609,82,850,1541,-0.0035891972151663176,0.006243379892833951,-0.0026541826776677047,-1594,-241,-0.15091838666919138,-0.000935014537498613
9677,37149,Polk,North Carolina,2012,4013,6236,140,10389,0.38627394359418615,0.6002502647030513,0.013475791702762537,-383,-36,246,-173,-0.029935107721852483,-0.003187718995968765,0.033122826717821297,-2223,-629,-0.21397632110886516,-0.06305793443967378
9678,37149,Polk,North Carolina,2016,3735,6768,431,10934,0.34159502469361624,0.6189866471556612,0.03941832815072252,-278,291,532,545,-0.04467891890056991,0.025942536447959984,0.01873638245260989,-3033,-810,-0.27739162246204496,-0.0634153013531798
9679,37151,Randolph,North Carolina,2000,11366,30959,371,42696,0.26620760727000187,0.7251030541502717,0.008689338579726438,0,0,0,0,0.0,0.0,0.0,-19593,0,-0.4588954468802698,0.0
9680,37151,Randolph,North Carolina,2004,12966,37771,173,50910,0.25468473777253975,0.7419171086230603,0.0033981536043999213,1600,-198,6812,8214,-0.011522869497462118,-0.005291184975326517,0.01681405447278861,-24805,-5212,-0.4872323708505205,-0.028336923970250727
9681,37151,Randolph,North Carolina,2008,16414,40998,735,58147,0.28228455466318125,0.7050750683612225,0.012640376975596333,3448,562,3227,7237,0.027599816890641504,0.009242223371196411,-0.036842040261837794,-24584,221,-0.4227905136980412,0.0644418571524793
9682,37151,Randolph,North Carolina,2012,14773,45160,782,60715,0.2433171374454418,0.7438030140821873,0.012879848472370913,-1641,47,4162,2568,-0.03896741721773944,0.0002394714967745796,0.03872794572096483,-30387,-5803,-0.5004858766367455,-0.07769536293870427
9683,37151,Randolph,North Carolina,2016,13194,49430,1951,64575,0.2043205574912892,0.7654665118079752,0.03021293070073558,-1579,1169,4270,3860,-0.03899657995415262,0.017333082228364667,0.021663497725787906,-36236,-5849,-0.561145954316686,-0.06066007767994053
9684,37153,Richmond,North Carolina,2000,7935,6263,71,14269,0.556100637746163,0.43892354054243465,0.004975821711402341,0,0,0,0,0.0,0.0,0.0,1672,0,0.11717709720372838,0.0
9685,37153,Richmond,North Carolina,2004,8383,7709,53,16145,0.5192319603592443,0.4774852895633323,0.003282750077423351,448,-18,1446,1876,-0.03686867738691868,-0.00169307163397899,0.03856174902089765,674,-998,0.041746670795912044,-0.07543042640781633
9686,37153,Richmond,North Carolina,2008,9713,9424,190,19327,0.5025611838360843,0.4876080095203601,0.009830806643555647,1330,137,1715,3182,-0.01667077652316007,0.0065480565661322964,0.010122719957027793,289,-385,0.014953174315724183,-0.02679349648018786
9687,37153,Richmond,North Carolina,2012,9904,9332,181,19417,0.5100684966781687,0.48060977493948603,0.009321728382345367,191,-9,-92,90,0.00750731284208439,-0.0005090782612102804,-0.006998234580874063,572,283,0.029458721738682636,0.014505547422958454
9688,37153,Richmond,North Carolina,2016,8501,10383,444,19328,0.4398282284768212,0.5371999172185431,0.02297185430463576,-1403,263,1051,-89,-0.07024026820134749,0.013650125922290394,0.056590142279057065,-1882,-2454,-0.09737168874172192,-0.12683041048040455
9689,37155,Robeson,North Carolina,2000,17834,11721,192,29747,0.5995226409385821,0.3940229266816822,0.006454432379735772,0,0,0,0,0.0,0.0,0.0,6113,0,0.2054997142568999,0.0
9690,37155,Robeson,North Carolina,2004,17868,15909,94,33871,0.5275309261610227,0.4696938383868206,0.0027752354521567123,34,-98,4188,4124,-0.07199171477755939,-0.0036791969275790596,0.0756709117051384,1959,-4154,0.0578370877742021,-0.1476626264826978
9691,37155,Robeson,North Carolina,2008,23058,17433,343,40834,0.5646764950776314,0.4269236420629867,0.008399862859381888,5190,249,1524,6963,0.037145568916608696,0.0056246274072251756,-0.04277019632383389,5625,3666,0.13775285301464468,0.07991576524044258
9692,37155,Robeson,North Carolina,2012,24988,17510,448,42946,0.5818469706142597,0.4077213244539655,0.010431704931774788,1930,105,77,2112,0.017170475536628316,0.0020318420723928997,-0.019202317609021247,7478,1853,0.17412564616029425,0.03637279314564956
9693,37155,Robeson,North Carolina,2016,19016,20762,1080,40858,0.46541680943756425,0.5081501786675804,0.026433011894855352,-5972,632,3252,-2088,-0.11643016117669547,0.016001306963080567,0.10042885421361492,-1746,-9224,-0.04273336923001614,-0.21685901539031038
9694,37157,Rockingham,North Carolina,2000,13260,18979,289,32528,0.4076487948844073,0.5834665518937531,0.008884653221839647,0,0,0,0,0.0,0.0,0.0,-5719,0,-0.17581775700934577,0.0
9695,37157,Rockingham,North Carolina,2004,14430,22840,118,37388,0.3859527121001391,0.6108911950358403,0.0031560928640205414,1170,-171,3861,4860,-0.02169608278426821,-0.005728560357819105,0.027424643142087257,-8410,-2691,-0.22493848293570123,-0.04912072592635547
9696,37157,Rockingham,North Carolina,2008,17255,23899,458,41612,0.41466403921945594,0.5743295203306739,0.011006440449870229,2825,340,1059,4224,0.028711327119316843,0.007850347585849687,-0.03656167470516647,-6644,1766,-0.15966548111121792,0.06527300182448331
9697,37157,Rockingham,North Carolina,2012,16351,25227,442,42020,0.38912422655878154,0.6003569728700618,0.010518800571156593,-904,-16,1328,408,-0.0255398126606744,-0.00048763987871363636,0.026027452539387985,-8876,-2232,-0.2112327463112803,-0.051567265200062384
9698,37157,Rockingham,North Carolina,2016,14228,26830,1220,42278,0.3365343677562799,0.6346090165097686,0.028856615733951464,-2123,778,1603,258,-0.052589858802501666,0.01833781516279487,0.0342520436397068,-12602,-3726,-0.29807464875348877,-0.08684190244220846
9699,37159,Rowan,North Carolina,2000,14891,28922,320,44133,0.3374119139872658,0.6553372759612988,0.007250810051435434,0,0,0,0,0.0,0.0,0.0,-14031,0,-0.317925361974033,0.0
9700,37159,Rowan,North Carolina,2004,16735,34915,217,51867,0.32265216804519253,0.6731640542155899,0.004183777739217615,1844,-103,5993,7734,-0.014759745942073244,-0.0030670323122178192,0.01782677825429113,-18180,-4149,-0.35051188617039736,-0.032586524196364375
9701,37159,Rowan,North Carolina,2008,23391,37451,718,61560,0.3799707602339181,0.6083658219623131,0.01166341780376868,6656,501,2536,9693,0.05731859218872559,0.007479640064551066,-0.06479823225327674,-14060,4120,-0.22839506172839502,0.12211682444200234
9702,37159,Rowan,North Carolina,2012,22650,38775,887,62312,0.3634933881114392,0.6222717935550135,0.014234818333547311,-741,169,1324,752,-0.016477372122478906,0.0025714005297786304,0.01390597159270035,-16125,-2065,-0.2587784054435743,-0.030383343715179256
9703,37159,Rowan,North Carolina,2016,19400,42810,2159,64369,0.3013873137690503,0.6650716960027342,0.033540990228215446,-3250,1272,4035,2057,-0.062106074342388906,0.019306171894668135,0.042799902447720695,-23410,-7285,-0.3636843822336839,-0.1049059767901096
9704,37161,Rutherford,North Carolina,2000,7697,13755,264,21716,0.35443912322711363,0.6334039417940689,0.012156934978817462,0,0,0,0,0.0,0.0,0.0,-6058,0,-0.27896481856695526,0.0
9705,37161,Rutherford,North Carolina,2004,8184,16343,131,24658,0.3319003974369373,0.6627869251358586,0.005312677427204153,487,-133,2588,2942,-0.02253872579017635,-0.006844257551613309,0.02938298334178968,-8159,-2101,-0.3308865276989213,-0.05192170913196603
9706,37161,Rutherford,North Carolina,2008,9641,18769,310,28720,0.33568941504178273,0.653516713091922,0.010793871866295265,1457,179,2426,4062,0.003789017604845457,0.0054811944390911116,-0.009270212043936521,-9128,-969,-0.3178272980501393,0.013059229648781978
9707,37161,Rutherford,North Carolina,2012,9374,18954,374,28702,0.3265974496550763,0.660372099505261,0.013030450839662741,-267,64,185,-18,-0.009091965386706424,0.0022365789733674764,0.0068553864133389375,-9580,-452,-0.3337746498501847,-0.015947351800045362
9708,37161,Rutherford,North Carolina,2016,7512,21871,924,30307,0.24786352987758603,0.7216484640512093,0.030488006071204672,-1862,550,2917,1605,-0.07873391977749028,0.01745755523154193,0.061276364545948314,-14359,-4779,-0.4737849341736233,-0.1400102843234386
9709,37163,Sampson,North Carolina,2000,8768,10410,61,19239,0.4557409428764489,0.5410884141587401,0.003170642964811061,0,0,0,0,0.0,0.0,0.0,-1642,0,-0.0853474712822912,0.0
9710,37163,Sampson,North Carolina,2004,9649,12600,39,22288,0.4329235463029433,0.5653266331658291,0.0017498205312275663,881,-22,2190,3049,-0.02281739657350562,-0.0014208224335834946,0.024238219007089,-2951,-1309,-0.13240308686288582,-0.04705561558059462
9711,37163,Sampson,North Carolina,2008,11836,14038,164,26038,0.4545664029495353,0.5391351102235195,0.0062984868269452335,2187,125,1438,3750,0.021642856646592046,0.004548666295717667,-0.026191522942309642,-2202,749,-0.08456870727398413,0.04783437958890169
9712,37163,Sampson,North Carolina,2012,11566,14422,186,26174,0.4418888973790785,0.5510048139374952,0.007106288683426301,-270,22,384,136,-0.012677505570456826,0.0008078018564810678,0.011869703713975777,-2856,-654,-0.10911591655841674,-0.024547209284432603
9713,37163,Sampson,North Carolina,2016,10547,14838,543,25928,0.4067803147176797,0.572277074976859,0.020942610305461278,-1019,357,416,-246,-0.03510858266139877,0.013836321622034978,0.02127226103936375,-4291,-1435,-0.16549676025917925,-0.05638084370076252
9714,37165,Scotland,North Carolina,2000,5627,3740,36,9403,0.5984260342443901,0.39774540040412637,0.003828565351483569,0,0,0,0,0.0,0.0,0.0,1887,0,0.20068063384026374,0.0
9715,37165,Scotland,North Carolina,2004,6386,5141,20,11547,0.5530440807136052,0.4452238676712566,0.001732051615138131,759,-16,1401,2144,-0.04538195353078489,-0.002096513736345438,0.04747846726713023,1245,-642,0.10782021304234862,-0.09286042079791512
9716,37165,Scotland,North Carolina,2008,8151,6005,61,14217,0.573327706267145,0.4223816557642259,0.004290637968629106,1765,41,864,2670,0.020283625553539797,0.0025585863534909746,-0.022842211907030674,2146,901,0.1509460505029191,0.04312583746057047
9717,37165,Scotland,North Carolina,2012,8215,5831,110,14156,0.5803192992370726,0.41191014410850524,0.007770556654422153,64,49,-174,-61,0.006991592969927574,0.0034799186857930476,-0.010471511655720689,2384,238,0.16840915512856736,0.017463104625648262
9718,37165,Scotland,North Carolina,2016,7319,6256,353,13928,0.5254882251579552,0.4491671453187823,0.025344629523262493,-896,243,425,-228,-0.05483107407911736,0.01757407286884034,0.037257001210277085,1063,-1321,0.07632107983917291,-0.09208807528939444
9719,37167,Stanly,North Carolina,2000,7066,15548,204,22818,0.30966780611797706,0.6813918836006662,0.008940310281356823,0,0,0,0,0.0,0.0,0.0,-8482,0,-0.3717240774826891,0.0
9720,37167,Stanly,North Carolina,2004,7650,17814,89,25553,0.29937776386334286,0.6971392791453058,0.003482956991351309,584,-115,2266,2735,-0.010290042254634202,-0.005457353290005514,0.015747395544639664,-10164,-1682,-0.39776151528196296,-0.026037437799273866
9721,37167,Stanly,North Carolina,2008,8878,19329,299,28506,0.31144320493931105,0.67806777520522,0.010489019855469024,1228,210,1515,2953,0.012065441075968186,0.007006062864117715,-0.019071503940085832,-10451,-287,-0.36662457026590894,0.03113694501605402
9722,37167,Stanly,North Carolina,2012,8431,19904,382,28717,0.2935891632134276,0.6931086116237769,0.013302225162795557,-447,83,575,211,-0.01785404172588345,0.002813205307326533,0.015040836418556913,-11473,-1022,-0.3995194484103493,-0.032894878144440365
9723,37167,Stanly,North Carolina,2016,7094,21964,859,29917,0.23712270615369188,0.7341645218437678,0.02871277200254036,-1337,477,2060,1200,-0.056466457059735714,0.015410546839744804,0.04105591021999089,-14870,-3397,-0.4970418156900759,-0.09752236727972657
9724,37169,Stokes,North Carolina,2000,5030,12028,124,17182,0.29274822488650915,0.700034920265394,0.007216854848096845,0,0,0,0,0.0,0.0,0.0,-6998,0,-0.4072866953788849,0.0
9725,37169,Stokes,North Carolina,2004,5767,13583,64,19414,0.29705367260739673,0.6996497373029772,0.003296590089626043,737,-60,1555,2232,0.00430544772088759,-0.003920264758470802,-0.00038518296241685235,-7816,-818,-0.40259606469558046,0.004690630683304442
9726,37169,Stokes,North Carolina,2008,6875,14488,380,21743,0.31619371751828174,0.6663293933679805,0.017476889113737754,1108,316,905,2329,0.019140044910885,0.014180299024111711,-0.03332034393499672,-7613,203,-0.35013567584969874,0.05246038884588172
9727,37169,Stokes,North Carolina,2012,6018,15237,364,21619,0.27836625190804387,0.7047967066006753,0.01683704149128082,-857,-16,749,-124,-0.037827465610237865,-0.0006398476224569356,0.03846731323269481,-9219,-1606,-0.4264304546926314,-0.07629477884293268
9728,37169,Stokes,North Carolina,2016,4665,17116,769,22550,0.20687361419068737,0.7590243902439024,0.0341019955654102,-1353,405,1879,931,-0.0714926377173565,0.017264954074129382,0.054227683643227165,-12451,-3232,-0.552150776053215,-0.12572032136058364
9729,37171,Surry,North Carolina,2000,7757,15401,200,23358,0.33209178868053774,0.6593458344036305,0.008562376915831836,0,0,0,0,0.0,0.0,0.0,-7644,0,-0.32725404572309275,0.0
9730,37171,Surry,North Carolina,2004,8304,17587,101,25992,0.31948291782086796,0.676631271160357,0.003885811018775008,547,-99,2186,2634,-0.012608870859669774,-0.004676565897056828,0.017285436756726558,-9283,-1639,-0.3571483533394891,-0.02989430761639633
9731,37171,Surry,North Carolina,2008,10475,18730,320,29525,0.35478408128704486,0.6343776460626588,0.01083827265029636,2171,219,1143,3533,0.0353011634661769,0.006952461631521352,-0.042253625097698255,-8255,1028,-0.2795935647756139,0.07755478856387515
9732,37171,Surry,North Carolina,2012,9112,19923,435,29470,0.30919579233118427,0.6760434340006787,0.014760773668137089,-1363,115,1193,-55,-0.04558828895586059,0.003922501017840729,0.041665787938019894,-10811,-2556,-0.3668476416694944,-0.08725407689388048
9733,37171,Surry,North Carolina,2016,7488,23671,1037,32196,0.23257547521431235,0.7352155547272953,0.03220897005839235,-1624,602,3748,2726,-0.07662031711687192,0.01744819639025526,0.059172120726616595,-16183,-5372,-0.502640079512983,-0.13579243784348854
9734,37173,Swain,North Carolina,2000,2097,2224,49,4370,0.47986270022883293,0.5089244851258581,0.011212814645308924,0,0,0,0,0.0,0.0,0.0,-127,0,-0.029061784897025156,0.0
9735,37173,Swain,North Carolina,2004,2419,2593,32,5044,0.4795796986518636,0.5140761300555114,0.006344171292624901,322,-17,369,674,-0.0002830015769693106,-0.004868643352684023,0.005151644929653365,-174,-47,-0.03449643140364783,-0.005434646506622676
9736,37173,Swain,North Carolina,2008,2806,2900,92,5798,0.48395998620213865,0.5001724732666437,0.01586754053121766,387,60,307,754,0.0043802875502750305,0.009523369238592759,-0.013903656788867735,-94,80,-0.016212487064505066,0.018283944339142766
9737,37173,Swain,North Carolina,2012,2618,2976,134,5728,0.45705307262569833,0.5195530726256983,0.02339385474860335,-188,42,76,-70,-0.026906913576440317,0.007526314217385692,0.019380599359054562,-358,-264,-0.062499999999999944,-0.04628751293549488
9738,37173,Swain,North Carolina,2016,2196,3565,363,6124,0.35858915741345526,0.5821358589157414,0.059274983670803395,-422,229,589,396,-0.09846391521224307,0.035881128922200044,0.0625827862900431,-1369,-1011,-0.22354670150228612,-0.16104670150228617
9739,37175,Transylvania,North Carolina,2000,5044,9011,170,14225,0.35458699472759225,0.6334622144112478,0.01195079086115993,0,0,0,0,0.0,0.0,0.0,-3967,0,-0.2788752196836556,0.0
9740,37175,Transylvania,North Carolina,2004,6097,9386,105,15588,0.39113420579933283,0.6021298434693354,0.006735950731331794,1053,-65,375,1363,0.03654721107174058,-0.005214840129828135,-0.031332370941912435,-3289,678,-0.21099563767000257,0.06787958201365302
9741,37175,Transylvania,North Carolina,2008,7275,9401,233,16909,0.4302442486249926,0.5559761073984268,0.013779643976580519,1178,128,15,1321,0.039110042825659774,0.007043693245248725,-0.04615373607090856,-2126,1163,-0.12573185877343424,0.08526377889656833
9742,37175,Transylvania,North Carolina,2012,6826,9634,303,16763,0.4072063473125336,0.574718129213148,0.01807552347431844,-449,70,233,-146,-0.02303790131245903,0.004295879497737919,0.018742021814721177,-2808,-682,-0.16751178190061444,-0.04177992312718021
9743,37175,Transylvania,North Carolina,2016,6558,10520,791,17869,0.3670043091387319,0.5887290838882981,0.04426660697296995,-268,488,886,1106,-0.04020203817380169,0.02619108349865151,0.014010954675150122,-3962,-1154,-0.22172477474956626,-0.05421299284895181
9744,37177,Tyrrell,North Carolina,2000,849,706,11,1566,0.5421455938697318,0.4508301404853129,0.0070242656449553,0,0,0,0,0.0,0.0,0.0,143,0,0.09131545338441893,0.0
9745,37177,Tyrrell,North Carolina,2004,731,855,4,1590,0.459748427672956,0.5377358490566038,0.0025157232704402514,-118,-7,149,24,-0.08239716619677584,-0.004508542374515048,0.08690570857129087,-124,-267,-0.07798742138364778,-0.1693028747680667
9746,37177,Tyrrell,North Carolina,2008,933,960,17,1910,0.4884816753926702,0.5026178010471204,0.008900523560209424,202,13,105,320,0.028733247719714194,0.0063848002897691734,-0.03511804800948337,-27,97,-0.014136125654450216,0.06385129572919757
9747,37177,Tyrrell,North Carolina,2012,837,930,16,1783,0.46943353897924844,0.5215928210880538,0.0089736399326977,-96,-1,-30,-127,-0.019048136413421735,7.311637248827614e-05,0.018975020040933432,-93,-66,-0.05215928210880538,-0.03802315645435517
9748,37177,Tyrrell,North Carolina,2016,720,975,44,1739,0.4140310523289247,0.5606670500287522,0.025301897642323174,-117,28,45,-44,-0.05540248665032377,0.016328257709625475,0.03907422894069834,-255,-162,-0.1466359976998275,-0.09447671559102211
9749,37179,Union,North Carolina,2000,14890,31876,395,47161,0.3157269777994529,0.6758974576450881,0.00837556455545896,0,0,0,0,0.0,0.0,0.0,-16986,0,-0.3601704798456352,0.0
9750,37179,Union,North Carolina,2004,17974,42820,207,61001,0.29465090736217436,0.7019557056441698,0.0033933869936558416,3084,-188,10944,13840,-0.02107607043727855,-0.004982177561803119,0.02605824799908163,-24846,-7860,-0.4073047982819954,-0.04713431843636018
9751,37179,Union,North Carolina,2008,31189,54123,777,86089,0.3622878648840154,0.6286865917829223,0.009025543333062295,13215,570,11303,25088,0.06763695752184101,0.005632156339406454,-0.07326911386124746,-22934,1912,-0.2663987268989069,0.14090607138308847
9752,37179,Union,North Carolina,2012,32473,61107,1148,94728,0.3428025504602652,0.6450785406637953,0.012118908875939532,1284,371,6984,8639,-0.019485314423750177,0.003093365542877237,0.01639194888087303,-28634,-5700,-0.30227599020353013,-0.03587726330462321
9753,37179,Union,North Carolina,2016,34337,66707,4666,105710,0.3248226279443761,0.6310377447734368,0.044139627282187115,1864,3518,5600,10982,-0.01797992251588909,0.03202071840624758,-0.01404079589035856,-32370,-3736,-0.30621511682906066,-0.003939126625530531
9754,37181,Vance,North Carolina,2000,7092,5564,45,12701,0.5583812298244233,0.43807574206755373,0.0035430281080229904,0,0,0,0,0.0,0.0,0.0,1528,0,0.12030548775686956,0.0
9755,37181,Vance,North Carolina,2004,8762,6884,31,15677,0.5589079543279964,0.4391146265229317,0.0019774191490718887,1670,-14,1320,2976,0.0005267245035731616,-0.0015656089589511017,0.0010388844553779752,1878,350,0.11979332780506474,-0.0005121599518048137
9756,37181,Vance,North Carolina,2008,13166,7606,99,20871,0.6308274639451871,0.3644291121652053,0.004743423889607589,4404,68,722,5194,0.07191950961719062,0.0027660047405357003,-0.07468551435772641,5560,3682,0.2663983517799818,0.14660502397491704
9757,37181,Vance,North Carolina,2012,13323,7429,102,20854,0.6388702407212046,0.35623861129759277,0.004891147981202647,157,3,-177,-17,0.008042776776017502,0.00014772409159505805,-0.008190500867612527,5894,334,0.2826316294236118,0.01623327764363003
9758,37181,Vance,North Carolina,2016,12229,7332,416,19977,0.6121539770736347,0.3670220753866947,0.02082394753967062,-1094,314,-97,-877,-0.02671626364756985,0.01593279955846797,0.010783464089101913,4897,-997,0.24513190168694005,-0.03749972773667176
9759,37183,Wake,North Carolina,2000,123466,142494,2260,268220,0.4603161583774513,0.53125792260085,0.008425919021698605,0,0,0,0,0.0,0.0,0.0,-19028,0,-0.0709417642233987,0.0
9760,37183,Wake,North Carolina,2004,169909,177324,1611,348844,0.48706298517388863,0.5083189047253214,0.004618110100790038,46443,-649,34830,80624,0.026746826796437306,-0.0038078089209085675,-0.022939017875528656,-7415,11613,-0.021255919551432745,0.04968584467196596
9761,37183,Wake,North Carolina,2008,250891,187001,4353,442245,0.5673122364300331,0.4228448032199347,0.009842960350032222,80982,2742,9677,93401,0.08024925125614452,0.005224850249242184,-0.0854741015053867,63890,71305,0.14446743321009847,0.16572335276153122
9762,37183,Wake,North Carolina,2012,267262,211596,7569,486427,0.5494390730777691,0.43500052423076846,0.015560402691462439,16371,3216,24595,44182,-0.017873163352264076,0.005717442341430217,0.012155721010833787,55666,-8224,0.11443854884700061,-0.030028884363097863
9763,37183,Wake,North Carolina,2016,302736,196082,28806,527624,0.5737722317407851,0.3716320713235183,0.05459569693569663,35474,21237,-15514,41197,0.024333158663015997,0.039035294244234194,-0.06336845290725018,106654,50988,0.2021401604172668,0.08770161157026618
9764,37185,Warren,North Carolina,2000,4576,2202,17,6795,0.6734363502575423,0.3240618101545254,0.002501839587932303,0,0,0,0,0.0,0.0,0.0,2374,0,0.34937454010301694,0.0
9765,37185,Warren,North Carolina,2004,5171,2840,16,8027,0.6442008222249906,0.35380590507038745,0.001993272704621901,595,-1,638,1232,-0.029235528032551694,-0.000508566883310402,0.02974409491586205,2331,-43,0.2903949171546032,-0.058979622948413746
9766,37185,Warren,North Carolina,2008,7086,3063,46,10195,0.6950465914664051,0.3004413928396273,0.004512015693967631,1915,30,223,2168,0.050845769241414485,0.00251874298934573,-0.053364512230760164,4023,1692,0.39460519862677784,0.10421028147217465
9767,37185,Warren,North Carolina,2012,6978,3140,44,10162,0.6866758512103917,0.30899429246211374,0.004329856327494588,-108,-2,77,-33,-0.008370740256013476,-0.0001821593664730432,0.008552899622486454,3838,-185,0.3776815587482779,-0.01692363987849993
9768,37185,Warren,North Carolina,2016,6413,3214,215,9842,0.6515952042267832,0.32655964234911605,0.021845153424100792,-565,171,74,-320,-0.035080646983608466,0.017515297096606205,0.017565349887002313,3199,-639,0.32503556187766713,-0.05264599687061078
9769,37187,Washington,North Carolina,2000,2704,2169,17,4890,0.5529652351738241,0.44355828220858895,0.003476482617586912,0,0,0,0,0.0,0.0,0.0,535,0,0.10940695296523517,0.0
9770,37187,Washington,North Carolina,2004,2969,2484,18,5471,0.5426795832571741,0.45403034180222995,0.003290074940595869,265,1,315,581,-0.010285651916649985,-0.00018640767699104306,0.010472059593641003,485,-50,0.08864924145494418,-0.020757711510290988
9771,37187,Washington,North Carolina,2008,3748,2670,36,6454,0.5807251317012705,0.41369693213511,0.005577936163619461,779,18,186,983,0.038045548444096355,0.002287861223023592,-0.04033340966711996,1078,593,0.1670281995661605,0.07837895811121631
9772,37187,Washington,North Carolina,2012,3833,2622,44,6499,0.5897830435451608,0.403446684105247,0.006770272349592245,85,8,-48,45,0.009057911843890265,0.0011923361859727836,-0.010250248029863018,1211,133,0.18633635943991378,0.019308159873753283
9773,37187,Washington,North Carolina,2016,3510,2564,91,6165,0.5693430656934306,0.4158961881589619,0.014760746147607461,-323,47,-58,-334,-0.02043997785173013,0.007990473798015216,0.012449504053714922,946,-265,0.15344687753446873,-0.03288948190544505
9774,37189,Watauga,North Carolina,2000,7959,10438,326,18723,0.4250921326710463,0.5574961277573038,0.01741173957164984,0,0,0,0,0.0,0.0,0.0,-2479,0,-0.13240399508625755,0.0
9775,37189,Watauga,North Carolina,2004,11232,12659,159,24050,0.46702702702702703,0.5263617463617464,0.006611226611226611,3273,-167,2221,5327,0.041934894355980745,-0.010800512960423229,-0.031134381395557464,-1427,1052,-0.059334719334719344,0.07306927575153821
9776,37189,Watauga,North Carolina,2008,14558,13344,470,28372,0.513111518398421,0.47032285351755254,0.016565628084026503,3326,311,685,4322,0.04608449137139392,0.009954401472799891,-0.05603889284419383,1214,2641,0.04278866488086841,0.10212338421558775
9777,37189,Watauga,North Carolina,2012,13002,13861,811,27674,0.46982727469827273,0.5008672400086724,0.029305485293054854,-1556,341,517,-698,-0.04328424370014822,0.01273985720902835,0.0305443864911199,-859,-2073,-0.03103996531039971,-0.07382863019126812
9778,37189,Watauga,North Carolina,2016,14138,13697,2150,29985,0.4715024178756045,0.45679506419876603,0.07170251792562948,1136,1339,-164,2311,0.0016751431773317504,0.04239703263257463,-0.04407217580990641,441,1300,0.014707353676838453,0.04574731898723816
9779,37191,Wayne,North Carolina,2000,13005,20758,121,33884,0.38380946759532525,0.6126195254397355,0.0035710069649392043,0,0,0,0,0.0,0.0,0.0,-7753,0,-0.22881005784441028,0.0
9780,37191,Wayne,North Carolina,2004,15076,24883,87,40046,0.37646706287769066,0.621360435499176,0.0021725016231333967,2071,-34,4125,6162,-0.0073424047176345875,-0.0013985053418058076,0.008740910059440443,-9807,-2054,-0.2448933726214853,-0.01608331477707503
9781,37191,Wayne,North Carolina,2008,22671,26952,259,49882,0.45449260254199914,0.5403151437392246,0.005192253718776312,7595,172,2069,9836,0.07802553966430847,0.003019752095642915,-0.08104529175995134,-4281,5526,-0.08582254119722549,0.15907083142425982
9782,37191,Wayne,North Carolina,2012,23314,27641,397,51352,0.45400373890014023,0.5382653061224489,0.007730954977410812,643,138,689,1470,-0.0004888636418589054,0.0025387012586345,-0.002049837616775685,-4327,-46,-0.08426156722230871,0.0015609739749167795
9783,37191,Wayne,North Carolina,2016,21770,27540,1379,50689,0.42948174160074176,0.5433131448637771,0.027205113535481072,-1544,982,-101,-663,-0.024521997299398468,0.019474158558070262,0.005047838741328192,-5770,-1443,-0.11383140326303537,-0.02956983604072666
9784,37193,Wilkes,North Carolina,2000,7226,16826,271,24323,0.297085063520125,0.6917732187641327,0.011141717715742301,0,0,0,0,0.0,0.0,0.0,-9600,0,-0.3946881552440077,0.0
9785,37193,Wilkes,North Carolina,2004,7862,19197,95,27154,0.2895337703469102,0.7069676659055756,0.0034985637475141783,636,-176,2371,2831,-0.00755129317321479,-0.007643153968228122,0.015194447141442913,-11335,-1735,-0.4174338955586654,-0.022745740314657703
9786,37193,Wilkes,North Carolina,2008,8934,20288,502,29724,0.3005651998385143,0.6825460907011169,0.016888709460368724,1072,407,1091,2570,0.011031429491604128,0.013390145712854545,-0.024421575204458645,-11354,-19,-0.3819808908626026,0.03545300469606277
9787,37193,Wilkes,North Carolina,2012,8148,20515,482,29145,0.2795676788471436,0.7038943214959684,0.016537999656887972,-786,-20,227,-579,-0.0209975209913707,-0.0003507098034807518,0.021348230794851486,-12367,-1013,-0.4243266426488248,-0.042345751786222185
9788,37193,Wilkes,North Carolina,2016,6638,23752,906,31296,0.21210378323108384,0.7589468302658486,0.028949386503067484,-1510,424,3237,2151,-0.06746389561605978,0.012411386846179512,0.055052508769880215,-17114,-4747,-0.5468430470347648,-0.12251640438594003
9789,37195,Wilson,North Carolina,2000,11266,13466,94,24826,0.4537984371223717,0.54241520986063,0.0037863530169983083,0,0,0,0,0.0,0.0,0.0,-2200,0,-0.08861677273825824,0.0
9790,37195,Wilson,North Carolina,2004,14206,16264,65,30535,0.4652366137219584,0.5326346815130178,0.002128704765023743,2940,-29,2798,5709,0.01143817659958668,-0.0016576482519745652,-0.009780528347612116,-2058,142,-0.06739806779105945,0.021218704947198797
9791,37195,Wilson,North Carolina,2008,19652,17375,164,37191,0.5284074103949881,0.4671829205990697,0.004409669005942298,5446,99,1111,6656,0.06317079667302966,0.0022809642409185545,-0.06545176091394816,2277,4335,0.06122448979591838,0.12862255758697783
9792,37195,Wilson,North Carolina,2012,20875,17954,280,39109,0.5337646066122888,0.45907591602955844,0.007159477358152855,1223,116,579,1918,0.005357196217300686,0.002749808352210557,-0.008107004569511245,2921,644,0.07468869058273031,0.01346420078681193
9793,37195,Wilson,North Carolina,2016,19663,17531,941,38135,0.5156155762422971,0.4597089288055592,0.0246754949521437,-1212,661,-423,-974,-0.018149030369991603,0.017516017593990844,0.000633012776000752,2132,-789,0.055906647436737955,-0.018782043145992355
9794,37197,Yadkin,North Carolina,2000,3127,10435,120,13682,0.22854845782780295,0.7626808946060517,0.0087706475661453,0,0,0,0,0.0,0.0,0.0,-7308,0,-0.5341324367782487,0.0
9795,37197,Yadkin,North Carolina,2004,3451,11816,46,15313,0.2253640697446614,0.7716319467119441,0.0030039835433945013,324,-74,1381,1631,-0.0031843880831415594,-0.005766664022750799,0.00895105210589242,-8365,-1057,-0.5462678769672827,-0.012135440189034008
9796,37197,Yadkin,North Carolina,2008,4527,12409,211,17147,0.2640111972939873,0.7236834431679011,0.012305359538111623,1076,165,593,1834,0.03864712754932592,0.009301375994717122,-0.04794850354404301,-7882,483,-0.4596722458739138,0.08659563109336893
9797,37197,Yadkin,North Carolina,2012,3957,12578,278,16813,0.2353535954321061,0.7481115803247487,0.016534824243145185,-570,67,169,-334,-0.02865760186188121,0.0042294647050335615,0.02442813715684755,-8621,-739,-0.5127579848926426,-0.05308573901872876
9798,37197,Yadkin,North Carolina,2016,3160,13880,584,17624,0.1793009532455742,0.787562414888788,0.03313663186563777,-797,306,1302,811,-0.05605264218653189,0.016601807622492585,0.039450834564039305,-10720,-2099,-0.6082614616432138,-0.09550347675057125
9799,37199,Yancey,North Carolina,2000,3714,4970,80,8764,0.423779096303058,0.5670926517571885,0.009128251939753538,0,0,0,0,0.0,0.0,0.0,-1256,0,-0.1433135554541305,0.0
9800,37199,Yancey,North Carolina,2004,4434,4940,57,9431,0.4701516276110699,0.523804474605026,0.006043897783904146,720,-23,-30,667,0.04637253130801189,-0.0030843541558493916,-0.04328817715216249,-506,750,-0.053652846993956116,0.08966070846017438
9801,37199,Yancey,North Carolina,2008,4486,5045,186,9717,0.46166512298034373,0.5191931666152104,0.019141710404445816,52,129,105,286,-0.008486504630726144,0.01309781262054167,-0.004611307989815572,-559,-53,-0.05752804363486669,-0.003875196640910572
9802,37199,Yancey,North Carolina,2012,3981,5278,192,9451,0.4212252671674955,0.5584594222833562,0.020315310549148237,-505,6,233,-266,-0.04043985581284826,0.0011736001447024205,0.03926625566814579,-1297,-738,-0.13723415511586073,-0.07970611148099405
9803,37199,Yancey,North Carolina,2016,3196,6385,379,9960,0.3208835341365462,0.6410642570281124,0.03805220883534136,-785,187,1107,509,-0.10034173303094929,0.017736898286193126,0.08260483474475622,-3189,-1892,-0.32018072289156624,-0.1829465677757055
9804,38001,Adams,North Dakota,2000,286,826,48,1160,0.24655172413793103,0.7120689655172414,0.041379310344827586,0,0,0,0,0.0,0.0,0.0,-540,0,-0.4655172413793104,0.0
9805,38001,Adams,North Dakota,2004,353,915,23,1291,0.273431448489543,0.7087529047250194,0.017815646785437646,67,-25,89,131,0.026879724351611956,-0.02356366355938994,-0.0033160607922220198,-562,-22,-0.4353214562354764,0.030195785143833975
9806,38001,Adams,North Dakota,2008,435,788,48,1271,0.3422501966955153,0.6199842643587726,0.03776553894571204,82,25,-127,-20,0.06881874820597234,0.01994989216027439,-0.08876864036624676,-353,209,-0.2777340676632573,0.1575873885722191
9807,38001,Adams,North Dakota,2012,328,918,40,1286,0.25505443234836706,0.713841368584759,0.03110419906687403,-107,-8,130,15,-0.08719576434714826,-0.006661339878838008,0.09385710422598637,-590,-237,-0.45878693623639194,-0.18105286857313463
9808,38001,Adams,North Dakota,2016,216,909,93,1218,0.17733990147783252,0.7463054187192119,0.07635467980295567,-112,53,-9,-68,-0.07771453087053454,0.045250480736081636,0.03246405013445286,-693,-103,-0.5689655172413793,-0.1101785810049874
9809,38003,Barnes,North Dakota,2000,1933,3452,363,5748,0.3362908837856646,0.6005567153792624,0.06315240083507306,0,0,0,0,0.0,0.0,0.0,-1519,0,-0.2642658315935978,0.0
9810,38003,Barnes,North Dakota,2004,2186,3541,86,5813,0.3760536728023396,0.6091519009117495,0.01479442628591089,253,-277,89,65,0.039762789016675015,-0.04835797454916217,0.00859518553248717,-1355,164,-0.23309822810940994,0.031167603484187845
9811,38003,Barnes,North Dakota,2008,2741,2826,127,5694,0.4813839128907622,0.49631190727081137,0.022304179838426415,555,41,-715,-119,0.10533024008842262,0.007509753552515526,-0.11283999364093816,-85,1270,-0.014927994380049159,0.21817023372936079
9812,38003,Barnes,North Dakota,2012,2394,2964,164,5522,0.43353857298080406,0.5367620427381383,0.02969938428105759,-347,37,138,-172,-0.04784533990995815,0.007395204442631174,0.04045013546732695,-570,-485,-0.10322346975733426,-0.0882954753772851
9813,38003,Barnes,North Dakota,2016,1597,3160,587,5344,0.2988398203592814,0.5913173652694611,0.10984281437125748,-797,423,196,-178,-0.13469875262152264,0.08014343009019989,0.05455532253132278,-1563,-993,-0.2924775449101797,-0.18925407515284542
9814,38005,Benson,North Dakota,2000,952,1055,147,2154,0.44196843082636955,0.48978644382544106,0.06824512534818941,0,0,0,0,0.0,0.0,0.0,-103,0,-0.04781801299907151,0.0
9815,38005,Benson,North Dakota,2004,1196,1002,48,2246,0.5325022261798753,0.44612644701691895,0.0213713268032057,244,-99,-53,92,0.09053379535350575,-0.04687379854498371,-0.04365999680852212,194,297,0.08637577916295636,0.13419379216202787
9816,38005,Benson,North Dakota,2008,1569,773,32,2374,0.6609098567818029,0.3256107834877843,0.013479359730412805,373,-16,-229,128,0.1284076306019276,-0.007891967072792895,-0.12051566352913462,796,602,0.3352990732940186,0.24892329413106223
9817,38005,Benson,North Dakota,2012,1235,868,54,2157,0.5725544738062124,0.40241075567918405,0.025034770514603615,-334,22,95,-217,-0.08835538297559054,0.01155541078419081,0.07679997219139972,367,-429,0.17014371812702833,-0.16515535516699026
9818,38005,Benson,North Dakota,2016,842,929,240,2011,0.41869716558925907,0.4619592242665341,0.11934361014420686,-393,186,61,-146,-0.15385730821695331,0.09430883962960324,0.05954846858735002,-87,-454,-0.043262058677275006,-0.21340577680430334
9819,38007,Billings,North Dakota,2000,82,394,49,525,0.15619047619047619,0.7504761904761905,0.09333333333333334,0,0,0,0,0.0,0.0,0.0,-312,0,-0.5942857142857143,0.0
9820,38007,Billings,North Dakota,2004,99,449,16,564,0.17553191489361702,0.7960992907801419,0.028368794326241134,17,-33,55,39,0.01934143870314084,-0.0649645390070922,0.045623100303951336,-350,-38,-0.6205673758865249,-0.02628166160081058
9821,38007,Billings,North Dakota,2008,114,375,10,499,0.22845691382765532,0.751503006012024,0.02004008016032064,15,-6,-74,-65,0.05292499893403829,-0.008328714165920494,-0.04459628476811783,-261,89,-0.5230460921843687,0.09752128370215618
9822,38007,Billings,North Dakota,2012,89,472,17,578,0.15397923875432526,0.8166089965397924,0.029411764705882353,-25,7,97,79,-0.07447767507333006,0.009371684545561712,0.06510599052776833,-383,-122,-0.6626297577854671,-0.13958366560109836
9823,38007,Billings,North Dakota,2016,59,495,51,605,0.09752066115702479,0.8181818181818182,0.08429752066115702,-30,34,23,27,-0.05645857759730047,0.054885755955274666,0.001572821642025879,-436,-53,-0.7206611570247934,-0.05803139923932632
9824,38009,Bottineau,North Dakota,2000,1173,2349,168,3690,0.3178861788617886,0.6365853658536585,0.04552845528455285,0,0,0,0,0.0,0.0,0.0,-1176,0,-0.31869918699186994,0.0
9825,38009,Bottineau,North Dakota,2004,1168,2468,38,3674,0.31790963527490473,0.6717474142623843,0.010342950462710943,-5,-130,119,-16,2.345641311612967e-05,-0.035185504821841906,0.03516204840872572,-1300,-124,-0.35383777898747953,-0.03513859199560959
9826,38009,Bottineau,North Dakota,2008,1387,2059,70,3516,0.39448236632536976,0.585608646188851,0.019908987485779295,219,32,-409,-158,0.07657273105046503,0.009566037023068352,-0.08613876807353327,-672,628,-0.19112627986348124,0.1627114991239983
9827,38009,Bottineau,North Dakota,2012,1183,2280,92,3555,0.3327707454289733,0.6413502109704642,0.025879043600562587,-204,22,221,39,-0.06171162089639648,0.005970056114783292,0.055741564781613184,-1097,-425,-0.3085794655414909,-0.11745318567800966
9828,38009,Bottineau,North Dakota,2016,736,2494,264,3494,0.21064682312535776,0.7137950772753291,0.0755580995993131,-447,172,214,-61,-0.12212392230361552,0.04967905599875051,0.07244486630486491,-1758,-661,-0.5031482541499713,-0.19456878860848043
9829,38011,Bowman,North Dakota,2000,330,1080,61,1471,0.22433718558803534,0.7341944255608429,0.04146838885112169,0,0,0,0,0.0,0.0,0.0,-750,0,-0.5098572399728076,0.0
9830,38011,Bowman,North Dakota,2004,397,1280,39,1716,0.23135198135198135,0.745920745920746,0.022727272727272728,67,-22,200,245,0.007014795763946008,-0.01874111612384896,0.011726320359903064,-883,-133,-0.5145687645687647,-0.0047115245959570284
9831,38011,Bowman,North Dakota,2008,478,1107,55,1640,0.2914634146341463,0.675,0.03353658536585366,81,16,-173,-76,0.06011143328216498,0.010809312638580933,-0.07092074592074593,-629,254,-0.3835365853658537,0.13103217920291094
9832,38011,Bowman,North Dakota,2012,414,1280,43,1737,0.23834196891191708,0.7369027058146229,0.02475532527345999,-64,-12,173,97,-0.05312144572222924,-0.008781260092393672,0.06190270581462287,-866,-237,-0.49856073690270586,-0.11502415153685214
9833,38011,Bowman,North Dakota,2016,227,1446,114,1787,0.12702853945159484,0.8091773922775601,0.063794068270845,-187,71,166,50,-0.11131342946032224,0.03903874299738501,0.07227468646293722,-1219,-353,-0.6821488528259653,-0.1835881159232594
9834,38013,Burke,North Dakota,2000,296,698,45,1039,0.2848893166506256,0.6717998075072185,0.04331087584215592,0,0,0,0,0.0,0.0,0.0,-402,0,-0.38691049085659285,0.0
9835,38013,Burke,North Dakota,2004,336,808,21,1165,0.28841201716738196,0.6935622317596567,0.018025751072961373,40,-24,110,126,0.0035227005167563497,-0.025285124769194547,0.02176242425243824,-472,-70,-0.40515021459227474,-0.01823972373568189
9836,38013,Burke,North Dakota,2008,286,640,17,943,0.30328738069989397,0.6786850477200425,0.018027571580063628,-50,-4,-168,-222,0.01487536353251201,1.8205071022556196e-06,-0.014877184039614244,-354,118,-0.3753976670201485,0.029752547572126253
9837,38013,Burke,North Dakota,2012,230,769,24,1023,0.22482893450635386,0.7517106549364614,0.02346041055718475,-56,7,129,80,-0.07845844619354012,0.0054328389771211225,0.07302560721641893,-539,-185,-0.5268817204301075,-0.15148405340995902
9838,38013,Burke,North Dakota,2016,119,895,38,1052,0.11311787072243346,0.8507604562737643,0.03612167300380228,-111,14,126,29,-0.1117110637839204,0.012661262446617527,0.0990498013373029,-776,-237,-0.7376425855513309,-0.21076086512122338
9839,38015,Burleigh,North Dakota,2000,9842,22467,2173,34482,0.2854242793341453,0.6515573342613538,0.0630183864045009,0,0,0,0,0.0,0.0,0.0,-12625,0,-0.36613305492720843,0.0
9840,38015,Burleigh,North Dakota,2004,11621,26577,616,38814,0.2994022775287267,0.6847271603029834,0.015870562168289793,1779,-1557,4110,4332,0.013977998194581398,-0.04714782423621111,0.03316982604162966,-14956,-2331,-0.3853248827742567,-0.01919182784704826
9841,38015,Burleigh,North Dakota,2008,15600,25443,956,41999,0.3714374151765518,0.6058001380985262,0.02276244672492202,3979,340,-1134,3185,0.0720351376478251,0.006891884556632227,-0.07892702220445724,-9843,5113,-0.23436272292197435,0.15096215985228234
9842,38015,Burleigh,North Dakota,2012,14122,27951,1314,43387,0.3254892018346509,0.6442252287551571,0.030285569410191993,-1478,358,2508,1388,-0.04594821334190091,0.007523122685269973,0.03842509065663091,-13829,-3986,-0.3187360269205062,-0.08437330399853182
9843,38015,Burleigh,North Dakota,2016,10881,32532,4566,47979,0.22678671918964546,0.6780466454073657,0.09516663540298881,-3241,3252,4581,4592,-0.09870248264500545,0.06488106599279682,0.033821416652208613,-21651,-7822,-0.45125992621772026,-0.1325238992972141
9844,38017,Cass,North Dakota,2000,21451,33536,4008,58995,0.3636070853462158,0.5684549538096448,0.06793796084413933,0,0,0,0,0.0,0.0,0.0,-12085,0,-0.20484786846342906,0.0
9845,38017,Cass,North Dakota,2004,26010,39619,1082,66711,0.3898907226694248,0.5938900631080332,0.01621921422254201,4559,-2926,6083,7716,0.02628363732320904,-0.051718746621597325,0.025435109298388325,-13609,-1524,-0.20399934043860835,0.0008485280248207161
9846,38017,Cass,North Dakota,2008,37622,32566,1646,71834,0.5237352785588997,0.45335078096723,0.022913940473870312,11612,564,-7053,5123,0.13384455588947486,0.0066947262513283035,-0.14053928214080313,5056,18665,0.07038449759166965,0.274383838030278
9847,38017,Cass,North Dakota,2012,34712,36855,2288,73855,0.47000203100670235,0.4990183467605443,0.030979622232753367,-2910,642,4289,2021,-0.05373324755219733,0.008065681758883055,0.04566756579331427,-2143,-7199,-0.029016315753841948,-0.0994008133455116
9848,38017,Cass,North Dakota,2016,31361,39816,9644,80821,0.3880303386496084,0.49264423850236944,0.11932542284802217,-3351,7356,2961,6966,-0.08197169235709395,0.0883458006152688,-0.00637410825817486,-8455,-6312,-0.10461389985276104,-0.07559758409891909
9849,38019,Cavalier,North Dakota,2000,618,1513,240,2371,0.2606495149725854,0.6381273724167018,0.10122311261071278,0,0,0,0,0.0,0.0,0.0,-895,0,-0.3774778574441164,0.0
9850,38019,Cavalier,North Dakota,2004,887,1522,35,2444,0.36292962356792147,0.6227495908346972,0.014320785597381341,269,-205,9,73,0.10228010859533604,-0.08690232701333143,-0.015377781582004646,-635,260,-0.2598199672667757,0.11765789017734068
9851,38019,Cavalier,North Dakota,2008,930,1128,72,2130,0.43661971830985913,0.5295774647887324,0.03380281690140845,43,37,-394,-314,0.07369009474193766,0.019482031304027106,-0.09317212604596481,-198,437,-0.09295774647887323,0.16686222078790247
9852,38019,Cavalier,North Dakota,2012,818,1195,56,2069,0.3953600773320445,0.5775737071048815,0.02706621556307395,-112,-16,67,-61,-0.04125964097781465,-0.006736601338334498,0.047996242316149185,-377,-179,-0.18221362977283706,-0.08925588329396383
9853,38019,Cavalier,North Dakota,2016,476,1357,173,2006,0.23728813559322035,0.6764705882352942,0.08624127617148554,-342,117,162,-63,-0.15807194173882413,0.05917506060841159,0.09889688113041262,-881,-504,-0.4391824526420738,-0.2569688228692367
9854,38021,Dickey,North Dakota,2000,806,1853,127,2786,0.28930366116295764,0.6651112706389088,0.04558506819813352,0,0,0,0,0.0,0.0,0.0,-1047,0,-0.3758076094759512,0.0
9855,38021,Dickey,North Dakota,2004,883,1890,48,2821,0.3130095710740872,0.6699751861042184,0.017015242821694435,77,-79,37,35,0.023705909911129586,-0.02856982537643909,0.00486391546530951,-1007,40,-0.35696561503013113,0.018841994445820076
9856,38021,Dickey,North Dakota,2008,1044,1525,51,2620,0.3984732824427481,0.5820610687022901,0.019465648854961833,161,3,-365,-201,0.08546371136866088,0.002450406033267398,-0.08791411740192823,-481,526,-0.18358778625954203,0.1733778287705891
9857,38021,Dickey,North Dakota,2012,853,1610,72,2535,0.33648915187376727,0.6351084812623274,0.028402366863905324,-191,21,85,-85,-0.06198413056898083,0.008936718008943492,0.05304741256003731,-757,-276,-0.2986193293885602,-0.11503154312901814
9858,38021,Dickey,North Dakota,2016,554,1667,186,2407,0.23016202742002492,0.692563356875779,0.0772746157041961,-299,114,57,-128,-0.10632712445374234,0.048872248840290775,0.05745487561345153,-1113,-356,-0.4624013294557541,-0.1637820000671939
9859,38023,Divide,North Dakota,2000,306,443,45,794,0.3853904282115869,0.5579345088161209,0.05667506297229219,0,0,0,0,0.0,0.0,0.0,-137,0,-0.17254408060453402,0.0
9860,38023,Divide,North Dakota,2004,487,751,30,1268,0.3840694006309148,0.5922712933753943,0.02365930599369085,181,-15,308,474,-0.0013210275806720961,-0.03301575697860134,0.03433678455927336,-264,-127,-0.20820189274447948,-0.035657812139945455
9861,38023,Divide,North Dakota,2008,464,630,37,1131,0.41025641025641024,0.5570291777188329,0.032714412024756855,-23,7,-121,-137,0.026187009625495417,0.009055106031066004,-0.035242115656561435,-166,98,-0.14677276746242263,0.06142912528205685
9862,38023,Divide,North Dakota,2012,385,733,44,1162,0.3313253012048193,0.6308089500860585,0.0378657487091222,-79,7,103,31,-0.07893110905159095,0.0051513366843653485,0.07377977236722566,-348,-182,-0.29948364888123924,-0.1527108814188166
9863,38023,Divide,North Dakota,2016,245,867,107,1219,0.20098441345365053,0.7112387202625102,0.08777686628383921,-140,63,134,57,-0.13034088775116875,0.04991111757471701,0.0804297701764517,-622,-274,-0.5102543068088596,-0.2107706579276204
9864,38025,Dunn,North Dakota,2000,474,1124,130,1728,0.2743055555555556,0.6504629629629629,0.07523148148148148,0,0,0,0,0.0,0.0,0.0,-650,0,-0.37615740740740733,0.0
9865,38025,Dunn,North Dakota,2004,571,1178,25,1774,0.3218714768883878,0.6640360766629086,0.014092446448703494,97,-105,54,46,0.04756592133283222,-0.06113903503277799,0.013573113699945738,-607,43,-0.34216459977452085,0.03399280763288648
9866,38025,Dunn,North Dakota,2008,527,1080,37,1644,0.32055961070559613,0.656934306569343,0.022506082725060828,-44,12,-98,-130,-0.0013118661827916656,0.008413636276357333,-0.007101770093565607,-553,54,-0.3363746958637469,0.005789903910773941
9867,38025,Dunn,North Dakota,2012,508,1506,20,2034,0.2497541789577188,0.7404129793510325,0.00983284169124877,-19,-17,426,390,-0.07080543174787735,-0.012673241033812057,0.08347867278168941,-998,-445,-0.49065880039331367,-0.15428410452956676
9868,38025,Dunn,North Dakota,2016,358,1771,114,2243,0.15960766830138207,0.7895675434685688,0.05082478823004904,-150,94,265,209,-0.09014651065633672,0.04099194653880027,0.04915456411753638,-1413,-415,-0.6299598751671868,-0.1393010747738731
9869,38027,Eddy,North Dakota,2000,458,703,107,1268,0.361198738170347,0.554416403785489,0.08438485804416404,0,0,0,0,0.0,0.0,0.0,-245,0,-0.19321766561514198,0.0
9870,38027,Eddy,North Dakota,2004,534,655,24,1213,0.4402308326463314,0.5399835119538334,0.01978565539983512,76,-83,-48,-55,0.07903209447598442,-0.06459920264432892,-0.014432891831655525,-121,124,-0.09975267930750203,0.09346498630763994
9871,38027,Eddy,North Dakota,2008,583,548,34,1165,0.5004291845493563,0.4703862660944206,0.029184549356223177,49,10,-107,-48,0.06019835190302486,0.009398893956388057,-0.06959724585941285,35,156,0.030042918454935674,0.1297955977624377
9872,38027,Eddy,North Dakota,2012,486,634,37,1157,0.42005185825410546,0.5479688850475367,0.03197925669835782,-97,3,86,-8,-0.0803773262952508,0.002794707342134644,0.07758261895311613,-148,-183,-0.12791702679343125,-0.15795994524836693
9873,38027,Eddy,North Dakota,2016,355,791,85,1231,0.2883834281072299,0.6425670186839968,0.06904955320877336,-131,48,157,74,-0.13166843014687557,0.03707029651041554,0.09459813363646008,-436,-288,-0.3541835905767669,-0.22626656378333565
9874,38029,Emmons,North Dakota,2000,405,1430,157,1992,0.2033132530120482,0.7178714859437751,0.0788152610441767,0,0,0,0,0.0,0.0,0.0,-1025,0,-0.514558232931727,0.0
9875,38029,Emmons,North Dakota,2004,611,1449,53,2113,0.28916232844297207,0.6857548509228585,0.025082820634169428,206,-104,19,121,0.08584907543092388,-0.05373244041000727,-0.03211663502091666,-838,187,-0.3965925224798864,0.11796571045184057
9876,38029,Emmons,North Dakota,2008,546,1230,61,1837,0.29722373434948285,0.6695699510070767,0.03320631464344039,-65,8,-219,-276,0.008061405906510777,0.008123494009270964,-0.01618489991578176,-684,154,-0.3723462166575939,0.024246305822292535
9877,38029,Emmons,North Dakota,2012,383,1435,66,1884,0.20329087048832273,0.7616772823779193,0.03503184713375796,-163,5,205,47,-0.09393286386116012,0.001825532490317569,0.0921073313708426,-1052,-368,-0.5583864118895966,-0.18604019523200271
9878,38029,Emmons,North Dakota,2016,215,1677,89,1981,0.10853104492680464,0.8465421504290762,0.044926804644119134,-168,23,242,97,-0.09475982556151809,0.009894957510361173,0.0848648680511569,-1462,-410,-0.7380111055022716,-0.17962469361267497
9879,38031,Foster,North Dakota,2000,474,1172,97,1743,0.2719449225473322,0.672403901319564,0.055651176133103844,0,0,0,0,0.0,0.0,0.0,-698,0,-0.40045897877223174,0.0
9880,38031,Foster,North Dakota,2004,518,1219,29,1766,0.29331823329558326,0.6902604756511891,0.01642129105322763,44,-68,47,23,0.02137331074825105,-0.03922988507987621,0.01785657433162513,-701,-3,-0.3969422423556058,0.0035167364166259207
9881,38031,Foster,North Dakota,2008,687,914,50,1651,0.4161114476075106,0.5536038764385222,0.03028467595396729,169,21,-305,-115,0.12279321431192736,0.01386338490073966,-0.13665659921266693,-227,474,-0.13749242883101154,0.2594498135245943
9882,38031,Foster,North Dakota,2012,607,1030,45,1682,0.36087990487514865,0.6123662306777645,0.0267538644470868,-80,-5,116,31,-0.05523154273236197,-0.0035308115068804907,0.058762354239242365,-423,-196,-0.2514863258026159,-0.11399389697160434
9883,38031,Foster,North Dakota,2016,347,1241,131,1719,0.20186154741128562,0.7219313554392088,0.07620709714950552,-260,86,211,37,-0.15901835746386303,0.04945323270241872,0.10956512476144431,-894,-471,-0.5200698080279232,-0.26858348222530737
9884,38033,Golden Valley,North Dakota,2000,156,611,45,812,0.1921182266009852,0.7524630541871922,0.05541871921182266,0,0,0,0,0.0,0.0,0.0,-455,0,-0.560344827586207,0.0
9885,38033,Golden Valley,North Dakota,2004,195,719,13,927,0.21035598705501618,0.7756202804746494,0.014023732470334413,39,-32,108,115,0.01823776045403097,-0.04139498674148825,0.0231572262874572,-524,-69,-0.5652642934196332,-0.004919465833426284
9886,38033,Golden Valley,North Dakota,2008,210,642,23,875,0.24,0.7337142857142858,0.026285714285714287,15,10,-77,-52,0.02964401294498381,0.012261981815379875,-0.04190599476036361,-432,92,-0.49371428571428577,0.07155000770534747
9887,38033,Golden Valley,North Dakota,2012,162,742,24,928,0.17456896551724138,0.7995689655172413,0.02586206896551724,-48,1,100,53,-0.06543103448275861,-0.00042364532019704623,0.06585467980295556,-580,-148,-0.625,-0.13128571428571423
9888,38033,Golden Valley,North Dakota,2016,99,796,62,957,0.10344827586206896,0.831765935214211,0.06478578892371996,-63,38,54,29,-0.07112068965517242,0.03892371995820272,0.032196969696969724,-697,-117,-0.7283176593521421,-0.1033176593521421
9889,38035,Grand Forks,North Dakota,2000,10593,15875,1917,28385,0.37319006517526865,0.5592742645763608,0.06753567024837062,0,0,0,0,0.0,0.0,0.0,-5282,0,-0.1860841994010921,0.0
9890,38035,Grand Forks,North Dakota,2004,12646,17298,526,30470,0.4150311782080735,0.5677059402691171,0.01726288152280932,2053,-1391,1423,2085,0.041841113032804855,-0.050272788725561304,0.00843167569275638,-4652,630,-0.15267476206104363,0.033409437340048476
9891,38035,Grand Forks,North Dakota,2008,16104,14520,709,31333,0.5139629144990904,0.4634091852040979,0.02262790029681167,3458,183,-2778,863,0.09893173629101687,0.0053650187740023475,-0.10429675506501923,1584,6236,0.05055372929499247,0.2032284913560361
9892,38035,Grand Forks,North Dakota,2012,14032,15060,937,30029,0.4672816277598322,0.5015152019714276,0.031203170268740216,-2072,228,540,-1304,-0.0466812867392582,0.008575269971928548,0.03810601676732972,-1028,-2612,-0.03423357421159545,-0.08478730350658792
9893,38035,Grand Forks,North Dakota,2016,10851,16340,3174,30365,0.3573522147208958,0.5381195455293923,0.10452823974971184,-3181,2237,1280,336,-0.10992941303893639,0.07332506948097163,0.036604343557964714,-5489,-4461,-0.18076733080849655,-0.1465337565969011
9894,38037,Grant,North Dakota,2000,235,1077,115,1427,0.1646811492641906,0.7547302032235459,0.0805886475122635,0,0,0,0,0.0,0.0,0.0,-842,0,-0.5900490539593553,0.0
9895,38037,Grant,North Dakota,2004,264,952,26,1242,0.21256038647342995,0.7665056360708534,0.020933977455716585,29,-89,-125,-185,0.04787923720923934,-0.05965467005654691,0.011775432847307532,-688,154,-0.5539452495974235,0.036103804361931724
9896,38037,Grant,North Dakota,2008,405,873,67,1345,0.30111524163568776,0.6490706319702603,0.04981412639405204,141,41,-79,103,0.0885548551622578,0.028880148938335456,-0.11743500410059315,-468,220,-0.3479553903345725,0.20598985926285102
9897,38037,Grant,North Dakota,2012,334,1025,54,1413,0.23637650389242745,0.7254069355980184,0.03821656050955414,-71,-13,152,68,-0.0647387377432603,-0.011597565884497903,0.07633630362775812,-691,-223,-0.4890304317055909,-0.1410750413710184
9898,38037,Grant,North Dakota,2016,185,1108,88,1381,0.1339608979000724,0.8023171614771905,0.06372194062273714,-149,34,83,-32,-0.10241560599235505,0.025505380113183006,0.07691022587917207,-923,-232,-0.6683562635771181,-0.17932583187152717
9899,38039,Griggs,North Dakota,2000,484,920,65,1469,0.32947583390061264,0.6262763784887678,0.04424778761061947,0,0,0,0,0.0,0.0,0.0,-436,0,-0.2968005445881552,0.0
9900,38039,Griggs,North Dakota,2004,505,907,27,1439,0.35093815149409313,0.6302988186240445,0.018763029881862403,21,-38,-13,-30,0.021462317593480496,-0.025484757728757065,0.004022440135276639,-402,34,-0.27936066712995133,0.017439877458203856
9901,38039,Griggs,North Dakota,2008,598,682,34,1314,0.4550989345509893,0.5190258751902588,0.0258751902587519,93,7,-225,-125,0.10416078305689619,0.007112160376889498,-0.11127294343378569,-84,318,-0.06392694063926946,0.21543372649068188
9902,38039,Griggs,North Dakota,2012,536,771,36,1343,0.3991064780342517,0.5740878629932986,0.02680565897244974,-62,2,89,29,-0.05599245651673762,0.0009304687136978372,0.055061987803039836,-235,-151,-0.17498138495904692,-0.11105444431977746
9903,38039,Griggs,North Dakota,2016,298,847,120,1265,0.23557312252964427,0.6695652173913044,0.09486166007905138,-238,84,76,-78,-0.16353335550460743,0.06805600110660164,0.09547735439800575,-549,-314,-0.4339920948616601,-0.2590107099026132
9904,38041,Hettinger,North Dakota,2000,353,1057,109,1519,0.2323897300855826,0.695852534562212,0.07175773535220539,0,0,0,0,0.0,0.0,0.0,-704,0,-0.46346280447662935,0.0
9905,38041,Hettinger,North Dakota,2004,405,1044,45,1494,0.2710843373493976,0.6987951807228916,0.030120481927710843,52,-64,-13,-25,0.03869460726381496,-0.04163725342449455,0.0029426461606796295,-639,65,-0.427710843373494,0.03575196110313533
9906,38041,Hettinger,North Dakota,2008,406,893,49,1348,0.30118694362017806,0.6624629080118695,0.03635014836795252,1,4,-151,-146,0.030102606270780485,0.006229666440241678,-0.03633227271102213,-487,152,-0.3612759643916914,0.06643487898180261
9907,38041,Hettinger,North Dakota,2012,313,1000,49,1362,0.22980910425844348,0.7342143906020558,0.035976505139500736,-93,0,107,14,-0.07137783936173459,-0.00037364322845178516,0.07175148259018638,-687,-200,-0.5044052863436124,-0.14312932195192096
9908,38041,Hettinger,North Dakota,2016,168,1050,78,1296,0.12962962962962962,0.8101851851851852,0.06018518518518518,-145,29,50,-66,-0.10017947462881385,0.024208680045684446,0.07597079458312939,-882,-195,-0.6805555555555556,-0.1761502692119432
9909,38043,Kidder,North Dakota,2000,283,837,156,1276,0.22178683385579936,0.6559561128526645,0.12225705329153605,0,0,0,0,0.0,0.0,0.0,-554,0,-0.4341692789968652,0.0
9910,38043,Kidder,North Dakota,2004,433,902,34,1369,0.3162892622352082,0.6588750913075238,0.02483564645726808,150,-122,65,93,0.09450242837940884,-0.09742140683426798,0.0029189784548592224,-469,85,-0.34258582907231555,0.09158344992454964
9911,38043,Kidder,North Dakota,2008,422,752,54,1228,0.34364820846905536,0.6123778501628665,0.043973941368078175,-11,20,-150,-141,0.02735894623384716,0.019138294910810094,-0.04649724114465725,-330,139,-0.26872964169381114,0.07385618737850441
9912,38043,Kidder,North Dakota,2012,393,870,65,1328,0.29593373493975905,0.6551204819277109,0.04894578313253012,-29,11,118,100,-0.04771447352929631,0.004971841764451944,0.042742631764844385,-477,-147,-0.35918674698795183,-0.0904571052941407
9913,38043,Kidder,North Dakota,2016,179,1111,86,1376,0.1300872093023256,0.8074127906976745,0.0625,-214,21,241,48,-0.16584652563743346,0.013554216867469882,0.15229230876996358,-932,-455,-0.6773255813953489,-0.3181388344073971
9914,38045,LaMoure,North Dakota,2000,689,1590,189,2468,0.2791734197730956,0.6442463533225283,0.07658022690437602,0,0,0,0,0.0,0.0,0.0,-901,0,-0.3650729335494327,0.0
9915,38045,LaMoure,North Dakota,2004,712,1592,31,2335,0.3049250535331906,0.6817987152034262,0.013276231263383297,23,-158,2,-133,0.025751633760094983,-0.06330399564099272,0.03755236188089783,-880,21,-0.37687366167023556,-0.01180072812080285
9916,38045,LaMoure,North Dakota,2008,868,1310,63,2241,0.38732708612226685,0.5845604640785363,0.028112449799196786,156,32,-282,-94,0.08240203258907625,0.014836218535813489,-0.09723825112488982,-442,438,-0.1972333779562695,0.17964028371396606
9917,38045,LaMoure,North Dakota,2012,740,1377,77,2194,0.33728350045578853,0.6276207839562443,0.03509571558796718,-128,14,67,-47,-0.05004358566647832,0.006983265788770395,0.043060319877707975,-637,-195,-0.2903372835004558,-0.0931039055441863
9918,38045,LaMoure,North Dakota,2016,502,1481,168,2151,0.23337982333798232,0.6885169688516969,0.07810320781032078,-238,91,104,-43,-0.10390367711780621,0.043007492222353595,0.060896184895452565,-979,-342,-0.45513714551371454,-0.16479986201325875
9919,38047,Logan,North Dakota,2000,223,812,110,1145,0.1947598253275109,0.7091703056768559,0.09606986899563319,0,0,0,0,0.0,0.0,0.0,-589,0,-0.514410480349345,0.0
9920,38047,Logan,North Dakota,2004,265,844,21,1130,0.2345132743362832,0.7469026548672566,0.018584070796460177,42,-89,32,-15,0.039753449008772285,-0.077485798199173,0.037732349190400694,-579,10,-0.5123893805309734,0.002021099818371619
9921,38047,Logan,North Dakota,2008,299,726,32,1057,0.282876064333018,0.6868495742667928,0.030274361400189215,34,11,-118,-73,0.048362789996734795,0.011690290603729038,-0.06005308060046377,-427,152,-0.40397350993377484,0.10841587059719854
9922,38047,Logan,North Dakota,2012,232,810,31,1073,0.21621621621621623,0.7548928238583411,0.028890959925442685,-67,-1,84,16,-0.06665984811680176,-0.0013834014747465297,0.06804324959154828,-578,-151,-0.5386766076421249,-0.13470309770835004
9923,38047,Logan,North Dakota,2016,114,888,65,1067,0.10684161199625117,0.8322399250234301,0.06091846298031865,-118,34,78,-6,-0.10937460421996506,0.032027503054875964,0.07734710116508903,-774,-196,-0.7253983130271789,-0.18672170538505406
9924,38049,McHenry,North Dakota,2000,888,1682,167,2737,0.3244428206065035,0.6145414687614176,0.06101571063207892,0,0,0,0,0.0,0.0,0.0,-794,0,-0.2900986481549141,0.0
9925,38049,McHenry,North Dakota,2004,1030,1744,46,2820,0.36524822695035464,0.6184397163120567,0.016312056737588652,142,-121,62,83,0.04080540634385116,-0.04470365389449027,0.0038982475506391667,-714,80,-0.2531914893617021,0.03690715879321199
9926,38049,McHenry,North Dakota,2008,981,1374,61,2416,0.4060430463576159,0.5687086092715232,0.025248344370860928,-49,15,-370,-404,0.04079481940726126,0.008936287633272276,-0.04973110704053352,-393,321,-0.16266556291390732,0.09052592644779478
9927,38049,McHenry,North Dakota,2012,943,1678,91,2712,0.34771386430678464,0.6187315634218289,0.03355457227138643,-38,30,304,296,-0.05832918205083126,0.008306227900525504,0.050022954150305665,-735,-342,-0.27101769911504425,-0.10835213620113693
9928,38049,McHenry,North Dakota,2016,490,2050,280,2820,0.17375886524822695,0.7269503546099291,0.09929078014184398,-453,189,372,108,-0.17395499905855769,0.06573620787045754,0.10821879118810018,-1560,-825,-0.5531914893617021,-0.2821737902466579
9929,38051,McIntosh,North Dakota,2000,350,1178,109,1637,0.21380574221136225,0.7196090409285278,0.06658521686010996,0,0,0,0,0.0,0.0,0.0,-828,0,-0.5058032987171656,0.0
9930,38051,McIntosh,North Dakota,2004,436,1254,32,1722,0.25319396051103366,0.7282229965156795,0.018583042973286876,86,-77,76,85,0.0393882182996714,-0.04800217388682308,0.008613955587151612,-818,10,-0.4750290360046458,0.030774262712519762
9931,38051,McIntosh,North Dakota,2008,579,916,37,1532,0.3779373368146214,0.597911227154047,0.024151436031331592,143,5,-338,-190,0.12474337630358773,0.005568393058044716,-0.13031176936163247,-337,481,-0.2199738903394256,0.2550551456652202
9932,38051,McIntosh,North Dakota,2012,459,1035,36,1530,0.3,0.6764705882352942,0.023529411764705882,-120,-1,119,-2,-0.0779373368146214,-0.0006220242666257099,0.07855936108124717,-576,-239,-0.37647058823529417,-0.15649669789586856
9933,38051,McIntosh,North Dakota,2016,235,1100,111,1446,0.16251728907330568,0.7607192254495159,0.07676348547717843,-224,75,65,-84,-0.1374827109266943,0.053234073712472546,0.08424863721422171,-865,-289,-0.5982019363762102,-0.22173134814091605
9934,38053,McKenzie,North Dakota,2000,653,1634,77,2364,0.27622673434856176,0.6912013536379019,0.03257191201353638,0,0,0,0,0.0,0.0,0.0,-981,0,-0.41497461928934015,0.0
9935,38053,McKenzie,North Dakota,2004,847,1897,18,2762,0.30666183924692253,0.6868211440984794,0.0065170166545981175,194,-59,263,398,0.030435104898360765,-0.026054895358938263,-0.0043802095394225304,-1050,-69,-0.38015930485155686,0.034815314437783296
9936,38053,McKenzie,North Dakota,2008,933,1740,42,2715,0.343646408839779,0.6408839779005525,0.015469613259668509,86,24,-157,-47,0.03698456959285645,0.008952596605070392,-0.04593716619792687,-807,243,-0.29723756906077353,0.08292173579078332
9937,38053,McKenzie,North Dakota,2012,927,2458,66,3451,0.26861779194436397,0.7122573167197913,0.019124891335844683,-6,24,718,736,-0.07502861689541501,0.0036552780761761744,0.0713733388192388,-1531,-724,-0.44363952477542734,-0.1464019557146538
9938,38053,McKenzie,North Dakota,2016,698,3670,304,4672,0.14940068493150685,0.7855308219178082,0.06506849315068493,-229,238,1212,1221,-0.11921710701285712,0.045943601814840244,0.0732735051980169,-2972,-1441,-0.6361301369863014,-0.19249061221087405
9939,38055,McLean,North Dakota,2000,1465,2891,290,4646,0.31532501076194575,0.6222557038312527,0.06241928540680155,0,0,0,0,0.0,0.0,0.0,-1426,0,-0.306930693069307,0.0
9940,38055,McLean,North Dakota,2004,1664,3014,72,4750,0.3503157894736842,0.6345263157894737,0.015157894736842105,199,-218,123,104,0.034990778711738446,-0.04726139066995944,0.01227061195822099,-1350,76,-0.2842105263157895,0.022720166753517457
9941,38055,McLean,North Dakota,2008,1867,2767,102,4736,0.39421452702702703,0.5842483108108109,0.02153716216216216,203,30,-247,-14,0.04389873755334284,0.006379267425320056,-0.05027800497866286,-900,450,-0.19003378378378383,0.0941767425320057
9942,38055,McLean,North Dakota,2012,1670,3141,127,4938,0.33819360064803566,0.6360874848116647,0.025718914540299717,-197,25,374,202,-0.056020926378991365,0.004181752378137556,0.051839174000853805,-1471,-571,-0.297893884163629,-0.10786010037984517
9943,38055,McLean,North Dakota,2016,1081,3860,374,5315,0.20338664158043274,0.7262464722483537,0.07036688617121355,-589,247,719,377,-0.13480695906760293,0.04464797163091383,0.09015898743668904,-2779,-1308,-0.522859830667921,-0.22496594650429197
9944,38057,Mercer,North Dakota,2000,1011,2984,358,4353,0.23225361819434873,0.6855042499425683,0.08224213186308293,0,0,0,0,0.0,0.0,0.0,-1973,0,-0.45325063174821956,0.0
9945,38057,Mercer,North Dakota,2004,1245,3285,87,4617,0.2696556205328135,0.7115009746588694,0.018843404808317088,234,-271,301,264,0.037402002338464774,-0.06339872705476585,0.0259967247163011,-2040,-67,-0.4418453541260559,0.011405277622163645
9946,38057,Mercer,North Dakota,2008,1476,2789,132,4397,0.3356834205139868,0.6342961109847624,0.03002046850125085,231,45,-496,-220,0.06602779998117331,0.011177063692933763,-0.07720486367410706,-1313,727,-0.29861269047077554,0.14323266365528037
9947,38057,Mercer,North Dakota,2012,1166,3152,137,4455,0.2617283950617284,0.7075196408529741,0.030751964085297418,-310,5,363,58,-0.0739550254522584,0.0007314955840465667,0.07322352986821179,-1986,-673,-0.44579124579124574,-0.1471785553204702
9948,38057,Mercer,North Dakota,2016,621,3759,302,4682,0.13263562580093977,0.8028620247757369,0.06450234942332336,-545,165,607,227,-0.12909276926078864,0.03375038533802595,0.09534238392276273,-3138,-1152,-0.6702263989747971,-0.22443515318355134
9949,38059,Morton,North Dakota,2000,3439,6993,791,11223,0.3064243072262318,0.6230954290296712,0.07048026374409694,0,0,0,0,0.0,0.0,0.0,-3554,0,-0.31667112180343937,0.0
9950,38059,Morton,North Dakota,2004,4073,8325,235,12633,0.32240956225757933,0.6589883638090714,0.018602073933349166,634,-556,1332,1410,0.01598525503134751,-0.05187818981074777,0.035892934779400254,-4252,-698,-0.3365788015514921,-0.019907679748052742
9951,38059,Morton,North Dakota,2008,5079,7869,391,13339,0.3807631756503486,0.5899242821800734,0.02931254216957793,1006,156,-456,706,0.05835361339276929,0.010710468236228763,-0.06906408162899802,-2790,1462,-0.2091611065297248,0.1274176950217673
9952,38059,Morton,North Dakota,2012,4469,8680,464,13613,0.3282891353852935,0.6376257988687284,0.03408506574597811,-610,73,811,274,-0.052474040265055144,0.004772523576400182,0.047701516688654966,-4211,-1421,-0.3093366634834349,-0.10017555695371011
9953,38059,Morton,North Dakota,2016,3080,11336,1416,15832,0.19454269833249116,0.7160181910055584,0.08943911066195048,-1389,952,2656,2219,-0.1337464370528023,0.05535404491597237,0.07839239213683002,-8256,-4045,-0.5214754926730673,-0.21213882918963234
9954,38061,Mountrail,North Dakota,2000,1256,1466,174,2896,0.43370165745856354,0.5062154696132597,0.060082872928176795,0,0,0,0,0.0,0.0,0.0,-210,0,-0.07251381215469616,0.0
9955,38061,Mountrail,North Dakota,2004,1465,1527,38,3030,0.4834983498349835,0.503960396039604,0.012541254125412541,209,-136,61,134,0.04979669237641998,-0.04754161880276425,-0.0022550735736557304,-62,148,-0.020462046204620443,0.05205176595007571
9956,38061,Mountrail,North Dakota,2008,1477,1406,55,2938,0.5027229407760381,0.4785568413886998,0.018720217835262083,12,17,-121,-92,0.019224590941054553,0.006178963709849541,-0.02540355465090416,71,133,0.02416609938733827,0.04462814559195871
9957,38061,Mountrail,North Dakota,2012,1403,1962,92,3457,0.40584321666184553,0.5675441133931154,0.026612669945039052,-74,37,556,519,-0.09687972411419254,0.00789245210977697,0.08898727200441559,-559,-630,-0.16170089673126986,-0.18586699611860813
9958,38061,Mountrail,North Dakota,2016,1220,2582,304,4106,0.29712615684364346,0.6288358499756453,0.07403799318071115,-183,212,620,649,-0.10871705981820207,0.0474253232356721,0.061291736582529954,-1362,-803,-0.3317096931320019,-0.17000879640073202
9959,38063,Nelson,North Dakota,2000,687,1031,122,1840,0.3733695652173913,0.5603260869565218,0.06630434782608696,0,0,0,0,0.0,0.0,0.0,-344,0,-0.18695652173913047,0.0
9960,38063,Nelson,North Dakota,2004,778,1107,37,1922,0.404786680541103,0.5759625390218522,0.019250780437044746,91,-85,76,82,0.03141711532371172,-0.04705356738904222,0.015636452065330486,-329,15,-0.17117585848074923,0.015780663258381233
9961,38063,Nelson,North Dakota,2008,907,800,45,1752,0.5176940639269406,0.45662100456621,0.025684931506849314,129,8,-307,-170,0.11290738338583761,0.0064341510698045674,-0.11934153445564222,107,436,0.0610730593607306,0.23224891784147983
9962,38063,Nelson,North Dakota,2012,767,865,46,1678,0.4570917759237187,0.5154946364719905,0.027413587604290822,-140,1,65,-74,-0.06060228800322193,0.0017286560974415083,0.05887363190578043,-98,-205,-0.05840286054827176,-0.11947591990900236
9963,38063,Nelson,North Dakota,2016,536,1025,156,1717,0.31217239370995925,0.5969714618520675,0.09085614443797321,-231,110,160,39,-0.14491938221375944,0.06344255683368238,0.08147682538007706,-489,-391,-0.28479906814210826,-0.2263962075938365
9964,38065,Oliver,North Dakota,2000,244,709,98,1051,0.23215984776403426,0.6745956232159848,0.09324452901998097,0,0,0,0,0.0,0.0,0.0,-465,0,-0.4424357754519505,0.0
9965,38065,Oliver,North Dakota,2004,310,790,19,1119,0.2770330652368186,0.7059874888293118,0.016979445933869526,66,-79,81,68,0.04487321747278433,-0.07626508308611143,0.031391865613327075,-480,-15,-0.42895442359249325,0.013481351859457258
9966,38065,Oliver,North Dakota,2008,332,682,26,1040,0.3192307692307692,0.6557692307692308,0.025,22,7,-108,-79,0.04219770399395062,0.008020554066130475,-0.05021825806008107,-350,130,-0.33653846153846156,0.09241596205403169
9967,38065,Oliver,North Dakota,2012,281,693,39,1013,0.2773938795656466,0.684106614017769,0.0384995064165844,-51,13,11,-27,-0.04183688966512261,0.0134995064165844,0.028337383248538184,-412,-62,-0.40671273445212236,-0.0701742729136608
9968,38065,Oliver,North Dakota,2016,119,830,68,1017,0.11701081612586037,0.816125860373648,0.06686332350049164,-162,29,137,4,-0.16038306343978623,0.028363817083907235,0.13201924635587903,-711,-299,-0.6991150442477876,-0.2924023097956652
9969,38067,Pembina,North Dakota,2000,1093,2430,256,3779,0.2892299550145541,0.643027255887801,0.06774278909764488,0,0,0,0,0.0,0.0,0.0,-1337,0,-0.35379730087324684,0.0
9970,38067,Pembina,North Dakota,2004,1321,2466,69,3856,0.3425829875518672,0.6395228215767634,0.017894190871369293,228,-187,36,77,0.053353032537313105,-0.04984859822627558,-0.0035044343110375298,-1145,192,-0.2969398340248962,0.056857466848350635
9971,38067,Pembina,North Dakota,2008,1494,1722,91,3307,0.45176897490172363,0.5207136377381313,0.027517387360145147,173,22,-744,-549,0.1091859873498564,0.009623196488775854,-0.11880918383863215,-228,917,-0.06894466283640766,0.22799517118848855
9972,38067,Pembina,North Dakota,2012,1253,1899,103,3255,0.3849462365591398,0.5834101382488479,0.03164362519201229,-241,12,177,-52,-0.06682273834258384,0.0041262378318671425,0.06269650051071662,-646,-418,-0.19846390168970812,-0.12951923885330047
9973,38067,Pembina,North Dakota,2016,681,2208,264,3153,0.2159847764034253,0.7002854424357755,0.08372978116079924,-572,161,309,-102,-0.16896146015571448,0.05208615596878695,0.1168753041869276,-1527,-881,-0.4843006660323502,-0.2858367643426421
9974,38069,Pierce,North Dakota,2000,500,1348,123,1971,0.2536783358701167,0.6839167935058346,0.0624048706240487,0,0,0,0,0.0,0.0,0.0,-848,0,-0.4302384576357179,0.0
9975,38069,Pierce,North Dakota,2004,686,1475,34,2195,0.3125284738041002,0.6719817767653758,0.015489749430523917,186,-89,127,224,0.058850137933983526,-0.046915121193524784,-0.011935016740458715,-789,59,-0.35945330296127564,0.07078515467444224
9976,38069,Pierce,North Dakota,2008,792,1301,46,2139,0.3702664796633941,0.6082281439925199,0.021505376344086023,106,12,-174,-56,0.057738005859293895,0.006015626913562106,-0.06375363277285595,-509,280,-0.2379616643291258,0.12149163863214985
9977,38069,Pierce,North Dakota,2012,660,1465,53,2178,0.30303030303030304,0.6726354453627181,0.024334251606978878,-132,7,164,39,-0.06723617663309106,0.002828875262892855,0.06440730137019823,-805,-296,-0.3696051423324151,-0.1316434780032893
9978,38069,Pierce,North Dakota,2016,431,1437,203,2071,0.2081120231772091,0.6938676967648479,0.09802028005794303,-229,150,-28,-107,-0.09491827985309395,0.07368602845096414,0.02123225140212981,-1006,-201,-0.4857556735876388,-0.11615053125522373
9979,38071,Ramsey,North Dakota,2000,1658,3005,314,4977,0.33313240908177616,0.6037773759292747,0.06309021498894916,0,0,0,0,0.0,0.0,0.0,-1347,0,-0.27064496684749856,0.0
9980,38071,Ramsey,North Dakota,2004,1885,2943,72,4900,0.3846938775510204,0.6006122448979592,0.014693877551020407,227,-242,-62,-77,0.051561468469244254,-0.04839633743792876,-0.003165131031315549,-1058,289,-0.21591836734693876,0.0547265995005598
9981,38071,Ramsey,North Dakota,2008,2314,2361,87,4762,0.4859302813943721,0.49580008399832004,0.018269634607307853,429,15,-582,-138,0.1012364038433517,0.0035757570562874458,-0.10481216089963913,-47,1011,-0.00986980260394793,0.20604856474299083
9982,38071,Ramsey,North Dakota,2012,2164,2665,170,4999,0.4328865773154631,0.5331066213242649,0.03400680136027205,-150,83,304,237,-0.053043704078909015,0.0157371667529642,0.037306537325944855,-501,-454,-0.1002200440088018,-0.09035024140485387
9983,38071,Ramsey,North Dakota,2016,1505,3217,583,5305,0.2836946277097078,0.6064090480678606,0.10989632422243167,-659,413,552,306,-0.14919194960575527,0.07588952286215962,0.07330242674359566,-1712,-1211,-0.32271442035815273,-0.22249437634935093
9984,38073,Ransom,North Dakota,2000,1080,1488,151,2719,0.3972048547260022,0.5472600220669364,0.05553512320706142,0,0,0,0,0.0,0.0,0.0,-408,0,-0.15005516734093416,0.0
9985,38073,Ransom,North Dakota,2004,1199,1352,51,2602,0.4607993850883935,0.5196003074558032,0.01960030745580323,119,-100,-136,-117,0.06359453036239132,-0.03593481575125819,-0.027659714611133146,-153,255,-0.05880092236740969,0.09125424497352447
9986,38073,Ransom,North Dakota,2008,1371,998,64,2433,0.5635018495684341,0.41019317714755443,0.026304973284011508,172,13,-354,-169,0.10270246448004056,0.006704665828208278,-0.10940713030824878,373,526,0.15330867242087964,0.21210959478828934
9987,38073,Ransom,North Dakota,2012,1343,1009,73,2425,0.5538144329896907,0.4160824742268041,0.030103092783505155,-28,9,11,-8,-0.00968741657874339,0.003798119499493647,0.005889297079249678,334,-39,0.13773195876288657,-0.015576713657993069
9988,38073,Ransom,North Dakota,2016,838,1210,311,2359,0.3552352691818567,0.512929207291225,0.13183552352691819,-505,238,201,-66,-0.19857916380783397,0.10173243074341304,0.09684673306442093,-372,-706,-0.15769393810936833,-0.2954258968722549
9989,38075,Renville,North Dakota,2000,443,820,69,1332,0.3325825825825826,0.6156156156156156,0.0518018018018018,0,0,0,0,0.0,0.0,0.0,-377,0,-0.283033033033033,0.0
9990,38075,Renville,North Dakota,2004,497,953,19,1469,0.33832539142273654,0.6487406398910823,0.012933968686181076,54,-50,133,137,0.0057428088401539346,-0.038867833115620726,0.03312502427546671,-456,-79,-0.3104152484683458,-0.027382215435312773
9991,38075,Renville,North Dakota,2008,505,799,42,1346,0.37518573551263,0.5936106983655275,0.031203566121842496,8,23,-154,-123,0.03686034408989347,0.018269597435661422,-0.05512994152555484,-294,162,-0.21842496285289748,0.09199028561544831
9992,38075,Renville,North Dakota,2012,398,851,29,1278,0.3114241001564945,0.6658841940532081,0.02269170579029734,-107,-13,52,-68,-0.0637616353561355,-0.008511860331545155,0.0722734956876806,-453,-159,-0.35446009389671357,-0.1360351310438161
9993,38075,Renville,North Dakota,2016,201,993,99,1293,0.1554524361948956,0.7679814385150812,0.0765661252900232,-197,70,142,15,-0.15597166396159892,0.05387441949972586,0.10209724446187307,-792,-339,-0.6125290023201856,-0.258068908423472
9994,38077,Richland,North Dakota,2000,2490,4999,526,8015,0.3106674984404242,0.6237055520898316,0.06562694946974423,0,0,0,0,0.0,0.0,0.0,-2509,0,-0.3130380536494074,0.0
9995,38077,Richland,North Dakota,2004,2821,5264,130,8215,0.3433962264150943,0.6407790626902009,0.01582471089470481,331,-396,265,200,0.032728727974670135,-0.049802238575039424,0.017073510600369324,-2443,66,-0.2973828362751066,0.01565521737430081
9996,38077,Richland,North Dakota,2008,3513,3900,150,7563,0.46449821499405,0.5156683855612852,0.019833399444664817,692,20,-1364,-652,0.12110198857895565,0.004008688549960008,-0.12511067712891566,-387,2056,-0.051170170567235274,0.24621266570787131
9997,38077,Richland,North Dakota,2012,3198,4229,186,7613,0.42007093130172074,0.5554971758833575,0.024431892814921845,-315,36,329,50,-0.044427283692329234,0.0045984933702570285,0.039828790322072205,-1031,-644,-0.1354262445816367,-0.08425607401440144
9998,38077,Richland,North Dakota,2016,2064,4767,761,7592,0.2718651211801897,0.6278977871443625,0.10023709167544784,-1134,575,538,-21,-0.14820581012153106,0.07580519886052599,0.07240061126100505,-2703,-1672,-0.3560326659641728,-0.2206064213825361
9999,38079,Rolette,North Dakota,2000,2681,1416,301,4398,0.6095952705775353,0.3219645293315143,0.06844020009095043,0,0,0,0,0.0,0.0,0.0,1265,0,0.28763074124602095,0.0
10000,38079,Rolette,North Dakota,2004,2564,1392,88,4044,0.6340257171117705,0.34421364985163205,0.021760633036597428,-117,-213,-24,-354,0.024430446534235206,-0.046679567054353006,0.022249120520117738,1172,-93,0.2898120672601384,0.0021813260141174684
10001,38079,Rolette,North Dakota,2008,3403,1045,86,4534,0.7505513895015439,0.23048081164534628,0.018967798853109837,839,-2,-347,490,0.1165256723897734,-0.0027928341834875907,-0.11373283820628577,2358,1186,0.5200705778561976,0.23025851059605917
10002,38079,Rolette,North Dakota,2012,3353,1092,107,4552,0.7365992970123023,0.2398945518453427,0.02350615114235501,-50,21,47,18,-0.013952092489241563,0.004538352289245172,0.009413740199996412,2261,-97,0.4967047451669596,-0.023365832689237975
10003,38079,Rolette,North Dakota,2016,2099,1217,439,3755,0.5589880159786951,0.3241011984021305,0.11691078561917444,-1254,332,125,-797,-0.17761128103360724,0.09340463447681943,0.08420664655678778,882,-1379,0.2348868175765646,-0.261817927590395
10004,38081,Sargent,North Dakota,2000,959,1103,122,2184,0.4391025641025641,0.50503663003663,0.055860805860805864,0,0,0,0,0.0,0.0,0.0,-144,0,-0.06593406593406592,0.0
10005,38081,Sargent,North Dakota,2004,1021,1147,32,2200,0.4640909090909091,0.5213636363636364,0.014545454545454545,62,-90,44,16,0.024988344988345013,-0.041315351315351315,0.016327006327006344,-126,18,-0.05727272727272725,0.008661338661338669
10006,38081,Sargent,North Dakota,2008,1115,778,34,1927,0.5786196159833938,0.4037363777893098,0.017644006227296314,94,2,-369,-273,0.11452870689248473,0.0030985516818417685,-0.11762725857432654,337,463,0.17488323819408402,0.23215596546681128
10007,38081,Sargent,North Dakota,2012,1075,879,53,2007,0.5356253114100648,0.43796711509715996,0.026407573492775286,-40,19,101,80,-0.04299430457332909,0.008763567265478972,0.034230737307850145,196,-141,0.09765819631290479,-0.07722504188117923
10008,38081,Sargent,North Dakota,2016,694,1088,215,1997,0.34752128192288434,0.5448172258387581,0.10766149223835754,-381,162,209,-10,-0.1881040294871804,0.08125391874558226,0.10685011074159817,-394,-590,-0.1972959439158738,-0.2949541402287786
10009,38083,Sheridan,North Dakota,2000,161,707,60,928,0.17349137931034483,0.7618534482758621,0.06465517241379311,0,0,0,0,0.0,0.0,0.0,-546,0,-0.5883620689655172,0.0
10010,38083,Sheridan,North Dakota,2004,200,727,17,944,0.211864406779661,0.7701271186440678,0.018008474576271187,39,-43,20,16,0.03837302746931617,-0.04664669783752192,0.008273670368205699,-527,19,-0.5582627118644068,0.030099357101110447
10011,38083,Sheridan,North Dakota,2008,229,555,19,803,0.2851805728518057,0.6911581569115816,0.023661270236612703,29,2,-172,-141,0.0733161660721447,0.005652795660341516,-0.07896896173248624,-326,201,-0.40597758405977585,0.15228512780463094
10012,38083,Sheridan,North Dakota,2012,163,642,17,822,0.19829683698296838,0.781021897810219,0.02068126520681265,-66,-2,87,19,-0.08688373586883733,-0.002980005029800052,0.08986374089863747,-479,-153,-0.5827250608272506,-0.17674747676747476
10013,38083,Sheridan,North Dakota,2016,95,650,42,787,0.1207115628970775,0.8259212198221093,0.053367217280813214,-68,25,8,-35,-0.07758527408589087,0.03268595207400056,0.044899322011890286,-555,-76,-0.7052096569250318,-0.12248459609778117
10014,38085,Sioux,North Dakota,2000,724,269,48,1041,0.6954851104707013,0.2584053794428434,0.04610951008645533,0,0,0,0,0.0,0.0,0.0,455,0,0.43707973102785785,0.0
10015,38085,Sioux,North Dakota,2004,804,319,17,1140,0.7052631578947368,0.27982456140350875,0.014912280701754385,80,-31,50,99,0.00977804742403554,-0.031197229384700945,0.021419181960665334,485,30,0.42543859649122806,-0.011641134536629794
10016,38085,Sioux,North Dakota,2008,1145,215,18,1378,0.8309143686502177,0.15602322206095792,0.013062409288824383,341,1,-104,238,0.1256512107554809,-0.0018498714129300022,-0.12380133934255083,930,445,0.6748911465892597,0.2494525500980317
10017,38085,Sioux,North Dakota,2012,900,225,19,1144,0.7867132867132867,0.19667832167832167,0.016608391608391608,-245,1,10,-234,-0.044201081936931064,0.0035459823195672247,0.040655099617363744,675,-255,0.590034965034965,-0.08485618155429475
10018,38085,Sioux,North Dakota,2016,758,260,214,1232,0.6152597402597403,0.21103896103896103,0.1737012987012987,-142,195,35,88,-0.17145354645354638,0.15709290709290707,0.01436063936063936,498,-177,0.40422077922077926,-0.18581418581418574
10019,38087,Slope,North Dakota,2000,85,316,41,442,0.19230769230769232,0.7149321266968326,0.09276018099547512,0,0,0,0,0.0,0.0,0.0,-231,0,-0.5226244343891403,0.0
10020,38087,Slope,North Dakota,2004,89,335,8,432,0.20601851851851852,0.7754629629629629,0.018518518518518517,4,-33,19,-10,0.013710826210826199,-0.0742416624769566,0.06053083626613032,-246,-15,-0.5694444444444444,-0.04682001005530412
10021,38087,Slope,North Dakota,2008,106,297,8,411,0.25790754257907544,0.7226277372262774,0.019464720194647202,17,0,-38,-21,0.051889024060556926,0.000946201676128685,-0.05283522573668553,-191,55,-0.46472019464720193,0.10472424979724249
10022,38087,Slope,North Dakota,2012,83,341,13,437,0.18993135011441648,0.7803203661327232,0.029748283752860413,-23,5,44,26,-0.06797619246465897,0.01028356355821321,0.057692628906445775,-258,-67,-0.5903890160183067,-0.1256688213711048
10023,38087,Slope,North Dakota,2016,43,362,25,430,0.1,0.8418604651162791,0.05813953488372093,-40,12,21,-7,-0.08993135011441647,0.028391251130860516,0.061540098983555946,-319,-61,-0.7418604651162791,-0.1514714490979724
10024,38089,Stark,North Dakota,2000,2784,6387,606,9777,0.28474992328935256,0.653267873580853,0.06198220312979442,0,0,0,0,0.0,0.0,0.0,-3603,0,-0.3685179502915005,0.0
10025,38089,Stark,North Dakota,2004,3013,7220,167,10400,0.28971153846153846,0.6942307692307692,0.016057692307692308,229,-439,833,623,0.004961615172185907,-0.04592451082210211,0.040962895649916176,-4207,-604,-0.40451923076923074,-0.03600128047773027
10026,38089,Stark,North Dakota,2008,3802,7024,301,11127,0.34169138132470567,0.631257302058057,0.02705131661723735,789,134,-196,727,0.0519798428631672,0.010993624309545043,-0.06297346717271224,-3222,985,-0.2895659207333513,0.11495331003587944
10027,38089,Stark,North Dakota,2012,2812,8521,300,11633,0.2417261239577065,0.7324851714948852,0.025788704547408236,-990,-1,1497,506,-0.09996525736699916,-0.0012626120698291145,0.10122786943682827,-5709,-2487,-0.4907590475371787,-0.2011931268038274
10028,38089,Stark,North Dakota,2016,1753,9755,814,12322,0.14226586593085538,0.7916734296380458,0.06606070443109885,-1059,514,1234,689,-0.09946025802685113,0.04027199988369061,0.05918825814316053,-8002,-2293,-0.6494075637071903,-0.15864851617001163
10029,38091,Steele,North Dakota,2000,475,655,80,1210,0.3925619834710744,0.5413223140495868,0.06611570247933884,0,0,0,0,0.0,0.0,0.0,-180,0,-0.14876033057851235,0.0
10030,38091,Steele,North Dakota,2004,616,586,11,1213,0.5078318219291014,0.4830997526793075,0.009068425391591096,141,-69,-69,3,0.11526983845802696,-0.05704727708774775,-0.05822256137027926,30,210,0.024732069249793875,0.17349239982830622
10031,38091,Steele,North Dakota,2008,614,404,14,1032,0.5949612403100775,0.39147286821705424,0.013565891472868217,-2,3,-182,-181,0.0871294183809761,0.004497466081277121,-0.09162688446225326,210,180,0.20348837209302323,0.17875630284322935
10032,38091,Steele,North Dakota,2012,518,498,26,1042,0.4971209213051823,0.4779270633397313,0.02495201535508637,-96,12,94,10,-0.09784031900489515,0.011386123882218154,0.08645419512267705,20,-190,0.019193857965451033,-0.1842945141275722
10033,38091,Steele,North Dakota,2016,361,538,100,999,0.3613613613613614,0.5385385385385385,0.1001001001001001,-157,74,40,-43,-0.13575955994382094,0.07514808474501374,0.06061147519880722,-177,-197,-0.17717717717717713,-0.19637103514262816
10034,38093,Stutsman,North Dakota,2000,3067,5488,563,9118,0.33636762447905244,0.6018863785917965,0.06174599692915113,0,0,0,0,0.0,0.0,0.0,-2421,0,-0.26551875411274406,0.0
10035,38093,Stutsman,North Dakota,2004,3438,6517,167,10122,0.3396561944279787,0.6438450899031812,0.01649871566884015,371,-396,1029,1004,0.0032885699489262343,-0.04524728126031098,0.04195871131138473,-3079,-658,-0.30418889547520256,-0.0386701413624585
10036,38093,Stutsman,North Dakota,2008,4056,5499,229,9784,0.4145543744889616,0.5620400654129191,0.02340556009811938,618,62,-1018,-338,0.07489818006098292,0.006906844429279229,-0.08180502449026217,-1443,1636,-0.14748569092395747,0.1567032045512451
10037,38093,Stutsman,North Dakota,2012,3585,5685,288,9558,0.37507846829880725,0.5947897049591965,0.030131826741996232,-471,59,186,-226,-0.03947590619015434,0.006726266643876853,0.03274963954627741,-2100,-657,-0.21971123666038922,-0.07222554573643175
10038,38093,Stutsman,North Dakota,2016,2498,6718,939,10155,0.24598719842442146,0.6615460364352536,0.09246676514032497,-1087,651,1033,597,-0.1290912698743858,0.06233493839832874,0.06675633147605708,-4220,-2120,-0.4155588380108321,-0.19584760135044288
10039,38095,Towner,North Dakota,2000,410,694,85,1189,0.3448275862068966,0.5836837678721615,0.07148864592094197,0,0,0,0,0.0,0.0,0.0,-284,0,-0.2388561816652649,0.0
10040,38095,Towner,North Dakota,2004,606,754,31,1391,0.43565780014378147,0.5420560747663551,0.02228612508986341,196,-54,60,202,0.0908302139368849,-0.04920252083107855,-0.041627693105806385,-148,136,-0.10639827462257362,0.13245790704269128
10041,38095,Towner,North Dakota,2008,621,536,40,1197,0.518796992481203,0.4477861319966583,0.03341687552213868,15,9,-218,-194,0.08313919233742156,0.01113075043227527,-0.0942699427696968,85,233,0.07101086048454475,0.17740913510711837
10042,38095,Towner,North Dakota,2012,516,623,43,1182,0.4365482233502538,0.5270727580372251,0.03637901861252115,-105,3,87,-15,-0.08224876913094925,0.0029621430903824728,0.0792866260405668,-107,-192,-0.0905245346869713,-0.16153539517151605
10043,38095,Towner,North Dakota,2016,305,733,119,1157,0.2636127917026793,0.6335350043215212,0.10285220397579949,-211,76,110,-25,-0.17293543164757447,0.06647318536327834,0.10646224628429612,-428,-321,-0.3699222126188419,-0.2793976779318706
10044,38097,Traill,North Dakota,2000,1512,2392,208,4112,0.36770428015564205,0.5817120622568094,0.05058365758754864,0,0,0,0,0.0,0.0,0.0,-880,0,-0.21400778210116733,0.0
10045,38097,Traill,North Dakota,2004,1651,2543,54,4248,0.388653483992467,0.5986346516007532,0.012711864406779662,139,-154,151,136,0.02094920383682497,-0.03787179318076898,0.01692258934394386,-892,-12,-0.20998116760828622,0.004026614492881109
10046,38097,Traill,North Dakota,2008,2136,1845,60,4041,0.5285820341499629,0.45657015590200445,0.014847809948032665,485,6,-698,-207,0.13992855015749583,0.0021359455412530027,-0.1420644956987488,291,1183,0.0720118782479584,0.28199304585624463
10047,38097,Traill,North Dakota,2012,1811,1996,114,3921,0.4618719714358582,0.5090538128028564,0.029074215761285386,-325,54,151,-120,-0.06671006271410468,0.014226405813252721,0.052483656900851994,-185,-476,-0.04718184136699827,-0.11919371961495667
10048,38097,Traill,North Dakota,2016,1241,2265,427,3933,0.315535214848716,0.5758962623951183,0.10856852275616578,-570,313,269,12,-0.14633675658714218,0.0794943069948804,0.06684244959226182,-1024,-839,-0.26036104754640227,-0.213179206179404
10049,38099,Walsh,North Dakota,2000,1743,3099,340,5182,0.3363566190659977,0.5980316480123504,0.06561173292165187,0,0,0,0,0.0,0.0,0.0,-1356,0,-0.26167502894635275,0.0
10050,38099,Walsh,North Dakota,2004,1905,3194,87,5186,0.3673351330505206,0.6158889317392982,0.016775935210181257,162,-253,95,4,0.03097851398452295,-0.04883579771147062,0.017857283726947726,-1289,67,-0.24855379868877753,0.013121230257575223
10051,38099,Walsh,North Dakota,2008,2325,2415,142,4882,0.47623924621056946,0.4946743138058173,0.029086439983613273,420,55,-779,-304,0.10890411316004883,0.012310504773432016,-0.12121461793348087,-90,1199,-0.018435067595247823,0.2301187310935297
10052,38099,Walsh,North Dakota,2012,1985,2656,150,4791,0.41431851388019203,0.5543727823001461,0.031308703819661866,-340,8,241,-91,-0.061920732330377426,0.0022222638360485936,0.059698468494328805,-671,-581,-0.14005426841995405,-0.12161920082470623
10053,38099,Walsh,North Dakota,2016,1167,2995,474,4636,0.251725625539258,0.6460310612597067,0.10224331320103537,-818,324,339,-155,-0.16259288834093405,0.0709346093813735,0.09165827895956058,-1828,-1157,-0.3943054357204487,-0.25425116730049463
10054,38101,Ward,North Dakota,2000,7533,13997,952,22482,0.33506805444355486,0.6225869584556534,0.042344987100791744,0,0,0,0,0.0,0.0,0.0,-6464,0,-0.2875189040120985,0.0
10055,38101,Ward,North Dakota,2004,8236,17008,368,25612,0.32156801499297205,0.6640637201311885,0.01436826487583945,703,-584,3011,3130,-0.013500039450582813,-0.027976722224952295,0.041476761675535156,-8772,-2308,-0.3424957051382165,-0.05497680112611797
10056,38101,Ward,North Dakota,2008,10144,15061,563,25768,0.3936665631791369,0.5844846321018318,0.021848804719031358,1908,195,-1947,156,0.07209854818616485,0.007480539843191908,-0.07957908802935676,-4917,3855,-0.19081806892269487,0.1516776362155216
10057,38101,Ward,North Dakota,2012,8441,16230,792,25463,0.3315006087263873,0.6373954365157287,0.031103954757883988,-1703,229,1169,-305,-0.06216595445274958,0.00925515003885263,0.05291080441389695,-7789,-2872,-0.3058948277893414,-0.11507675886664653
10058,38101,Ward,North Dakota,2016,5806,18636,2970,27412,0.21180504888370058,0.6798482416459944,0.10834670947030497,-2635,2178,2406,1949,-0.11969555984268673,0.07724275471242098,0.042452805130265725,-12830,-5041,-0.4680431927622939,-0.16214836497295249
10059,38103,Wells,North Dakota,2000,661,1610,139,2410,0.27427385892116185,0.6680497925311203,0.057676348547717846,0,0,0,0,0.0,0.0,0.0,-949,0,-0.39377593360995844,0.0
10060,38103,Wells,North Dakota,2004,858,1654,49,2561,0.3350253807106599,0.6458414681764936,0.019133151112846546,197,-90,44,151,0.06075152178949805,-0.0385431974348713,-0.02220832435462672,-796,153,-0.31081608746583367,0.08295984614412477
10061,38103,Wells,North Dakota,2008,841,1468,68,2377,0.3538073201514514,0.6175851914177535,0.02860748843079512,-17,19,-186,-184,0.018781939440791484,0.009474337317948573,-0.028256276758740095,-627,169,-0.2637778712663021,0.04703821619953158
10062,38103,Wells,North Dakota,2012,673,1654,52,2379,0.2828919714165616,0.6952501050861707,0.02185792349726776,-168,-16,186,2,-0.0709153487348898,-0.006749564933527359,0.07766491366841721,-981,-354,-0.4123581336696091,-0.14858026240330702
10063,38103,Wells,North Dakota,2016,419,1796,168,2383,0.17582878724297105,0.7536718422156945,0.07049937054133446,-254,116,142,4,-0.10706318417359054,0.0486414470440667,0.05842173712952381,-1377,-396,-0.5778430549727235,-0.16548492130311437
10064,38105,Williams,North Dakota,2000,2330,5187,290,7807,0.29845010887664913,0.6644037402331241,0.03714615089022672,0,0,0,0,0.0,0.0,0.0,-2857,0,-0.36595363135647496,0.0
10065,38105,Williams,North Dakota,2004,2512,6278,139,8929,0.28133049613618544,0.7031022510919476,0.01556725277186695,182,-151,1091,1122,-0.017119612740463697,-0.021578898118359773,0.038698510858823476,-3766,-909,-0.42177175495576213,-0.05581812359928717
10066,38105,Williams,North Dakota,2008,2921,6291,161,9373,0.31163981649418543,0.6711831857462925,0.01717699775952203,409,22,13,444,0.03030932035799999,0.0016097449876550807,-0.03191906534565503,-3370,396,-0.3595433692521071,0.06222838570365502
10067,38105,Williams,North Dakota,2012,2322,7184,302,9808,0.23674551386623166,0.732463295269168,0.030791190864600325,-599,141,893,435,-0.07489430262795377,0.013614193105078293,0.06128010952287544,-4862,-1492,-0.4957177814029363,-0.1361744121508292
10068,38105,Williams,North Dakota,2016,1735,10069,1003,12807,0.13547278831888812,0.7862106660420083,0.07831654563910362,-587,701,2885,2999,-0.10127272554734354,0.047525354774503294,0.05374737077284031,-8334,-3472,-0.6507378777231202,-0.15502009632018388
10069,39001,Adams,Ohio,2000,3581,6380,274,10235,0.34987787005373716,0.6233512457254519,0.026770884220810944,0,0,0,0,0.0,0.0,0.0,-2799,0,-0.2734733756717147,0.0
10070,39001,Adams,Ohio,2004,4281,7653,66,12000,0.35675,0.63775,0.0055,700,-208,1273,1765,0.0068721299462628505,-0.021270884220810943,0.014398754274548176,-3372,-573,-0.281,-0.007526624328285325
10071,39001,Adams,Ohio,2008,4170,6914,330,11414,0.3653408095321535,0.6057473278429998,0.028911862624846678,-111,264,-739,-586,0.008590809532153465,0.02341186262484668,-0.032002672157000256,-2744,628,-0.2404065183108463,0.04059348168915372
10072,39001,Adams,Ohio,2012,3976,6865,277,11118,0.3576182766684656,0.6174671703543803,0.024914552977154166,-194,-53,-49,-296,-0.007722532863687903,-0.003997309647692512,0.011719842511380474,-2889,-145,-0.2598488936859147,-0.019442375375068377
10073,39001,Adams,Ohio,2016,2326,8659,427,11412,0.20382053978268488,0.7587627059235892,0.0374167542937259,-1650,150,1794,294,-0.1537977368857807,0.012502201316571735,0.14129553556920893,-6333,-3444,-0.5549421661409043,-0.2950932724549896
10074,39003,Allen,Ohio,2000,13996,28647,1152,43795,0.31957986071469346,0.6541157666400274,0.026304372645279142,0,0,0,0,0.0,0.0,0.0,-14651,0,-0.3345359059253339,0.0
10075,39003,Allen,Ohio,2004,16470,32580,206,49256,0.3343755075523794,0.6614422608413189,0.004182231606301771,2474,-946,3933,5461,0.014795646837685916,-0.02212214103897737,0.0073264942012915,-16110,-1459,-0.32706675328893947,0.007469152636394416
10076,39003,Allen,Ohio,2008,19522,29940,1033,50495,0.38661253589464306,0.5929299930686207,0.02045747103673631,3052,827,-2640,1239,0.05223702834226368,0.01627523943043454,-0.06851226777269814,-10418,5692,-0.20631745717397765,0.12074929611496182
10077,39003,Allen,Ohio,2012,17914,29502,925,48341,0.3705757017852341,0.6102894023706584,0.019134895844107488,-1608,-108,-438,-2154,-0.01603683410940898,-0.001322575192628822,0.01735940930203772,-11588,-1170,-0.23971370058542435,-0.0333962434114467
10078,39003,Allen,Ohio,2016,13294,30487,2453,46234,0.2875373102046113,0.6594064973828784,0.05305619241251027,-4620,1528,985,-2107,-0.08303839158062276,0.03392129656840279,0.04911709501221995,-17193,-5605,-0.37186918717826706,-0.1321554865928427
10079,39005,Ashland,Ohio,2000,6685,13533,1040,21258,0.31446984664596855,0.6366073948631104,0.048922758490921064,0,0,0,0,0.0,0.0,0.0,-6848,0,-0.3221375482171418,0.0
10080,39005,Ashland,Ohio,2004,8576,16209,194,24979,0.3433283958525161,0.6489050802674247,0.0077665238800592494,1891,-846,2676,3721,0.028858549206547568,-0.04115623461086181,0.012297685404314307,-7633,-785,-0.30557668441490854,0.01656086380223326
10081,39005,Ashland,Ohio,2008,9300,15158,727,25185,0.36926742108397853,0.6018661901925749,0.028866388723446497,724,533,-1051,206,0.02593902523146241,0.02109986484338725,-0.04703889007484974,-5858,1775,-0.2325987691085964,0.07297791530631215
10082,39005,Ashland,Ohio,2012,8281,15519,540,24340,0.3402218570254725,0.6375924404272802,0.02218570254724733,-1019,-187,361,-845,-0.029045564058506057,-0.006680686176199168,0.035726250234705326,-7238,-1380,-0.2973705834018078,-0.06477181429321138
10083,39005,Ashland,Ohio,2016,5740,17493,1504,24737,0.23204107207826333,0.7071593160043659,0.06079961191737074,-2541,964,1974,397,-0.10818078494720915,0.038613909370123406,0.06956687557708563,-11753,-4515,-0.4751182439261026,-0.1777476605242948
10084,39007,Ashtabula,Ohio,2000,19831,17940,1701,39472,0.5024067693554926,0.4544993919740576,0.04309383867044994,0,0,0,0,0.0,0.0,0.0,1891,0,0.04790737738143497,0.0
10085,39007,Ashtabula,Ohio,2004,24060,21038,309,45407,0.5298742484638932,0.4633206333825181,0.006805118153588654,4229,-1392,3098,5935,0.02746747910840064,-0.036288720516861286,0.008821241408460523,3022,1131,0.06655361508137508,0.018646237699940116
10086,39007,Ashtabula,Ohio,2008,25027,18949,1100,45076,0.5552178542905315,0.4203789156091934,0.024403230100275092,967,791,-2089,-331,0.025343605826638305,0.017598111946686437,-0.04294171777332473,6078,3056,0.13483893868133812,0.06828532359996303
10087,39007,Ashtabula,Ohio,2012,23803,18298,1098,43199,0.5510081251880831,0.42357461978286537,0.025417255029051598,-1224,-2,-651,-1877,-0.004209729102448434,0.0010140249287765059,0.003195704173671987,5505,-573,0.1274335054052177,-0.007405433276120421
10088,39007,Ashtabula,Ohio,2016,15577,23318,2285,41180,0.3782661486158329,0.5662457503642545,0.05548810101991258,-8226,1187,5020,-2019,-0.17274197657225016,0.03007084599086098,0.14267113058138914,-7741,-13246,-0.1879796017484216,-0.3154131071536393
10089,39009,Athens,Ohio,2000,13158,9703,2586,25447,0.5170747042873424,0.38130231461468933,0.10162298109796833,0,0,0,0,0.0,0.0,0.0,3455,0,0.13577238967265304,0.0
10090,39009,Athens,Ohio,2004,18998,10847,200,30045,0.6323181893825928,0.3610251289732069,0.006656681644200366,5840,-2386,1144,4598,0.1152434850952504,-0.09496629945376796,-0.020277185641482454,8151,4696,0.2712930604093859,0.13552067073673285
10091,39009,Athens,Ohio,2008,20722,9742,795,31259,0.6629130810326626,0.3116542435778496,0.02543267538948783,1724,595,-1105,1214,0.03059489165006979,0.01877599374528746,-0.04937088539535728,10980,2829,0.35125883745481296,0.07996577704542707
10092,39009,Athens,Ohio,2012,18307,8543,878,27728,0.660235141373341,0.308100115406809,0.031664743219849974,-2415,83,-1199,-3531,-0.0026779396593215044,0.0062320678303621445,-0.003554128171040616,9764,-1216,0.35213502596653207,0.0008761885117191115
10093,39009,Athens,Ohio,2016,16370,11354,1985,29709,0.5510114780032986,0.3821737520616648,0.06681476993503652,-1937,1107,2811,1981,-0.10922366337004241,0.03515002671518654,0.07407363665485583,5016,-4748,0.16883772594163382,-0.18329730002489825
10094,39011,Auglaize,Ohio,2000,5564,13770,558,19892,0.27971043635632414,0.6922380856625779,0.02805147798109793,0,0,0,0,0.0,0.0,0.0,-8206,0,-0.4125276493062538,0.0
10095,39011,Auglaize,Ohio,2004,5903,17016,115,23034,0.2562733350698967,0.7387340453243032,0.004992619605800121,339,-443,3246,3142,-0.023437101286427453,-0.023058858375297808,0.04649595966172526,-11113,-2907,-0.4824607102544065,-0.06993306094815271
10096,39011,Auglaize,Ohio,2008,6738,16414,407,23559,0.28600534827454477,0.6967188760134131,0.017275775712042106,835,292,-602,525,0.029732013204648078,0.012283156106241984,-0.04201516931089011,-9676,1437,-0.4107135277388683,0.07174718251553819
10097,39011,Auglaize,Ohio,2012,5831,17169,449,23449,0.24866732056804128,0.7321847413535758,0.019147938078382873,-907,42,755,-110,-0.03733802770650349,0.0018721623663407669,0.03546586534016272,-11338,-1662,-0.4835174207855345,-0.07280389304666618
10098,39011,Auglaize,Ohio,2016,3980,18658,1156,23794,0.16726905942674625,0.7841472640161385,0.04858367655711524,-1851,707,1489,345,-0.08139826114129503,0.02943573847873237,0.05196252266256274,-14678,-3340,-0.6168782045893924,-0.13336078380385785
10099,39013,Belmont,Ohio,2000,15980,12625,1536,30141,0.530174844895657,0.41886466938721345,0.050960485717129494,0,0,0,0,0.0,0.0,0.0,3355,0,0.11131017550844358,0.0
10100,39013,Belmont,Ohio,2004,17576,15589,157,33322,0.5274593361742993,0.46782906188103957,0.0047116019446611845,1596,-1379,2964,3181,-0.002715508721357729,-0.04624888377246831,0.048964392493826114,1987,-1368,0.05963027429325973,-0.05167990121518384
10101,39013,Belmont,Ohio,2008,16302,15422,812,32536,0.5010449963117777,0.473998032948119,0.02495697074010327,-1274,655,-167,-786,-0.02641433986252162,0.020245368795442083,0.006168971067079421,880,-1107,0.027046963363658694,-0.03258331092960104
10102,39013,Belmont,Ohio,2012,14156,16758,773,31687,0.4467447218102061,0.5288604159434468,0.02439486224634708,-2146,-39,1336,-849,-0.0543002745015716,-0.0005621084937561874,0.05486238299532781,-2602,-3482,-0.08211569413324071,-0.1091626574968994
10103,39013,Belmont,Ohio,2016,8785,21108,1438,31331,0.2803932207717596,0.6737097443426638,0.04589703488557659,-5371,665,4350,-356,-0.16635150103844648,0.021502172639229506,0.14484932839921705,-12323,-9721,-0.39331652357090424,-0.31120082943766353
10104,39015,Brown,Ohio,2000,5972,10027,430,16429,0.3635035607766754,0.6103232089597662,0.02617323026355834,0,0,0,0,0.0,0.0,0.0,-4055,0,-0.24681964818309082,0.0
10105,39015,Brown,Ohio,2004,7140,12647,105,19892,0.35893826663985523,0.6357832294389705,0.005278503921174341,1168,-325,2620,3463,-0.004565294136820164,-0.020894726342384,0.02546002047920426,-5507,-1452,-0.27684496279911525,-0.030025314616024423
10106,39015,Brown,Ohio,2008,7503,12192,471,20166,0.3720618863433502,0.6045819696518894,0.02335614400476049,363,366,-455,274,0.01312361970349496,0.018077640083586147,-0.031201259787081104,-4689,818,-0.23252008330853918,0.04432487949057606
10107,39015,Brown,Ohio,2012,7107,11916,369,19392,0.36649133663366334,0.614480198019802,0.019028465346534653,-396,-102,-276,-774,-0.005570549709686845,-0.004327678658225836,0.009898228367912654,-4809,-120,-0.24798886138613868,-0.015468778077599499
10108,39015,Brown,Ohio,2016,4353,14573,756,19682,0.22116654811502895,0.7404227212681638,0.038410730616807234,-2754,387,2657,290,-0.1453247885186344,0.01938226527027258,0.12594252324836175,-10220,-5411,-0.5192561731531349,-0.2712673117669962
10109,39017,Butler,Ohio,2000,46390,86587,3760,136737,0.33926442733130024,0.6332375289789889,0.027498043689710906,0,0,0,0,0.0,0.0,0.0,-40197,0,-0.29397310164768864,0.0
10110,39017,Butler,Ohio,2004,56243,109872,704,166819,0.3371498450416319,0.6586300121688776,0.004220142789490406,9853,-3056,23285,30082,-0.002114582289668321,-0.0232779009002205,0.025392483189888737,-53629,-13432,-0.3214801671272457,-0.027507065479557058
10111,39017,Butler,Ohio,2008,66030,105341,2688,174059,0.3793541270488742,0.6052028335219667,0.015443039429159078,9787,1984,-4531,7240,0.0422042820072423,0.011222896639668672,-0.05342717864691093,-39311,14318,-0.22584870647309246,0.09563146065415323
10112,39017,Butler,Ohio,2012,62388,105176,2966,170530,0.3658476514396294,0.6167595144549346,0.017392834105435993,-3642,278,-165,-3529,-0.013506475609244839,0.0019497946762769142,0.011556680932967911,-42788,-3477,-0.2509118630153052,-0.02506315654221275
10113,39017,Butler,Ohio,2016,58642,106976,9376,174994,0.33510863229596444,0.6113123878532978,0.05357897985073774,-3746,6410,1800,4464,-0.030739019143664947,0.036186145745301754,-0.00544712660163682,-48334,-5546,-0.27620375555733334,-0.025291892542028127
10114,39019,Carroll,Ohio,2000,4960,6732,569,12261,0.4045347035315227,0.5490579887448006,0.0464073077236767,0,0,0,0,0.0,0.0,0.0,-1772,0,-0.1445232852132779,0.0
10115,39019,Carroll,Ohio,2004,6300,7695,117,14112,0.44642857142857145,0.545280612244898,0.008290816326530613,1340,-452,963,1851,0.04189386789704874,-0.03811649139714608,-0.0037773764999026183,-1395,377,-0.09885204081632654,0.04567124439695136
10116,39019,Carroll,Ohio,2008,6423,7097,465,13985,0.45927779764032894,0.5074722917411513,0.03324991061851984,123,348,-598,-127,0.012849226211757492,0.024959094291989226,-0.03780832050374672,-674,721,-0.04819449410082233,0.05065754671550421
10117,39019,Carroll,Ohio,2012,5543,7315,425,13283,0.4173003086652112,0.5507039072498683,0.03199578408492058,-880,-40,218,-702,-0.04197748897511777,-0.0012541265335992632,0.043231615508717014,-1772,-1098,-0.1334035985846571,-0.08520910448383479
10118,39019,Carroll,Ohio,2016,3154,9254,740,13148,0.2398843930635838,0.7038332826285366,0.05628232430787952,-2389,315,1939,-135,-0.17741591560162737,0.024286540222958945,0.15312937537866833,-6100,-4328,-0.46394888956495284,-0.3305452909802957
10119,39021,Champaign,Ohio,2000,5955,9220,505,15680,0.37978316326530615,0.5880102040816326,0.03220663265306122,0,0,0,0,0.0,0.0,0.0,-3265,0,-0.20822704081632648,0.0
10120,39021,Champaign,Ohio,2004,6968,11718,90,18776,0.37111205794631447,0.6240945888368129,0.004793353216872603,1013,-415,2498,3096,-0.008671105318991679,-0.02741327943618862,0.03608438475518028,-4750,-1485,-0.25298253089049844,-0.044755490074171955
10121,39021,Champaign,Ohio,2008,7385,11141,410,18936,0.38999788762146176,0.5883502323616392,0.02165188001689903,417,320,-577,160,0.018885829675147292,0.016858526800026426,-0.03574435647517371,-3756,994,-0.19835234474017743,0.054630186150321
10122,39021,Champaign,Ohio,2012,7044,11045,379,18468,0.38141650422352175,0.5980615118042019,0.02052198397227637,-341,-31,-96,-468,-0.008581383397940012,-0.001129896044622658,0.00971127944256267,-4001,-245,-0.21664500758068012,-0.018292662840502683
10123,39021,Champaign,Ohio,2016,4594,12631,1018,18243,0.2518226168941512,0.6923751575946938,0.05580222551115496,-2450,639,1586,-225,-0.12959388732937055,0.03528024153887859,0.09431364579049195,-8037,-4036,-0.4405525407005426,-0.2239075331198625
10124,39023,Clark,Ohio,2000,27984,27660,1915,57559,0.4861793985302038,0.480550391771921,0.033270209697875225,0,0,0,0,0.0,0.0,0.0,324,0,0.005629006758282817,0.0
10125,39023,Clark,Ohio,2004,33535,34941,331,68807,0.4873777377301728,0.5078117052044123,0.004810557065414856,5551,-1584,7281,11248,0.0011983391999689785,-0.02845965263246037,0.02726131343249133,-1406,-1730,-0.020433967474239534,-0.02606297423252235
10126,39023,Clark,Ohio,2008,31958,33634,1395,66987,0.4770776419305238,0.502097421887829,0.020824936181647186,-1577,1064,-1307,-1820,-0.010300095799648967,0.01601437911623233,-0.005714283316583302,-1676,-270,-0.0250197799573052,-0.0045858124830656655
10127,39023,Clark,Ohio,2012,31297,31820,1184,64301,0.4867264894791683,0.4948601110402638,0.018413399480567954,-661,-211,-1814,-2686,0.00964884754864448,-0.0024115367010792317,-0.007237310847565237,-523,1153,-0.008133621561095483,0.016886158396209716
10128,39023,Clark,Ohio,2016,23328,35205,3360,61893,0.3769085356987058,0.5688042266492171,0.05428723765207697,-7969,2176,3385,-2408,-0.1098179537804625,0.03587383817150902,0.07394411560895336,-11877,-11354,-0.19189569095051134,-0.18376206938941586
10129,39025,Clermont,Ohio,2000,20927,47129,1821,69877,0.29948337793551527,0.6744565450720552,0.026060076992429553,0,0,0,0,0.0,0.0,0.0,-26202,0,-0.37497316713653994,0.0
10130,39025,Clermont,Ohio,2004,25887,62949,243,89079,0.2906072138214394,0.7066648705082006,0.0027279156703600175,4960,-1578,15820,19202,-0.00887616411407588,-0.023332161322069535,0.03220832543614538,-37062,-10860,-0.4160576566867612,-0.04108448955022126
10131,39025,Clermont,Ohio,2008,31611,62559,1564,95734,0.33019616855035827,0.6534668978628283,0.016336933586813464,5724,1321,-390,6655,0.03958895472891888,0.013609017916453445,-0.05319797264537229,-30948,6114,-0.32327072931247003,0.09278692737429117
10132,39025,Clermont,Ohio,2012,30458,64208,1859,96525,0.31554519554519556,0.6651955451955452,0.01925925925925926,-1153,295,1649,791,-0.014650973005162715,0.002922325672445797,0.011728647332716946,-33750,-2802,-0.3496503496503497,-0.02637962033787966
10133,39025,Clermont,Ohio,2016,26715,67518,5739,99972,0.2672248229504261,0.6753691033489377,0.057406073700636176,-3743,3880,3310,3447,-0.048320372594769456,0.038146814441376915,0.010173558153392492,-40803,-7053,-0.40814428039851164,-0.05849393074816195
10134,39027,Clinton,Ohio,2000,4791,9824,455,15070,0.3179163901791639,0.6518911745189118,0.030192435301924354,0,0,0,0,0.0,0.0,0.0,-5033,0,-0.33397478433974787,0.0
10135,39027,Clinton,Ohio,2004,5417,12938,59,18414,0.29417834256543934,0.7026175735853155,0.0032040838492451394,626,-396,3114,3344,-0.023738047613724556,-0.026988351452679214,0.05072639906640375,-7521,-2488,-0.40843923101987617,-0.0744644466801283
10136,39027,Clinton,Ohio,2008,6558,12409,375,19342,0.33905490642125946,0.6415572329645332,0.019387860614207424,1141,316,-529,928,0.04487656385582012,0.016183776764962285,-0.06106034062078236,-5851,1670,-0.3025023265432737,0.10593690447660248
10137,39027,Clinton,Ohio,2012,5791,12009,383,18183,0.3184842985205962,0.66045207061541,0.02106363086399384,-767,8,-400,-1159,-0.020570607900663285,0.0016757702497864173,0.01889483765087685,-6218,-367,-0.3419677720948138,-0.039465445551540135
10138,39027,Clinton,Ohio,2016,4066,13838,862,18766,0.21666844292870086,0.7373974208675264,0.045934136203772784,-1725,479,1829,583,-0.10181585559189532,0.024870505339778942,0.07694535025211635,-9772,-3554,-0.5207289779388256,-0.17876120584401173
10139,39029,Columbiana,Ohio,2000,20657,21804,1966,44427,0.4649649987620141,0.4907826321831319,0.04425236905485403,0,0,0,0,0.0,0.0,0.0,-1147,0,-0.025817633421117814,0.0
10140,39029,Columbiana,Ohio,2004,23429,25753,283,49465,0.4736480339634085,0.5206307490144547,0.005721217022136864,2772,-1683,3949,5038,0.008683035201394407,-0.03853115203271717,0.029848116831322824,-2324,-1177,-0.04698271505104623,-0.021165081629928417
10141,39029,Columbiana,Ohio,2008,21882,25585,1232,48699,0.44933160845191894,0.5253701308035073,0.025298260744573812,-1547,949,-168,-766,-0.024316425511489548,0.019577043722436946,0.0047393817890525325,-3703,-1379,-0.07603852235158831,-0.02905580730054208
10142,39029,Columbiana,Ohio,2012,19821,25251,1127,46199,0.4290352605034741,0.5465702720838114,0.02439446741271456,-2061,-105,-334,-2500,-0.020296347948444815,-0.0009037933318592518,0.02120014128030412,-5430,-1727,-0.11753501158033725,-0.041496489228748934
10143,39029,Columbiana,Ohio,2016,12432,31676,2384,46492,0.26740084315581175,0.6813215176804611,0.051277639163727094,-7389,1257,6425,293,-0.16163441734766237,0.026883171751012534,0.13475124559664975,-19244,-13814,-0.41392067452464937,-0.2963856629443121
10144,39031,Coshocton,Ohio,2000,5594,8243,431,14268,0.39206616204093075,0.5777263807120829,0.03020745724698626,0,0,0,0,0.0,0.0,0.0,-2649,0,-0.18566021867115218,0.0
10145,39031,Coshocton,Ohio,2004,7378,9839,86,17303,0.42640004623475697,0.568629717390048,0.004970236375195053,1784,-345,1596,3035,0.034333884193826214,-0.025237220871791206,-0.009096663322034959,-2461,188,-0.142229671155291,0.04343054751586117
10146,39031,Coshocton,Ohio,2008,7689,8675,574,16938,0.4539496989018774,0.5121620025977093,0.03388829850041327,311,488,-1164,-365,0.02754965266712045,0.02891806212521822,-0.0564677147923387,-986,1475,-0.05821230369583186,0.08401736745945915
10147,39031,Coshocton,Ohio,2012,6940,8390,454,15784,0.43968575772934615,0.5315509376583882,0.028763304612265585,-749,-120,-285,-1154,-0.01426394117253127,-0.005124993888147685,0.019388935060678958,-1450,-464,-0.09186517992904208,-0.03365287623321023
10148,39031,Coshocton,Ohio,2016,4013,10785,861,15659,0.2562743470208826,0.6887412989335207,0.05498435404559678,-2927,407,2395,-125,-0.18341141070846356,0.026221049433331197,0.15719036127513242,-6772,-5322,-0.43246695191263806,-0.340601771983596
10149,39033,Crawford,Ohio,2000,6721,11666,789,19176,0.35049019607843135,0.6083646224447226,0.04114518147684606,0,0,0,0,0.0,0.0,0.0,-4945,0,-0.2578744263662912,0.0
10150,39033,Crawford,Ohio,2004,7773,13885,143,21801,0.35654327783129214,0.6368973900279804,0.00655933214072749,1052,-646,2219,2625,0.006053081752860789,-0.034585849336118565,0.028532767583257845,-6112,-1167,-0.28035411219668827,-0.022479685830397056
10151,39033,Crawford,Ohio,2008,8289,12316,620,21225,0.39053003533568903,0.5802591283863369,0.02921083627797409,516,477,-1569,-576,0.03398675750439689,0.0226515041372466,-0.05663826164164354,-4027,2085,-0.18972909305064783,0.09062501914604043
10152,39033,Crawford,Ohio,2012,7507,11852,488,19847,0.3782435632589308,0.597168337784048,0.02458809895702121,-782,-132,-464,-1378,-0.012286472076758204,-0.004622737320952877,0.016909209397711122,-4345,-318,-0.21892477452511716,-0.029195681474469326
10153,39033,Crawford,Ohio,2016,4625,13611,1093,19329,0.23927776915515547,0.7041750737234208,0.05654715712142377,-2882,605,1759,-518,-0.13896579410377535,0.03195905816440256,0.10700673593937282,-8986,-4641,-0.46489730456826533,-0.24597253004314817
10154,39035,Cuyahoga,Ohio,2000,359913,192099,22770,574782,0.6261730534359113,0.33421192730461285,0.03961501925947577,0,0,0,0,0.0,0.0,0.0,167814,0,0.2919611261312985,0.0
10155,39035,Cuyahoga,Ohio,2004,448503,221600,3674,673777,0.6656549570555244,0.3288922002383578,0.0054528427061179,88590,-19096,29501,98995,0.03948190361961301,-0.03416217655335787,-0.005319727066255053,226903,59089,0.33676275681716655,0.044801630685868066
10156,39035,Cuyahoga,Ohio,2008,458422,199880,8997,667299,0.6869813981438605,0.2995358902081376,0.01348271164800187,9919,5323,-21720,-6478,0.021326441088336145,0.008029868941883971,-0.029356310030220212,258542,31639,0.3874455079357229,0.05068275111855636
10157,39035,Cuyahoga,Ohio,2012,447273,190660,7319,645252,0.6931756894980565,0.2954814553073838,0.011342855194559645,-11149,-1678,-9220,-22047,0.006194291354196024,-0.0021398564534422255,-0.0040544349007538005,256613,-1929,0.39769423419067274,0.010248726254949825
10158,39035,Cuyahoga,Ohio,2016,398271,184211,26391,608873,0.6541117770043999,0.3025442087266146,0.04334401426898549,-49002,19072,-6449,-36379,-0.039063912493656594,0.03200115907442584,0.007062753419230794,214060,-42553,0.35156756827778535,-0.04612666591288739
10159,39037,Darke,Ohio,2000,7741,14817,709,23267,0.33270296987149184,0.6368246873253964,0.0304723428031117,0,0,0,0,0.0,0.0,0.0,-7076,0,-0.3041217174539046,0.0
10160,39037,Darke,Ohio,2004,7846,18306,161,26313,0.29817960703834606,0.6957017443849048,0.006118648576749135,105,-548,3489,3046,-0.034523362833145776,-0.024353694226362566,0.05887705705950841,-10460,-3384,-0.3975221373465588,-0.09340041989265419
10161,39037,Darke,Ohio,2008,7964,17290,584,25838,0.30822819103645793,0.6691694403591609,0.022602368604381144,118,423,-1016,-475,0.01004858399811187,0.016483720027632008,-0.026532304025743914,-9326,1134,-0.360941249322703,0.036580888023855784
10162,39037,Darke,Ohio,2012,6826,18108,496,25430,0.26842312229650017,0.7120723554856468,0.01950452221785293,-1138,-88,818,-408,-0.03980506873995776,-0.0030978463865282135,0.04290291512648592,-11282,-1956,-0.4436492331891467,-0.08270798386644368
10163,39037,Darke,Ohio,2016,4470,20012,1119,25601,0.17460255458771143,0.7816882153040897,0.043709230108198896,-2356,623,1904,171,-0.09382056770878874,0.024204707890345966,0.06961585981844287,-15542,-4260,-0.6070856607163783,-0.1634364275272316
10164,39039,Defiance,Ohio,2000,6175,9540,527,16242,0.3801871690678488,0.5873660879202068,0.03244674301194434,0,0,0,0,0.0,0.0,0.0,-3365,0,-0.20717891885235806,0.0
10165,39039,Defiance,Ohio,2004,6975,11397,144,18516,0.37670123136746597,0.6155217109526896,0.007777057679844459,800,-383,1857,2274,-0.003485937700382802,-0.024669685332099883,0.028155623032482757,-4422,-1057,-0.23882047958522362,-0.03164156073286556
10166,39039,Defiance,Ohio,2008,8399,10407,426,19232,0.4367200499168053,0.5411293677204659,0.022150582362728787,1424,282,-990,716,0.060018818549339326,0.014373524682884328,-0.07439234323222366,-2008,2414,-0.10440931780366064,0.13441116178156298
10167,39039,Defiance,Ohio,2012,7732,10176,431,18339,0.4216151371394296,0.5548830361524619,0.023501826708108402,-667,5,-231,-893,-0.01510491277737569,0.0013512443453796152,0.013753668431995991,-2444,-436,-0.13326789901303232,-0.02885858120937168
10168,39039,Defiance,Ohio,2016,5368,11688,1293,18349,0.29255000272494414,0.6369829418496921,0.07046705542536379,-2364,862,1512,10,-0.12906513441448547,0.046965228717255385,0.08209990569723014,-6320,-3876,-0.3444329391247479,-0.2111650401117156
10169,39041,Delaware,Ohio,2000,17134,36639,1630,55403,0.3092612313412631,0.661317979170803,0.029420789487933866,0,0,0,0,0.0,0.0,0.0,-19505,0,-0.35205674782953994,0.0
10170,39041,Delaware,Ohio,2004,27048,53143,265,80456,0.3361837526101223,0.6605225216267276,0.003293725763150045,9914,-1365,16504,25053,0.02692252126885919,-0.026127063724783822,-0.0007954575440753953,-26095,-6590,-0.32433876901660535,0.027717978812934585
10171,39041,Delaware,Ohio,2008,36653,54778,1150,92581,0.3959019669262592,0.5916764778950324,0.012421555178708374,9605,885,1635,12125,0.059718214316136886,0.009127829415558328,-0.06884604373169523,-18125,7970,-0.19577451096877324,0.12856425804783211
10172,39041,Delaware,Ohio,2012,37292,60194,1413,98899,0.37707155785194996,0.6086411389397264,0.014287303208323643,639,263,5416,6318,-0.018830409074309218,0.001865748029615269,0.016964661044693963,-22902,-4777,-0.23156958108777642,-0.03579507011900318
10173,39041,Delaware,Ohio,2016,40872,57568,7199,105639,0.3869025643938318,0.5449502551141151,0.06814718049205312,3580,5786,-2626,6740,0.009831006541881848,0.05385987728372948,-0.06369088382561128,-16696,6206,-0.1580476907202833,0.07352189036749313
10174,39043,Erie,Ohio,2000,17732,16105,1178,35015,0.5064115379123233,0.45994573754105383,0.03364272454662288,0,0,0,0,0.0,0.0,0.0,1627,0,0.04646580037126946,0.0
10175,39043,Erie,Ohio,2004,21421,18597,67,40085,0.5343894224772359,0.463939129350131,0.0016714481726331546,3689,-1111,2492,5070,0.02797788456491257,-0.03197127637398972,0.003993391809077151,2824,1197,0.07045029312710488,0.023984492755835418
10176,39043,Erie,Ohio,2008,23148,17432,795,41375,0.5594682779456194,0.42131722054380666,0.01921450151057402,1727,728,-1165,1290,0.02507885546838351,0.017543053337940866,-0.04262190880632433,5716,2892,0.13815105740181272,0.06770076427470784
10177,39043,Erie,Ohio,2012,21793,16952,755,39500,0.5517215189873418,0.4291645569620253,0.019113924050632912,-1355,-40,-480,-1875,-0.007746758958277589,-0.00010057745994110703,0.007847336418218664,4841,-875,0.12255696202531646,-0.015594095376496253
10178,39043,Erie,Ohio,2016,16057,19648,2157,37862,0.4240927579103059,0.5189371929639216,0.05697004912577254,-5736,1402,2696,-1638,-0.1276287610770359,0.03785612507513963,0.08977263600189628,-3591,-8432,-0.09484443505361573,-0.2174013970789322
10179,39045,Fairfield,Ohio,2000,19065,33523,1506,54094,0.35244204532850226,0.6197175287462565,0.027840425925241247,0,0,0,0,0.0,0.0,0.0,-14458,0,-0.26727548341775426,0.0
10180,39045,Fairfield,Ohio,2004,24783,42715,384,67882,0.3650894198756666,0.6292537049586047,0.0056568751657287645,5718,-1122,9192,13788,0.012647374547164358,-0.022183550759512484,0.009536176212348146,-17932,-3474,-0.26416428508293804,0.003111198334816212
10181,39045,Fairfield,Ohio,2008,29250,41580,1317,72147,0.4054222628799534,0.5763233398478107,0.01825439727223585,4467,933,-1135,4265,0.0403328430042868,0.012597522106507086,-0.052930365110793964,-12330,5602,-0.17090107696785728,0.09326320811508076
10182,39045,Fairfield,Ohio,2012,29890,41034,1296,72220,0.41387427305455554,0.5681805594018278,0.017945167543616726,640,-21,-546,73,0.00845201017460212,-0.0003092297286191245,-0.008142780445982933,-11144,1186,-0.15430628634727223,0.016594790620585054
10183,39045,Fairfield,Ohio,2016,24881,44314,4359,73554,0.33826848301927837,0.6024689343883406,0.05926258259238111,-5009,3063,3280,1334,-0.07560579003527718,0.041317415048764385,0.034288374986512826,-19433,-8289,-0.26420045136906223,-0.10989416502179
10184,39047,Fayette,Ohio,2000,3363,5685,230,9278,0.36247035999137744,0.6127398146152188,0.024789825393403752,0,0,0,0,0.0,0.0,0.0,-2322,0,-0.2502694546238413,0.0
10185,39047,Fayette,Ohio,2004,4334,7376,47,11757,0.36863145360210936,0.6273709279578124,0.003997618440078251,971,-183,1691,2479,0.006161093610731916,-0.020792206953325502,0.014631113342593594,-3042,-720,-0.258739474355703,-0.008470019731861678
10186,39047,Fayette,Ohio,2008,4401,7102,215,11718,0.37557603686635943,0.6060761222051545,0.01834784092848609,67,168,-274,-39,0.0069445832642500704,0.01435022248840784,-0.021294805752657853,-2701,341,-0.23050008533879507,0.028239389016907923
10187,39047,Fayette,Ohio,2012,4249,6620,169,11038,0.38494292444283384,0.5997463308570393,0.015310744700126834,-152,-46,-482,-680,0.009366887576474414,-0.0030370962283592564,-0.006329791348115177,-2371,330,-0.21480340641420548,0.01569667892458959
10188,39047,Fayette,Ohio,2016,2739,7995,498,11232,0.2438568376068376,0.7118055555555556,0.04433760683760684,-1510,329,1375,194,-0.14108608683599624,0.029026862137480007,0.11205922469851626,-5256,-2885,-0.46794871794871795,-0.2531453115345125
10189,39049,Franklin,Ohio,2000,202018,197862,14194,414074,0.4878789781536634,0.4778421248375894,0.03427889700874723,0,0,0,0,0.0,0.0,0.0,4156,0,0.010036853316073957,0.0
10190,39049,Franklin,Ohio,2004,285801,237253,2773,525827,0.5435266732214208,0.4511997291884974,0.005273597590081909,83783,-11421,39391,111753,0.05564769506775741,-0.02900529941866532,-0.026642395649092043,48548,44392,0.09232694403292341,0.08229009071684945
10191,39049,Franklin,Ohio,2008,334709,218486,8568,561763,0.5958188773557532,0.3889291391565482,0.015251983487698548,48908,5795,-18767,35936,0.05229220413433244,0.00997838589761664,-0.06227059003194918,116223,67675,0.20688973819920503,0.11456279416628162
10192,39049,Franklin,Ohio,2012,346373,215997,9818,572188,0.6053482421861346,0.3774930617209728,0.017158696092892545,11664,1250,-2489,10425,0.00952936483038136,0.001906712605193997,-0.011436077435575398,130376,14153,0.2278551804651618,0.020965442265956757
10193,39049,Franklin,Ohio,2016,351198,199331,36995,587524,0.5977594106793935,0.3392729488497491,0.06296764047085736,4825,27177,-16666,15336,-0.007588831506741056,0.045808944377964816,-0.03822011287122368,151867,21491,0.2584864618296444,0.03063128136448262
10194,39051,Fulton,Ohio,2000,6805,11546,545,18896,0.36012912785774764,0.6110287891617273,0.02884208298052498,0,0,0,0,0.0,0.0,0.0,-4741,0,-0.25089966130397967,0.0
10195,39051,Fulton,Ohio,2004,8224,13640,90,21954,0.3746014393732349,0.6212990798943245,0.004099480732440558,1419,-455,2094,3058,0.01447231151548728,-0.02474260224808442,0.01027029073259722,-5416,-675,-0.2466976405210896,0.004202020782890059
10196,39051,Fulton,Ohio,2008,9900,11689,424,22013,0.4497342479443965,0.5310044064870758,0.01926134556852769,1676,334,-1951,59,0.07513280857116156,0.01516186483608713,-0.09029467340724873,-1789,3627,-0.08127015854267933,0.16542748197841028
10197,39051,Fulton,Ohio,2012,9073,11738,499,21310,0.4257625527921164,0.5508212106992022,0.02341623650868137,-827,75,49,-703,-0.023971695152280093,0.004154890940153682,0.019816804212126393,-2665,-876,-0.1250586579070858,-0.043788499364406486
10198,39051,Fulton,Ohio,2016,6069,13709,1575,21353,0.28422235751416663,0.6420175151032642,0.0737601273825692,-3004,1076,1971,43,-0.14154019527794975,0.050343890873887825,0.09119630440406201,-7640,-4975,-0.3577951575890976,-0.23273649968201177
10199,39053,Gallia,Ohio,2000,4872,7511,393,12776,0.38134001252348154,0.5878991859737007,0.030760801502817785,0,0,0,0,0.0,0.0,0.0,-2639,0,-0.20655917345021918,0.0
10200,39053,Gallia,Ohio,2004,5366,8576,51,13993,0.3834774530122204,0.6128778675051811,0.003644679482598442,494,-342,1065,1217,0.002137440488738873,-0.027116122020219343,0.024978681531480418,-3210,-571,-0.22940041449296072,-0.022841241042741545
10201,39053,Gallia,Ohio,2008,4777,8247,347,13371,0.35726572432877124,0.6167825891855508,0.02595168648567796,-589,296,-329,-622,-0.026211728683449176,0.02230700700307952,0.003904721680369705,-3470,-260,-0.2595168648567796,-0.03011645036381888
10202,39053,Gallia,Ohio,2012,4557,7750,315,12622,0.361036285850103,0.6140072888607194,0.024956425289177627,-220,-32,-497,-749,0.003770561521331761,-0.0009952611965003341,-0.00277530032483142,-3193,277,-0.2529710030106164,0.006545861846163181
10203,39053,Gallia,Ohio,2016,2628,9822,554,13004,0.2020916641033528,0.7553060596739465,0.042602276222700707,-1929,239,2072,382,-0.1589446217467502,0.01764585093352308,0.14129877081322706,-7194,-4001,-0.5532143955705937,-0.3002433925599773
10204,39055,Geauga,Ohio,2000,15327,25417,1856,42600,0.3597887323943662,0.5966431924882629,0.04356807511737089,0,0,0,0,0.0,0.0,0.0,-10090,0,-0.2368544600938967,0.0
10205,39055,Geauga,Ohio,2004,19850,30370,222,50442,0.39352127195590975,0.6020776337179334,0.004401094326156774,4523,-1634,4953,7842,0.03373253956154354,-0.03916698079121411,0.005434441229670517,-10520,-430,-0.2085563617620237,0.028298098331873023
10206,39055,Geauga,Ohio,2008,21250,29096,899,51245,0.4146746024002342,0.5677822226558689,0.017543174943896966,1400,677,-1274,803,0.021153330444324436,0.013142080617740193,-0.034295411062064574,-7846,2674,-0.15310762025563468,0.05544874150638901
10207,39055,Geauga,Ohio,2012,19659,30589,865,51113,0.38461839453759317,0.5984583178447753,0.01692328761763152,-1591,-34,1493,-132,-0.030056207862641016,-0.0006198873262654447,0.03067609518890646,-10930,-3084,-0.21383992330718216,-0.060732303051547476
10208,39055,Geauga,Ohio,2016,17569,30227,2866,50662,0.3467885199952627,0.5966404800442145,0.05657099996052268,-2090,2001,-362,-451,-0.037829874542330444,0.03964771234289116,-0.0018178378005607732,-12658,-1728,-0.24985196004895183,-0.03601203674176967
10209,39057,Greene,Ohio,2000,25059,37946,2199,65204,0.3843169130728176,0.5819581620759463,0.03372492485123612,0,0,0,0,0.0,0.0,0.0,-12887,0,-0.19764124900312868,0.0
10210,39057,Greene,Ohio,2004,30531,48388,363,79282,0.3850937161020156,0.610327691026967,0.004578592871017381,5472,-1836,10442,14078,0.00077680302919797,-0.029146331980218737,0.02836952895102074,-17857,-4970,-0.22523397492495145,-0.02759272592182277
10211,39057,Greene,Ohio,2008,33540,48936,1253,83729,0.40057805539299407,0.5844569981726762,0.014964946434329803,3009,890,548,4447,0.015484339290978477,0.010386353563312422,-0.02587069285429089,-15396,2461,-0.1838789427796821,0.041355032145269366
10212,39057,Greene,Ohio,2012,32256,49819,1551,83626,0.3857173606294693,0.5957357759548466,0.018546863415684116,-1284,298,883,-103,-0.014860694763524751,0.003581916981354313,0.011278777782170457,-17563,-2167,-0.2100184153253773,-0.026139472545695208
10213,39057,Greene,Ohio,2016,28943,48540,5454,82937,0.3489757285650554,0.5852635132691079,0.06576075816583672,-3313,3903,-1279,-689,-0.03674163206441394,0.047213894750152606,-0.010472262685738754,-19597,-2034,-0.23628778470405248,-0.02626936937867519
10214,39059,Guernsey,Ohio,2000,6643,8181,606,15430,0.4305249513933895,0.530200907323396,0.03927414128321452,0,0,0,0,0.0,0.0,0.0,-1538,0,-0.0996759559300065,0.0
10215,39059,Guernsey,Ohio,2004,7768,9962,110,17840,0.4354260089686099,0.558408071748879,0.00616591928251121,1125,-496,1781,2410,0.004901057575220413,-0.03310822200070331,0.02820716442548299,-2194,-656,-0.12298206278026907,-0.023306106850262576
10216,39059,Guernsey,Ohio,2008,7625,9197,553,17375,0.43884892086330934,0.5293237410071943,0.0318273381294964,-143,443,-765,-465,0.003422911894699454,0.025661418846985192,-0.029084330741684705,-1572,622,-0.09047482014388492,0.03250724263638416
10217,39059,Guernsey,Ohio,2012,7450,8993,406,16849,0.4421627396284646,0.5337408748293667,0.024096385542168676,-175,-147,-204,-526,0.003313818765155241,-0.007730952587327727,0.004417133822172459,-1543,29,-0.09157813520090213,-0.0011033150570172179
10218,39059,Guernsey,Ohio,2016,4359,11445,843,16647,0.26184898179852223,0.687511263290683,0.05063975491079474,-3091,437,2452,-202,-0.18031375782994236,0.026543369368626064,0.1537703884613163,-7086,-5543,-0.4256622814921608,-0.33408414629125865
10219,39061,Hamilton,Ohio,2000,161578,204175,12146,377899,0.4275692711544619,0.540289865810706,0.03214086303483206,0,0,0,0,0.0,0.0,0.0,-42597,0,-0.11272059465624412,0.0
10220,39061,Hamilton,Ohio,2004,199679,222616,1730,424025,0.47091327162313545,0.5250067802605979,0.00407994811626673,38101,-10416,18441,46126,0.04334400046867354,-0.02806091491856533,-0.015283085550108155,-22937,19660,-0.05409350863746243,0.05862708601878169
10221,39061,Hamilton,Ohio,2008,225213,195530,4343,425086,0.5298057334280593,0.4599775104331829,0.010216756138757804,25534,2613,-27086,1061,0.0588924618049238,0.006136808022491075,-0.06502926982741497,29683,52620,0.06982822299487634,0.12392173163233877
10222,39061,Hamilton,Ohio,2012,219927,193326,5641,418894,0.5250182623766394,0.4615153236857057,0.013466413937654872,-5286,1298,-2204,-6192,-0.004787471051419856,0.003249657798897068,0.0015378132525227795,26601,-3082,0.06350293869093371,-0.006325284303942635
10223,39061,Hamilton,Ohio,2016,215719,173665,19725,409109,0.5272897931847014,0.4244956723024915,0.0482145345128071,-4208,14084,-19661,-9785,0.0022715308080619723,0.034748120575152225,-0.03701965138321417,42054,15453,0.10279412088220985,0.03929118219127614
10224,39063,Hancock,Ohio,2000,8798,20985,834,30617,0.2873566972596923,0.6854035339843878,0.027239768755919914,0,0,0,0,0.0,0.0,0.0,-12187,0,-0.3980468367246955,0.0
10225,39063,Hancock,Ohio,2004,10352,25105,162,35619,0.2906314045874393,0.7048204609899211,0.004548134422639603,1554,-672,4120,5002,0.003274707327746984,-0.022691634333280312,0.019416927005533324,-14753,-2566,-0.4141890564024818,-0.01614221967778634
10226,39063,Hancock,Ohio,2008,13870,22420,765,37055,0.3743084603967076,0.6050465524220753,0.02064498718121711,3518,603,-2685,1436,0.08367705580926832,0.016096852758577508,-0.09977390856784585,-8550,6203,-0.23073809202536766,0.18345096437711417
10227,39063,Hancock,Ohio,2012,12564,22443,776,35783,0.351116451946455,0.6271972724478104,0.021686275605734568,-1306,11,23,-1272,-0.0231920084502526,0.0010412884245174572,0.02215072002573515,-9879,-1329,-0.2760808205013554,-0.04534272847598775
10228,39063,Hancock,Ohio,2016,9609,24183,2442,36234,0.26519291273389634,0.6674118231495281,0.06739526411657559,-2955,1666,1740,451,-0.08592353921255869,0.04570898851084103,0.040214550701717644,-14574,-4695,-0.40221891041563174,-0.12613808991427633
10229,39065,Hardin,Ohio,2000,4557,7124,387,12068,0.3776102088167053,0.5903215114352005,0.03206827974809413,0,0,0,0,0.0,0.0,0.0,-2567,0,-0.2127113026184952,0.0
10230,39065,Hardin,Ohio,2004,4891,8441,60,13392,0.36521804062126645,0.6303016726403823,0.004480286738351254,334,-327,1317,1324,-0.012392168195438868,-0.02758799300974288,0.039980161205181775,-3550,-983,-0.26508363201911583,-0.05237232940062064
10231,39065,Hardin,Ohio,2008,5013,7749,387,13149,0.3812457221081451,0.5893223819301848,0.02943189596167009,122,327,-692,-243,0.016027681486878664,0.024951609223318835,-0.04097929071019746,-2736,814,-0.2080766598220397,0.05700697219707612
10232,39065,Hardin,Ohio,2012,4619,7489,362,12470,0.37040898155573376,0.6005613472333601,0.029029671210906174,-394,-25,-260,-679,-0.01083674055241135,-0.00040222475076391595,0.011238965303175252,-2870,-134,-0.2301523656776263,-0.022075705855586603
10233,39065,Hardin,Ohio,2016,2920,8717,717,12354,0.23636069289299014,0.7056014246397928,0.0580378824672171,-1699,355,1228,-116,-0.13404828866274363,0.029008211256310923,0.10504007740643273,-5797,-2927,-0.4692407317468027,-0.23908836606917638
10234,39067,Harrison,Ohio,2000,3351,3417,393,7161,0.4679514034352744,0.47716799329702553,0.05488060326770004,0,0,0,0,0.0,0.0,0.0,-66,0,-0.009216589861751112,0.0
10235,39067,Harrison,Ohio,2004,3780,4274,55,8109,0.46614872364039955,0.5270686891108645,0.0067825872487359724,429,-338,857,948,-0.0018026797948748619,-0.048098016018964074,0.049900695813838936,-494,-428,-0.06091996547046491,-0.0517033756087138
10236,39067,Harrison,Ohio,2008,3683,3872,262,7817,0.47115261609313036,0.4953306895228348,0.0335166943840348,-97,207,-402,-292,0.005003892452730807,0.026734107135298824,-0.03173799958802964,-189,305,-0.02417807342970446,0.03674189204076045
10237,39067,Harrison,Ohio,2012,2950,4019,184,7153,0.4124143715923389,0.5618621557388508,0.02572347266881029,-733,-78,147,-664,-0.05873824450079146,-0.007793221715224508,0.06653146621601597,-1069,-880,-0.1494477841465119,-0.12526971071680743
10238,39067,Harrison,Ohio,2016,1688,5098,319,7105,0.23757916959887404,0.7175228712174525,0.044897959183673466,-1262,135,1079,-48,-0.17483520199346486,0.019174486514863177,0.15566071547860172,-3410,-2341,-0.47994370161857847,-0.3304959174720666
10239,39069,Henry,Ohio,2000,4367,8530,355,13252,0.3295351645034712,0.6436764261998189,0.02678840929670993,0,0,0,0,0.0,0.0,0.0,-4163,0,-0.3141412616963477,0.0
10240,39069,Henry,Ohio,2004,5111,9902,92,15105,0.3383647798742138,0.6555445216815624,0.006090698444223767,744,-263,1372,1853,0.008829615370742616,-0.020697710852486163,0.011868095481743501,-4791,-628,-0.3171797418073486,-0.0030384801110008852
10241,39069,Henry,Ohio,2008,6320,8239,293,14852,0.425531914893617,0.5547401023431188,0.019727982763264207,1209,201,-1663,-253,0.08716713501940321,0.01363728431904044,-0.10080441933844364,-1919,2872,-0.12920818744950174,0.18797155435784685
10242,39069,Henry,Ohio,2012,5658,8257,342,14257,0.3968576839447289,0.5791540997404784,0.023988216314792733,-662,49,18,-595,-0.028674230948888102,0.004260233551528526,0.02441399739735961,-2599,-680,-0.18229641579574946,-0.05308822834624771
10243,39069,Henry,Ohio,2016,3756,9301,996,14053,0.26727389169572335,0.6618515619440689,0.07087454636020779,-1902,654,1044,-204,-0.12958379224900557,0.04688633004541506,0.08269746220359053,-5545,-2946,-0.39457767024834556,-0.2122812544525961
10244,39071,Highland,Ohio,2000,5328,9728,391,15447,0.3449213439502816,0.6297662976629766,0.025312358386741764,0,0,0,0,0.0,0.0,0.0,-4400,0,-0.284844953712695,0.0
10245,39071,Highland,Ohio,2004,6194,12211,76,18481,0.3351550240787836,0.6607326443374276,0.004112331583788756,866,-315,2483,3034,-0.009766319871498008,-0.021200026802953006,0.030966346674450973,-6017,-1617,-0.325577620258644,-0.04073266654594898
10246,39071,Highland,Ohio,2008,6856,11907,468,19231,0.3565077219073371,0.6191565701211585,0.02433570797150434,662,392,-304,750,0.02135269782855348,0.020223376387715583,-0.04157607421626908,-5051,966,-0.26264884821382145,0.06292877204482256
10247,39071,Highland,Ohio,2012,6054,11413,412,17879,0.3386095419206891,0.6383466636836512,0.023043794395659713,-802,-56,-494,-1352,-0.017898179986648,-0.0012919135758446276,0.019190093562492683,-5359,-308,-0.29973712176296213,-0.03708827354914068
10248,39071,Highland,Ohio,2016,3773,14020,795,18588,0.2029804174736389,0.7542500537981494,0.04276952872821175,-2281,383,2607,709,-0.1356291244470502,0.019725734332552036,0.11590339011449813,-10247,-4888,-0.5512696363245104,-0.2515325145615483
10249,39073,Hocking,Ohio,2000,4474,5702,580,10756,0.41595388620304946,0.5301227222015619,0.05392339159538862,0,0,0,0,0.0,0.0,0.0,-1228,0,-0.11416883599851241,0.0
10250,39073,Hocking,Ohio,2004,6175,6936,88,13199,0.4678384726115615,0.5254943556330025,0.006667171755436018,1701,-492,1234,2443,0.05188458640851201,-0.0472562198399526,-0.004628366568559361,-761,467,-0.057655883021441034,0.05651295297707137
10251,39073,Hocking,Ohio,2008,6259,6364,393,13016,0.48086969883220654,0.48893669330055317,0.03019360786724032,84,305,-572,-183,0.013031226220645065,0.0235264361118043,-0.03655766233244934,-105,656,-0.008066994468346633,0.0495888885530944
10252,39073,Hocking,Ohio,2012,6157,6285,326,12768,0.48222117794486213,0.49224624060150374,0.025532581453634084,-102,-67,-79,-248,0.0013514791126555958,-0.004661026413606235,0.003309547300950566,-128,-23,-0.010025062656641603,-0.00195806818829497
10253,39073,Hocking,Ohio,2016,3775,8497,657,12929,0.2919792714053678,0.6572047335447444,0.05081599504988785,-2382,331,2212,161,-0.19024190653949435,0.025283413596253763,0.16495849294324066,-4722,-4594,-0.3652254621393766,-0.355200399482735
10254,39075,Holmes,Ohio,2000,2066,6754,325,9145,0.22591580098414435,0.7385456533624931,0.035538545653362494,0,0,0,0,0.0,0.0,0.0,-4688,0,-0.5126298523783488,0.0
10255,39075,Holmes,Ohio,2004,2697,8468,55,11220,0.24037433155080215,0.7547237076648842,0.004901960784313725,631,-270,1714,2075,0.014458530566657801,-0.03063658486904877,0.016178054302391054,-5771,-1083,-0.514349376114082,-0.0017195237357332527
10256,39075,Holmes,Ohio,2008,3141,7720,273,11134,0.2821088557571403,0.6933716543919526,0.02451948985090713,444,218,-748,-86,0.041734524206338136,0.019617529066593406,-0.061352053272931584,-4579,1192,-0.4112627986348123,0.10308657747926975
10257,39075,Holmes,Ohio,2012,2608,8702,257,11567,0.22546900665686867,0.7523126134693525,0.022218379873778855,-533,-16,982,433,-0.056639849100271616,-0.0023011099771282767,0.058940959077399935,-6094,-1515,-0.5268436068124839,-0.11558080817767158
10258,39075,Holmes,Ohio,2016,1788,8720,598,11106,0.16099405726634253,0.7851611741401044,0.053844768593553034,-820,341,18,-461,-0.06447494939052614,0.031626388719774176,0.032848560670751925,-6932,-838,-0.6241671168737619,-0.09732351006127804
10259,39077,Huron,Ohio,2000,8183,12286,891,21360,0.38309925093632957,0.5751872659176029,0.04171348314606742,0,0,0,0,0.0,0.0,0.0,-4103,0,-0.19208801498127337,0.0
10260,39077,Huron,Ohio,2004,10568,14817,173,25558,0.41349088348071056,0.5797401987635965,0.006768917755692934,2385,-718,2531,4198,0.030391632544380986,-0.03494456539037449,0.0045529328459935625,-4249,-146,-0.16624931528288595,0.025838699698387424
10261,39077,Huron,Ohio,2008,12076,12884,622,25582,0.47205066062074896,0.50363536861856,0.02431397076069111,1508,449,-1933,24,0.058559777140038405,0.017545053004998177,-0.07610483014503655,-808,3441,-0.03158470799781099,0.13466460728507496
10262,39077,Huron,Ohio,2012,11006,13060,645,24711,0.4453886932944842,0.5285095706365586,0.026101736068957146,-1070,23,176,-871,-0.026661967326264746,0.0017877653082660344,0.024874202017998615,-2054,-1246,-0.08312087734207435,-0.05153616934426336
10263,39077,Huron,Ohio,2016,7192,16226,1584,25002,0.2876569874410047,0.6489880809535237,0.06335493160547156,-3814,939,3166,291,-0.1577317058534795,0.03725319553651442,0.1204785103169651,-9034,-6980,-0.36133109351251896,-0.2782102161704446
10264,39079,Jackson,Ohio,2000,5131,6958,401,12490,0.41080864691753405,0.5570856685348279,0.03210568454763811,0,0,0,0,0.0,0.0,0.0,-1827,0,-0.14627702161729383,0.0
10265,39079,Jackson,Ohio,2004,5700,8585,49,14334,0.3976559229803265,0.598925631365983,0.003418445653690526,569,-352,1627,1844,-0.013152723937207567,-0.028687238893947586,0.0418399628311551,-2885,-1058,-0.2012697083856565,-0.054992686768362664
10266,39079,Jackson,Ohio,2008,5397,8219,431,14047,0.3842101516338008,0.5851071403146579,0.030682708051541253,-303,382,-366,-287,-0.013445771346525692,0.02726426239785073,-0.013818491051325044,-2822,63,-0.20089698868085715,0.00037271970479935135
10267,39079,Jackson,Ohio,2012,5166,7904,334,13404,0.38540734109221125,0.5896747239629961,0.024917934944792598,-231,-97,-315,-643,0.0011971894584104636,-0.005764773106748656,0.004567583648338203,-2738,84,-0.20426738287078489,-0.003370394189927739
10268,39079,Jackson,Ohio,2016,3226,9949,601,13776,0.23417537746806039,0.7221980255516841,0.04362659698025552,-1940,267,2045,372,-0.15123196362415087,0.01870866203546292,0.13252330158868797,-6723,-3985,-0.4880226480836237,-0.28375526521283884
10269,39081,Jefferson,Ohio,2000,17488,15038,2110,34636,0.5049081880124726,0.4341725372444855,0.06091927474304192,0,0,0,0,0.0,0.0,0.0,2450,0,0.0707356507679871,0.0
10270,39081,Jefferson,Ohio,2004,19024,17185,163,36372,0.5230397008688001,0.4724788298691301,0.004481469262069724,1536,-1947,2147,1736,0.018131512856327525,-0.0564378054809722,0.03830629262464458,1839,-611,0.05056087099967005,-0.020174779768317053
10271,39081,Jefferson,Ohio,2008,17635,17559,877,36071,0.4888968977849242,0.4867899420587175,0.024313160156358295,-1389,714,374,-301,-0.03414280308387596,0.019831690894288573,0.014311112189587416,76,-1763,0.002106955726206672,-0.04845391527346338
10272,39081,Jefferson,Ohio,2012,15385,17034,758,33177,0.46372486963860504,0.5134279772131296,0.022847153148265364,-2250,-119,-525,-2894,-0.025172028146319136,-0.001466007008092931,0.0266380351544121,-1649,-1725,-0.04970310757452456,-0.051810063300731235
10273,39081,Jefferson,Ohio,2016,9675,21117,1619,32411,0.29850976520317174,0.6515380580667057,0.04995217673012249,-5710,861,4083,-766,-0.1652151044354333,0.027105023581857127,0.13811008085357612,-11442,-9793,-0.353028292863534,-0.3033251852890094
10274,39083,Knox,Ohio,2000,7133,13393,734,21260,0.33551269990592664,0.6299623706491063,0.03452492944496707,0,0,0,0,0.0,0.0,0.0,-6260,0,-0.2944496707431797,0.0
10275,39083,Knox,Ohio,2004,9820,17068,157,27045,0.3630985394712516,0.6310963209465705,0.005805139582177852,2687,-577,3675,5785,0.027585839565324954,-0.02871978986278922,0.0011339502974642146,-7248,-988,-0.26799778147531894,0.02645188926786074
10276,39083,Knox,Ohio,2008,11014,16640,631,28285,0.38939367155736254,0.5882976842849567,0.02230864415768075,1194,474,-428,1240,0.02629513208611095,0.016503504575502898,-0.042798636661613876,-5626,1622,-0.19890401272759411,0.06909376874772483
10277,39083,Knox,Ohio,2012,10470,17266,727,28463,0.367845975476935,0.6066120928925272,0.02554193163053789,-544,96,626,178,-0.02154769608042756,0.00323328747285714,0.018314408607570498,-6796,-1170,-0.23876611741559217,-0.03986210468799806
10278,39083,Knox,Ohio,2016,8171,19131,1625,28927,0.2824696650188405,0.6613544439451032,0.05617589103605628,-2299,898,1865,464,-0.08537631045809446,0.030633959405518392,0.05474235105257608,-10960,-4164,-0.3788847789262627,-0.14011866151067054
10279,39085,Lake,Ohio,2000,46497,51747,4320,102564,0.45334620334620335,0.5045337545337545,0.04212004212004212,0,0,0,0,0.0,0.0,0.0,-5250,0,-0.05118755118755114,0.0
10280,39085,Lake,Ohio,2004,59049,62193,581,121823,0.48471142559286834,0.510519360055162,0.004769214351969661,12552,-3739,10446,19259,0.03136522224666499,-0.037350827768072456,0.005985605521407478,-3144,2106,-0.025807934462293625,0.025379616725257514
10281,39085,Lake,Ohio,2008,60155,59142,2345,121642,0.49452491738051,0.4861972016244389,0.019277880995051053,1106,1764,-3051,-181,0.009813491787641682,0.014508666643081392,-0.02432215843072305,1013,4157,0.008327715756071108,0.03413565021836473
10282,39085,Lake,Ohio,2012,57680,58744,2241,118665,0.4860742426157671,0.49504066068343655,0.01888509670079636,-2475,-104,-398,-2977,-0.008450674764742927,-0.0003927842942546937,0.008843459058997638,-1064,-2077,-0.008966418067669457,-0.017294133823740565
10283,39085,Lake,Ohio,2016,46397,64255,6538,117190,0.395912620530762,0.5482976363170919,0.05578974315214609,-11283,4297,5511,-1475,-0.09016162208500511,0.036904646451349735,0.05325697563365539,-17858,-16794,-0.15238501578632996,-0.1434185977186605
10284,39087,Lawrence,Ohio,2000,11307,12531,614,24452,0.46241616227711435,0.5124734173073777,0.025110420415507935,0,0,0,0,0.0,0.0,0.0,-1224,0,-0.05005725503026337,0.0
10285,39087,Lawrence,Ohio,2004,12120,15455,135,27710,0.4373872248285817,0.5577408877661494,0.004871887405268856,813,-479,2924,3258,-0.02502893744853263,-0.02023853301023908,0.045267470458771664,-3335,-2111,-0.12035366293756766,-0.07029640790730429
10286,39087,Lawrence,Ohio,2008,11262,15415,713,27390,0.4111719605695509,0.5627966411098941,0.026031398320554948,-858,578,-40,-320,-0.026215264259030813,0.021159510915286093,0.005055753343744751,-4153,-818,-0.15162468054034323,-0.031271017602775564
10287,39087,Lawrence,Ohio,2012,10744,14651,537,25932,0.41431436063550825,0.564977633811507,0.02070800555298473,-518,-176,-764,-1458,0.0031424000659573403,-0.005323392767570219,0.0021809927016128716,-3907,246,-0.15066327317599876,0.0009614073643444687
10288,39087,Lawrence,Ohio,2016,6974,18689,1126,26789,0.2603307327634477,0.6976370898503117,0.04203217738624062,-3770,589,4038,857,-0.15398362787206055,0.02132417183325589,0.1326594560388047,-11715,-7808,-0.437306357086864,-0.28664308391086524
10289,39089,Licking,Ohio,2000,23196,37180,2090,62466,0.3713380078762847,0.5952037908622291,0.03345820126148625,0,0,0,0,0.0,0.0,0.0,-13984,0,-0.2238657829859444,0.0
10290,39089,Licking,Ohio,2004,30053,49016,351,79420,0.3784059430873835,0.6171745152354571,0.004419541677159406,6857,-1739,11836,16954,0.00706793521109883,-0.029038659584326845,0.021970724373228,-18963,-4979,-0.23876857214807357,-0.01490278916212917
10291,39089,Licking,Ohio,2008,33932,46918,1720,82570,0.41094828630253116,0.5682209034758386,0.020830810221630133,3879,1369,-2098,3150,0.03254234321514765,0.016411268544470725,-0.04895361175961843,-12986,5977,-0.15727261717330748,0.08149595497476608
10292,39089,Licking,Ohio,2012,34201,45503,1846,81550,0.4193868792152054,0.5579767014101779,0.0226364193746168,269,126,-1415,-1020,0.008438592912674237,0.0018056091529866682,-0.01024420206566079,-11302,1684,-0.13858982219497246,0.018682794978335027
10293,39089,Licking,Ohio,2016,27376,51241,5007,83624,0.32737013297617906,0.6127547115660575,0.05987515545776332,-6825,3161,5738,2074,-0.09201674623902634,0.03723873608314652,0.054778010155879686,-23865,-12563,-0.2853845785898785,-0.14679475639490602
10294,39091,Logan,Ohio,2000,5945,11849,661,18455,0.3221349227851531,0.6420482254131672,0.03581685180167976,0,0,0,0,0.0,0.0,0.0,-5904,0,-0.3199133026280141,0.0
10295,39091,Logan,Ohio,2004,6825,14471,102,21398,0.318955042527339,0.6762781568370876,0.004766800635573418,880,-559,2622,2943,-0.0031798802578140717,-0.031050051166106343,0.03422993142392039,-7646,-1742,-0.35732311430974856,-0.03740981168173446
10296,39091,Logan,Ohio,2008,7936,13848,499,22283,0.3561459408517704,0.6214603060629179,0.022393753085311673,1111,397,-623,885,0.0371908983244314,0.017626952449738255,-0.054817850774169674,-5912,1734,-0.2653143652111475,0.09200874909860107
10297,39091,Logan,Ohio,2012,7062,13633,504,21199,0.33312892117552717,0.6430963724703995,0.023774706354073305,-874,5,-215,-1084,-0.023017019676243256,0.0013809532687616317,0.021636066407481613,-6571,-659,-0.30996745129487235,-0.04465308608372487
10298,39091,Logan,Ohio,2016,4647,15957,1108,21712,0.21402910832719232,0.7349392041267502,0.05103168754605748,-2415,604,2324,513,-0.11909981284833485,0.027256981191984178,0.09184283165635065,-11310,-4739,-0.5209100957995578,-0.21094264450468547
10299,39093,Lorain,Ohio,2000,59809,47957,4414,112180,0.5331520770190765,0.42750044571224816,0.039347477268675345,0,0,0,0,0.0,0.0,0.0,11852,0,0.10565163130682836,0.0
10300,39093,Lorain,Ohio,2004,78970,61203,569,140742,0.5610976112318995,0.4348595302042034,0.00404285856389706,19161,-3845,13246,28562,0.027945534212822976,-0.03530461870477829,0.00735908449195527,17767,5915,0.12623808102769607,0.020586449720867706
10301,39093,Lorain,Ohio,2008,85276,59068,2515,146859,0.5806658087008627,0.4022089214825104,0.017125269816626834,6306,1946,-2135,6117,0.01956819746896321,0.013082411252729773,-0.03265060872169301,26208,8441,0.1784568872183523,0.05221880619065622
10302,39093,Lorain,Ohio,2012,81464,59405,2383,143252,0.5686761790411303,0.4146888001563678,0.016635020802501885,-3812,-132,337,-3607,-0.011989629659732381,-0.0004902490141249494,0.012479878673857359,22059,-4149,0.15398737888476255,-0.02446950833358974
10303,39093,Lorain,Ohio,2016,66949,66818,6795,140562,0.4762951580085656,0.4753631849290704,0.04834165706236394,-14515,4412,7413,-2690,-0.09238102103256474,0.03170663625986205,0.06067438477270265,131,-21928,0.0009319730794951631,-0.15305540580526739
10304,39095,Lucas,Ohio,2000,108344,73342,5664,187350,0.5782973045102748,0.39147050974112624,0.03023218574859888,0,0,0,0,0.0,0.0,0.0,35002,0,0.1868267947691486,0.0
10305,39095,Lucas,Ohio,2004,132715,87160,555,220430,0.6020732205235222,0.3954089733702309,0.002517806106246881,24371,-5109,13818,33080,0.023775916013247356,-0.027714379642352,0.00393846362910466,45555,10553,0.2066642471532913,0.019837452384142695
10306,39095,Lucas,Ohio,2008,142852,73706,3899,220457,0.6479812389717723,0.33433277237737974,0.01768598865084801,10137,3344,-13454,27,0.0459080184482501,0.01516818254460113,-0.06107620099285116,69146,23591,0.31364846659439255,0.10698421944110126
10307,39095,Lucas,Ohio,2012,136616,69940,4064,210620,0.6486373563764125,0.33206723008261324,0.019295413540974266,-6236,165,-3766,-9837,0.0006561174046402218,0.0016094248901262556,-0.0022655422947664983,66676,-2470,0.31657012629379927,0.00292165969940672
10308,39095,Lucas,Ohio,2016,110833,75698,12299,198830,0.5574259417592918,0.38071719559422623,0.06185686264648192,-25783,8235,5758,-11790,-0.09121141461712068,0.04256144910550766,0.04864996551161299,35135,-31541,0.1767087461650656,-0.13986138012873367
10309,39097,Madison,Ohio,2000,5287,8892,488,14667,0.3604690802481762,0.6062589486602578,0.0332719710915661,0,0,0,0,0.0,0.0,0.0,-3605,0,-0.24578986841208156,0.0
10310,39097,Madison,Ohio,2004,6203,11117,78,17398,0.356535233934935,0.6389814921255317,0.00448327393953328,916,-410,2225,2731,-0.003933846313241174,-0.02878869715203282,0.03272254346527392,-4914,-1309,-0.28244625819059666,-0.0366563897785151
10311,39097,Madison,Ohio,2008,6532,10606,372,17510,0.373043974871502,0.6057110222729869,0.021245002855511137,329,294,-511,112,0.016508740936566957,0.016761728915977856,-0.03327046985254478,-4074,840,-0.23266704740148492,0.04977921078911174
10312,39097,Madison,Ohio,2012,6845,10342,370,17557,0.38987298513413454,0.5890527994532095,0.02107421541265592,313,-2,-264,47,0.01682901026263256,-0.0001707874428552164,-0.016658222819777357,-3497,577,-0.199179814319075,0.03348723308240992
10313,39097,Madison,Ohio,2016,4779,11631,1011,17421,0.27432409161356985,0.6676425004305149,0.05803340795591527,-2066,641,1289,-136,-0.11554889352056469,0.036959192543259356,0.07858970097730533,-6852,-3355,-0.393318408816945,-0.19413859449787002
10314,39099,Mahoning,Ohio,2000,69212,40460,4447,114119,0.6064897168744907,0.3545421884173538,0.03896809470815552,0,0,0,0,0.0,0.0,0.0,28752,0,0.2519475284571369,0.0
10315,39099,Mahoning,Ohio,2004,83194,48761,949,132904,0.6259706254138325,0.3668888822006862,0.007140492385481249,13982,-3498,8301,18785,0.019480908539341812,-0.03182760232267427,0.012346693783332419,34433,5681,0.2590817432131463,0.007134214756009394
10316,39099,Mahoning,Ohio,2008,79173,45319,3167,127659,0.6201912908608088,0.3550004308352721,0.024808278303919035,-4021,2218,-3442,-5245,-0.005779334553023707,0.017667785918437786,-0.01188845136541411,33854,-579,0.2651908600255367,0.006109116812390403
10317,39099,Mahoning,Ohio,2012,77059,42641,1882,121582,0.6338027010577224,0.3507180339194947,0.015479265022782978,-2114,-1285,-2678,-6077,0.013611410196913587,-0.009329013281136058,-0.00428239691577742,34418,564,0.2830846671382277,0.017893807112691007
10318,39099,Mahoning,Ohio,2016,57381,53616,4961,115958,0.4948429603822074,0.4623743079390814,0.04278273167871126,-19678,3079,10975,-5624,-0.13895974067551503,0.027303466655928282,0.11165627401958672,3765,-30653,0.03246865244312597,-0.25061601469510175
10319,39101,Marion,Ohio,2000,10370,13617,828,24815,0.41789240378803144,0.5487406810396938,0.03336691517227484,0,0,0,0,0.0,0.0,0.0,-3247,0,-0.13084827725166231,0.0
10320,39101,Marion,Ohio,2004,11930,17171,157,29258,0.4077517260236517,0.5868822202474537,0.005366053728894662,1560,-671,3554,4443,-0.010140677764379769,-0.028000861443380175,0.03814153920775998,-5241,-1994,-0.17913049422380206,-0.048282216972139747
10321,39101,Marion,Ohio,2008,12870,15454,768,29092,0.4423896603877355,0.531211329575141,0.026399010037123607,940,611,-1717,-166,0.0346379343640838,0.021032956308228944,-0.05567089067231279,-2584,2657,-0.08882166918740547,0.09030882503639659
10322,39101,Marion,Ohio,2012,12504,14265,649,27418,0.45605076956743745,0.5202786490626595,0.023670581369902983,-366,-119,-1189,-1674,0.01366110917970198,-0.002728428667220624,-0.010932680512481419,-1761,823,-0.06422787949522207,0.0245937896921834
10323,39101,Marion,Ohio,2016,7928,16961,1589,26478,0.2994183850744014,0.6405695294206512,0.0600120855049475,-4576,940,2696,-940,-0.15663238449303607,0.036341504135044514,0.12029088035799163,-9033,-7272,-0.34115114434624977,-0.2769232648510277
10324,39103,Medina,Ohio,2000,26635,37349,2899,66883,0.398232734775653,0.5584229176322832,0.04334434759206375,0,0,0,0,0.0,0.0,0.0,-10714,0,-0.16019018285663023,0.0
10325,39103,Medina,Ohio,2004,36272,48196,410,84878,0.4273427743349278,0.5678267631188294,0.004830462546242842,9637,-2489,10847,17995,0.02911003955927477,-0.03851388504582091,0.009403845486546158,-11924,-1210,-0.14048398878390161,0.01970619407272861
10326,39103,Medina,Ohio,2008,40924,48189,1539,90652,0.45144067422671313,0.5315823147862154,0.01697701098707144,4652,1129,-7,5774,0.024097899891785346,0.012146548440828596,-0.03624444833261398,-7265,4659,-0.08014164055950229,0.06034234822439932
10327,39103,Medina,Ohio,2012,38785,50418,1728,90931,0.42653220573841705,0.5544643740858453,0.019003420175737647,-2139,189,2229,279,-0.024908468488296087,0.0020264091886662075,0.02288205929962983,-11633,-4368,-0.1279321683474282,-0.04779052778792592
10328,39103,Medina,Ohio,2016,32182,54810,5171,92163,0.34918568188969545,0.5947072035415514,0.05610711456875319,-6603,3443,4392,1232,-0.0773465238487216,0.03710369439301554,0.04024282945570612,-22628,-10995,-0.24552152165185592,-0.11758935330442771
10329,39105,Meigs,Ohio,2000,3674,5750,371,9795,0.37508933129147526,0.587034201123022,0.03787646758550281,0,0,0,0,0.0,0.0,0.0,-2076,0,-0.2119448698315467,0.0
10330,39105,Meigs,Ohio,2004,4438,6272,61,10771,0.4120323089778108,0.5823043357162752,0.005663355305914029,764,-310,522,976,0.03694297768633553,-0.032213112279588785,-0.004729865406746803,-1834,242,-0.17027202673846437,0.041672843093082335
10331,39105,Meigs,Ohio,2008,4094,6015,298,10407,0.3933890650523686,0.5779763620639954,0.028634572883636016,-344,237,-257,-364,-0.0186432439254422,0.022971217577721987,-0.004327973652279771,-1921,-87,-0.1845872970116268,-0.014315270273162428
10332,39105,Meigs,Ohio,2012,4027,5895,296,10218,0.3941084360931689,0.5769230769230769,0.02896848698375416,-67,-2,-120,-189,0.0007193710408003318,0.00033391410011814407,-0.001053285140918514,-1868,53,-0.18281464082990795,0.0017726561817188458
10333,39105,Meigs,Ohio,2016,2260,7309,472,10041,0.22507718354745543,0.7279155462603326,0.04700727019221193,-1767,176,1414,-177,-0.1690312525457135,0.01803878320845777,0.15099246933725574,-5049,-3181,-0.5028383627128772,-0.32002372188296924
10334,39107,Mercer,Ohio,2000,5212,12485,597,18294,0.28490215371159944,0.6824641959112278,0.03263365037717284,0,0,0,0,0.0,0.0,0.0,-7273,0,-0.3975620421996283,0.0
10335,39107,Mercer,Ohio,2004,5118,15650,122,20890,0.244997606510292,0.749162278602202,0.005840114887505984,-94,-475,3165,2596,-0.03990454720130743,-0.026793535489666856,0.06669808269097421,-10532,-3259,-0.50416467209191,-0.10660262989228164
10336,39107,Mercer,Ohio,2008,5853,15100,346,21299,0.2748016338795249,0.7089534719939903,0.01624489412648481,735,224,-550,409,0.029804027369232877,0.010404779238978827,-0.04020880660821169,-9247,1285,-0.4341518381144654,0.07001283397744457
10337,39107,Mercer,Ohio,2012,4745,16561,370,21676,0.21890570215906993,0.764024727809559,0.017069570031371103,-1108,24,1461,377,-0.055895931720454956,0.0008246759048862913,0.05507125581556871,-11816,-2569,-0.5451190256504891,-0.11096718753602369
10338,39107,Mercer,Ohio,2016,3384,17506,926,21816,0.1551155115511551,0.8024385771910525,0.04244591125779244,-1361,556,945,140,-0.06379019060791483,0.02537634122642134,0.0384138493814935,-14122,-2306,-0.6473230656398974,-0.1022040399894083
10339,39109,Miami,Ohio,2000,15584,26037,1220,42841,0.3637636843210943,0.6077589225274853,0.02847739315142037,0,0,0,0,0.0,0.0,0.0,-10453,0,-0.24399523820639102,0.0
10340,39109,Miami,Ohio,2004,17606,33992,162,51760,0.3401468315301391,0.6567233384853168,0.0031298299845440494,2022,-1058,7955,8919,-0.02361685279095521,-0.025347563166876322,0.04896441595783152,-16386,-5933,-0.31657650695517775,-0.07258126874878673
10341,39109,Miami,Ohio,2008,18372,33417,1126,52915,0.3471983369554947,0.6315222526693755,0.021279410375129926,766,964,-575,1155,0.0070515054253555975,0.018149580390585875,-0.025201085815941382,-15045,1341,-0.28432391571388077,0.03225259124129698
10342,39109,Miami,Ohio,2012,16383,34606,1025,52014,0.3149728919137155,0.6653208751489983,0.019706232937286114,-1989,-101,1189,-901,-0.032225445041779155,-0.0015731774378438118,0.03379862247962284,-18223,-3178,-0.35034798323528277,-0.066024067521402
10343,39109,Miami,Ohio,2016,13120,37079,2895,53094,0.24710890119410855,0.698365163671978,0.054525935133913433,-3263,1870,2473,1080,-0.06786399071960697,0.03481970219662732,0.03304428852297969,-23959,-5736,-0.45125626247786943,-0.10090827924258666
10344,39111,Monroe,Ohio,2000,3605,3145,365,7115,0.5066760365425158,0.44202389318341534,0.05130007027406887,0,0,0,0,0.0,0.0,0.0,460,0,0.06465214335910047,0.0
10345,39111,Monroe,Ohio,2004,4243,3424,62,7729,0.5489714063915125,0.44300685729072325,0.008021736317764264,638,-303,279,614,0.04229536984899673,-0.04327833395630461,0.0009829641073079154,819,359,0.10596454910078928,0.04131240574168882
10346,39111,Monroe,Ohio,2008,3705,3066,211,6982,0.5306502434832426,0.4391291893440275,0.030220567172729876,-538,149,-358,-747,-0.018321162908269906,0.02219883085496561,-0.003877667946695751,639,-180,0.09152105413921513,-0.014443494961574155
10347,39111,Monroe,Ohio,2012,3035,3548,199,6782,0.44750810970215277,0.5231495134178709,0.029342376879976408,-670,-12,482,-200,-0.08314213378108987,-0.0008781902927534682,0.08402032407384336,-513,-1152,-0.07564140371571809,-0.16716245785493322
10348,39111,Monroe,Ohio,2016,1662,4868,323,6853,0.24252152342039981,0.7103458339413395,0.04713264263826061,-1373,124,1320,71,-0.20498658628175295,0.017790265758284206,0.18719632052346868,-3206,-2693,-0.46782431052093976,-0.39218290680522166
10349,39113,Montgomery,Ohio,2000,114597,109792,6598,230987,0.49611882919818,0.4753167927199366,0.028564378081883397,0,0,0,0,0.0,0.0,0.0,4805,0,0.020802036478243413,0.0
10350,39113,Montgomery,Ohio,2004,142997,138371,1216,282584,0.5060336041672565,0.48966325057328086,0.004303145259462673,28400,-5382,28579,51597,0.0099147749690765,-0.024261232822420722,0.014346457853344263,4626,-179,0.01637035359397565,-0.0044316828842677625
10351,39113,Montgomery,Ohio,2008,145997,128679,4355,279031,0.5232286018399389,0.46116381333973644,0.015607584820324623,3000,3139,-9692,-3553,0.0171949976726824,0.01130443956086195,-0.028499437233544422,17318,12692,0.06206478850020247,0.04569443490622682
10352,39113,Montgomery,Ohio,2012,137139,124841,4727,266707,0.5141934782364167,0.4680829524534414,0.01772356931014184,-8858,372,-3838,-12324,-0.00903512360352221,0.0021159844898172176,0.006919139113704953,12298,-5020,0.04611052578297531,-0.015954262717227163
10353,39113,Montgomery,Ohio,2016,122016,123909,13951,259876,0.4695162308177746,0.47680047407224985,0.05368329510997553,-15123,9224,-932,-6831,-0.044677247418642096,0.03595972579983368,0.008717521618808455,-1893,-14191,-0.007284243254475242,-0.05339476903745055
10354,39115,Morgan,Ohio,2000,2261,3451,281,5993,0.37727348573335556,0.5758384782245953,0.04688803604204906,0,0,0,0,0.0,0.0,0.0,-1190,0,-0.19856499249123977,0.0
10355,39115,Morgan,Ohio,2004,2875,3758,70,6703,0.428912427271371,0.5606444875428912,0.010443085185737729,614,-211,307,710,0.05163894153801546,-0.03644495085631133,-0.015193990681704128,-883,307,-0.13173206027152018,0.06683293221971959
10356,39115,Morgan,Ohio,2008,2966,3440,214,6620,0.448036253776435,0.5196374622356495,0.032326283987915407,91,144,-318,-83,0.019123826505064,0.021883198802177678,-0.04100702530724165,-474,409,-0.07160120845921453,0.06013085181230565
10357,39115,Morgan,Ohio,2012,2814,3179,141,6134,0.45875448320834694,0.5182588849038148,0.02298663188783828,-152,-73,-261,-486,0.010718229431911919,-0.009339652100077128,-0.0013785773318347738,-365,109,-0.059504401695467835,0.012096806763746693
10358,39115,Morgan,Ohio,2016,1736,4431,310,6477,0.2680253203643662,0.6841130152848541,0.04786166435077968,-1078,169,1252,343,-0.19072916284398073,0.024875032462941402,0.16585413038103936,-2695,-2330,-0.4160876949204879,-0.3565832932250201
10359,39117,Morrow,Ohio,2000,4529,7842,468,12839,0.35275332969857465,0.6107952332736194,0.03645143702780591,0,0,0,0,0.0,0.0,0.0,-3313,0,-0.25804190357504475,0.0
10360,39117,Morrow,Ohio,2004,5775,10474,79,16328,0.35368691817736403,0.6414747672709457,0.004838314551690348,1246,-389,2632,3489,0.0009335884787893822,-0.03161312247611556,0.030679533997326258,-4699,-1386,-0.2877878490935816,-0.029745945518536876
10361,39117,Morrow,Ohio,2008,6177,10067,435,16679,0.37034594400143894,0.6035733557167696,0.026080700281791474,402,356,-407,351,0.016659025824074913,0.021242385730101128,-0.037901411554176034,-3890,809,-0.23322741171533068,0.05456043737825095
10362,39117,Morrow,Ohio,2012,5933,9865,419,16217,0.36585065055189,0.6083122649071961,0.025837084540913855,-244,-16,-202,-462,-0.004495293449548965,-0.00024361574087761878,0.004738909190426521,-3932,-42,-0.24246161435530617,-0.009234202639975486
10363,39117,Morrow,Ohio,2016,3761,11948,979,16688,0.22537152444870565,0.7159635666347076,0.05866490891658677,-2172,560,2083,471,-0.14047912610318433,0.032827824375672915,0.10765130172751147,-8187,-4255,-0.49059204218600194,-0.24813042783069578
10364,39119,Muskingum,Ohio,2000,13415,17995,1214,32624,0.41120034330554195,0.5515877881314369,0.03721186856302109,0,0,0,0,0.0,0.0,0.0,-4580,0,-0.140387444825895,0.0
10365,39119,Muskingum,Ohio,2004,16421,22254,191,38866,0.42250295888437195,0.5725827201152679,0.004914321000360212,3006,-1023,4259,6242,0.01130261557883,-0.03229754756266088,0.020994931983830956,-5833,-1253,-0.15007976123089595,-0.009692316405000956
10366,39119,Muskingum,Ohio,2008,17730,20549,946,39225,0.45200764818355643,0.5238750796685787,0.024117272147864882,1309,755,-1705,359,0.029504689299184483,0.01920295114750467,-0.04870764044668918,-2819,3014,-0.07186743148502228,0.07821232974587367
10367,39119,Muskingum,Ohio,2012,17002,19264,913,37179,0.4573011646359504,0.5181419618601899,0.024556873503859707,-728,-33,-1285,-2046,0.005293516452393954,0.00043960135599482517,-0.00573311780838881,-2262,557,-0.06084079722423952,0.011026634260782764
10368,39119,Muskingum,Ohio,2016,11123,24056,2066,37245,0.29864411330379914,0.6458853537387569,0.05547053295744395,-5879,1153,4792,66,-0.15865705133215124,0.030913659453584246,0.12774339187856698,-12933,-10671,-0.34724124043495774,-0.2864004432107182
10369,39121,Noble,Ohio,2000,2296,3435,257,5988,0.3834335337341349,0.5736472945891784,0.042919171676686706,0,0,0,0,0.0,0.0,0.0,-1139,0,-0.1902137608550435,0.0
10370,39121,Noble,Ohio,2004,2654,3841,45,6540,0.40581039755351683,0.5873088685015291,0.006880733944954129,358,-212,406,552,0.02237686381938192,-0.03603843773173258,0.013661573912350677,-1187,-48,-0.18149847094801225,0.008715289907031243
10371,39121,Noble,Ohio,2008,2474,3450,264,6188,0.39980607627666453,0.5575307045895281,0.04266321913380737,-180,219,-391,-352,-0.006004321276852298,0.03578248518885324,-0.029778163912000943,-976,211,-0.1577246283128636,0.023773842635148645
10372,39121,Noble,Ohio,2012,2131,3563,197,5891,0.36173824478017313,0.6048209132575114,0.03344084196231539,-343,-67,113,-297,-0.0380678314964914,-0.009222377171491977,0.04729020866798328,-1432,-456,-0.24308266847733828,-0.08535804016447468
10373,39121,Noble,Ohio,2016,1221,4549,269,6039,0.20218579234972678,0.7532704090081139,0.0445437986421593,-910,72,986,148,-0.15955245243044636,0.011102956679843907,0.1484494957506025,-3328,-1896,-0.5510846166583871,-0.30800194818104887
10374,39123,Ottawa,Ohio,2000,9485,9917,566,19968,0.475010016025641,0.4966446314102564,0.028345352564102564,0,0,0,0,0.0,0.0,0.0,-432,0,-0.021634615384615363,0.0
10375,39123,Ottawa,Ohio,2004,11118,12073,68,23259,0.4780085128337418,0.5190678876993852,0.0029235994668730383,1633,-498,2156,3291,0.00299849680810077,-0.025421753097229525,0.02242325628912878,-955,-523,-0.04105937486564337,-0.01942475948102801
10376,39123,Ottawa,Ohio,2008,12064,10624,402,23090,0.5224772628843656,0.46011260285838024,0.017410134257254222,946,334,-1449,-169,0.044468750050623784,0.014486534790381183,-0.05895528484100493,1440,2395,0.06236466002598534,0.10342403489162871
10377,39123,Ottawa,Ohio,2012,11503,10538,464,22505,0.5111308598089314,0.46825149966674073,0.020617640524327928,-561,62,-86,-585,-0.01134640307543422,0.0032075062670737058,0.008138896808360496,965,-475,0.042879360142190626,-0.019485299883794716
10378,39123,Ottawa,Ohio,2016,8285,12653,1447,22385,0.370113915568461,0.5652445834264016,0.06464150100513737,-3218,983,2115,-120,-0.14101694424047034,0.04402386048080944,0.09699308375966087,-4368,-5333,-0.1951306678579406,-0.2380100280001312
10379,39125,Paulding,Ohio,2000,3384,5210,352,8946,0.3782696177062374,0.5823831880169908,0.03934719427677174,0,0,0,0,0.0,0.0,0.0,-1826,0,-0.20411357031075344,0.0
10380,39125,Paulding,Ohio,2004,3610,6206,63,9879,0.3654216013766576,0.628201234942808,0.006377163680534467,226,-289,996,933,-0.012848016329579826,-0.03297003059623727,0.045818046925817146,-2596,-770,-0.2627796335661504,-0.05866606325539697
10381,39125,Paulding,Ohio,2008,4165,5317,303,9785,0.42565150740929997,0.543382728666326,0.030965763924374043,555,240,-889,-94,0.06022990603264239,0.024588600243839576,-0.08481850627648202,-1152,1444,-0.11773122125702601,0.1450484123091244
10382,39125,Paulding,Ohio,2012,3538,5354,258,9150,0.38666666666666666,0.585136612021858,0.02819672131147541,-627,-45,37,-635,-0.03898484074263331,-0.002769042612898634,0.041753883355531984,-1816,-664,-0.1984699453551913,-0.0807387240981653
10383,39125,Paulding,Ohio,2016,2093,6500,502,9095,0.23012644310060473,0.7146783947223749,0.05519516217702034,-1445,244,1146,-55,-0.15654022356606193,0.026998440865544933,0.12954178270051697,-4407,-2591,-0.4845519516217702,-0.2860820062665789
10384,39127,Perry,Ohio,2000,5895,6440,493,12828,0.45954162768942936,0.5020268163392578,0.03843155597131275,0,0,0,0,0.0,0.0,0.0,-545,0,-0.042485188649828476,0.0
10385,39127,Perry,Ohio,2004,7257,7856,76,15189,0.47777997234841,0.5172164066100468,0.005003621041543222,1362,-417,1416,2361,0.018238344658980665,-0.03342793492976953,0.015189590270788922,-599,-54,-0.03943643426163673,0.0030487543881917434
10386,39127,Perry,Ohio,2008,7261,7721,455,15437,0.47036341258016456,0.5001619485651357,0.029474638854699746,4,379,-135,248,-0.0074165597682454565,0.024471017813156526,-0.017054458044911014,-460,139,-0.029798535984971175,0.009637898276665557
10387,39127,Perry,Ohio,2012,7033,7627,360,15020,0.46824234354194405,0.5077896138482024,0.023968042609853527,-228,-95,-94,-417,-0.0021210690382205133,-0.005506596244846219,0.007627665283066687,-594,-134,-0.039547270306258375,-0.0097487343212872
10388,39127,Perry,Ohio,2016,4138,10228,735,15101,0.2740215879743063,0.6773061386663135,0.04867227335938017,-2895,375,2601,81,-0.19422075556763774,0.024704230749526646,0.16951652481811108,-6090,-5496,-0.4032845506920072,-0.3637372803857488
10389,39129,Pickaway,Ohio,2000,6598,10717,425,17740,0.37192784667418266,0.6041149943630214,0.023957158962795943,0,0,0,0,0.0,0.0,0.0,-4119,0,-0.23218714768883875,0.0
10390,39129,Pickaway,Ohio,2004,8579,14161,112,22852,0.3754157185366708,0.619683178715211,0.004901102748118327,1981,-313,3444,5112,0.003487871862488112,-0.019056056214677618,0.01556818435218954,-5582,-1463,-0.24426746017854017,-0.012080312489701428
10391,39129,Pickaway,Ohio,2008,9077,14228,482,23787,0.381594988859461,0.5981418421827048,0.020263168957834112,498,370,67,935,0.0061792703227902535,0.015362066209715785,-0.021541336532506117,-5151,431,-0.2165468533232438,0.02772060685529637
10392,39129,Pickaway,Ohio,2012,9684,14037,433,24154,0.40092738262813615,0.5811459799619111,0.017926637409952803,607,-49,-191,367,0.019332393768675127,-0.002336531547881309,-0.016995862220793745,-4353,798,-0.18021859733377493,0.03632825598946887
10393,39129,Pickaway,Ohio,2016,6529,17076,1307,24912,0.262082530507386,0.6854527938342967,0.05246467565831728,-3155,874,3039,758,-0.13884485212075015,0.034538038248364475,0.1043068138723856,-10547,-6194,-0.4233702633269107,-0.24315166599313576
10394,39131,Pike,Ohio,2000,4923,5333,304,10560,0.4661931818181818,0.5050189393939394,0.02878787878787879,0,0,0,0,0.0,0.0,0.0,-410,0,-0.03882575757575757,0.0
10395,39131,Pike,Ohio,2004,5989,6520,67,12576,0.4762245547073791,0.5184478371501272,0.005327608142493639,1066,-237,1187,2016,0.01003137288919731,-0.02346027064538515,0.01342889775618783,-531,-121,-0.04222328244274809,-0.00339752486699052
10396,39131,Pike,Ohio,2008,6033,6162,311,12506,0.48240844394690546,0.49272349272349275,0.02486806332960179,44,244,-358,-70,0.006183889239526341,0.01954045518710815,-0.02572434442663446,-129,402,-0.010315048776587288,0.0319082336661608
10397,39131,Pike,Ohio,2012,5684,5685,227,11596,0.4901690238013108,0.49025526043463263,0.019575715764056572,-349,-84,-477,-910,0.007760579854405314,-0.005292347565545218,-0.002468232288860117,-1,128,-8.623663332185671e-05,0.010228812143265431
10398,39131,Pike,Ohio,2016,3539,7902,510,11951,0.2961258472094385,0.6611998995899925,0.04267425320056899,-2145,283,2217,355,-0.19404317659187226,0.023098537436512415,0.17094463915535985,-4363,-4362,-0.36507405238055396,-0.3649878157472321
10399,39133,Portage,Ohio,2000,31446,28271,3182,62899,0.49994435523617226,0.4494666051924514,0.05058903957137633,0,0,0,0,0.0,0.0,0.0,3175,0,0.05047775004372085,0.0
10400,39133,Portage,Ohio,2004,40675,35583,389,76647,0.5306796091171213,0.4642451759364359,0.005075214946442783,9229,-2793,7312,13748,0.030735253880949054,-0.045513824624933544,0.014778570743984476,5092,1917,0.06643443318068543,0.015956683136964578
10401,39133,Portage,Ohio,2008,41856,34822,1724,78402,0.5338639320425499,0.44414683298895435,0.0219892349684957,1181,1335,-761,1755,0.0031843229254285843,0.016914020022052917,-0.02009834294748153,7034,1942,0.08971709905359554,0.023282665872910113
10402,39133,Portage,Ohio,2012,39453,35242,1689,76384,0.5165086929199832,0.4613793464599916,0.022111960620025135,-2403,-35,420,-2018,-0.017355239122566646,0.00012272565152943518,0.01723251347103727,4211,-2823,0.055129346459991624,-0.034587752593603915
10403,39133,Portage,Ohio,2016,32397,39971,4394,76762,0.42204476173106487,0.5207133738047471,0.05724186446418801,-7056,2705,4729,378,-0.09446393118891838,0.035129903844162876,0.05933402734475551,-7574,-11785,-0.09866861207368227,-0.1537979585336739
10404,39135,Preble,Ohio,2000,6375,11176,615,18166,0.35093030936915115,0.615215237256413,0.03385445337443576,0,0,0,0,0.0,0.0,0.0,-4801,0,-0.2642849278872619,0.0
10405,39135,Preble,Ohio,2004,7274,13734,119,21127,0.34429876461400105,0.6500686325554977,0.005632602830501254,899,-496,2558,2961,-0.006631544755150098,-0.028221850543934505,0.03485339529908471,-6460,-1659,-0.3057698679414967,-0.04148494005423481
10406,39135,Preble,Ohio,2008,6999,13562,488,21049,0.3325098579504965,0.6443061428096346,0.02318399923986888,-275,369,-172,-78,-0.011788906663504573,0.017551396409367623,-0.005762489745863131,-6563,-103,-0.31179628485913813,-0.006026416917641442
10407,39135,Preble,Ohio,2012,6211,13535,479,20225,0.30709517923362173,0.669221260815822,0.02368355995055624,-788,-9,-27,-824,-0.02541467871687475,0.0004995607106873627,0.024915118006187398,-7324,-761,-0.3621260815822003,-0.05032979672306215
10408,39135,Preble,Ohio,2016,4325,15446,910,20681,0.20912915236207147,0.7468691069097239,0.04400174072820463,-1886,431,1911,456,-0.09796602687155026,0.020318180777648392,0.07764784609390185,-11121,-3797,-0.5377399545476524,-0.17561387296545217
10409,39137,Putnam,Ohio,2000,4063,12837,444,17344,0.23425968634686348,0.7401406826568265,0.025599630996309963,0,0,0,0,0.0,0.0,0.0,-8774,0,-0.5058809963099631,0.0
10410,39137,Putnam,Ohio,2004,4392,14370,87,18849,0.23300970873786409,0.7623746617857712,0.0046156294763647935,329,-357,1533,1505,-0.001249977608999392,-0.02098400151994517,0.022233979128944648,-9978,-1204,-0.5293649530479071,-0.02348395673794401
10411,39137,Putnam,Ohio,2008,5281,13072,327,18680,0.28270877944325484,0.6997858672376873,0.017505353319057816,889,240,-1298,-169,0.04969907070539076,0.012889723842693022,-0.06258879454808386,-7791,2187,-0.4170770877944325,0.11228786525347462
10412,39137,Putnam,Ohio,2012,4318,13721,361,18400,0.23467391304347826,0.7457065217391304,0.019619565217391305,-963,34,649,-280,-0.04803486639977658,0.0021142118983334887,0.045920654501443114,-9403,-1612,-0.5110326086956521,-0.09395552090121967
10413,39137,Putnam,Ohio,2016,2922,14961,974,18857,0.1549557193615103,0.7933923741846529,0.05165190645383677,-1396,613,1240,457,-0.07971819368196795,0.032032341236445466,0.04768585244552248,-12039,-2636,-0.6384366548231426,-0.12740404612749046
10414,39139,Richland,Ohio,2000,20572,30138,2069,52779,0.3897762367608329,0.5710225657932132,0.039201197445953885,0,0,0,0,0.0,0.0,0.0,-9566,0,-0.1812463290323803,0.0
10415,39139,Richland,Ohio,2004,24638,36872,330,61840,0.39841526520051745,0.596248382923674,0.005336351875808538,4066,-1739,6734,9061,0.00863902843968456,-0.033864845570145345,0.025225817130460793,-12234,-2668,-0.19783311772315654,-0.016586788690776233
10416,39139,Richland,Ohio,2008,25727,34034,1478,61239,0.4201081010467186,0.5557569522689789,0.024134946684302487,1089,1148,-2838,-601,0.02169283584620113,0.018798594808493947,-0.04049143065469507,-8307,3927,-0.13564885122226034,0.0621842665008962
10417,39139,Richland,Ohio,2012,22687,33867,1252,57806,0.39246790990554614,0.585873438743383,0.021658651351070823,-3040,-226,-167,-3433,-0.027640191141172443,-0.0024762953332316644,0.030116486474404125,-11180,-2873,-0.1934055288378369,-0.05775667761557657
10418,39139,Richland,Ohio,2016,16085,36590,2749,55424,0.29021723441108543,0.6601833140877598,0.04959945150115473,-6602,1497,2723,-2382,-0.10225067549446071,0.02794080015008391,0.07430987534437672,-20505,-9325,-0.36996607967667433,-0.17656055083883743
10419,39141,Ross,Ohio,2000,11662,13706,648,26016,0.4482626076260763,0.526829643296433,0.024907749077490774,0,0,0,0,0.0,0.0,0.0,-2044,0,-0.07856703567035672,0.0
10420,39141,Ross,Ohio,2004,13978,17231,462,31671,0.4413501310347005,0.5440623914622209,0.014587477503078526,2316,-186,3525,5655,-0.006912476591375782,-0.010320271574412248,0.017232748165787903,-3253,-1209,-0.10271226042752041,-0.024145224757163686
10421,39141,Ross,Ohio,2008,14455,16759,711,31925,0.4527799530148786,0.5249490994518402,0.022270947533281127,477,249,-472,254,0.011429821980178112,0.0076834700302026,-0.0191132920103807,-2304,949,-0.0721691464369616,0.030543113990558812
10422,39141,Ross,Ohio,2012,14569,15008,583,30160,0.4830570291777188,0.49761273209549073,0.01933023872679045,114,-128,-1751,-1765,0.0302770761628402,-0.0029407088064906765,-0.027336367356349478,-439,1865,-0.014555702917771918,0.05761344351918968
10423,39141,Ross,Ohio,2016,10356,18652,1557,30565,0.338818910518567,0.6102404711271062,0.050940618354326846,-4213,974,3644,405,-0.14423811865915181,0.03161037962753639,0.11262773903161549,-8296,-7857,-0.2714215606085392,-0.2568658576907673
10424,39143,Sandusky,Ohio,2000,11146,13699,899,25744,0.4329552517091361,0.5321239900559354,0.034920758234928524,0,0,0,0,0.0,0.0,0.0,-2553,0,-0.09916873834679923,0.0
10425,39143,Sandusky,Ohio,2004,12686,16224,104,29014,0.43723719583649273,0.5591783277038671,0.0035844764596401736,1540,-795,2525,3270,0.004281944127356607,-0.03133628177528835,0.027054337647931748,-3538,-985,-0.12194113186737437,-0.02277239352057514
10426,39143,Sandusky,Ohio,2008,15602,14192,583,30377,0.5136122724429667,0.4671955755999605,0.019192151957072787,2916,479,-2032,1363,0.07637507660647397,0.015607675497432614,-0.0919827521039066,1410,4948,0.0464166968430062,0.16835782871038057
10427,39143,Sandusky,Ohio,2012,14541,13755,799,29095,0.4997765939164805,0.47276164289396805,0.02746176318955147,-1061,216,-437,-1282,-0.013835678526486206,0.008269611232478682,0.005566067294007548,786,-624,0.027014951022512446,-0.019401745820493754
10428,39143,Sandusky,Ohio,2016,9929,16316,2040,28285,0.3510341170231572,0.5768428495669082,0.07212303340993459,-4612,1241,2561,-810,-0.14874247689332332,0.04466127022038312,0.10408120667294019,-6387,-7173,-0.22580873254375106,-0.2528236835662635
10429,39145,Scioto,Ohio,2000,13997,15022,926,29945,0.4674236099515779,0.5016530305560194,0.030923359492402738,0,0,0,0,0.0,0.0,0.0,-1025,0,-0.03422942060444151,0.0
10430,39145,Scioto,Ohio,2004,16827,18259,117,35203,0.47799903417322387,0.5186773854501037,0.003323580376672443,2830,-809,3237,5258,0.01057542422164598,-0.027599779115730295,0.01702435489408427,-1432,-407,-0.0406783512768798,-0.006448930672438291
10431,39145,Scioto,Ohio,2008,14926,16994,803,32723,0.45613177275922134,0.5193289123857837,0.024539314854994956,-1901,686,-1265,-2480,-0.021867261414002526,0.021215734478322514,0.0006515269356800468,-2068,-636,-0.06319713962656237,-0.022518788349682572
10432,39145,Scioto,Ohio,2012,15077,15492,693,31262,0.48227880493890346,0.49555370737636745,0.022167487684729065,151,-110,-1502,-1461,0.026147032179682117,-0.0023718271702658916,-0.023775205009416267,-415,1653,-0.013274902437463987,0.049922237189098384
10433,39145,Scioto,Ohio,2016,9132,20550,1321,31003,0.2945521401154727,0.6628390800890236,0.04260877979550366,-5945,628,5058,-259,-0.18772666482343076,0.020441292110774598,0.16728537271265614,-11418,-11003,-0.3682869399735509,-0.3550120375360869
10434,39147,Seneca,Ohio,2000,9512,13863,976,24351,0.3906205083980124,0.5692990020943698,0.04008048950761776,0,0,0,0,0.0,0.0,0.0,-4351,0,-0.1786784936963574,0.0
10435,39147,Seneca,Ohio,2004,10957,15886,148,26991,0.4059501315253233,0.5885665592234448,0.0054833092512318925,1445,-828,2023,2640,0.015329623127310898,-0.03459718025638586,0.01926755712907502,-4929,-578,-0.18261642769812153,-0.003937934001764121
10436,39147,Seneca,Ohio,2008,13087,13823,643,27553,0.4749755017602439,0.5016876565165318,0.02333684172322433,2130,495,-2063,562,0.06902537023492061,0.01785353247199244,-0.08687890270691301,-736,4193,-0.02671215475628791,0.15590427294183362
10437,39147,Seneca,Ohio,2012,11353,13243,747,25343,0.4479737994712544,0.5225506056899341,0.029475594838811507,-1734,104,-580,-2210,-0.027001702288989515,0.0061387531155871755,0.020862949173402257,-1890,-1154,-0.07457680621867968,-0.04786465146239177
10438,39147,Seneca,Ohio,2016,7404,14825,1954,24183,0.3061654881528346,0.613033949468635,0.08080056237853037,-3949,1207,1582,-1160,-0.14180831131841976,0.05132496753971886,0.09048334377870093,-7421,-5531,-0.30686846131580037,-0.2322916550971207
10439,39149,Shelby,Ohio,2000,6593,12476,601,19670,0.33518047788510424,0.6342653787493645,0.030554143365531267,0,0,0,0,0.0,0.0,0.0,-5883,0,-0.29908490086426026,0.0
10440,39149,Shelby,Ohio,2004,6535,16204,116,22855,0.285933056224021,0.7089914679501204,0.005075475825858674,-58,-485,3728,3185,-0.04924742166108326,-0.025478667539672595,0.07472608920075585,-9669,-3786,-0.42305841172609937,-0.12397351086183911
10441,39149,Shelby,Ohio,2008,7316,15924,478,23718,0.30845771144278605,0.6713888186187705,0.020153469938443375,781,362,-280,863,0.022524655218765066,0.015077994112584701,-0.037602649331349824,-8608,1061,-0.3629311071759845,0.06012730455011489
10442,39149,Shelby,Ohio,2012,6343,17142,417,23902,0.2653752824031462,0.7171784787883859,0.01744623880846791,-973,-61,1218,184,-0.04308242903963988,-0.0027072311299754653,0.04578966016961539,-10799,-2191,-0.45180319638523975,-0.08887208920925527
10443,39149,Shelby,Ohio,2016,4243,18590,996,23829,0.17806034663645137,0.7801418439716312,0.04179780939191741,-2100,579,1448,-73,-0.0873149357666948,0.024351570583449503,0.0629633651832453,-14347,-3548,-0.6020814973351798,-0.15027830094994005
10444,39151,Stark,Ohio,2000,75308,78153,6383,159844,0.4711343559970972,0.48893295963564476,0.039932684367258074,0,0,0,0,0.0,0.0,0.0,-2845,0,-0.017798603638547572,0.0
10445,39151,Stark,Ohio,2004,95337,92215,907,188459,0.5058766097665806,0.4893106723478316,0.004812717885587846,20029,-5476,14062,28615,0.03474225376948337,-0.03511996648167023,0.00037771271218683955,3122,5967,0.016565937418748955,0.03436454105729653
10446,39151,Stark,Ohio,2008,96990,86743,4277,188010,0.5158768150630285,0.46137439497899047,0.022748789957980957,1653,3370,-5472,-449,0.010000205296447962,0.01793607207239311,-0.027936277368841134,10247,7125,0.05450242008403805,0.037936482665289095
10447,39151,Stark,Ohio,2012,89432,88581,3732,181745,0.49207405980907315,0.4873916751492476,0.020534265041679278,-7558,-545,1838,-6265,-0.023802755253955366,-0.0022145249163016793,0.026017280170257118,851,-9396,0.004682384659825567,-0.04982003542421248
10448,39151,Stark,Ohio,2016,68146,98388,9631,176165,0.3868305281979962,0.5584991343342889,0.05467033746771493,-21286,5899,9807,-5580,-0.10524353161107697,0.034136072426035655,0.0711074591850413,-30242,-31093,-0.1716686061362927,-0.17635099079611827
10449,39153,Summit,Ohio,2000,119759,96721,8359,224839,0.5326433581362664,0.430178928032948,0.03717771383078559,0,0,0,0,0.0,0.0,0.0,23038,0,0.1024644301033184,0.0
10450,39153,Summit,Ohio,2004,156587,118558,1175,276320,0.5666871742906775,0.4290605095541401,0.004252316155182397,36828,-7184,21837,51481,0.0340438161544111,-0.032925397675603194,-0.0011184184788078921,38029,14991,0.1376266647365374,0.03516223463321899
10451,39153,Summit,Ohio,2008,160858,113284,4487,278629,0.5773196616289044,0.40657648701319676,0.016103851357898855,4271,3312,-5274,2309,0.01063248733822686,0.011851535202716458,-0.022484022540943338,47574,9545,0.1707431746157076,0.0331165098791702
10452,39153,Summit,Ohio,2012,153041,111001,4316,268358,0.5702867065636202,0.4136302998233703,0.016082993613009487,-7817,-171,-2283,-10271,-0.007032955065284119,-2.0857744889368063e-05,0.007053812810173532,42040,-5534,0.15665640674024994,-0.01408676787545765
10453,39153,Summit,Ohio,2016,134256,112026,14064,260346,0.5156829757322947,0.43029660528681063,0.05402041898089466,-18785,9748,1025,-8012,-0.054603730831325525,0.03793742536788517,0.016666305463440334,22230,-19810,0.08538637044548408,-0.07127003629476586
10454,39155,Trumbull,Ohio,2000,57643,34654,3942,96239,0.5989567638898992,0.3600827107513586,0.0409605253587423,0,0,0,0,0.0,0.0,0.0,22989,0,0.23887405313854054,0.0
10455,39155,Trumbull,Ohio,2004,66673,40977,495,108145,0.6165148643025568,0.37890794766286007,0.0045771880345831985,9030,-3447,6323,11906,0.017558100412657596,-0.0363833373241591,0.018825236911501453,25696,2707,0.23760691663969669,-0.0012671364988438572
10456,39155,Trumbull,Ohio,2008,64145,40164,2962,107271,0.5979714927613241,0.3744161982269206,0.027612309011755275,-2528,2467,-813,-874,-0.018543371541232645,0.02303512097717208,-0.0044917494359394405,23981,-1715,0.22355529453440348,-0.014051622105293204
10457,39155,Trumbull,Ohio,2012,61672,38279,2011,101962,0.6048527882936781,0.3754241776348051,0.019723034071516838,-2473,-951,-1885,-5309,0.006881295532353948,-0.007889274940238437,0.0010079794078844961,23393,-588,0.22942861065887293,0.005873316124469452
10458,39155,Trumbull,Ohio,2016,43014,49024,4638,96676,0.444929455087095,0.5070958666059828,0.04797467830692209,-18658,2627,10745,-5286,-0.15992333320658303,0.028251644235405254,0.1316716889711777,-6010,-29403,-0.0621664115188878,-0.29159502217776073
10459,39157,Tuscarawas,Ohio,2000,15879,19549,1690,37118,0.427797833935018,0.5266716956732582,0.04553047039172369,0,0,0,0,0.0,0.0,0.0,-3670,0,-0.0988738617382402,0.0
10460,39157,Tuscarawas,Ohio,2004,18853,23829,224,42906,0.43940241458071133,0.5553768703677807,0.005220715051507948,2974,-1466,4280,5788,0.011604580645693308,-0.04030975534021575,0.028705174694522495,-4976,-1306,-0.11597445578706939,-0.017100594048829187
10461,39157,Tuscarawas,Ohio,2008,21498,20454,1105,43057,0.49929163666767307,0.4750447081775321,0.025663655154794806,2645,881,-3375,151,0.059889222086961735,0.020442940103286858,-0.08033216219024863,1044,6020,0.024246928490140984,0.14022138427721037
10462,39157,Tuscarawas,Ohio,2012,18407,22242,1044,41693,0.44148897896529393,0.5334708464250594,0.025040174609646703,-3091,-61,1788,-1364,-0.057802657702379134,-0.0006234805451481029,0.05842613824752729,-3835,-4879,-0.09198186745976544,-0.11622879594990643
10463,39157,Tuscarawas,Ohio,2016,12188,26918,2500,41606,0.29293851848291114,0.6469739941354612,0.06008748738162765,-6219,1456,4676,-87,-0.1485504604823828,0.03504731277198095,0.11350314771040182,-14730,-10895,-0.35403547565255006,-0.2620536081927846
10464,39159,Union,Ohio,2000,5040,11502,482,17024,0.29605263157894735,0.6756343984962406,0.02831296992481203,0,0,0,0,0.0,0.0,0.0,-6462,0,-0.3795817669172933,0.0
10465,39159,Union,Ohio,2004,6665,15870,96,22631,0.29450753391365825,0.70125049710574,0.004241968980601829,1625,-386,4368,5607,-0.0015450976652890969,-0.024071000944210198,0.025616098609499316,-9205,-2743,-0.4067429631920817,-0.027161196274788413
10466,39159,Union,Ohio,2008,8761,15744,479,24984,0.3506644252321486,0.6301633045148896,0.019172270252961896,2096,383,-126,2353,0.05615689131849033,0.014930301272360067,-0.07108719259085039,-6983,2222,-0.279498879282741,0.12724408390934072
10467,39159,Union,Ohio,2012,8805,16289,529,25623,0.3436365765132888,0.6357179096905125,0.02064551379619873,44,50,545,639,-0.007027848718859753,0.001473243543236833,0.005554605175622895,-7484,-501,-0.2920813331772236,-0.012582453894482648
10468,39159,Union,Ohio,2016,7718,18096,1881,27695,0.2786784618162123,0.6534031413612565,0.06791839682253115,-1087,1352,1807,2072,-0.06495811469707652,0.04727288302633242,0.017685231670744095,-10378,-2894,-0.37472467954504424,-0.08264334636782061
10469,39161,Van Wert,Ohio,2000,4209,8679,331,13219,0.31840532566759966,0.6565549587714653,0.025039715560935018,0,0,0,0,0.0,0.0,0.0,-4470,0,-0.33814963310386564,0.0
10470,39161,Van Wert,Ohio,2004,4095,10678,54,14827,0.276185337559857,0.7201726579888043,0.003642004451338774,-114,-277,1999,1608,-0.042219988107742634,-0.021397711109596245,0.06361769921733895,-6583,-2113,-0.44398732042894723,-0.10583768732508159
10471,39161,Van Wert,Ohio,2008,5178,9168,355,14701,0.3522209373512006,0.6236310455071084,0.02414801714169104,1083,301,-1510,-126,0.07603559979134356,0.02050601269035227,-0.0965416124816959,-3990,2593,-0.27141010815590777,0.17257721227303946
10472,39161,Van Wert,Ohio,2012,4029,9585,284,13898,0.2898978270254713,0.6896675780687869,0.020434594905741833,-1149,-71,417,-803,-0.06232311032572929,-0.003713422235949209,0.06603653256167852,-5556,-1566,-0.3997697510433156,-0.1283596428874078
10473,39161,Van Wert,Ohio,2016,2697,10469,604,13770,0.19586056644880173,0.7602759622367465,0.04386347131445171,-1332,320,884,-128,-0.09403726057666956,0.023428876408709876,0.07060838416795967,-7772,-2216,-0.5644153957879448,-0.16464564474462917
10474,39163,Vinton,Ohio,2000,2037,2720,189,4946,0.4118479579458148,0.549939344925192,0.038212697128993126,0,0,0,0,0.0,0.0,0.0,-683,0,-0.13809138697937723,0.0
10475,39163,Vinton,Ohio,2004,2651,3249,28,5928,0.44719973009446695,0.5480769230769231,0.004723346828609987,614,-161,529,982,0.03535177214865215,-0.033489350300383136,-0.0018624218482689026,-598,85,-0.10087719298245618,0.03721419399692105
10476,39163,Vinton,Ohio,2008,2463,3021,162,5646,0.43623804463336874,0.5350690754516472,0.028692879914984058,-188,134,-228,-282,-0.010961685461098214,0.023969533086374072,-0.013007847625275959,-558,40,-0.09883103081827843,0.002046162164177745
10477,39163,Vinton,Ohio,2012,2436,2856,198,5490,0.44371584699453553,0.5202185792349727,0.036065573770491806,-27,36,-165,-156,0.0074778023611667965,0.007372693855507748,-0.014850496216674447,-420,138,-0.07650273224043719,0.022328298577841243
10478,39163,Vinton,Ohio,2016,1351,3883,306,5540,0.24386281588447653,0.7009025270758122,0.05523465703971119,-1085,108,1027,50,-0.199853031110059,0.019169083269219386,0.18068394784083952,-2532,-2112,-0.4570397111913357,-0.3805369789508985
10479,39165,Warren,Ohio,2000,19142,48318,1618,69078,0.2771070384203364,0.6994701641622514,0.0234227974174122,0,0,0,0,0.0,0.0,0.0,-29176,0,-0.422363125741915,0.0
10480,39165,Warren,Ohio,2004,26044,68037,341,94422,0.2758255491304992,0.7205630043845714,0.0036114464849293596,6902,-1277,19719,25344,-0.0012814892898371788,-0.01981135093248284,0.021092840222320053,-41993,-12817,-0.4447374552540722,-0.02237432951215723
10481,39165,Warren,Ohio,2008,33398,71691,1337,106426,0.31381429349970874,0.6736229868641121,0.012562719636179128,7354,996,3654,12004,0.037988744369209515,0.008951273151249769,-0.04694001752045929,-38293,3700,-0.3598086933644034,0.0849287618896688
10482,39165,Warren,Ohio,2012,32909,76564,1724,111197,0.2959522289270394,0.6885437556768618,0.015504015396098816,-489,387,4873,4771,-0.017862064572669367,0.002941295759919688,0.014920768812749619,-43655,-5362,-0.3925915267498224,-0.032782833385418986
10483,39165,Warren,Ohio,2016,33730,77643,6936,118309,0.2851008798992469,0.6562729800775934,0.05862614002315969,821,5212,1079,7112,-0.0108513490277925,0.04312212462706087,-0.032270775599268386,-43913,-258,-0.3711721001783465,0.021419426571475886
10484,39167,Washington,Ohio,2000,10383,15342,790,26515,0.39158966622666413,0.578615877805016,0.029794455968319818,0,0,0,0,0.0,0.0,0.0,-4959,0,-0.18702621157835186,0.0
10485,39167,Washington,Ohio,2004,12538,17532,146,30216,0.4149457241196717,0.5802223987291502,0.004831877151178184,2155,-644,2190,3701,0.023356057893007542,-0.024962578817141635,0.0016065209241341583,-4994,-35,-0.16527667460947848,0.021749536968873384
10486,39167,Washington,Ohio,2008,12368,17019,545,29932,0.4132032607243084,0.5685888012829079,0.018207937992783644,-170,399,-513,-284,-0.0017424633953632696,0.013376060841605461,-0.011633597446242261,-4651,343,-0.1553855405585995,0.009891134050878991
10487,39167,Washington,Ohio,2012,11651,17284,667,29602,0.393588271062766,0.5838794676035403,0.022532261333693668,-717,122,265,-330,-0.019614989661542404,0.004324323340910024,0.015290666320632362,-5633,-982,-0.19029119654077425,-0.034905655982174766
10488,39167,Washington,Ohio,2016,8026,20514,1597,30137,0.266317151674022,0.6806915087765869,0.052991339549391114,-3625,930,3230,535,-0.12727111938874403,0.030459078215697447,0.09681204117304665,-12488,-6855,-0.4143743571025649,-0.22408316056179067
10489,39169,Wayne,Ohio,2000,14779,25901,1756,42436,0.34826562352719387,0.6103544160618343,0.04137996041097182,0,0,0,0,0.0,0.0,0.0,-11122,0,-0.2620887925346404,0.0
10490,39169,Wayne,Ohio,2004,19786,31879,183,51848,0.3816154914365067,0.6148549606542201,0.0035295479092732605,5007,-1573,5978,9412,0.033349867909312825,-0.03785041250169856,0.004500544592385802,-12093,-971,-0.23323946921771338,0.028849323316927022
10491,39169,Wayne,Ohio,2008,21712,29342,1222,52276,0.41533399648022035,0.561290075751779,0.023375927768000612,1926,1039,-2537,428,0.033718505043713654,0.01984637985872735,-0.053564884902441046,-7630,4463,-0.14595607927155868,0.0872833899461547
10492,39169,Wayne,Ohio,2012,19808,30251,1105,51164,0.3871472128840591,0.5912555703228832,0.02159721679305762,-1904,-117,909,-1112,-0.028186783596161225,-0.0017787109749429937,0.0299654945711042,-10443,-2813,-0.2041083574388241,-0.058152278167265425
10493,39169,Wayne,Ohio,2016,15031,32270,2916,50217,0.29932094708963103,0.6426110679650318,0.058067984945337235,-4777,1811,2019,-947,-0.0878262657944281,0.03647076815227962,0.05135549764214853,-17239,-6796,-0.34329012087540073,-0.13918176343657662
10494,39171,Williams,Ohio,2000,5454,9941,524,15919,0.3426094603932408,0.624473899114266,0.032916640492493245,0,0,0,0,0.0,0.0,0.0,-4487,0,-0.2818644387210252,0.0
10495,39171,Williams,Ohio,2004,6481,12040,118,18639,0.34771178711304257,0.6459574011481303,0.00633081173882719,1027,-406,2099,2720,0.005102326719801764,-0.026585828753666055,0.021483502033864288,-5559,-1072,-0.2982456140350877,-0.016381175314062524
10496,39171,Williams,Ohio,2008,8174,9879,343,18396,0.44433572515764297,0.5370189171559034,0.018645357686453576,1693,225,-2161,-243,0.0966239380446004,0.012314545947626387,-0.10893848399222683,-1705,3854,-0.09268319199826047,0.20556242203682723
10497,39171,Williams,Ohio,2012,7266,10047,393,17706,0.4103693663165029,0.5674347678752966,0.02219586580820061,-908,50,168,-690,-0.033966358841140076,0.0035505081217470334,0.030415850719393123,-2781,-1076,-0.15706540155879367,-0.0643822095605332
10498,39171,Williams,Ohio,2016,4358,11939,1011,17308,0.25179107926970185,0.6897966258377629,0.058412294892535244,-2908,618,1892,-398,-0.15857828704680105,0.03621642908433463,0.12236185796246635,-7581,-4800,-0.43800554656806107,-0.2809401450092674
10499,39173,Wood,Ohio,2000,22687,27504,2003,52194,0.4346668199409894,0.5269571215082194,0.03837605855079128,0,0,0,0,0.0,0.0,0.0,-4817,0,-0.09229030156723,0.0
10500,39173,Wood,Ohio,2004,29401,33592,353,63346,0.46413348909165536,0.5302939412117577,0.0055725696965869985,6714,-1650,6088,11152,0.02946666915066598,-0.03280348885420428,0.003336819703538274,-4191,626,-0.0661604521201023,0.026129849447127707
10501,39173,Wood,Ohio,2008,34285,29648,1231,65164,0.5261340617518876,0.45497513964765823,0.01889079860045424,4884,878,-3944,1818,0.062000572660232234,0.01331822890386724,-0.07531880156409942,4637,8828,0.07115892210422936,0.13731937422433166
10502,39173,Wood,Ohio,2012,32802,29704,1553,64059,0.5120591954292137,0.46369752884060006,0.024243275730186236,-1483,322,56,-1105,-0.014074866322673851,0.005352477129731997,0.008722389192941826,3098,-1539,0.04836166658861368,-0.022797255515615678
10503,39173,Wood,Ohio,2016,27318,32498,5010,64826,0.42140499182426805,0.5013112022953753,0.07728380588035665,-5484,3457,2794,767,-0.0906542036049457,0.053040530150170406,0.03761367345477523,-5180,-8278,-0.07990621047110724,-0.12826787705972093
10504,39175,Wyandot,Ohio,2000,3397,6113,317,9827,0.34568026864760354,0.6220616668362674,0.03225806451612903,0,0,0,0,0.0,0.0,0.0,-2716,0,-0.27638139818866386,0.0
10505,39175,Wyandot,Ohio,2004,3708,7254,81,11043,0.33577832110839445,0.6568867155664222,0.007334963325183374,311,-236,1141,1216,-0.009901947539209088,-0.024923101190945658,0.034825048730154795,-3546,-830,-0.32110839445802775,-0.04472699626936388
10506,39175,Wyandot,Ohio,2008,4461,6270,271,11002,0.4054717324122887,0.5698963824759135,0.024631885111797855,753,190,-984,-41,0.06969341130389423,0.01729692178661448,-0.08699033309050874,-1809,1737,-0.16442465006362478,0.15668374439440297
10507,39175,Wyandot,Ohio,2012,4137,6180,285,10602,0.39020939445387665,0.5829088851160158,0.026881720430107527,-324,14,-90,-400,-0.015262337958412031,0.0022498353183096724,0.013012502640102341,-2043,-234,-0.19269949066213915,-0.028274840598514372
10508,39175,Wyandot,Ohio,2016,2515,7468,655,10638,0.23641661966535063,0.7020116563263772,0.06157172400827223,-1622,370,1288,36,-0.15379277478852602,0.03469000357816471,0.11910277121036139,-4953,-2910,-0.46559503666102653,-0.2728955459988874
10509,40001,Adair,Oklahoma,2000,2361,3503,113,5977,0.39501422118119456,0.5860799732307177,0.01890580558808767,0,0,0,0,0.0,0.0,0.0,-1142,0,-0.19106575204952314,0.0
10510,40001,Adair,Oklahoma,2004,2562,4971,0,7533,0.34010354440461965,0.6598964555953803,0.0,201,-113,1468,1556,-0.05491067677657491,-0.01890580558808767,0.07381648236466265,-2409,-1267,-0.3197929111907607,-0.12872715914123756
10511,40001,Adair,Oklahoma,2008,2052,4638,0,6690,0.30672645739910315,0.6932735426008969,0.0,-510,0,-333,-843,-0.033377087005516504,0.0,0.03337708700551656,-2586,-177,-0.38654708520179376,-0.06675417401103306
10512,40001,Adair,Oklahoma,2012,2127,4381,0,6508,0.3268285187461586,0.6731714812538414,0.0,75,0,-257,-182,0.020102061347055444,0.0,-0.0201020613470555,-2254,332,-0.3463429625076828,0.040204122694110944
10513,40001,Adair,Oklahoma,2016,1382,4787,344,6513,0.2121910026101643,0.7349915553508368,0.05281744203899893,-745,344,406,5,-0.1146375161359943,0.05281744203899893,0.061820074096995414,-3405,-1151,-0.5228005527406725,-0.17645759023298968
10514,40003,Alfalfa,Oklahoma,2000,583,1886,38,2507,0.23254886318308735,0.7522935779816514,0.015157558835261268,0,0,0,0,0.0,0.0,0.0,-1303,0,-0.5197447147985641,0.0
10515,40003,Alfalfa,Oklahoma,2004,470,2201,0,2671,0.17596405840509172,0.8240359415949082,0.0,-113,-38,315,164,-0.05658480477799563,-0.015157558835261268,0.07174236361325681,-1731,-428,-0.6480718831898165,-0.12832716839125236
10516,40003,Alfalfa,Oklahoma,2008,411,2023,0,2434,0.16885784716516022,0.8311421528348397,0.0,-59,0,-178,-237,-0.0071062112399314925,0.0,0.0071062112399314925,-1612,119,-0.6622843056696794,-0.014212422479862985
10517,40003,Alfalfa,Oklahoma,2012,322,1761,0,2083,0.15458473355736918,0.8454152664426309,0.0,-89,0,-262,-351,-0.014273113607791044,0.0,0.014273113607791155,-1439,173,-0.6908305328852617,-0.02854622721558231
10518,40003,Alfalfa,Oklahoma,2016,216,1933,109,2258,0.09565987599645705,0.8560673162090345,0.04827280779450841,-106,109,172,175,-0.05892485756091213,0.04827280779450841,0.01065204976640366,-1717,-278,-0.7604074402125774,-0.0695769073273157
10519,40005,Atoka,Oklahoma,2000,1906,2375,43,4324,0.44079555966697503,0.5492599444958371,0.009944495837187789,0,0,0,0,0.0,0.0,0.0,-469,0,-0.10846438482886211,0.0
10520,40005,Atoka,Oklahoma,2004,1946,3142,0,5088,0.3824685534591195,0.6175314465408805,0.0,40,-43,767,764,-0.058327006207855525,-0.009944495837187789,0.0682715020450434,-1196,-727,-0.23506289308176104,-0.12659850825289892
10521,40005,Atoka,Oklahoma,2008,1370,3511,0,4881,0.280680188485966,0.719319811514034,0.0,-576,0,369,-207,-0.10178836497315352,0.0,0.10178836497315347,-2141,-945,-0.438639623028068,-0.203576729946307
10522,40005,Atoka,Oklahoma,2012,1243,3538,0,4781,0.25998745032419995,0.7400125496758,0.0,-127,0,27,-100,-0.020692738161766033,0.0,0.020692738161765978,-2295,-154,-0.48002509935160004,-0.04138547632353201
10523,40005,Atoka,Oklahoma,2016,795,4084,139,5018,0.1584296532483061,0.8138700677560781,0.027700278995615783,-448,139,546,237,-0.10155779707589385,0.027700278995615783,0.07385751808027807,-3289,-994,-0.6554404145077719,-0.17541531515617187
10524,40007,Beaver,Oklahoma,2000,339,2092,25,2456,0.13802931596091206,0.8517915309446255,0.01017915309446254,0,0,0,0,0.0,0.0,0.0,-1753,0,-0.7137622149837134,0.0
10525,40007,Beaver,Oklahoma,2004,297,2272,0,2569,0.11560918645387311,0.8843908135461269,0.0,-42,-25,180,113,-0.02242012950703895,-0.01017915309446254,0.03259928260150147,-1975,-222,-0.7687816270922538,-0.055019412108540444
10526,40007,Beaver,Oklahoma,2008,265,2199,0,2464,0.1075487012987013,0.8924512987012987,0.0,-32,0,-73,-105,-0.008060485155171812,0.0,0.00806048515517177,-1934,41,-0.7849025974025974,-0.01612097031034354
10527,40007,Beaver,Oklahoma,2012,244,2062,0,2306,0.10581092801387684,0.8941890719861232,0.0,-21,0,-137,-158,-0.0017377732848244537,0.0,0.0017377732848244953,-1818,116,-0.7883781439722464,-0.0034755465696489907
10528,40007,Beaver,Oklahoma,2016,176,1993,74,2243,0.07846633972358448,0.8885421310744539,0.03299152920196166,-68,74,-69,-63,-0.027344588290292363,0.03299152920196166,-0.005646940911669285,-1817,1,-0.8100757913508694,-0.02169764737862301
10529,40009,Beckham,Oklahoma,2000,2408,4067,57,6532,0.36864666258420087,0.622627066748316,0.00872627066748316,0,0,0,0,0.0,0.0,0.0,-1659,0,-0.25398040416411516,0.0
10530,40009,Beckham,Oklahoma,2004,1931,5454,0,7385,0.2614759647935003,0.7385240352064997,0.0,-477,-57,1387,853,-0.10717069779070054,-0.00872627066748316,0.11589696845818365,-3523,-1864,-0.47704807041299935,-0.2230676662488842
10531,40009,Beckham,Oklahoma,2008,1625,5772,0,7397,0.21968365553602812,0.7803163444639719,0.0,-306,0,318,12,-0.04179230925747221,0.0,0.04179230925747224,-4147,-624,-0.5606326889279438,-0.08358461851494448
10532,40009,Beckham,Oklahoma,2012,1417,5508,0,6925,0.20462093862815883,0.7953790613718411,0.0,-208,0,-264,-472,-0.015062716907869284,0.0,0.0150627169078692,-4091,56,-0.5907581227436822,-0.0301254338157384
10533,40009,Beckham,Oklahoma,2016,960,6308,284,7552,0.1271186440677966,0.8352754237288136,0.03760593220338983,-457,284,800,627,-0.07750229456036223,0.03760593220338983,0.03989636235697247,-5348,-1257,-0.708156779661017,-0.11739865691733475
10534,40011,Blaine,Oklahoma,2000,1402,2633,59,4094,0.3424523693209575,0.6431362970200293,0.01441133365901319,0,0,0,0,0.0,0.0,0.0,-1231,0,-0.30068392769907176,0.0
10535,40011,Blaine,Oklahoma,2004,1222,3199,0,4421,0.2764080524768152,0.7235919475231848,0.0,-180,-59,566,327,-0.0660443168441423,-0.01441133365901319,0.0804556505031555,-1977,-746,-0.4471838950463696,-0.1464999673472978
10536,40011,Blaine,Oklahoma,2008,1011,3101,0,4112,0.2458657587548638,0.7541342412451362,0.0,-211,0,-98,-309,-0.030542293721951413,0.0,0.030542293721951386,-2090,-113,-0.5082684824902723,-0.06108458744390277
10537,40011,Blaine,Oklahoma,2012,992,2824,0,3816,0.259958071278826,0.740041928721174,0.0,-19,0,-277,-296,0.014092312523962175,0.0,-0.014092312523962147,-1832,258,-0.48008385744234805,0.028184625047924294
10538,40011,Blaine,Oklahoma,2016,711,2884,198,3793,0.18745056683364092,0.760348009491168,0.05220142367519114,-281,198,60,-23,-0.07250750444518506,0.05220142367519114,0.02030608076999396,-2173,-341,-0.5728974426575271,-0.09281358521517902
10539,40013,Bryan,Oklahoma,2000,5554,6084,108,11746,0.47284181849140133,0.5179635620636812,0.009194619444917418,0,0,0,0,0.0,0.0,0.0,-530,0,-0.04512174357227988,0.0
10540,40013,Bryan,Oklahoma,2004,5745,8615,0,14360,0.40006963788300837,0.5999303621169917,0.0,191,-108,2531,2614,-0.07277218060839297,-0.009194619444917418,0.08196680005331047,-2870,-2340,-0.19986072423398332,-0.15473898066170344
10541,40013,Bryan,Oklahoma,2008,4426,9307,0,13733,0.3222893759557271,0.677710624044273,0.0,-1319,0,692,-627,-0.07778026192728127,0.0,0.07778026192728127,-4881,-2011,-0.35542124808854586,-0.15556052385456254
10542,40013,Bryan,Oklahoma,2012,3681,9520,0,13201,0.2788425119309143,0.7211574880690856,0.0,-745,0,213,-532,-0.04344686402481279,0.0,0.04344686402481268,-5839,-958,-0.44231497613817133,-0.08689372804962547
10543,40013,Bryan,Oklahoma,2016,2804,10478,536,13818,0.20292372268056158,0.7582862932407005,0.03878998407873788,-877,536,958,617,-0.07591878925035273,0.03878998407873788,0.037128805171614876,-7674,-1835,-0.5553625705601389,-0.1130475944219676
10544,40015,Caddo,Oklahoma,2000,4272,4835,103,9210,0.4638436482084691,0.5249728555917481,0.011183496199782844,0,0,0,0,0.0,0.0,0.0,-563,0,-0.06112920738327904,0.0
10545,40015,Caddo,Oklahoma,2004,3916,6491,0,10407,0.37628519265878735,0.6237148073412127,0.0,-356,-103,1656,1197,-0.08755845554968172,-0.011183496199782844,0.09874195174946454,-2575,-2012,-0.2474296146824253,-0.18630040729914626
10546,40015,Caddo,Oklahoma,2008,3404,6413,0,9817,0.346745441580931,0.653254558419069,0.0,-512,0,-78,-590,-0.029539751077856335,0.0,0.029539751077856335,-3009,-434,-0.306509116838138,-0.05907950215571267
10547,40015,Caddo,Oklahoma,2012,3164,5687,0,8851,0.3574737317817196,0.6425262682182804,0.0,-240,0,-726,-966,0.010728290200788582,0.0,-0.010728290200788582,-2523,486,-0.2850525364365608,0.021456580401577163
10548,40015,Caddo,Oklahoma,2016,2420,6482,446,9348,0.2588789045785195,0.6934103551561831,0.04771074026529739,-744,446,795,497,-0.09859482720320012,0.04771074026529739,0.050884086937902695,-4062,-1539,-0.4345314505776636,-0.14947891414110281
10549,40017,Canadian,Oklahoma,2000,8367,22679,314,31360,0.2668048469387755,0.7231823979591837,0.010012755102040817,0,0,0,0,0.0,0.0,0.0,-14312,0,-0.4563775510204082,0.0
10550,40017,Canadian,Oklahoma,2004,9712,33297,0,43009,0.22581320188797693,0.7741867981120231,0.0,1345,-314,10618,11649,-0.04099164505079855,-0.010012755102040817,0.05100440015283936,-23585,-9273,-0.5483735962240461,-0.09199604520363791
10551,40017,Canadian,Oklahoma,2008,11426,36428,0,47854,0.23876791908722364,0.7612320809127764,0.0,1714,0,3131,4845,0.012954717199246707,0.0,-0.01295471719924668,-25002,-1417,-0.5224641618255528,0.02590943439849336
10552,40017,Canadian,Oklahoma,2012,10537,35625,0,46162,0.22826134049651228,0.7717386595034877,0.0,-889,0,-803,-1692,-0.010506578590711357,0.0,0.010506578590711357,-25088,-86,-0.5434773190069755,-0.021013157181422715
10553,40017,Canadian,Oklahoma,2016,11674,39986,3618,55278,0.211187090705163,0.7233619161330005,0.06545099316183653,1137,3618,4361,9116,-0.017074249791349277,0.06545099316183653,-0.04837674337048725,-28312,-3224,-0.5121748254278375,0.03130249357913795
10554,40019,Carter,Oklahoma,2000,6659,9667,132,16458,0.4046056628995018,0.5873739214971443,0.008020415603353991,0,0,0,0,0.0,0.0,0.0,-3008,0,-0.1827682585976425,0.0
10555,40019,Carter,Oklahoma,2004,6466,12178,0,18644,0.34681398841450334,0.6531860115854967,0.0,-193,-132,2511,2186,-0.057791674484998445,-0.008020415603353991,0.06581209008835243,-5712,-2704,-0.3063720231709934,-0.12360376457335087
10556,40019,Carter,Oklahoma,2008,5603,13241,0,18844,0.29733602207599236,0.7026639779240076,0.0,-863,0,1063,200,-0.04947796633851098,0.0,0.04947796633851087,-7638,-1926,-0.40532795584801523,-0.09895593267702185
10557,40019,Carter,Oklahoma,2012,4908,12214,0,17122,0.2866487559864502,0.7133512440135498,0.0,-695,0,-1027,-1722,-0.01068726608954218,0.0,0.01068726608954218,-7306,332,-0.4267024880270996,-0.02137453217908436
10558,40019,Carter,Oklahoma,2016,4002,13752,780,18534,0.2159274846228553,0.7419876982842344,0.04208481709291033,-906,780,1538,1412,-0.07072127136359488,0.04208481709291033,0.02863645427068462,-9750,-2444,-0.5260602136613791,-0.09935772563427953
10559,40021,Cherokee,Oklahoma,2000,7256,6918,294,14468,0.5015205971799834,0.4781586950511474,0.02032070776886923,0,0,0,0,0.0,0.0,0.0,338,0,0.023361902128836043,0.0
10560,40021,Cherokee,Oklahoma,2004,8623,9569,0,18192,0.4739995602462621,0.5260004397537379,0.0,1367,-294,2651,3724,-0.02752103693372132,-0.02032070776886923,0.047841744702590505,-946,-1284,-0.052000879507475783,-0.07536278163631183
10561,40021,Cherokee,Oklahoma,2008,7194,9186,0,16380,0.4391941391941392,0.5608058608058608,0.0,-1429,0,-383,-1812,-0.03480542105212292,0.0,0.03480542105212292,-1992,-1046,-0.12161172161172162,-0.06961084210424584
10562,40021,Cherokee,Oklahoma,2012,6144,8162,0,14306,0.42947015238361524,0.5705298476163847,0.0,-1050,0,-1024,-2074,-0.009723986810523944,0.0,0.009723986810523888,-2018,-26,-0.14105969523276946,-0.01944797362104783
10563,40021,Cherokee,Oklahoma,2016,5456,9994,1040,16490,0.3308671922377198,0.6060642813826561,0.06306852637962401,-688,1040,1832,2184,-0.09860296014589542,0.06306852637962401,0.03553443376627141,-4538,-2520,-0.2751970891449363,-0.13413739391216684
10564,40023,Choctaw,Oklahoma,2000,2799,2461,55,5315,0.5266227657572907,0.4630291627469426,0.010348071495766699,0,0,0,0,0.0,0.0,0.0,338,0,0.06359360301034811,0.0
10565,40023,Choctaw,Oklahoma,2004,2639,3168,0,5807,0.4544515240227312,0.5455484759772689,0.0,-160,-55,707,492,-0.07217124173455952,-0.010348071495766699,0.08251931323032624,-529,-867,-0.09109695195453765,-0.15469055496488576
10566,40023,Choctaw,Oklahoma,2008,1860,3730,0,5590,0.33273703041144903,0.667262969588551,0.0,-779,0,562,-217,-0.12171449361128217,0.0,0.12171449361128217,-1870,-1341,-0.334525939177102,-0.24342898722256434
10567,40023,Choctaw,Oklahoma,2012,1494,3572,0,5066,0.2949072246348204,0.7050927753651797,0.0,-366,0,-158,-524,-0.037829805776628644,0.0,0.037829805776628644,-2078,-208,-0.4101855507303593,-0.07565961155325729
10568,40023,Choctaw,Oklahoma,2016,1067,4206,153,5426,0.19664577957980095,0.7751566531514928,0.02819756726870623,-427,153,634,360,-0.09826144505501944,0.02819756726870623,0.07006387778631318,-3139,-1061,-0.578510873571692,-0.16832532284133267
10569,40025,Cimarron,Oklahoma,2000,227,1230,27,1484,0.15296495956873316,0.8288409703504043,0.018194070080862535,0,0,0,0,0.0,0.0,0.0,-1003,0,-0.6758760107816711,0.0
10570,40025,Cimarron,Oklahoma,2004,184,1242,0,1426,0.12903225806451613,0.8709677419354839,0.0,-43,-27,12,-58,-0.02393270150421703,-0.018194070080862535,0.0421267715850796,-1058,-55,-0.7419354838709677,-0.0660594730892966
10571,40025,Cimarron,Oklahoma,2008,152,1119,0,1271,0.11959087332808813,0.8804091266719118,0.0,-32,0,-123,-155,-0.009441384736427999,0.0,0.009441384736427971,-967,91,-0.7608182533438237,-0.018882769472855943
10572,40025,Cimarron,Oklahoma,2012,115,1082,0,1197,0.0960735171261487,0.9039264828738512,0.0,-37,0,-37,-74,-0.023517356201939427,0.0,0.0235173562019394,-967,0,-0.8078529657477025,-0.0470347124038788
10573,40025,Cimarron,Oklahoma,2016,71,963,45,1079,0.06580166821130677,0.8924930491195552,0.04170528266913809,-44,45,-119,-118,-0.03027184891484193,0.04170528266913809,-0.011433433754296063,-892,75,-0.8266913809082485,-0.018838415160545963
10574,40027,Cleveland,Oklahoma,2000,27792,47393,986,76171,0.3648632681729267,0.6221921728741909,0.01294455895288233,0,0,0,0,0.0,0.0,0.0,-19601,0,-0.25732890470126424,0.0
10575,40027,Cleveland,Oklahoma,2004,34007,65720,0,99727,0.3410009325458502,0.6589990674541498,0.0,6215,-986,18327,23556,-0.023862335627076514,-0.01294455895288233,0.03680689457995889,-31713,-12112,-0.31799813490829965,-0.06066923020703541
10576,40027,Cleveland,Oklahoma,2008,39681,64749,0,104430,0.37997701809824763,0.6200229819017524,0.0,5674,0,-971,4703,0.038976085552397455,0.0,-0.0389760855523974,-25068,6645,-0.2400459638035048,0.07795217110479485
10577,40027,Cleveland,Oklahoma,2012,34771,59116,0,93887,0.3703494626519113,0.6296505373480886,0.0,-4910,0,-5633,-10543,-0.009627555446336311,0.0,0.0096275554463362,-24345,723,-0.2593010746961773,-0.01925511089267251
10578,40027,Cleveland,Oklahoma,2016,38829,62538,8083,109450,0.3547647327546825,0.5713841936957514,0.07385107354956601,4058,8083,3422,15563,-0.01558472989722881,0.07385107354956601,-0.05826634365233718,-23709,636,-0.21661946094106893,0.04268161375510837
10579,40029,Coal,Oklahoma,2000,1148,1196,18,2362,0.48602878916172737,0.506350550381033,0.007620660457239628,0,0,0,0,0.0,0.0,0.0,-48,0,-0.02032176121930568,0.0
10580,40029,Coal,Oklahoma,2004,1203,1396,0,2599,0.46287033474413236,0.5371296652558677,0.0,55,-18,200,237,-0.02315845441759501,-0.007620660457239628,0.030779114874834645,-193,-145,-0.07425933051173533,-0.053937569292429655
10581,40029,Coal,Oklahoma,2008,600,1672,0,2272,0.2640845070422535,0.7359154929577465,0.0,-603,0,276,-327,-0.19878582770187886,0.0,0.1987858277018788,-1072,-879,-0.471830985915493,-0.39757165540375766
10582,40029,Coal,Oklahoma,2012,649,1710,0,2359,0.2751165748198389,0.7248834251801611,0.0,49,0,38,87,0.01103206777758542,0.0,-0.011032067777585364,-1061,11,-0.4497668503603222,0.022064135555170783
10583,40029,Coal,Oklahoma,2016,411,1898,90,2399,0.1713213839099625,0.791162984576907,0.03751563151313047,-238,90,188,40,-0.10379519090987643,0.03751563151313047,0.0662795593967459,-1487,-426,-0.6198416006669445,-0.17007475030662228
10584,40031,Comanche,Oklahoma,2000,11971,17103,259,29333,0.40810691030579893,0.5830634439027716,0.008829645791429449,0,0,0,0,0.0,0.0,0.0,-5132,0,-0.17495653359697272,0.0
10585,40031,Comanche,Oklahoma,2004,12022,21170,0,33192,0.36219570980959265,0.6378042901904073,0.0,51,-259,4067,3859,-0.045911200496206284,-0.008829645791429449,0.05474084628763565,-9148,-4016,-0.27560858038081465,-0.10065204678384193
10586,40031,Comanche,Oklahoma,2008,14120,20127,0,34247,0.41229888749379506,0.5877011125062049,0.0,2098,0,-1043,1055,0.050103177684202416,0.0,-0.05010317768420236,-6007,3141,-0.17540222501240987,0.10020635536840478
10587,40031,Comanche,Oklahoma,2012,12521,17664,0,30185,0.4148086798078516,0.5851913201921484,0.0,-1599,0,-2463,-4062,0.0025097923140565137,0.0,-0.0025097923140565692,-5143,864,-0.1703826403842968,0.005019584628113083
10588,40031,Comanche,Oklahoma,2016,11463,19183,1918,32564,0.35201449453384104,0.5890861073578184,0.0588993981083405,-1058,1918,1519,2379,-0.06279418527401054,0.0588993981083405,0.003894787165670044,-7720,-2577,-0.23707161282397737,-0.06668897243968058
10589,40033,Cotton,Oklahoma,2000,1068,1388,26,2482,0.43029814665592264,0.5592264302981467,0.010475423045930701,0,0,0,0,0.0,0.0,0.0,-320,0,-0.12892828364222403,0.0
10590,40033,Cotton,Oklahoma,2004,898,1742,0,2640,0.34015151515151515,0.6598484848484848,0.0,-170,-26,354,158,-0.09014663150440749,-0.010475423045930701,0.10062205455033812,-844,-524,-0.31969696969696965,-0.19076868605474562
10591,40033,Cotton,Oklahoma,2008,690,1793,0,2483,0.2778896496173983,0.7221103503826017,0.0,-208,0,51,-157,-0.062261865534116834,0.0,0.062261865534116945,-1103,-259,-0.4442207007652034,-0.12452373106823378
10592,40033,Cotton,Oklahoma,2012,657,1796,0,2453,0.2678353037097432,0.7321646962902568,0.0,-33,0,3,-30,-0.010054345907655138,0.0,0.010054345907655082,-1139,-36,-0.46432939258051364,-0.02010869181531022
10593,40033,Cotton,Oklahoma,2016,424,2054,124,2602,0.16295157571099156,0.7893927747886241,0.04765564950038432,-233,124,258,149,-0.10488372799875162,0.04765564950038432,0.05722807849836731,-1630,-491,-0.6264411990776326,-0.16211180649711898
10594,40035,Craig,Oklahoma,2000,2568,2815,101,5484,0.4682713347921225,0.5133114514952589,0.018417213712618525,0,0,0,0,0.0,0.0,0.0,-247,0,-0.0450401167031364,0.0
10595,40035,Craig,Oklahoma,2004,2504,3894,0,6398,0.39137230384495153,0.6086276961550484,0.0,-64,-101,1079,914,-0.07689903094717099,-0.018417213712618525,0.0953162446597895,-1390,-1143,-0.21725539231009688,-0.17221527560696048
10596,40035,Craig,Oklahoma,2008,2073,3858,0,5931,0.3495194739504299,0.6504805260495701,0.0,-431,0,-36,-467,-0.041852829894521604,0.0,0.04185282989452166,-1785,-395,-0.30096105209914015,-0.08370565978904326
10597,40035,Craig,Oklahoma,2012,1747,3559,0,5306,0.32924990576705615,0.6707500942329438,0.0,-326,0,-299,-625,-0.020269568183373776,0.0,0.020269568183373776,-1812,-27,-0.3415001884658877,-0.04053913636674755
10598,40035,Craig,Oklahoma,2016,1252,4283,250,5785,0.21642178046672428,0.7403630077787381,0.043215211754537596,-495,250,724,479,-0.11282812530033187,0.043215211754537596,0.06961291354579424,-3031,-1219,-0.5239412273120139,-0.18244103884612617
10599,40037,Creek,Oklahoma,2000,9753,13580,408,23741,0.4108083063055474,0.572006233941283,0.01718545975316962,0,0,0,0,0.0,0.0,0.0,-3827,0,-0.16119792763573565,0.0
10600,40037,Creek,Oklahoma,2004,9929,18848,0,28777,0.34503249122563157,0.6549675087743684,0.0,176,-408,5268,5036,-0.06577581507991581,-0.01718545975316962,0.08296127483308535,-8919,-5092,-0.3099350175487368,-0.14873708991300116
10601,40037,Creek,Oklahoma,2008,8318,20187,0,28505,0.2918084546570777,0.7081915453429223,0.0,-1611,0,1339,-272,-0.053224036568553845,0.0,0.0532240365685539,-11869,-2950,-0.41638309068584456,-0.10644807313710775
10602,40037,Creek,Oklahoma,2012,7128,18986,0,26114,0.2729570345408593,0.7270429654591407,0.0,-1190,0,-1201,-2391,-0.01885142011621843,0.0,0.01885142011621843,-11858,11,-0.4540859309182814,-0.03770284023243686
10603,40037,Creek,Oklahoma,2016,5841,21575,1414,28830,0.20260145681581684,0.748352410683316,0.04904613250086715,-1287,1414,2589,2716,-0.07035557772504245,0.04904613250086715,0.021309445224175327,-15734,-3876,-0.5457509538674992,-0.09166502294921774
10604,40039,Custer,Oklahoma,2000,3115,6527,101,9743,0.31971671969619214,0.6699168633890998,0.010366416914707995,0,0,0,0,0.0,0.0,0.0,-3412,0,-0.3502001436929077,0.0
10605,40039,Custer,Oklahoma,2004,2801,7839,0,10640,0.2632518796992481,0.7367481203007519,0.0,-314,-101,1312,897,-0.056464839996944016,-0.010366416914707995,0.06683125691165204,-5038,-1626,-0.47349624060150375,-0.12329609690859605
10606,40039,Custer,Oklahoma,2008,2660,7842,0,10502,0.25328508855456106,0.746714911445439,0.0,-141,0,3,-138,-0.00996679114468707,0.0,0.009966791144687126,-5182,-144,-0.49342982289087794,-0.019933582289374197
10607,40039,Custer,Oklahoma,2012,2359,7446,0,9805,0.24059153493115756,0.7594084650688424,0.0,-301,0,-396,-697,-0.012693553623403492,0.0,0.012693553623403409,-5087,95,-0.5188169301376848,-0.025387107246806873
10608,40039,Custer,Oklahoma,2016,2104,7826,611,10541,0.1996015558296177,0.7424343041457168,0.05796414002466559,-255,611,380,736,-0.04098997910153987,0.05796414002466559,-0.016974160923125647,-5722,-635,-0.5428327483160991,-0.02401581817841425
10609,40041,Delaware,Oklahoma,2000,5514,7618,221,13353,0.412940912154572,0.5705084999625553,0.016550587882872763,0,0,0,0,0.0,0.0,0.0,-2104,0,-0.15756758780798324,0.0
10610,40041,Delaware,Oklahoma,2004,5591,10017,0,15608,0.35821373654536137,0.6417862634546386,0.0,77,-221,2399,2255,-0.05472717560921064,-0.016550587882872763,0.07127776349208337,-4426,-2322,-0.28357252690927726,-0.126004939101294
10611,40041,Delaware,Oklahoma,2008,5085,10277,0,15362,0.3310115870329384,0.6689884129670616,0.0,-506,0,260,-246,-0.027202149512422946,0.0,0.027202149512422946,-5192,-766,-0.33797682593412315,-0.05440429902484589
10612,40041,Delaware,Oklahoma,2012,4196,10080,0,14276,0.2939198655085458,0.7060801344914542,0.0,-889,0,-197,-1086,-0.03709172152439261,0.0,0.03709172152439266,-5884,-692,-0.4121602689829084,-0.07418344304878527
10613,40041,Delaware,Oklahoma,2016,3311,11826,579,15716,0.21067701705268516,0.752481547467549,0.036841435479765844,-885,579,1746,1440,-0.08324284845586066,0.036841435479765844,0.04640141297609479,-8515,-2631,-0.5418045304148639,-0.12964426143195545
10614,40043,Dewey,Oklahoma,2000,599,1607,14,2220,0.26981981981981984,0.7238738738738739,0.006306306306306306,0,0,0,0,0.0,0.0,0.0,-1008,0,-0.4540540540540541,0.0
10615,40043,Dewey,Oklahoma,2004,408,1843,0,2251,0.18125277654375832,0.8187472234562416,0.0,-191,-14,236,31,-0.08856704327606152,-0.006306306306306306,0.0948733495823677,-1435,-427,-0.6374944469124832,-0.18344039285842917
10616,40043,Dewey,Oklahoma,2008,346,1857,0,2203,0.15705855651384476,0.8429414434861553,0.0,-62,0,14,-48,-0.02419422002991356,0.0,0.02419422002991367,-1511,-76,-0.6858828869723106,-0.04838844005982734
10617,40043,Dewey,Oklahoma,2012,301,1792,0,2093,0.14381270903010032,0.8561872909698997,0.0,-45,0,-65,-110,-0.013245847483744438,0.0,0.013245847483744355,-1491,20,-0.7123745819397993,-0.02649169496748871
10618,40043,Dewey,Oklahoma,2016,222,1965,61,2248,0.09875444839857651,0.8741103202846975,0.027135231316725978,-79,61,173,155,-0.04505826063152381,0.027135231316725978,0.017923029314797834,-1743,-252,-0.775355871886121,-0.06298128994632168
10619,40045,Ellis,Oklahoma,2000,468,1513,32,2013,0.23248882265275708,0.7516145057128664,0.015896671634376552,0,0,0,0,0.0,0.0,0.0,-1045,0,-0.5191256830601093,0.0
10620,40045,Ellis,Oklahoma,2004,395,1685,0,2080,0.18990384615384615,0.8100961538461539,0.0,-73,-32,172,67,-0.04258497649891094,-0.015896671634376552,0.05848164813328749,-1290,-245,-0.6201923076923077,-0.1010666246321984
10621,40045,Ellis,Oklahoma,2008,282,1627,0,1909,0.14772132006286012,0.8522786799371399,0.0,-113,0,-58,-171,-0.04218252609098602,0.0,0.04218252609098605,-1345,-55,-0.7045573598742798,-0.0843650521819721
10622,40045,Ellis,Oklahoma,2012,226,1575,0,1801,0.1254858411993337,0.8745141588006663,0.0,-56,0,-52,-108,-0.02223547886352642,0.0,0.022235478863526392,-1349,-4,-0.7490283176013326,-0.044470957727052784
10623,40045,Ellis,Oklahoma,2016,155,1611,61,1827,0.08483853311439518,0.8817733990147784,0.033388067870826495,-71,61,36,26,-0.04064730808493852,0.033388067870826495,0.0072592402141120616,-1456,-107,-0.7969348659003832,-0.04790654829905061
10624,40047,Garfield,Oklahoma,2000,6543,14902,238,21683,0.3017571369275469,0.6872665221602177,0.010976340912235392,0,0,0,0,0.0,0.0,0.0,-8359,0,-0.38550938523267075,0.0
10625,40047,Garfield,Oklahoma,2004,5586,17685,0,23271,0.24004125306175067,0.7599587469382493,0.0,-957,-238,2783,1588,-0.06171588386579624,-0.010976340912235392,0.07269222477803161,-12099,-3740,-0.5199174938764985,-0.1344081086438278
10626,40047,Garfield,Oklahoma,2008,5545,17067,0,22612,0.2452237749867327,0.7547762250132672,0.0,-41,0,-618,-659,0.005182521924982031,0.0,-0.005182521924982031,-11522,577,-0.5095524500265345,0.010365043849964062
10627,40047,Garfield,Oklahoma,2012,4733,15177,0,19910,0.2377197388247112,0.7622802611752888,0.0,-812,0,-1890,-2702,-0.007504036162021499,0.0,0.0075040361620215545,-10444,1078,-0.5245605223505776,-0.015008072324043109
10628,40047,Garfield,Oklahoma,2016,4397,16009,1304,21710,0.20253339474896362,0.7374021188392446,0.0600644864117918,-336,1304,832,1800,-0.03518634407574758,0.0600644864117918,-0.02487814233604424,-11612,-1168,-0.534868724090281,-0.010308201739703371
10629,40049,Garvin,Oklahoma,2000,4189,5536,118,9843,0.42558163161637713,0.5624301534085137,0.011988214975109214,0,0,0,0,0.0,0.0,0.0,-1347,0,-0.13684852179213652,0.0
10630,40049,Garvin,Oklahoma,2004,3707,7610,0,11317,0.32756030750198817,0.6724396924980118,0.0,-482,-118,2074,1474,-0.09802132411438896,-0.011988214975109214,0.11000953908949818,-3903,-2556,-0.34487938499602366,-0.20803086320388714
10631,40049,Garvin,Oklahoma,2008,3028,7710,0,10738,0.2819891972434345,0.7180108027565655,0.0,-679,0,100,-579,-0.04557111025855365,0.0,0.04557111025855365,-4682,-779,-0.43602160551313096,-0.0911422205171073
10632,40049,Garvin,Oklahoma,2012,2559,6925,0,9484,0.2698228595529312,0.7301771404470687,0.0,-469,0,-785,-1254,-0.012166337690503293,0.0,0.012166337690503237,-4366,316,-0.4603542808941375,-0.02433267538100653
10633,40049,Garvin,Oklahoma,2016,1855,8253,438,10546,0.17589607434098237,0.782571591124597,0.04153233453442064,-704,438,1328,1062,-0.09392678521194886,0.04153233453442064,0.05239445067752824,-6398,-2032,-0.6066755167836146,-0.14632123588947715
10634,40051,Grady,Oklahoma,2000,6037,10040,199,16276,0.37091422954042763,0.6168591791594986,0.012226591300073728,0,0,0,0,0.0,0.0,0.0,-4003,0,-0.24594494961907098,0.0
10635,40051,Grady,Oklahoma,2004,5970,14136,0,20106,0.2969262906595046,0.7030737093404954,0.0,-67,-199,4096,3830,-0.07398793888092303,-0.012226591300073728,0.08621453018099678,-8166,-4163,-0.4061474186809908,-0.16020246906191982
10636,40051,Grady,Oklahoma,2008,5520,15195,0,20715,0.2664735698769008,0.7335264301230991,0.0,-450,0,1059,609,-0.030452720782603804,0.0,0.030452720782603748,-9675,-1509,-0.46705286024619835,-0.06090544156520755
10637,40051,Grady,Oklahoma,2012,4786,14833,0,19619,0.2439471940465875,0.7560528059534125,0.0,-734,0,-362,-1096,-0.022526375830313305,0.0,0.02252637583031336,-10047,-372,-0.512105611906825,-0.045052751660626666
10638,40051,Grady,Oklahoma,2016,3882,17316,1088,22286,0.17419007448622453,0.7769900385892489,0.04881988692452661,-904,1088,2483,2667,-0.06975711956036296,0.04881988692452661,0.020937232635836356,-13434,-3387,-0.6027999641030244,-0.09069435219619937
10639,40053,Grant,Oklahoma,2000,709,1762,32,2503,0.28326008789452656,0.7039552536955653,0.01278465840990811,0,0,0,0,0.0,0.0,0.0,-1053,0,-0.4206951658010388,0.0
10640,40053,Grant,Oklahoma,2004,571,1950,0,2521,0.22649742165807218,0.7735025783419278,0.0,-138,-32,188,18,-0.05676266623645437,-0.01278465840990811,0.06954732464636249,-1379,-326,-0.5470051566838556,-0.12630999088281686
10641,40053,Grant,Oklahoma,2008,514,1836,0,2350,0.21872340425531914,0.7812765957446809,0.0,-57,0,-114,-171,-0.007774017402753047,0.0,0.007774017402753075,-1322,57,-0.5625531914893618,-0.01554803480550615
10642,40053,Grant,Oklahoma,2012,393,1675,0,2068,0.19003868471953578,0.8099613152804642,0.0,-121,0,-161,-282,-0.02868471953578336,0.0,0.028684719535783332,-1282,40,-0.6199226305609284,-0.057369439071566664
10643,40053,Grant,Oklahoma,2016,288,1827,86,2201,0.1308496138119037,0.830077237619264,0.03907314856883235,-105,86,152,133,-0.05918907090763209,0.03907314856883235,0.020115922338799774,-1539,-257,-0.6992276238073603,-0.07930499324643181
10644,40055,Greer,Oklahoma,2000,839,1287,26,2152,0.3898698884758364,0.5980483271375465,0.012081784386617101,0,0,0,0,0.0,0.0,0.0,-448,0,-0.2081784386617101,0.0
10645,40055,Greer,Oklahoma,2004,719,1529,0,2248,0.31983985765124556,0.6801601423487544,0.0,-120,-26,242,96,-0.07003003082459086,-0.012081784386617101,0.08211181521120792,-810,-362,-0.3603202846975089,-0.15214184603579878
10646,40055,Greer,Oklahoma,2008,566,1548,0,2114,0.26773888363292336,0.7322611163670766,0.0,-153,0,19,-134,-0.0521009740183222,0.0,0.052100974018322144,-982,-172,-0.4645222327341532,-0.10420194803664434
10647,40055,Greer,Oklahoma,2012,488,1344,0,1832,0.2663755458515284,0.7336244541484717,0.0,-78,0,-204,-282,-0.0013633377813949688,0.0,0.0013633377813950798,-856,126,-0.46724890829694327,-0.0027266755627900485
10648,40055,Greer,Oklahoma,2016,323,1482,91,1896,0.17035864978902954,0.7816455696202531,0.047995780590717296,-165,91,138,64,-0.09601689606249886,0.047995780590717296,0.04802111547178145,-1159,-303,-0.6112869198312236,-0.14403801153428036
10649,40057,Harmon,Oklahoma,2000,507,692,6,1205,0.420746887966805,0.5742738589211618,0.004979253112033195,0,0,0,0,0.0,0.0,0.0,-185,0,-0.1535269709543568,0.0
10650,40057,Harmon,Oklahoma,2004,354,838,0,1192,0.29697986577181207,0.7030201342281879,0.0,-153,-6,146,-13,-0.12376702219499292,-0.004979253112033195,0.1287462753070261,-484,-299,-0.4060402684563758,-0.252513297502019
10651,40057,Harmon,Oklahoma,2008,333,757,0,1090,0.3055045871559633,0.6944954128440367,0.0,-21,0,-81,-102,0.008524721384151224,0.0,-0.008524721384151168,-424,60,-0.3889908256880734,0.017049442768302392
10652,40057,Harmon,Oklahoma,2012,264,659,0,923,0.28602383531960995,0.71397616468039,0.0,-69,0,-98,-167,-0.01948075183635334,0.0,0.01948075183635334,-395,29,-0.4279523293607801,-0.03896150367270668
10653,40057,Harmon,Oklahoma,2016,225,715,37,977,0.23029682702149437,0.7318321392016377,0.037871033776867964,-39,37,56,54,-0.05572700829811558,0.037871033776867964,0.017855974521247653,-490,-95,-0.5015353121801434,-0.07358298281936326
10654,40059,Harper,Oklahoma,2000,374,1296,13,1683,0.2222222222222222,0.7700534759358288,0.007724301841948901,0,0,0,0,0.0,0.0,0.0,-922,0,-0.5478312537136066,0.0
10655,40059,Harper,Oklahoma,2004,268,1397,0,1665,0.16096096096096096,0.8390390390390391,0.0,-106,-13,101,-18,-0.061261261261261246,-0.007724301841948901,0.06898556310321025,-1129,-207,-0.6780780780780782,-0.13024682436447155
10656,40059,Harper,Oklahoma,2008,221,1342,0,1563,0.1413947536788228,0.8586052463211772,0.0,-47,0,-55,-102,-0.019566207282138176,0.0,0.019566207282138093,-1121,8,-0.7172104926423544,-0.039132414564276186
10657,40059,Harper,Oklahoma,2012,173,1261,0,1434,0.1206415620641562,0.8793584379358438,0.0,-48,0,-81,-129,-0.020753191614666586,0.0,0.0207531916146666,-1088,33,-0.7587168758716876,-0.0415063832293332
10658,40059,Harper,Oklahoma,2016,134,1318,47,1499,0.08939292861907938,0.8792528352234823,0.03135423615743829,-39,47,57,65,-0.03124863344507682,0.03135423615743829,-0.00010560271236148555,-1184,-96,-0.789859906604403,-0.031143030732715404
10659,40061,Haskell,Oklahoma,2000,2510,2039,79,4628,0.5423509075194468,0.4405790838375108,0.01707000864304235,0,0,0,0,0.0,0.0,0.0,471,0,0.10177182368193599,0.0
10660,40061,Haskell,Oklahoma,2004,2378,2946,0,5324,0.44665664913598796,0.553343350864012,0.0,-132,-79,907,696,-0.09569425838345885,-0.01707000864304235,0.11276426702650116,-568,-1039,-0.10668670172802402,-0.20845852540996002
10661,40061,Haskell,Oklahoma,2008,1474,3207,0,4681,0.314889980773339,0.6851100192266609,0.0,-904,0,261,-643,-0.13176666836264894,0.0,0.13176666836264894,-1733,-1165,-0.3702200384533219,-0.2635333367252979
10662,40061,Haskell,Oklahoma,2012,1175,3069,0,4244,0.276861451460886,0.7231385485391141,0.0,-299,0,-138,-437,-0.03802852931245304,0.0,0.03802852931245315,-1894,-161,-0.4462770970782281,-0.0760570586249062
10663,40061,Haskell,Oklahoma,2016,882,3701,155,4738,0.1861544955677501,0.7811312790206838,0.03271422541156606,-293,155,632,494,-0.09070695589313588,0.03271422541156606,0.05799273048156972,-2819,-925,-0.5949767834529337,-0.1486996863747056
10664,40063,Hughes,Oklahoma,2000,2334,2196,55,4585,0.509051254089422,0.47895310796074153,0.011995637949836423,0,0,0,0,0.0,0.0,0.0,138,0,0.030098146128680447,0.0
10665,40063,Hughes,Oklahoma,2004,2283,3066,0,5349,0.42680874929893436,0.5731912507010656,0.0,-51,-55,870,764,-0.08224250479048761,-0.011995637949836423,0.09423814274032405,-783,-921,-0.14638250140213122,-0.17648064753081166
10666,40063,Hughes,Oklahoma,2008,1709,3134,0,4843,0.35288044600454266,0.6471195539954574,0.0,-574,0,68,-506,-0.0739283032943917,0.0,0.07392830329439182,-1425,-642,-0.29423910799091474,-0.14785660658878352
10667,40063,Hughes,Oklahoma,2012,1370,2838,0,4208,0.3255703422053232,0.6744296577946768,0.0,-339,0,-296,-635,-0.027310103799219443,0.0,0.027310103799219387,-1468,-43,-0.34885931558935357,-0.05462020759843883
10668,40063,Hughes,Oklahoma,2016,961,3388,177,4526,0.21232876712328766,0.7485638532920902,0.03910737958462218,-409,177,550,318,-0.11324157508203556,0.03910737958462218,0.0741341954974134,-2427,-959,-0.5362350861688026,-0.18737577057944899
10669,40065,Jackson,Oklahoma,2000,2515,5591,53,8159,0.3082485598725334,0.6852555460227969,0.00649589410466969,0,0,0,0,0.0,0.0,0.0,-3076,0,-0.3770069861502635,0.0
10670,40065,Jackson,Oklahoma,2004,2232,7024,0,9256,0.2411408815903198,0.7588591184096802,0.0,-283,-53,1433,1097,-0.06710767828221362,-0.00649589410466969,0.07360357238688331,-4792,-1716,-0.5177182368193605,-0.14071125066909695
10671,40065,Jackson,Oklahoma,2008,2264,6719,0,8983,0.252031615273294,0.747968384726706,0.0,32,0,-305,-273,0.01089073368297419,0.0,-0.010890733682974219,-4455,337,-0.49593676945341203,0.021781467365948437
10672,40065,Jackson,Oklahoma,2012,1954,5965,0,7919,0.24674832680894052,0.7532516731910595,0.0,-310,0,-754,-1064,-0.0052832884643534694,0.0,0.005283288464353442,-4011,444,-0.5065033463821189,-0.010566576928706883
10673,40065,Jackson,Oklahoma,2016,1473,5969,364,7806,0.1887009992313605,0.7646682039456828,0.0466307968229567,-481,364,4,-113,-0.05804732757758002,0.0466307968229567,0.011416530754623344,-4496,-485,-0.5759672047143223,-0.06946385833220337
10674,40067,Jefferson,Oklahoma,2000,1245,1320,28,2593,0.48013883532587737,0.5090628615503278,0.010798303123794832,0,0,0,0,0.0,0.0,0.0,-75,0,-0.028924026224450394,0.0
10675,40067,Jefferson,Oklahoma,2004,1057,1546,0,2603,0.4060699193238571,0.593930080676143,0.0,-188,-28,226,10,-0.07406891600202026,-0.010798303123794832,0.08486721912581519,-489,-414,-0.18786016135228584,-0.15893613512783544
10676,40067,Jefferson,Oklahoma,2008,805,1652,0,2457,0.32763532763532766,0.6723646723646723,0.0,-252,0,106,-146,-0.07843459168852945,0.0,0.0784345916885294,-847,-358,-0.3447293447293447,-0.15686918337705885
10677,40067,Jefferson,Oklahoma,2012,605,1634,0,2239,0.2702099151406878,0.7297900848593122,0.0,-200,0,-18,-218,-0.05742541249463984,0.0,0.05742541249463984,-1029,-182,-0.45958016971862437,-0.11485082498927968
10678,40067,Jefferson,Oklahoma,2016,365,1910,75,2350,0.15531914893617021,0.8127659574468085,0.031914893617021274,-240,75,276,111,-0.1148907662045176,0.031914893617021274,0.08297587258749628,-1545,-516,-0.6574468085106382,-0.19786663879201383
10679,40069,Johnston,Oklahoma,2000,1809,2072,49,3930,0.46030534351145036,0.5272264631043257,0.012468193384223919,0,0,0,0,0.0,0.0,0.0,-263,0,-0.06692111959287539,0.0
10680,40069,Johnston,Oklahoma,2004,1713,2635,0,4348,0.3939742410303588,0.6060257589696412,0.0,-96,-49,563,418,-0.06633110248109159,-0.012468193384223919,0.07879929586531542,-922,-659,-0.2120515179392824,-0.145130398346407
10681,40069,Johnston,Oklahoma,2008,1249,2708,0,3957,0.31564316401314124,0.6843568359868587,0.0,-464,0,73,-391,-0.07833107701721753,0.0,0.07833107701721753,-1459,-537,-0.36871367197371746,-0.15666215403443506
10682,40069,Johnston,Oklahoma,2012,1137,2649,0,3786,0.30031695721077656,0.6996830427892234,0.0,-112,0,-59,-171,-0.015326206802364684,0.0,0.015326206802364739,-1512,-53,-0.3993660855784469,-0.030652413604729423
10683,40069,Johnston,Oklahoma,2016,786,3093,139,4018,0.19561971129915381,0.7697859631657541,0.034594325535092084,-351,139,444,232,-0.10469724591162274,0.034594325535092084,0.07010292037653065,-2307,-795,-0.5741662518666003,-0.17480016628815342
10684,40071,Kay,Oklahoma,2000,6122,11768,272,18162,0.33707741438167604,0.6479462614249532,0.014976324193370773,0,0,0,0,0.0,0.0,0.0,-5646,0,-0.3108688470432771,0.0
10685,40071,Kay,Oklahoma,2004,5957,14121,0,20078,0.296692897698974,0.703307102301026,0.0,-165,-272,2353,1916,-0.04038451668270204,-0.014976324193370773,0.05536084087607285,-8164,-2518,-0.406614204602052,-0.09574535755877489
10686,40071,Kay,Oklahoma,2008,5463,13230,0,18693,0.29224843524313915,0.7077515647568609,0.0,-494,0,-891,-1385,-0.004444462455834852,0.0,0.004444462455834852,-7767,397,-0.4155031295137217,-0.008888924911669704
10687,40071,Kay,Oklahoma,2012,4627,11499,0,16126,0.2869279424531812,0.7130720575468188,0.0,-836,0,-1731,-2567,-0.005320492789957942,0.0,0.005320492789957942,-6872,895,-0.4261441150936376,-0.010640985579915885
10688,40071,Kay,Oklahoma,2016,3738,12172,893,16803,0.22246027495090162,0.7243944533714217,0.0531452716776766,-889,893,673,677,-0.06446766750227959,0.0531452716776766,0.011322395824602927,-8434,-1562,-0.5019341784205201,-0.07579006332688254
10689,40073,Kingfisher,Oklahoma,2000,1304,4693,59,6056,0.21532364597093792,0.7749339498018494,0.009742404227212682,0,0,0,0,0.0,0.0,0.0,-3389,0,-0.5596103038309115,0.0
10690,40073,Kingfisher,Oklahoma,2004,1022,5630,0,6652,0.15363800360793747,0.8463619963920626,0.0,-282,-59,937,596,-0.06168564236300045,-0.009742404227212682,0.07142804659021318,-4608,-1219,-0.6927239927841251,-0.13311368895321363
10691,40073,Kingfisher,Oklahoma,2008,1009,5372,0,6381,0.15812568562921173,0.8418743143707883,0.0,-13,0,-258,-271,0.004487682021274253,0.0,-0.004487682021274253,-4363,245,-0.6837486287415766,0.008975364042548506
10692,40073,Kingfisher,Oklahoma,2012,898,4870,0,5768,0.15568654646324548,0.8443134535367545,0.0,-111,0,-502,-613,-0.0024391391659662476,0.0,0.0024391391659661643,-3972,391,-0.6886269070735089,-0.004878278331932329
10693,40073,Kingfisher,Oklahoma,2016,786,5156,189,6131,0.1282009460120698,0.8409721089544936,0.030826945033436633,-112,189,286,363,-0.02748560045117568,0.030826945033436633,-0.0033413445822608745,-4370,-398,-0.7127711629424238,-0.024144255868914888
10694,40075,Kiowa,Oklahoma,2000,1544,2173,33,3750,0.41173333333333334,0.5794666666666667,0.0088,0,0,0,0,0.0,0.0,0.0,-629,0,-0.16773333333333335,0.0
10695,40075,Kiowa,Oklahoma,2004,1413,2610,0,4023,0.3512304250559284,0.6487695749440716,0.0,-131,-33,437,273,-0.060502908277404954,-0.0088,0.06930290827740493,-1197,-568,-0.29753914988814323,-0.12980581655480988
10696,40075,Kiowa,Oklahoma,2008,1226,2537,0,3763,0.325803879883072,0.674196120116928,0.0,-187,0,-73,-260,-0.025426545172856363,0.0,0.025426545172856363,-1311,-114,-0.34839224023385595,-0.050853090345712726
10697,40075,Kiowa,Oklahoma,2012,1106,2316,0,3422,0.32320280537697255,0.6767971946230275,0.0,-120,0,-221,-341,-0.0026010745060994767,0.0,0.0026010745060994767,-1210,101,-0.3535943892460549,-0.005202149012198953
10698,40075,Kiowa,Oklahoma,2016,767,2596,130,3493,0.2195820211852276,0.7432006870884627,0.03721729172630976,-339,130,280,71,-0.10362078419174495,0.03721729172630976,0.0664034924654352,-1829,-619,-0.523618665903235,-0.17002427665718012
10699,40077,Latimer,Oklahoma,2000,1865,1739,65,3669,0.5083128917961297,0.4739711092940856,0.017715998909784682,0,0,0,0,0.0,0.0,0.0,126,0,0.034341782502044116,0.0
10700,40077,Latimer,Oklahoma,2004,1945,2535,0,4480,0.4341517857142857,0.5658482142857143,0.0,80,-65,796,811,-0.07416110608184401,-0.017715998909784682,0.09187710499162871,-590,-716,-0.1316964285714286,-0.16603821107347272
10701,40077,Latimer,Oklahoma,2008,1313,2860,0,4173,0.3146417445482866,0.6853582554517134,0.0,-632,0,325,-307,-0.11951004116599911,0.0,0.11951004116599906,-1547,-957,-0.3707165109034268,-0.23902008233199817
10702,40077,Latimer,Oklahoma,2012,1170,2628,0,3798,0.3080568720379147,0.6919431279620853,0.0,-143,0,-232,-375,-0.006584872510371875,0.0,0.006584872510371986,-1458,89,-0.38388625592417064,-0.013169745020743862
10703,40077,Latimer,Oklahoma,2016,797,3100,159,4056,0.19649901380670612,0.7642998027613412,0.03920118343195266,-373,159,472,258,-0.11155785823120859,0.03920118343195266,0.0723566747992559,-2303,-845,-0.5678007889546351,-0.1839145330304645
10704,40079,Le Flore,Oklahoma,2000,6536,8215,234,14985,0.4361695028361695,0.5482148815482148,0.015615615615615615,0,0,0,0,0.0,0.0,0.0,-1679,0,-0.11204537871204534,0.0
10705,40079,Le Flore,Oklahoma,2004,6741,10683,0,17424,0.3868801652892562,0.6131198347107438,0.0,205,-234,2468,2439,-0.04928933754691334,-0.015615615615615615,0.06490495316252898,-3942,-2263,-0.22623966942148765,-0.11419429070944231
10706,40079,Le Flore,Oklahoma,2008,5136,11605,0,16741,0.3067917089779583,0.6932082910220417,0.0,-1605,0,922,-683,-0.08008845631129785,0.0,0.0800884563112979,-6469,-2527,-0.3864165820440834,-0.16017691262259576
10707,40079,Le Flore,Oklahoma,2012,4662,11177,0,15839,0.29433676368457606,0.7056632363154239,0.0,-474,0,-428,-902,-0.012454945293382258,0.0,0.012454945293382202,-6515,-46,-0.4113264726308479,-0.02490989058676446
10708,40079,Le Flore,Oklahoma,2016,3250,13362,609,17221,0.1887230706695314,0.7759131293188549,0.035363800011613725,-1412,609,2185,1382,-0.10561369301504467,0.035363800011613725,0.07024989300343099,-10112,-3597,-0.5871900586493235,-0.17586358601847563
10709,40081,Lincoln,Oklahoma,2000,4140,7387,174,11701,0.35381591316981453,0.6313135629433382,0.014870523886847278,0,0,0,0,0.0,0.0,0.0,-3247,0,-0.27749764977352365,0.0
10710,40081,Lincoln,Oklahoma,2004,4041,10149,0,14190,0.2847780126849894,0.7152219873150105,0.0,-99,-174,2762,2489,-0.06903790048482511,-0.014870523886847278,0.08390842437167234,-6108,-2861,-0.4304439746300211,-0.15294632485649745
10711,40081,Lincoln,Oklahoma,2008,3504,10470,0,13974,0.2507513954486904,0.7492486045513096,0.0,-537,0,321,-216,-0.03402661723629902,0.0,0.03402661723629907,-6966,-858,-0.4984972091026192,-0.06805323447259809
10712,40081,Lincoln,Oklahoma,2012,3273,9553,0,12826,0.2551847809137689,0.744815219086231,0.0,-231,0,-917,-1148,0.004433385465078488,0.0,-0.004433385465078543,-6280,686,-0.48963043817246216,0.00886677093015703
10713,40081,Lincoln,Oklahoma,2016,2430,10854,741,14025,0.17326203208556148,0.773903743315508,0.05283422459893048,-843,741,1301,1199,-0.08192274882820741,0.05283422459893048,0.02908852422927699,-8424,-2144,-0.6006417112299466,-0.11101127305748443
10714,40083,Logan,Oklahoma,2000,4510,8187,173,12870,0.3504273504273504,0.6361305361305362,0.013442113442113442,0,0,0,0,0.0,0.0,0.0,-3677,0,-0.28570318570318576,0.0
10715,40083,Logan,Oklahoma,2004,4869,11474,0,16343,0.2979257174325399,0.7020742825674601,0.0,359,-173,3287,3473,-0.052501632994810477,-0.013442113442113442,0.06594374643692391,-6605,-2928,-0.40414856513492015,-0.11844537943173439
10716,40083,Logan,Oklahoma,2008,5717,12556,0,18273,0.31286597712471953,0.6871340228752805,0.0,848,0,1082,1930,0.014940259692179603,0.0,-0.014940259692179603,-6839,-234,-0.37426804575056094,0.029880519384359205
10717,40083,Logan,Oklahoma,2012,4724,12314,0,17038,0.27726258950581056,0.7227374104941895,0.0,-993,0,-242,-1235,-0.035603387618908966,0.0,0.03560338761890902,-7590,-751,-0.44547482098837893,-0.07120677523781799
10718,40083,Logan,Oklahoma,2016,4248,13633,1098,18979,0.22382633436956637,0.718320248695927,0.05785341693450656,-476,1098,1319,1941,-0.0534362551362442,0.05785341693450656,-0.004417161798262459,-9385,-1795,-0.4944939143263607,-0.04901909333798177
10719,40085,Love,Oklahoma,2000,1530,1807,35,3372,0.45373665480427045,0.5358837485172004,0.010379596678529062,0,0,0,0,0.0,0.0,0.0,-277,0,-0.08214709371293,0.0
10720,40085,Love,Oklahoma,2004,1538,2295,0,3833,0.4012522828072006,0.5987477171927994,0.0,8,-35,488,461,-0.052484371997069845,-0.010379596678529062,0.06286396867559896,-757,-480,-0.1974954343855988,-0.1153483406726688
10721,40085,Love,Oklahoma,2008,1257,2589,0,3846,0.32683307332293293,0.6731669266770671,0.0,-281,0,294,13,-0.07441920948426767,0.0,0.07441920948426772,-1332,-575,-0.3463338533541342,-0.1488384189685354
10722,40085,Love,Oklahoma,2012,1034,2436,0,3470,0.2979827089337176,0.7020172910662824,0.0,-223,0,-153,-376,-0.028850364389215344,0.0,0.02885036438921529,-1402,-70,-0.4040345821325648,-0.05770072877843063
10723,40085,Love,Oklahoma,2016,735,2922,132,3789,0.19398258115597783,0.7711797307996833,0.03483768804433888,-299,132,486,319,-0.10400012777773976,0.03483768804433888,0.06916243973340086,-2187,-785,-0.5771971496437054,-0.17316256751114056
10724,40087,McClain,Oklahoma,2000,3679,6750,110,10539,0.3490843533542082,0.6404782237403929,0.010437422905398994,0,0,0,0,0.0,0.0,0.0,-3071,0,-0.2913938703861847,0.0
10725,40087,McClain,Oklahoma,2004,3742,10041,0,13783,0.2714938692592324,0.7285061307407676,0.0,63,-110,3291,3244,-0.07759048409497576,-0.010437422905398994,0.08802790700037477,-6299,-3228,-0.45701226148153523,-0.16561839109535054
10726,40087,McClain,Oklahoma,2008,3551,11193,0,14744,0.24084373304395007,0.7591562669560499,0.0,-191,0,1152,961,-0.030650136215282342,0.0,0.03065013621528223,-7642,-1343,-0.5183125339120997,-0.06130027243056452
10727,40087,McClain,Oklahoma,2012,3194,11112,0,14306,0.22326296658744582,0.7767370334125542,0.0,-357,0,-81,-438,-0.01758076645650425,0.0,0.017580766456504304,-7918,-276,-0.5534740668251084,-0.03516153291300861
10728,40087,McClain,Oklahoma,2016,2894,13169,795,16858,0.17166923715743268,0.7811721437892989,0.04715861905326848,-300,795,2057,2552,-0.05159372943001314,0.04715861905326848,0.004435110376744711,-10275,-2357,-0.6095029066318662,-0.05602883980675788
10729,40089,McCurtain,Oklahoma,2000,3752,6601,129,10482,0.357946956687655,0.6297462316351842,0.012306811677160847,0,0,0,0,0.0,0.0,0.0,-2849,0,-0.27179927494752915,0.0
10730,40089,McCurtain,Oklahoma,2004,3684,7472,0,11156,0.33022588741484404,0.669774112585156,0.0,-68,-129,871,674,-0.027721069272810983,-0.012306811677160847,0.040027880949971784,-3788,-939,-0.3395482251703119,-0.06774895022278277
10731,40089,McCurtain,Oklahoma,2008,2794,7745,0,10539,0.26511054179713445,0.7348894582028656,0.0,-890,0,273,-617,-0.0651153456177096,0.0,0.0651153456177096,-4951,-1163,-0.4697789164057311,-0.1302306912354192
10732,40089,McCurtain,Oklahoma,2012,2440,7635,0,10075,0.2421836228287841,0.7578163771712159,0.0,-354,0,-110,-464,-0.022926918968350335,0.0,0.022926918968350307,-5195,-244,-0.5156327543424317,-0.045853837936700614
10733,40089,McCurtain,Oklahoma,2016,1802,8656,268,10726,0.16800298340481074,0.8070110013052396,0.024986015289949655,-638,268,1021,651,-0.07418063942397338,0.024986015289949655,0.04919462413402376,-6854,-1659,-0.6390080179004289,-0.12337526355799722
10734,40091,McIntosh,Oklahoma,2000,4206,3444,131,7781,0.5405474874694769,0.4426166302531808,0.016835882277342243,0,0,0,0,0.0,0.0,0.0,762,0,0.09793085721629607,0.0
10735,40091,McIntosh,Oklahoma,2004,4488,4692,0,9180,0.4888888888888889,0.5111111111111111,0.0,282,-131,1248,1399,-0.05165859858058802,-0.016835882277342243,0.06849448085793025,-204,-966,-0.0222222222222222,-0.12015307943851827
10736,40091,McIntosh,Oklahoma,2008,3320,4903,0,8223,0.4037455916332239,0.5962544083667761,0.0,-1168,0,211,-957,-0.085143297255665,0.0,0.08514329725566505,-1583,-1379,-0.19250881673355225,-0.17028659451133005
10737,40091,McIntosh,Oklahoma,2012,2779,4509,0,7288,0.38131174533479695,0.618688254665203,0.0,-541,0,-394,-935,-0.02243384629842693,0.0,0.02243384629842693,-1730,-147,-0.2373765093304061,-0.04486769259685386
10738,40091,McIntosh,Oklahoma,2016,2123,5505,335,7963,0.26660806228808237,0.691322365942484,0.04206957176943363,-656,335,996,675,-0.11470368304671458,0.04206957176943363,0.07263411127728092,-3382,-1652,-0.4247143036544016,-0.1873377943239955
10739,40093,Major,Oklahoma,2000,635,2672,45,3352,0.18943914081145585,0.7971360381861575,0.013424821002386634,0,0,0,0,0.0,0.0,0.0,-2037,0,-0.6076968973747017,0.0
10740,40093,Major,Oklahoma,2004,537,3122,0,3659,0.14676141022137196,0.853238589778628,0.0,-98,-45,450,307,-0.042677730590083895,-0.013424821002386634,0.05610255159247046,-2585,-548,-0.706477179557256,-0.0987802821825543
10741,40093,Major,Oklahoma,2008,515,2956,0,3471,0.14837222702391242,0.8516277729760876,0.0,-22,0,-166,-188,0.0016108168025404657,0.0,-0.0016108168025403824,-2441,144,-0.7032555459521752,0.003221633605080765
10742,40093,Major,Oklahoma,2012,446,2700,0,3146,0.1417673235855054,0.8582326764144946,0.0,-69,0,-256,-325,-0.006604903438407028,0.0,0.006604903438407028,-2254,187,-0.7164653528289893,-0.013209806876814056
10743,40093,Major,Oklahoma,2016,310,2948,149,3407,0.09098914000587027,0.8652773701203404,0.04373348987378926,-136,149,248,261,-0.05077818357963512,0.04373348987378926,0.007044693705845817,-2638,-384,-0.7742882301144702,-0.05782287728548097
10744,40095,Marshall,Oklahoma,2000,2210,2641,49,4900,0.45102040816326533,0.5389795918367347,0.01,0,0,0,0,0.0,0.0,0.0,-431,0,-0.08795918367346939,0.0
10745,40095,Marshall,Oklahoma,2004,2088,3363,0,5451,0.3830489818381948,0.6169510181618052,0.0,-122,-49,722,551,-0.06797142632507053,-0.01,0.07797142632507048,-1275,-844,-0.2339020363236104,-0.145942852650141
10746,40095,Marshall,Oklahoma,2008,1643,3730,0,5373,0.3057882002605621,0.6942117997394379,0.0,-445,0,367,-78,-0.07726078157763272,0.0,0.07726078157763272,-2087,-812,-0.38842359947887584,-0.15452156315526544
10747,40095,Marshall,Oklahoma,2012,1396,3744,0,5140,0.2715953307392996,0.7284046692607004,0.0,-247,0,14,-233,-0.03419286952126249,0.0,0.03419286952126244,-2348,-261,-0.45680933852140077,-0.06838573904252493
10748,40095,Marshall,Oklahoma,2016,1096,4206,190,5492,0.1995630007283321,0.7658412235979607,0.03459577567370721,-300,190,462,352,-0.07203233001096748,0.03459577567370721,0.03743655433726034,-3110,-762,-0.5662782228696286,-0.10946888434822782
10749,40097,Mayes,Oklahoma,2000,6618,7132,251,14001,0.4726805228197986,0.5093921862724091,0.0179272909077923,0,0,0,0,0.0,0.0,0.0,-514,0,-0.03671166345261051,0.0
10750,40097,Mayes,Oklahoma,2004,6933,9946,0,16879,0.4107470821731145,0.5892529178268855,0.0,315,-251,2814,2878,-0.0619334406466841,-0.0179272909077923,0.07986073155447637,-3013,-2499,-0.17850583565377098,-0.14179417220116047
10751,40097,Mayes,Oklahoma,2008,5749,10234,0,15983,0.35969467559281737,0.6403053244071827,0.0,-1184,0,288,-896,-0.05105240658029714,0.0,0.051052406580297194,-4485,-1472,-0.2806106488143653,-0.10210481316059433
10752,40097,Mayes,Oklahoma,2012,4823,9637,0,14460,0.33354080221300136,0.6664591977869986,0.0,-926,0,-597,-1523,-0.026153873379816006,0.0,0.026153873379815895,-4814,-329,-0.3329183955739972,-0.0523077467596319
10753,40097,Mayes,Oklahoma,2016,3423,11555,739,15717,0.21778965451422028,0.7351911942482662,0.04701915123751352,-1400,739,1918,1257,-0.11575114769878109,0.04701915123751352,0.0687319964612676,-8132,-3318,-0.5174015397340459,-0.18448314416004868
10754,40099,Murray,Oklahoma,2000,2263,2609,50,4922,0.4597724502234864,0.5300690776107273,0.010158472165786265,0,0,0,0,0.0,0.0,0.0,-346,0,-0.0702966273872409,0.0
10755,40099,Murray,Oklahoma,2004,2130,3665,0,5795,0.36755823986194996,0.6324417601380501,0.0,-133,-50,1056,873,-0.09221421036153643,-0.010158472165786265,0.10237268252732279,-1535,-1189,-0.2648835202761001,-0.19458689288885922
10756,40099,Murray,Oklahoma,2008,1592,3746,0,5338,0.29823904083926567,0.7017609591607343,0.0,-538,0,81,-457,-0.0693191990226843,0.0,0.06931919902268424,-2154,-619,-0.40352191832146866,-0.13863839804536854
10757,40099,Murray,Oklahoma,2012,1540,3606,0,5146,0.29926156237854645,0.7007384376214536,0.0,-52,0,-140,-192,0.0010225215392807852,0.0,-0.0010225215392807296,-2066,88,-0.40147687524290715,0.002045043078561515
10758,40099,Murray,Oklahoma,2016,1087,4175,266,5528,0.19663531114327062,0.755246020260492,0.04811866859623734,-453,266,569,382,-0.10262625123527583,0.04811866859623734,0.05450758263903843,-3088,-1022,-0.5586107091172214,-0.1571338338743143
10759,40101,Muskogee,Oklahoma,2000,12520,11820,353,24693,0.507026282752197,0.47867816790183454,0.014295549345968493,0,0,0,0,0.0,0.0,0.0,700,0,0.028348114850362427,0.0
10760,40101,Muskogee,Oklahoma,2004,12585,15124,0,27709,0.45418456097296905,0.5458154390270309,0.0,65,-353,3304,3016,-0.05284172177922791,-0.014295549345968493,0.06713727112519635,-2539,-3239,-0.09163087805406184,-0.11997899290442426
10761,40101,Muskogee,Oklahoma,2008,11294,15289,0,26583,0.42485799194974233,0.5751420080502577,0.0,-1291,0,165,-1126,-0.029326569023226723,0.0,0.029326569023226834,-3995,-1456,-0.1502840161005154,-0.05865313804645356
10762,40101,Muskogee,Oklahoma,2012,9952,13404,0,23356,0.4261003596506251,0.5738996403493749,0.0,-1342,0,-1885,-3227,0.0012423677008827627,0.0,-0.0012423677008828182,-3452,543,-0.1477992806987498,0.002484735401765581
10763,40101,Muskogee,Oklahoma,2016,7977,15043,1196,24216,0.329410307234886,0.6212008589362406,0.04938883382887347,-1975,1196,1639,860,-0.09669005241573908,0.04938883382887347,0.047301218586865645,-7066,-3614,-0.29179055170135454,-0.14399127100260473
10764,40103,Noble,Oklahoma,2000,1416,3230,51,4697,0.3014690227804982,0.6876729827549499,0.010857994464551842,0,0,0,0,0.0,0.0,0.0,-1814,0,-0.3862039599744517,0.0
10765,40103,Noble,Oklahoma,2004,1335,3993,0,5328,0.2505630630630631,0.7494369369369369,0.0,-81,-51,763,631,-0.05090595971743511,-0.010857994464551842,0.06176395418198699,-2658,-844,-0.49887387387387383,-0.1126699138994221
10766,40103,Noble,Oklahoma,2008,1174,3881,0,5055,0.23224530168150345,0.7677546983184965,0.0,-161,0,-112,-273,-0.018317761381559633,0.0,0.018317761381559605,-2707,-49,-0.535509396636993,-0.03663552276311921
10767,40103,Noble,Oklahoma,2012,1143,3488,0,4631,0.24681494277693802,0.753185057223062,0.0,-31,0,-393,-424,0.014569641095434571,0.0,-0.014569641095434571,-2345,362,-0.5063701144461239,0.029139282190869142
10768,40103,Noble,Oklahoma,2016,901,3715,262,4878,0.18470684706847068,0.7615826158261583,0.053710537105371055,-242,262,227,247,-0.06210809570846734,0.053710537105371055,0.008397558603096322,-2814,-469,-0.5768757687576875,-0.07050565431156364
10769,40105,Nowata,Oklahoma,2000,1703,2069,77,3849,0.4424525850870356,0.537542218758119,0.020005196154845414,0,0,0,0,0.0,0.0,0.0,-366,0,-0.09508963367108342,0.0
10770,40105,Nowata,Oklahoma,2004,1660,2805,0,4465,0.3717805151175812,0.6282194848824189,0.0,-43,-77,736,616,-0.07067206996945441,-0.020005196154845414,0.09067726612429983,-1145,-779,-0.25643896976483765,-0.16134933609375424
10771,40105,Nowata,Oklahoma,2008,1411,3031,0,4442,0.31764970733903647,0.6823502926609635,0.0,-249,0,226,-23,-0.05413080777854473,0.0,0.05413080777854462,-1620,-475,-0.364700585321927,-0.10826161555708935
10772,40105,Nowata,Oklahoma,2012,1244,2832,0,4076,0.30520117762512267,0.6947988223748773,0.0,-167,0,-199,-366,-0.012448529713913803,0.0,0.012448529713913858,-1588,32,-0.38959764474975467,-0.02489705942782766
10773,40105,Nowata,Oklahoma,2016,742,3321,174,4237,0.17512390842577294,0.7838092990323342,0.04106679254189285,-502,174,489,161,-0.13007726919934973,0.04106679254189285,0.08901047665745687,-2579,-991,-0.6086853906065612,-0.21908774585680657
10774,40107,Okfuskee,Oklahoma,2000,1814,1910,64,3788,0.4788806758183738,0.5042238648363252,0.01689545934530095,0,0,0,0,0.0,0.0,0.0,-96,0,-0.025343189017951406,0.0
10775,40107,Okfuskee,Oklahoma,2004,1743,2542,0,4285,0.40676779463243873,0.5932322053675613,0.0,-71,-64,632,497,-0.07211288118593506,-0.01689545934530095,0.08900834053123607,-799,-703,-0.18646441073512254,-0.16112122171717114
10776,40107,Okfuskee,Oklahoma,2008,1480,2643,0,4123,0.35896192093136065,0.6410380790686393,0.0,-263,0,101,-162,-0.04780587370107808,0.0,0.04780587370107803,-1163,-364,-0.28207615813727865,-0.09561174740215611
10777,40107,Okfuskee,Oklahoma,2012,1256,2335,0,3591,0.34976329713171816,0.6502367028682818,0.0,-224,0,-308,-532,-0.00919862379964248,0.0,0.009198623799642536,-1079,84,-0.30047340573656367,-0.018397247599285016
10778,40107,Okfuskee,Oklahoma,2016,943,2800,200,3943,0.239158001521684,0.7101191985797616,0.0507227998985544,-313,200,465,352,-0.11060529561003415,0.0507227998985544,0.059882495711479744,-1857,-778,-0.4709611970580776,-0.17048779132151393
10779,40109,Oklahoma,Oklahoma,2000,81590,139078,2443,223111,0.3656924131934329,0.6233578801583068,0.010949706648260282,0,0,0,0,0.0,0.0,0.0,-57488,0,-0.25766546696487397,0.0
10780,40109,Oklahoma,Oklahoma,2004,97298,174741,0,272039,0.35766195288175595,0.642338047118244,0.0,15708,-2443,35663,48928,-0.008030460311676924,-0.010949706648260282,0.018980166959937206,-77443,-19955,-0.2846760942364881,-0.02701062727161413
10781,40109,Oklahoma,Oklahoma,2008,116182,163172,0,279354,0.41589524402729156,0.5841047559727085,0.0,18884,0,-11569,7315,0.058233291145535604,0.0,-0.05823329114553555,-46990,30453,-0.16820951194541695,0.11646658229107115
10782,40109,Oklahoma,Oklahoma,2012,106982,149728,0,256710,0.4167426278680223,0.5832573721319777,0.0,-9200,0,-13444,-22644,0.0008473838407307421,0.0,-0.0008473838407307976,-42746,4244,-0.1665147442639554,0.0016947676814615398
10783,40109,Oklahoma,Oklahoma,2016,112813,141569,19560,273942,0.41181344956231614,0.5167845748370093,0.0714019756006746,5831,19560,-8159,17232,-0.004929178305706161,0.0714019756006746,-0.06647279729496836,-28756,13990,-0.10497112527469321,0.061543618989262194
10784,40111,Okmulgee,Oklahoma,2000,7186,5797,195,13178,0.5453027773561997,0.43989983305509184,0.014797389588708453,0,0,0,0,0.0,0.0,0.0,1389,0,0.10540294430110786,0.0
10785,40111,Okmulgee,Oklahoma,2004,7367,8363,0,15730,0.46834075015893195,0.531659249841068,0.0,181,-195,2566,2552,-0.07696202719726775,-0.014797389588708453,0.09175941678597621,-996,-2385,-0.0633184996821361,-0.16872144398324396
10786,40111,Okmulgee,Oklahoma,2008,6191,8727,0,14918,0.41500201099343076,0.5849979890065693,0.0,-1176,0,364,-812,-0.05333873916550119,0.0,0.05333873916550125,-2536,-1540,-0.16999597801313854,-0.10667747833100244
10787,40111,Okmulgee,Oklahoma,2012,5432,7731,0,13163,0.412671883309276,0.587328116690724,0.0,-759,0,-996,-1755,-0.002330127684154748,0.0,0.002330127684154748,-2299,237,-0.17465623338144803,-0.004660255368309496
10788,40111,Okmulgee,Oklahoma,2016,4385,8944,620,13949,0.3143594522904868,0.641192917054986,0.044447630654527205,-1047,620,1213,786,-0.09831243101878923,0.044447630654527205,0.053864800364262,-4559,-2260,-0.32683346476449926,-0.15217723138305123
10789,40113,Osage,Oklahoma,2000,7540,8138,231,15909,0.47394556540323085,0.5115343516248664,0.014520082971902697,0,0,0,0,0.0,0.0,0.0,-598,0,-0.03758878622163553,0.0
10790,40113,Osage,Oklahoma,2004,8068,11467,0,19535,0.41300230355771694,0.5869976964422831,0.0,528,-231,3329,3626,-0.06094326184551391,-0.014520082971902697,0.07546334481741668,-3399,-2801,-0.1739953928845661,-0.13640660666293059
10791,40113,Osage,Oklahoma,2008,7498,12160,0,19658,0.38142232170108864,0.6185776782989114,0.0,-570,0,693,123,-0.0315799818566283,0.0,0.03157998185662836,-4662,-1263,-0.23715535659782278,-0.06315996371325666
10792,40113,Osage,Oklahoma,2012,6704,11242,0,17946,0.37356513986403656,0.6264348601359635,0.0,-794,0,-918,-1712,-0.007857181837052085,0.0,0.007857181837052085,-4538,124,-0.25286972027192695,-0.01571436367410417
10793,40113,Osage,Oklahoma,2016,5597,12577,792,18966,0.29510703363914376,0.6631340293156174,0.04175893704523885,-1107,792,1335,1020,-0.0784581062248928,0.04175893704523885,0.03669916917965388,-6980,-2442,-0.3680269956764736,-0.11515727540454668
10794,40115,Ottawa,Oklahoma,2000,5647,5625,139,11411,0.4948733678029971,0.4929454035579704,0.012181228639032513,0,0,0,0,0.0,0.0,0.0,22,0,0.0019279642450267254,0.0
10795,40115,Ottawa,Oklahoma,2004,5086,7443,0,12529,0.4059382233218932,0.5940617766781068,0.0,-561,-139,1818,1118,-0.0889351444811039,-0.012181228639032513,0.10111637312013638,-2357,-2379,-0.18812355335621356,-0.19005151760124028
10796,40115,Ottawa,Oklahoma,2008,4268,6905,0,11173,0.3819923028729974,0.6180076971270025,0.0,-818,0,-538,-1356,-0.02394592044889582,0.0,0.023945920448895763,-2637,-280,-0.23601539425400514,-0.04789184089779158
10797,40115,Ottawa,Oklahoma,2012,3509,6466,0,9975,0.35177944862155386,0.6482205513784461,0.0,-759,0,-439,-1198,-0.030212854251443544,0.0,0.0302128542514436,-2957,-320,-0.2964411027568923,-0.06042570850288714
10798,40115,Ottawa,Oklahoma,2016,2584,7631,475,10690,0.24172123479887744,0.713844714686623,0.04443405051449953,-925,475,1165,715,-0.11005821382267642,0.04443405051449953,0.06562416330817689,-5047,-2090,-0.4721234798877456,-0.17568237713085333
10799,40117,Pawnee,Oklahoma,2000,2435,3386,104,5925,0.4109704641350211,0.5714767932489452,0.017552742616033755,0,0,0,0,0.0,0.0,0.0,-951,0,-0.1605063291139241,0.0
10800,40117,Pawnee,Oklahoma,2004,2564,4412,0,6976,0.36754587155963303,0.632454128440367,0.0,129,-104,1026,1051,-0.043424592575388055,-0.017552742616033755,0.06097733519142179,-1848,-897,-0.26490825688073394,-0.10440192776680984
10801,40117,Pawnee,Oklahoma,2008,2063,4533,0,6596,0.3127653123104912,0.6872346876895088,0.0,-501,0,121,-380,-0.054780559249141825,0.0,0.054780559249141825,-2470,-622,-0.3744693753790176,-0.10956111849828365
10802,40117,Pawnee,Oklahoma,2012,1813,4232,0,6045,0.29991728701406123,0.7000827129859388,0.0,-250,0,-301,-551,-0.012848025296429977,0.0,0.012848025296430032,-2419,51,-0.4001654259718776,-0.02569605059286001
10803,40117,Pawnee,Oklahoma,2016,1344,4729,291,6364,0.21118793211816467,0.7430861093651792,0.045725958516656194,-469,291,497,319,-0.08872935489589656,0.045725958516656194,0.04300339637924033,-3385,-966,-0.5318981772470145,-0.1317327512751369
10804,40119,Payne,Oklahoma,2000,9319,15256,372,24947,0.3735519300917946,0.6115364572894536,0.014911612618751754,0,0,0,0,0.0,0.0,0.0,-5937,0,-0.237984527197659,0.0
10805,40119,Payne,Oklahoma,2004,10101,19560,0,29661,0.34054819459896835,0.6594518054010317,0.0,782,-372,4304,4714,-0.03300373549282626,-0.014911612618751754,0.04791534811157805,-9459,-3522,-0.3189036108020633,-0.08091908360440431
10806,40119,Payne,Oklahoma,2008,10601,18435,0,29036,0.36509849841575975,0.6349015015842403,0.0,500,0,-1125,-625,0.024550303816791408,0.0,-0.024550303816791352,-7834,1625,-0.26980300316848055,0.04910060763358276
10807,40119,Payne,Oklahoma,2012,9198,16481,0,25679,0.3581915183613069,0.6418084816386931,0.0,-1403,0,-1954,-3357,-0.006906980054452838,0.0,0.006906980054452783,-7283,551,-0.28361696327738617,-0.01381396010890562
10808,40119,Payne,Oklahoma,2016,8788,16651,2321,27760,0.3165706051873199,0.5998198847262248,0.08360951008645533,-410,2321,170,2081,-0.04162091317398703,0.08360951008645533,-0.04198859691246826,-7863,-580,-0.28324927953890494,0.00036768373848122815
10809,40121,Pittsburg,Oklahoma,2000,7627,8514,216,16357,0.466283548327933,0.5205110961667787,0.013205355505288256,0,0,0,0,0.0,0.0,0.0,-887,0,-0.0542275478388457,0.0
10810,40121,Pittsburg,Oklahoma,2004,7452,11134,0,18586,0.40094694931669,0.59905305068331,0.0,-175,-216,2620,2229,-0.065336599011243,-0.013205355505288256,0.07854195451653134,-3682,-2795,-0.19810610136662005,-0.14387855352777434
10811,40121,Pittsburg,Oklahoma,2008,5457,11752,0,17209,0.31710151664826547,0.6828984833517345,0.0,-1995,0,618,-1377,-0.08384543266842454,0.0,0.08384543266842448,-6295,-2613,-0.36579696670346906,-0.16769086533684902
10812,40121,Pittsburg,Oklahoma,2012,4831,10841,0,15672,0.308256763654926,0.6917432363450741,0.0,-626,0,-911,-1537,-0.008844752993339478,0.0,0.008844752993339533,-6010,285,-0.3834864726901481,-0.01768950598667901
10813,40121,Pittsburg,Oklahoma,2016,3711,12753,807,17271,0.21486885530658328,0.7384054194893174,0.04672572520409936,-1120,807,1912,1599,-0.09338790834834271,0.04672572520409936,0.04666218314424331,-9042,-3032,-0.5235365641827341,-0.14005009149258602
10814,40123,Pontotoc,Oklahoma,2000,5387,7299,150,12836,0.4196790277344967,0.5686350888127143,0.011685883452789031,0,0,0,0,0.0,0.0,0.0,-1912,0,-0.14895606107821757,0.0
10815,40123,Pontotoc,Oklahoma,2004,5165,9647,0,14812,0.3487037537132055,0.6512962462867945,0.0,-222,-150,2348,1976,-0.07097527402129122,-0.011685883452789031,0.0826611574740802,-4482,-2570,-0.302592492573589,-0.15363643149537143
10816,40123,Pontotoc,Oklahoma,2008,4512,9750,0,14262,0.3163651661758519,0.6836348338241481,0.0,-653,0,103,-550,-0.03233858753735358,0.0,0.032338587537353636,-5238,-756,-0.3672696676482962,-0.06467717507470722
10817,40123,Pontotoc,Oklahoma,2012,3947,8945,0,12892,0.3061588582066398,0.6938411417933602,0.0,-565,0,-805,-1370,-0.010206307969212125,0.0,0.01020630796921207,-4998,240,-0.3876822835867204,-0.020412615938424195
10818,40123,Pontotoc,Oklahoma,2016,3637,10431,763,14831,0.24522958667655587,0.7033241184006473,0.05144629492279684,-310,763,1486,1939,-0.06092927153008393,0.05144629492279684,0.009482976607287141,-6794,-1796,-0.4580945317240915,-0.07041224813737107
10819,40125,Pottawatomie,Oklahoma,2000,8763,13235,318,22316,0.39267789926510127,0.5930722351675928,0.014249865567305968,0,0,0,0,0.0,0.0,0.0,-4472,0,-0.2003943359024915,0.0
10820,40125,Pottawatomie,Oklahoma,2004,8638,17215,0,25853,0.3341198313541949,0.6658801686458051,0.0,-125,-318,3980,3537,-0.0585580679109064,-0.014249865567305968,0.07280793347821235,-8577,-4105,-0.33176033729161025,-0.13136600138911875
10821,40125,Pottawatomie,Oklahoma,2008,7910,17753,0,25663,0.3082258504461676,0.6917741495538323,0.0,-728,0,538,-190,-0.025893980908027248,0.0,0.025893980908027192,-9843,-1266,-0.3835482991076647,-0.05178796181605444
10822,40125,Pottawatomie,Oklahoma,2012,7188,16250,0,23438,0.3066814574622408,0.6933185425377592,0.0,-722,0,-1503,-2225,-0.0015443929839268344,0.0,0.0015443929839268344,-9062,781,-0.38663708507551836,-0.003088785967853669
10823,40125,Pottawatomie,Oklahoma,2016,6015,17848,1589,25452,0.23632720414898634,0.7012415527267012,0.06243124312431243,-1173,1589,1598,2014,-0.07035425331325446,0.06243124312431243,0.007923010188942037,-11833,-2771,-0.46491434857771485,-0.07827726350219649
10824,40127,Pushmataha,Oklahoma,2000,1969,2331,48,4348,0.452851885924563,0.5361085556577737,0.011039558417663294,0,0,0,0,0.0,0.0,0.0,-362,0,-0.08325666973321072,0.0
10825,40127,Pushmataha,Oklahoma,2004,1934,2863,0,4797,0.4031686470710861,0.5968313529289139,0.0,-35,-48,532,449,-0.04968323885347692,-0.011039558417663294,0.06072279727114016,-929,-567,-0.1936627058578278,-0.11040603612461708
10826,40127,Pushmataha,Oklahoma,2008,1265,3208,0,4473,0.2828079588642969,0.7171920411357031,0.0,-669,0,345,-324,-0.12036068820678919,0.0,0.12036068820678925,-1943,-1014,-0.43438408227140624,-0.24072137641357844
10827,40127,Pushmataha,Oklahoma,2012,1043,3087,0,4130,0.25254237288135595,0.747457627118644,0.0,-222,0,-121,-343,-0.030265585982940935,0.0,0.030265585982940935,-2044,-101,-0.4949152542372881,-0.06053117196588187
10828,40127,Pushmataha,Oklahoma,2016,748,3581,154,4483,0.16685255409324112,0.7987954494757975,0.03435199643096141,-295,154,494,353,-0.08568981878811482,0.03435199643096141,0.05133782235715345,-2833,-789,-0.6319428953825563,-0.13702764114526822
10829,40129,Roger Mills,Oklahoma,2000,441,1234,12,1687,0.26141078838174275,0.7314759928867812,0.007113218731475993,0,0,0,0,0.0,0.0,0.0,-793,0,-0.47006520450503847,0.0
10830,40129,Roger Mills,Oklahoma,2004,382,1388,0,1770,0.21581920903954802,0.784180790960452,0.0,-59,-12,154,83,-0.04559157934219474,-0.007113218731475993,0.05270479807367079,-1006,-213,-0.568361581920904,-0.09829637741586555
10831,40129,Roger Mills,Oklahoma,2008,287,1502,0,1789,0.16042481833426495,0.8395751816657351,0.0,-95,0,114,19,-0.05539439070528307,0.0,0.05539439070528307,-1215,-209,-0.6791503633314702,-0.11078878141056614
10832,40129,Roger Mills,Oklahoma,2012,272,1402,0,1674,0.16248506571087215,0.8375149342891278,0.0,-15,0,-100,-115,0.002060247376607205,0.0,-0.0020602473766072604,-1130,85,-0.6750298685782556,0.004120494753214521
10833,40129,Roger Mills,Oklahoma,2016,151,1547,61,1759,0.08584422967595225,0.8794769755542922,0.03467879476975554,-121,61,145,85,-0.0766408360349199,0.03467879476975554,0.04196204126516434,-1396,-266,-0.7936327458783399,-0.11860287730008423
10834,40131,Rogers,Oklahoma,2000,10813,17713,425,28951,0.37349314358744085,0.6118268799005215,0.014679976512037582,0,0,0,0,0.0,0.0,0.0,-6900,0,-0.2383337363130807,0.0
10835,40131,Rogers,Oklahoma,2004,11918,24976,0,36894,0.3230335555916951,0.6769664444083049,0.0,1105,-425,7263,7943,-0.050459587995745736,-0.014679976512037582,0.06513956450778335,-13058,-6158,-0.3539328888166098,-0.11559915250352909
10836,40131,Rogers,Oklahoma,2008,10772,27743,0,38515,0.27968324029598857,0.7203167597040114,0.0,-1146,0,2767,1621,-0.04335031529570654,0.0,0.04335031529570654,-16971,-3913,-0.44063351940802287,-0.08670063059141309
10837,40131,Rogers,Oklahoma,2012,9148,27553,0,36701,0.24925751341925287,0.7507424865807472,0.0,-1624,0,-190,-1814,-0.030425726876735698,0.0,0.030425726876735726,-18405,-1434,-0.5014849731614943,-0.06085145375347145
10838,40131,Rogers,Oklahoma,2016,7902,30913,2047,40862,0.19338260486515588,0.7565219519357839,0.05009544319906025,-1246,2047,3360,4161,-0.05587490855409699,0.05009544319906025,0.005779465355036706,-23011,-4606,-0.563139347070628,-0.06165437390913364
10839,40133,Seminole,Oklahoma,2000,3783,4011,72,7866,0.48093058733791,0.5099160945842868,0.009153318077803204,0,0,0,0,0.0,0.0,0.0,-228,0,-0.028985507246376774,0.0
10840,40133,Seminole,Oklahoma,2004,3648,5624,0,9272,0.39344262295081966,0.6065573770491803,0.0,-135,-72,1613,1406,-0.08748796438709033,-0.009153318077803204,0.09664128246489356,-1976,-1748,-0.21311475409836067,-0.1841292468519839
10841,40133,Seminole,Oklahoma,2008,2977,5600,0,8577,0.34709105747930513,0.6529089425206949,0.0,-671,0,-24,-695,-0.04635156547151453,0.0,0.04635156547151453,-2623,-647,-0.30581788504138974,-0.09270313094302907
10842,40133,Seminole,Oklahoma,2012,2600,4856,0,7456,0.3487124463519313,0.6512875536480687,0.0,-377,0,-744,-1121,0.001621388872626195,0.0,-0.001621388872626195,-2256,367,-0.30257510729613735,0.00324277774525239
10843,40133,Seminole,Oklahoma,2016,2071,5613,353,8037,0.2576832151300236,0.6983949234789101,0.04392186139106632,-529,353,757,581,-0.0910292312219077,0.04392186139106632,0.047107369830841406,-3542,-1286,-0.44071170834888646,-0.1381366010527491
10844,40135,Sequoyah,Oklahoma,2000,5425,6614,215,12254,0.44271258364615634,0.5397421250204015,0.017545291333442143,0,0,0,0,0.0,0.0,0.0,-1189,0,-0.09702954137424519,0.0
10845,40135,Sequoyah,Oklahoma,2004,5910,8865,0,14775,0.4,0.6,0.0,485,-215,2251,2521,-0.04271258364615632,-0.017545291333442143,0.06025787497959845,-2955,-1766,-0.19999999999999996,-0.10297045862575477
10846,40135,Sequoyah,Oklahoma,2008,4454,9466,0,13920,0.3199712643678161,0.6800287356321839,0.0,-1456,0,601,-855,-0.08002873563218393,0.0,0.08002873563218393,-5012,-2057,-0.3600574712643678,-0.16005747126436787
10847,40135,Sequoyah,Oklahoma,2012,4193,9578,0,13771,0.30448042988889695,0.695519570111103,0.0,-261,0,112,-149,-0.015490834478919135,0.0,0.01549083447891908,-5385,-373,-0.39103914022220604,-0.030981668957838215
10848,40135,Sequoyah,Oklahoma,2016,3061,10888,488,14437,0.2120246588626446,0.7541733047031932,0.03380203643416222,-1132,488,1310,666,-0.09245577102625235,0.03380203643416222,0.05865373459209022,-7827,-2442,-0.5421486458405487,-0.15110950561834263
10849,40137,Stephens,Oklahoma,2000,6467,10860,161,17488,0.3697964318389753,0.6209972552607502,0.009206312900274474,0,0,0,0,0.0,0.0,0.0,-4393,0,-0.2512008234217749,0.0
10850,40137,Stephens,Oklahoma,2004,5515,13646,0,19161,0.287824226292991,0.712175773707009,0.0,-952,-161,2786,1673,-0.08197220554598433,-0.009206312900274474,0.0911785184462588,-8131,-3738,-0.42435154741401804,-0.17315072399224313
10851,40137,Stephens,Oklahoma,2008,4538,14394,0,18932,0.23969997887175154,0.7603000211282485,0.0,-977,0,748,-229,-0.04812424742123944,0.0,0.04812424742123944,-9856,-1725,-0.5206000422564969,-0.09624849484247888
10852,40137,Stephens,Oklahoma,2012,3939,12908,0,16847,0.23381017391820502,0.766189826081795,0.0,-599,0,-1486,-2085,-0.005889804953546518,0.0,0.005889804953546518,-8969,887,-0.53237965216359,-0.011779609907093036
10853,40137,Stephens,Oklahoma,2016,3086,14182,636,17904,0.17236371760500446,0.7921134941912422,0.035522788203753354,-853,636,1274,1057,-0.06144645631320056,0.035522788203753354,0.02592366810944724,-11096,-2127,-0.6197497765862378,-0.0873701244226478
10854,40139,Texas,Oklahoma,2000,1084,4964,40,6088,0.17805519053876478,0.8153745072273325,0.006570302233902759,0,0,0,0,0.0,0.0,0.0,-3880,0,-0.6373193166885678,0.0
10855,40139,Texas,Oklahoma,2004,1016,5450,0,6466,0.15712960098979276,0.8428703990102072,0.0,-68,-40,486,378,-0.02092558954897203,-0.006570302233902759,0.027495891782874704,-4434,-554,-0.6857407980204144,-0.04842148133184665
10856,40139,Texas,Oklahoma,2008,923,5336,0,6259,0.14746764658891195,0.852532353411088,0.0,-93,0,-114,-207,-0.009661954400880801,0.0,0.009661954400880801,-4413,21,-0.705064706822176,-0.019323908801761602
10857,40139,Texas,Oklahoma,2012,862,4930,0,5792,0.14882596685082872,0.8511740331491713,0.0,-61,0,-406,-467,0.0013583202619167623,0.0,-0.0013583202619167345,-4068,345,-0.7023480662983426,0.002716640523833469
10858,40139,Texas,Oklahoma,2016,858,4621,301,5780,0.14844290657439446,0.7994809688581315,0.05207612456747405,-4,301,-309,-12,-0.000383060276434255,0.05207612456747405,-0.051693064291039814,-3763,305,-0.6510380622837371,0.051310004014605504
10859,40141,Tillman,Oklahoma,2000,1400,1920,29,3349,0.41803523439832785,0.5733054643177068,0.008659301283965363,0,0,0,0,0.0,0.0,0.0,-520,0,-0.15527022991937894,0.0
10860,40141,Tillman,Oklahoma,2004,1175,2273,0,3448,0.3407772621809745,0.6592227378190255,0.0,-225,-29,353,99,-0.07725797221735337,-0.008659301283965363,0.08591727350131872,-1098,-578,-0.31844547563805103,-0.1631752457186721
10861,40141,Tillman,Oklahoma,2008,1042,2195,0,3237,0.3219029966017918,0.6780970033982082,0.0,-133,0,-78,-211,-0.018874265579182703,0.0,0.018874265579182703,-1153,-55,-0.35619400679641644,-0.037748531158365406
10862,40141,Tillman,Oklahoma,2012,906,1815,0,2721,0.33296582138919517,0.6670341786108048,0.0,-136,0,-380,-516,0.011062824787403391,0.0,-0.011062824787403391,-909,244,-0.33406835722160966,0.022125649574806783
10863,40141,Tillman,Oklahoma,2016,657,1944,105,2706,0.24279379157427938,0.7184035476718403,0.038802660753880266,-249,105,129,-15,-0.09017202981491579,0.038802660753880266,0.05136936906103551,-1287,-378,-0.47560975609756095,-0.1415413988759513
10864,40143,Tulsa,Oklahoma,2000,81656,134152,2883,218691,0.37338527877233174,0.6134317370170698,0.013182984210598516,0,0,0,0,0.0,0.0,0.0,-52496,0,-0.24004645824473803,0.0
10865,40143,Tulsa,Oklahoma,2004,90220,163452,0,253672,0.35565612286732473,0.6443438771326753,0.0,8564,-2883,29300,34981,-0.01772915590500701,-0.013182984210598516,0.030912140115605502,-73232,-20736,-0.28868775426535054,-0.04864129602061251
10866,40143,Tulsa,Oklahoma,2008,96133,158363,0,254496,0.3777387463850119,0.6222612536149881,0.0,5913,0,-5089,824,0.022082623517687194,0.0,-0.022082623517687194,-62230,11002,-0.24452250722997615,0.04416524703537439
10867,40143,Tulsa,Oklahoma,2012,82744,145062,0,227806,0.3632213374537984,0.6367786625462016,0.0,-13389,0,-13301,-26690,-0.014517408931213505,0.0,0.01451740893121356,-62318,-88,-0.2735573250924032,-0.029034817862427065
10868,40143,Tulsa,Oklahoma,2016,87847,144258,14949,247054,0.3555781327159245,0.5839128287742761,0.060509038509799475,5103,14949,-804,19248,-0.007643204737873943,0.060509038509799475,-0.05286583377192555,-56411,5907,-0.2283346960583516,0.04522262903405161
10869,40145,Wagoner,Oklahoma,2000,8244,12981,292,21517,0.38313891341729794,0.6032904215271646,0.013570665055537482,0,0,0,0,0.0,0.0,0.0,-4737,0,-0.22015150810986667,0.0
10870,40145,Wagoner,Oklahoma,2004,9157,19081,0,28238,0.32427933989659324,0.6757206601034068,0.0,913,-292,6100,6721,-0.0588595735207047,-0.013570665055537482,0.0724302385762422,-9924,-5187,-0.35144132020681357,-0.1312898120969469
10871,40145,Wagoner,Oklahoma,2008,8810,21441,0,30251,0.29123004198208324,0.7087699580179168,0.0,-347,0,2360,2013,-0.03304929791451,0.0,0.033049297914509945,-12631,-2707,-0.4175399160358335,-0.06609859582901995
10872,40145,Wagoner,Oklahoma,2012,7791,20900,0,28691,0.27154856923774007,0.7284514307622599,0.0,-1019,0,-541,-1560,-0.019681472744343176,0.0,0.019681472744343176,-13109,-478,-0.45690286152451987,-0.03936294548868635
10873,40145,Wagoner,Oklahoma,2016,6723,23005,1572,31300,0.2147923322683706,0.7349840255591055,0.05022364217252396,-1068,1572,2105,2609,-0.05675623696936946,0.05022364217252396,0.006532594796845537,-16282,-3173,-0.5201916932907349,-0.06328883176621503
10874,40147,Washington,Oklahoma,2000,6644,13788,312,20744,0.3202853837254146,0.6646741226378712,0.01504049363671423,0,0,0,0,0.0,0.0,0.0,-7144,0,-0.3443887389124566,0.0
10875,40147,Washington,Oklahoma,2004,6862,16551,0,23413,0.29308503822662624,0.7069149617733738,0.0,218,-312,2763,2669,-0.02720034549878836,-0.01504049363671423,0.042240839135502584,-9689,-2545,-0.4138299235467475,-0.06944118463429094
10876,40147,Washington,Oklahoma,2008,6308,16457,0,22765,0.27709202723479026,0.7229079727652098,0.0,-554,0,-94,-648,-0.015993010991835976,0.0,0.015993010991836032,-10149,-460,-0.44581594553041953,-0.03198602198367201
10877,40147,Washington,Oklahoma,2012,5532,15668,0,21200,0.2609433962264151,0.739056603773585,0.0,-776,0,-789,-1565,-0.01614863100837516,0.0,0.01614863100837516,-10136,13,-0.47811320754716985,-0.03229726201675032
10878,40147,Washington,Oklahoma,2016,5048,15825,1351,22224,0.22714182865370772,0.7120680345572354,0.06079013678905688,-484,1351,157,1024,-0.033801567572707386,0.06079013678905688,-0.02698856921634951,-10777,-641,-0.48492620590352775,-0.006812998356357902
10879,40149,Washita,Oklahoma,2000,1564,2850,54,4468,0.35004476275738583,0.6378692927484333,0.012085944494180842,0,0,0,0,0.0,0.0,0.0,-1286,0,-0.28782452999104746,0.0
10880,40149,Washita,Oklahoma,2004,1340,3705,0,5045,0.26560951437066405,0.734390485629336,0.0,-224,-54,855,577,-0.08443524838672178,-0.012085944494180842,0.09652119288090266,-2365,-1079,-0.4687809712586719,-0.18095644126762445
10881,40149,Washita,Oklahoma,2008,1052,3724,0,4776,0.2202680067001675,0.7797319932998324,0.0,-288,0,19,-269,-0.04534150767049655,0.0,0.045341507670496495,-2672,-307,-0.5594639865996649,-0.09068301534099299
10882,40149,Washita,Oklahoma,2012,822,3494,0,4316,0.19045412418906396,0.8095458758109361,0.0,-230,0,-230,-460,-0.029813882511103534,0.0,0.029813882511103618,-2672,0,-0.6190917516218721,-0.059627765022207235
10883,40149,Washita,Oklahoma,2016,588,3854,189,4631,0.12697041675664003,0.8322176635715828,0.04081191967177716,-234,189,360,315,-0.06348370743242393,0.04081191967177716,0.02267178776064671,-3266,-594,-0.7052472468149428,-0.08615549519307064
10884,40151,Woods,Oklahoma,2000,1235,2774,37,4046,0.3052397429560059,0.6856154226396441,0.009144834404349975,0,0,0,0,0.0,0.0,0.0,-1539,0,-0.3803756796836382,0.0
10885,40151,Woods,Oklahoma,2004,932,3166,0,4098,0.22742801366520254,0.7725719863347975,0.0,-303,-37,392,52,-0.07781172929080338,-0.009144834404349975,0.08695656369515337,-2234,-695,-0.545143972669595,-0.1647682929859568
10886,40151,Woods,Oklahoma,2008,873,3043,0,3916,0.22293156281920326,0.7770684371807968,0.0,-59,0,-123,-182,-0.004496450845999284,0.0,0.004496450845999256,-2170,64,-0.5541368743615935,-0.008992901691998512
10887,40151,Woods,Oklahoma,2012,671,2727,0,3398,0.19746909947027663,0.8025309005297233,0.0,-202,0,-316,-518,-0.02546246334892663,0.0,0.025462463348926545,-2056,114,-0.6050618010594466,-0.05092492669785309
10888,40151,Woods,Oklahoma,2016,522,2947,199,3668,0.14231188658669575,0.8034351145038168,0.05425299890948746,-149,199,220,270,-0.055157212883580886,0.05425299890948746,0.0009042139740934596,-2425,-369,-0.6611232279171211,-0.05606142685767446
10889,40153,Woodward,Oklahoma,2000,1950,5067,83,7100,0.2746478873239437,0.7136619718309859,0.011690140845070423,0,0,0,0,0.0,0.0,0.0,-3117,0,-0.4390140845070422,0.0
10890,40153,Woodward,Oklahoma,2004,1458,6193,0,7651,0.1905633250555483,0.8094366749444517,0.0,-492,-83,1126,551,-0.08408456226839539,-0.011690140845070423,0.09577470311346581,-4735,-1618,-0.6188733498889034,-0.1798592653818612
10891,40153,Woodward,Oklahoma,2008,1350,6404,0,7754,0.17410368841888058,0.8258963115811194,0.0,-108,0,211,103,-0.016459636636667718,0.0,0.016459636636667718,-5054,-319,-0.6517926231622388,-0.032919273273335437
10892,40153,Woodward,Oklahoma,2012,1133,5945,0,7078,0.16007346708109635,0.8399265329189036,0.0,-217,0,-459,-676,-0.014030221337784227,0.0,0.014030221337784199,-4812,242,-0.6798530658378072,-0.028060442675568398
10893,40153,Woodward,Oklahoma,2016,873,6347,375,7595,0.11494404213298222,0.8356813693219223,0.04937458854509546,-260,375,402,517,-0.04512942494811413,0.04937458854509546,-0.0042451635969813495,-5474,-662,-0.72073732718894,-0.04088426135113277
10894,41001,Baker,Oregon,2000,2195,5618,445,8258,0.2658028578348268,0.6803100024218939,0.053887139743279244,0,0,0,0,0.0,0.0,0.0,-3423,0,-0.41450714458706706,0.0
10895,41001,Baker,Oregon,2004,2616,6253,165,9034,0.2895727252601284,0.6921629400044277,0.01826433473544388,421,-280,635,776,0.023769867425301572,-0.035622805007835365,0.011852937582533807,-3637,-214,-0.4025902147442993,0.011916929842767765
10896,41001,Baker,Oregon,2008,2805,5650,322,8777,0.31958527970832856,0.6437279252592002,0.03668679503247123,189,157,-603,-257,0.03001255444820017,0.01842246029702735,-0.04843501474522749,-2845,792,-0.32414264555087163,0.07844756919342766
10897,41001,Baker,Oregon,2012,2369,5702,377,8448,0.2804214015151515,0.6749526515151515,0.04462594696969697,-436,55,52,-329,-0.03916387819317707,0.00793915193722574,0.031224726255951296,-3333,-488,-0.39453125,-0.07038860444912837
10898,41001,Baker,Oregon,2016,1797,6218,764,8779,0.20469301742795307,0.7082811254129172,0.08702585715912974,-572,387,516,331,-0.07572838408719842,0.04239991018943277,0.03332847389776572,-4421,-1088,-0.5035881079849641,-0.10905685798496412
10899,41003,Benton,Oregon,2000,19444,15825,2957,38226,0.5086590278867786,0.41398524564432587,0.07735572646889552,0,0,0,0,0.0,0.0,0.0,3619,0,0.09467378224245276,0.0
10900,41003,Benton,Oregon,2004,26515,18460,760,45735,0.5797529244561058,0.4036296053350825,0.016617470208811633,7071,-2197,2635,7509,0.07109389656932719,-0.06073825626008389,-0.010355640309243352,8055,4436,0.1761233191210233,0.08144953687857054
10901,41003,Benton,Oregon,2008,29901,15264,1313,46478,0.6433366323852145,0.3284134429192306,0.028249924695554887,3386,553,-3196,743,0.06358370792910872,0.011632454486743254,-0.07521616241585194,14637,6582,0.31492318946598397,0.13879987034496066
10902,41003,Benton,Oregon,2012,27776,14991,2035,44802,0.6199723226641668,0.3346055979643766,0.04542207937145663,-2125,722,-273,-1676,-0.02336430972104775,0.017172154675901746,0.0061921550451460305,12785,-1852,0.2853667246997902,-0.02955646476619378
10903,41003,Benton,Oregon,2016,29193,13445,6115,48753,0.5987939203741308,0.27577790084712733,0.12542817877874182,1417,4080,-1546,3951,-0.02117840229003598,0.08000609940728519,-0.05882769711724928,15748,2963,0.3230160195270035,0.0376492948272133
10904,41005,Clackamas,Oregon,2000,76421,77539,8302,162262,0.4709728710357323,0.47786296236950115,0.05116416659476649,0,0,0,0,0.0,0.0,0.0,-1118,0,-0.006890091333768833,0.0
10905,41005,Clackamas,Oregon,2004,95129,97691,2180,195000,0.48784102564102566,0.5009794871794871,0.011179487179487179,18708,-6122,20152,32738,0.01686815460529334,-0.03998467941527931,0.023116524809985994,-2562,-1444,-0.013138461538461488,-0.006248370204692655
10906,41005,Clackamas,Oregon,2008,103476,83595,4807,191878,0.5392801676065,0.4356674553622614,0.0250523770312386,8347,2627,-14096,-3122,0.05143914196547433,0.01387288985175142,-0.06531203181722572,19881,22443,0.10361271224423857,0.11675117378270006
10907,41005,Clackamas,Oregon,2012,95493,88592,5247,189332,0.5043679885069613,0.46791878816048,0.02771322333255868,-7983,440,4997,-2546,-0.0349121790995387,0.0026608463013200814,0.03225133279821857,6901,-12980,0.0364492003464813,-0.06716351189775727
10908,41005,Clackamas,Oregon,2016,102095,88392,23552,214039,0.4769925107106649,0.41297146781661287,0.11003602147272226,6602,18305,-200,24707,-0.0273754777962964,0.08232279814016358,-0.05494732034386712,13703,6802,0.06402104289405203,0.027571842547570724
10909,41007,Clatsop,Oregon,2000,8296,6950,1228,16474,0.5035814009955081,0.4218768969284934,0.07454170207599854,0,0,0,0,0.0,0.0,0.0,1346,0,0.08170450406701468,0.0
10910,41007,Clatsop,Oregon,2004,10461,8503,345,19309,0.541768087420374,0.4403645968201357,0.017867315759490392,2165,-883,1553,2835,0.03818668642486589,-0.056674386316508146,0.018487699891642284,1958,612,0.10140349060023829,0.019698986533223606
10911,41007,Clatsop,Oregon,2008,10701,7192,655,18548,0.5769355186543024,0.3877507008841924,0.03531378046150528,240,310,-1311,-761,0.0351674312339284,0.01744646470201489,-0.05261389593594329,3509,1551,0.18918481777010998,0.08778132716987169
10912,41007,Clatsop,Oregon,2012,9861,7249,708,17818,0.553429116623639,0.40683578403861265,0.039735099337748346,-840,53,57,-730,-0.023506402030663343,0.004421318876243065,0.019085083154420257,2612,-897,0.14659333258502638,-0.0425914851850836
10913,41007,Clatsop,Oregon,2016,9252,8138,2274,19664,0.4705044751830757,0.41385272579332794,0.11564279902359642,-609,1566,889,1846,-0.08292464144056333,0.07590769968584807,0.007016941754715289,1114,-1498,0.05665174938974776,-0.08994158319527862
10914,41009,Columbia,Oregon,2000,10331,9369,1495,21195,0.4874262797829677,0.44203821656050957,0.07053550365652277,0,0,0,0,0.0,0.0,0.0,962,0,0.04538806322245814,0.0
10915,41009,Columbia,Oregon,2004,12563,11868,486,24917,0.504193923827106,0.4763013203836738,0.019504755789220212,2232,-1009,2499,3722,0.01676764404413833,-0.05103074786730255,0.03426310382316422,695,-267,0.02789260344343225,-0.01749545977902589
10916,41009,Columbia,Oregon,2008,13390,10413,965,24768,0.5406169250645995,0.420421511627907,0.03896156330749354,827,479,-1455,-149,0.036423001237493424,0.01945680751827333,-0.05587980875576681,2977,2282,0.12019541343669249,0.09230280999326024
10917,41009,Columbia,Oregon,2012,12004,10772,1099,23875,0.5027853403141361,0.4511832460732984,0.04603141361256544,-1386,134,359,-893,-0.03783158475046333,0.007069850305071901,0.03076173444539143,1232,-1745,0.051602094240837726,-0.06859331919585476
10918,41009,Columbia,Oregon,2016,10167,13217,3234,26618,0.3819595762266136,0.49654369223833494,0.12149673153505147,-1837,2135,2445,2743,-0.12082576408752255,0.07546531792248604,0.04536044616503654,-3050,-4282,-0.11458411601172136,-0.16618621025255909
10919,41011,Coos,Oregon,2000,11610,15626,2143,29379,0.3951802307770857,0.531876510432622,0.07294325879029238,0,0,0,0,0.0,0.0,0.0,-4016,0,-0.13669627965553627,0.0
10920,41011,Coos,Oregon,2004,14393,18291,678,33362,0.4314189796774774,0.5482584976919849,0.02032252263053774,2783,-1465,2665,3983,0.03623874890039169,-0.05262073615975464,0.016381987259362907,-3898,118,-0.11683951801450748,0.019856761641028786
10921,41011,Coos,Oregon,2008,14401,15354,1196,30951,0.4652838357403638,0.49607444024425706,0.038641724015379145,8,518,-2937,-2411,0.03386485606288642,0.018319201384841406,-0.052184057447727805,-953,2945,-0.03079060450389326,0.08604891351061422
10922,41011,Coos,Oregon,2012,12845,14673,1168,28686,0.44777940458760374,0.5115038694833717,0.04071672592902461,-1556,-28,-681,-2265,-0.01750443115276007,0.0020750019136454648,0.015429429239114612,-1828,-875,-0.06372446489576794,-0.03293386039187468
10923,41011,Coos,Oregon,2016,10448,17865,3000,31313,0.3336633347172101,0.5705298118992111,0.09580685338357871,-2397,1832,3192,2627,-0.11411606987039363,0.0550901274545541,0.05902594241583947,-7417,-5589,-0.23686647718200105,-0.1731420122862331
10924,41013,Crook,Oregon,2000,2474,5363,440,8277,0.29890056783858887,0.6479400749063671,0.0531593572550441,0,0,0,0,0.0,0.0,0.0,-2889,0,-0.3490395070677782,0.0
10925,41013,Crook,Oregon,2004,3024,6830,197,10051,0.3008655855138792,0.6795343746890856,0.01960003979703512,550,-243,1467,1774,0.001965017675290337,-0.03355931745800898,0.03159429978271855,-3806,-917,-0.3786687891752064,-0.029629282107428212
10926,41013,Crook,Oregon,2008,3632,6371,349,10352,0.3508500772797527,0.6154366306027821,0.033713292117465224,608,152,-459,301,0.049984491765873496,0.014113252320430102,-0.06409774408630353,-2739,1067,-0.2645865533230294,0.11408223585217703
10927,41013,Crook,Oregon,2012,3104,6790,336,10230,0.30342130987292276,0.6637341153470185,0.03284457478005865,-528,-13,419,-122,-0.04742876740682994,-0.0008687173374065729,0.04829748474423645,-3686,-947,-0.3603128054740958,-0.0957262521510664
10928,41013,Crook,Oregon,2016,2637,8511,1024,12172,0.21664475846204403,0.6992277357870522,0.08412750575090372,-467,688,1721,1942,-0.08677655141087873,0.05128293097084507,0.03549362044003368,-5874,-2188,-0.4825829773250082,-0.12227017185091243
10929,41015,Curry,Oregon,2000,4090,6551,872,11513,0.3552505862937549,0.5690089464084079,0.07574046729783723,0,0,0,0,0.0,0.0,0.0,-2461,0,-0.21375836011465305,0.0
10930,41015,Curry,Oregon,2004,5220,7332,247,12799,0.40784436284084696,0.5728572544730057,0.019298382686147354,1130,-625,781,1286,0.052593776547092075,-0.05644208461168988,0.003848308064597794,-2112,349,-0.16501289163215876,0.04874546848249428
10931,41015,Curry,Oregon,2008,5230,6646,456,12332,0.42409990269218295,0.5389231268245216,0.03697697048329549,10,209,-686,-467,0.016255539851335987,0.017678587797148138,-0.033934127648484136,-1416,696,-0.11482322413233864,0.05018966749982012
10932,41015,Curry,Oregon,2012,4625,6598,455,11678,0.39604384312382257,0.5649940058229149,0.03896215105326255,-605,-1,-48,-654,-0.02805605956836038,0.0019851805699670558,0.026070878998393332,-1973,-557,-0.16895016269909235,-0.05412693856675371
10933,41015,Curry,Oregon,2016,4300,7212,1099,12611,0.34097216715565776,0.5718816905875823,0.08714614225675997,-325,644,614,933,-0.05507167596816481,0.04818399120349742,0.00688768476466739,-2912,-939,-0.23090952343192456,-0.0619593607328322
10934,41017,Deschutes,Oregon,2000,22061,32132,3692,57885,0.3811177334369871,0.5551006305605943,0.06378163600241858,0,0,0,0,0.0,0.0,0.0,-10071,0,-0.1739828971236072,0.0
10935,41017,Deschutes,Oregon,2004,31179,41757,1112,74048,0.42106471477960244,0.5639179991356957,0.015017286084701814,9118,-2580,9625,16163,0.03994698134261532,-0.04876434991771677,0.008817368575101403,-10578,-507,-0.1428532843560933,0.031129612767513914
10936,41017,Deschutes,Oregon,2008,38819,39064,1899,79782,0.4865633852247374,0.4896342533403525,0.02380236143491013,7640,787,-2693,5734,0.06549867044513497,0.008785075350208315,-0.07428374579534325,-245,10333,-0.0030708681156150774,0.1397824162404782
10937,41017,Deschutes,Oregon,2012,36961,42463,2476,81900,0.4512942612942613,0.5184737484737485,0.030231990231990233,-1858,577,3399,2118,-0.0352691239304761,0.006429628797080103,0.02883949513339601,-5502,-5257,-0.06717948717948719,-0.06410861906387211
10938,41017,Deschutes,Oregon,2016,42444,45692,10421,98557,0.4306543421573303,0.46360989072313485,0.10573576711953489,5483,7945,3229,16657,-0.02063991913693103,0.07550377688754466,-0.05486385775061364,-3248,2254,-0.03295554856580457,0.034223938613682614
10939,41019,Douglas,Oregon,2000,14193,30294,2733,47220,0.300571791613723,0.6415501905972045,0.05787801778907243,0,0,0,0,0.0,0.0,0.0,-16101,0,-0.34097839898348153,0.0
10940,41019,Douglas,Oregon,2004,18089,35956,939,54984,0.3289866142877928,0.6539356903826568,0.017077695329550415,3896,-1794,5662,7764,0.028414822674069806,-0.04080032245952202,0.012385499785452225,-17867,-1766,-0.32494907609486395,0.01602932288861758
10941,41019,Douglas,Oregon,2008,20298,30919,1720,52937,0.38343691557889564,0.5840716323176606,0.032491452103443716,2209,781,-5037,-2047,0.05445030129110284,0.0154137567738933,-0.06986405806499618,-10621,7246,-0.20063471673876493,0.12431435935609902
10942,41019,Douglas,Oregon,2012,17145,30776,1882,49803,0.3442563700981869,0.617954741682228,0.03778888821958516,-3153,162,-143,-3134,-0.03918054548070876,0.005297436116141446,0.0338831093645674,-13631,-3010,-0.2736983715840411,-0.07306365484527616
10943,41019,Douglas,Oregon,2016,14096,34582,4843,53521,0.26337325535771006,0.6461388987500234,0.09048784589226659,-3049,2961,3806,3718,-0.08088311474047682,0.05269895767268143,0.028184157067795423,-20486,-6855,-0.38276564339231334,-0.10906727180827225
10944,41021,Gilliam,Oregon,2000,359,679,52,1090,0.3293577981651376,0.6229357798165137,0.047706422018348627,0,0,0,0,0.0,0.0,0.0,-320,0,-0.2935779816513761,0.0
10945,41021,Gilliam,Oregon,2004,370,755,13,1138,0.3251318101933216,0.663444639718805,0.011423550087873463,11,-39,76,48,-0.004225987971816003,-0.03628287193047516,0.04050885990229125,-385,-65,-0.33831282952548336,-0.04473484787410725
10946,41021,Gilliam,Oregon,2008,430,648,32,1110,0.38738738738738737,0.5837837837837838,0.02882882882882883,60,19,-107,-28,0.06225557719406577,0.017405278740955366,-0.07966085593502115,-218,167,-0.19639639639639644,0.14191643312908692
10947,41021,Gilliam,Oregon,2012,371,639,51,1061,0.34967012252591895,0.6022620169651273,0.04806786050895382,-59,19,-9,-49,-0.037717264861468425,0.01923903168012499,0.01847823318134345,-268,-50,-0.2525918944392083,-0.056195498042811876
10948,41021,Gilliam,Oregon,2016,239,671,109,1019,0.23454367026496564,0.6584887144259077,0.1069676153091266,-132,58,32,-42,-0.1151264522609533,0.05889975480017278,0.05622669746078046,-432,-164,-0.4239450441609421,-0.17135314972173377
10949,41023,Grant,Oregon,2000,589,3078,179,3846,0.15314612584503381,0.8003120124804992,0.04654186167446698,0,0,0,0,0.0,0.0,0.0,-2489,0,-0.6471658866354654,0.0
10950,41023,Grant,Oregon,2004,780,3204,77,4061,0.19207091849298202,0.7889682344250185,0.018960847081999507,191,-102,126,215,0.03892479264794821,-0.027581014592467472,-0.011343778055480702,-2424,65,-0.5968973159320365,0.05026857070342883
10951,41023,Grant,Oregon,2008,1006,2785,118,3909,0.2573548222051676,0.7124584292657968,0.030186748529035558,226,41,-419,-152,0.06528390371218556,0.01122590144703605,-0.07650980515922168,-1779,645,-0.45510360706062924,0.1417937088714073
10952,41023,Grant,Oregon,2012,853,2926,132,3911,0.21810278701099464,0.7481462541549476,0.033750958834057786,-153,14,141,2,-0.039252035194172946,0.003564210305022228,0.03568782488915079,-2073,-294,-0.530043467143953,-0.07493986008332376
10953,41023,Grant,Oregon,2016,739,3210,391,4340,0.17027649769585254,0.7396313364055299,0.09009216589861752,-114,259,284,429,-0.0478262893151421,0.05634120706455973,-0.008514917749417705,-2471,-398,-0.5693548387096774,-0.039311371565724396
10954,41025,Harney,Oregon,2000,766,2799,169,3734,0.2051419389394751,0.7495982860203535,0.045259775040171396,0,0,0,0,0.0,0.0,0.0,-2033,0,-0.5444563470808784,0.0
10955,41025,Harney,Oregon,2004,839,2815,48,3702,0.22663425175580768,0.7603997839005943,0.012965964343598054,73,-121,16,-32,0.02149231281633257,-0.03229381069657334,0.010801497880240762,-1976,57,-0.5337655321447866,0.010690814936091808
10956,41025,Harney,Oregon,2008,950,2595,138,3683,0.25794189519413524,0.7045886505566115,0.037469454249253326,111,90,-220,-19,0.031307643438327565,0.02450348990565527,-0.0558111333439828,-1645,331,-0.4466467553624762,0.08711877678231039
10957,41025,Harney,Oregon,2012,832,2607,144,3583,0.2322076472229975,0.7276025676807145,0.040189785096288025,-118,6,12,-100,-0.02573424797113774,0.0027203308470346993,0.023013917124103056,-1775,-130,-0.49539492045771705,-0.048748165095240825
10958,41025,Harney,Oregon,2016,683,2912,379,3974,0.17186713638651233,0.7327629592350277,0.09536990437845999,-149,235,305,391,-0.06034051083648517,0.055180119282171966,0.005160391554313137,-2229,-454,-0.5608958228485154,-0.06550090239079831
10959,41027,Hood River,Oregon,2000,4072,3721,756,8549,0.4763130190665575,0.4352555854485905,0.08843139548485203,0,0,0,0,0.0,0.0,0.0,351,0,0.04105743361796699,0.0
10960,41027,Hood River,Oregon,2004,5587,4124,148,9859,0.5666903337052439,0.41829800182574295,0.015011664469013085,1515,-608,403,1310,0.09037731463868642,-0.07341973101583894,-0.01695758362284755,1463,1112,0.14839233187950096,0.10733489826153397
10961,41027,Hood River,Oregon,2008,6302,3265,263,9830,0.6410986775178027,0.33214649033570703,0.026754832146490336,715,115,-859,-29,0.07440834381255879,0.011743167677477252,-0.08615151149003591,3037,1574,0.30895218718209566,0.1605598553025947
10962,41027,Hood River,Oregon,2012,6058,3429,351,9838,0.6157755641390527,0.34854645253100225,0.03567798332994511,-244,88,164,8,-0.02532311337875004,0.008923151183454773,0.016399962195295215,2629,-408,0.2672291116080504,-0.041723075574045254
10963,41027,Hood River,Oregon,2016,6510,3272,1128,10910,0.5967002749770852,0.2999083409715857,0.10339138405132905,452,777,-157,1072,-0.019075289161967435,0.06771340072138395,-0.04863811155941655,3238,609,0.2967919340054995,0.029562822397449118
10964,41029,Jackson,Oregon,2000,33153,46052,5591,84796,0.390973630831643,0.5430916552667578,0.06593471390159913,0,0,0,0,0.0,0.0,0.0,-12899,0,-0.15211802443511485,0.0
10965,41029,Jackson,Oregon,2004,44366,56519,1304,102189,0.4341563181947176,0.5530830128487411,0.01276066895654131,11213,-4287,10467,17393,0.04318268736307462,-0.05317404494505783,0.009991357581983218,-12153,746,-0.11892669465402345,0.033191329781091405
10966,41029,Jackson,Oregon,2008,49090,49043,2914,101047,0.4858135323166447,0.4853484022286659,0.0288380654546894,4724,1610,-7476,-1142,0.051657214121927086,0.01607739649814809,-0.06773461062007519,47,12200,0.0004651300879788267,0.11939182474200227
10967,41029,Jackson,Oregon,2012,44468,49020,3639,97127,0.4578335581249292,0.5047000319169747,0.0374664099580961,-4622,725,-23,-3920,-0.027979974191715495,0.008628344503406701,0.01935162968830878,-4552,-4599,-0.04686647379204545,-0.047331603880024276
10968,41029,Jackson,Oregon,2016,44447,53870,11010,109327,0.40655098923413246,0.49274195761339834,0.1007070531524692,-21,7371,4850,12200,-0.05128256889079674,0.06324064319437309,-0.011958074303576316,-9423,-4871,-0.08619096837926588,-0.03932449458722043
10969,41031,Jefferson,Oregon,2000,2681,3838,378,6897,0.3887197332173409,0.5564738292011019,0.0548064375815572,0,0,0,0,0.0,0.0,0.0,-1157,0,-0.167754095983761,0.0
10970,41031,Jefferson,Oregon,2004,3243,4762,110,8115,0.399630314232902,0.5868145409735058,0.013555144793592114,562,-268,924,1218,0.010910581015561138,-0.041251292787965084,0.03034071177240394,-1519,-362,-0.1871842267406038,-0.0194301307568428
10971,41031,Jefferson,Oregon,2008,3682,4402,234,8318,0.4426544842510219,0.5292137533060832,0.028131762442894927,439,124,-360,203,0.04302417001811987,0.014576617649302813,-0.057600787667422604,-720,799,-0.08655926905506134,0.10062495768554247
10972,41031,Jefferson,Oregon,2012,3301,4642,232,8175,0.4037920489296636,0.56782874617737,0.028379204892966362,-381,-2,240,-143,-0.0388624353213583,0.0002474424500714355,0.03861499287128678,-1341,-621,-0.16403669724770642,-0.07747742819264508
10973,41031,Jefferson,Oregon,2016,2980,5483,996,9459,0.3150438735595729,0.5796595834654826,0.1052965429749445,-321,764,841,1284,-0.08874817537009067,0.07691733808197813,0.011830837288112628,-2503,-1162,-0.2646157099059097,-0.10057901265820329
10974,41033,Josephine,Oregon,2000,11864,22186,2683,36733,0.322979337380557,0.6039800724144502,0.07304059020499279,0,0,0,0,0.0,0.0,0.0,-10322,0,-0.28100073503389317,0.0
10975,41033,Josephine,Oregon,2004,15214,26241,820,42275,0.3598817267888823,0.6207214665878179,0.019396806623299824,3350,-1863,4055,5542,0.0369023894083253,-0.053643783581692965,0.01674139417336773,-11027,-705,-0.2608397397989356,0.02016099523495757
10976,41033,Josephine,Oregon,2008,17412,22973,1664,42049,0.41408832552498276,0.5463387952151062,0.039572879259911056,2198,844,-3268,-226,0.05420659873610045,0.020176072636611232,-0.0743826713727117,-5561,5466,-0.13225046969012344,0.12858927010881216
10977,41033,Josephine,Oregon,2012,14953,23673,1612,40238,0.37161389731099953,0.5883244694070282,0.040061633281972264,-2459,-52,700,-1811,-0.04247442821398323,0.000488754022061208,0.04198567419192201,-8720,-3159,-0.21671057209602868,-0.08446010240590524
10978,41033,Josephine,Oregon,2016,13453,26923,4184,44560,0.3019075403949731,0.6041965888689408,0.09389587073608617,-1500,2572,3250,4322,-0.06970635691602645,0.053834237454113906,0.01587211946191258,-13470,-4750,-0.3022890484739677,-0.08557847637793903
10979,41035,Klamath,Oregon,2000,7541,18855,1448,27844,0.2708303404683235,0.6771656371211033,0.05200402241057319,0,0,0,0,0.0,0.0,0.0,-11314,0,-0.40633529665277984,0.0
10980,41035,Klamath,Oregon,2004,8264,22733,518,31515,0.26222433761700775,0.7213390448992544,0.0164366174837379,723,-930,3878,3671,-0.008606002851315742,-0.035567404926835286,0.04417340777815104,-14469,-3155,-0.4591147072822466,-0.05277941062946678
10981,41035,Klamath,Oregon,2008,9370,19113,916,29399,0.3187183237525086,0.6501241538827851,0.031157522364706283,1106,398,-3620,-2116,0.05649398613550083,0.014720904880968382,-0.07121489101646927,-9743,4726,-0.3314058301302765,0.1277088771519701
10982,41035,Klamath,Oregon,2012,8302,18898,952,28152,0.29489911906791705,0.67128445581131,0.033816425120772944,-1068,36,-215,-1247,-0.023819204684591533,0.002658902756066662,0.021160301928524916,-10596,-853,-0.376385336743393,-0.04497950661311645
10983,41035,Klamath,Oregon,2016,7210,20435,2862,30507,0.23633920083915166,0.6698462647916872,0.09381453436916118,-1092,1910,1537,2355,-0.058559918228765384,0.059998109248388234,-0.0014381910196228365,-13225,-2629,-0.4335070639525355,-0.05712172720914255
10984,41037,Lake,Oregon,2000,707,2830,192,3729,0.1895950657012604,0.7589165996245643,0.05148833467417538,0,0,0,0,0.0,0.0,0.0,-2123,0,-0.5693215339233039,0.0
10985,41037,Lake,Oregon,2004,802,3039,64,3905,0.20537772087067863,0.7782330345710627,0.01638924455825864,95,-128,209,176,0.015782655169418236,-0.035099090115916734,0.019316434946498484,-2237,-114,-0.5728553137003841,-0.003533779777080248
10986,41037,Lake,Oregon,2008,957,2638,93,3688,0.25949023861171366,0.71529284164859,0.025216919739696312,155,29,-401,-217,0.05411251774103504,0.00882767518143767,-0.06294019292247277,-1681,556,-0.4558026030368763,0.11705271066350781
10987,41037,Lake,Oregon,2012,770,2808,132,3710,0.20754716981132076,0.7568733153638814,0.03557951482479784,-187,39,170,22,-0.0519430688003929,0.010362595085101529,0.04158047371529139,-2038,-357,-0.5493261455525607,-0.09352354251568434
10988,41037,Lake,Oregon,2016,639,3022,269,3930,0.16259541984732825,0.7689567430025446,0.06844783715012723,-131,137,214,220,-0.04495174996399251,0.03286832232532939,0.012083427638663213,-2383,-345,-0.6063613231552163,-0.05703517760265564
10989,41039,Lane,Oregon,2000,78583,61578,12027,152188,0.5163547717297028,0.4046179725076879,0.07902725576260941,0,0,0,0,0.0,0.0,0.0,17005,0,0.1117367992220149,0.0
10990,41039,Lane,Oregon,2004,107769,75007,3096,185872,0.5798022294912628,0.4035411465955066,0.01665662391323061,29186,-8931,13429,33684,0.06344745776156002,-0.0623706318493788,-0.0010768259121812784,32762,15757,0.1762610828957562,0.0645242836737413
10991,41039,Lane,Oregon,2008,114037,63835,5038,182910,0.6234596249521622,0.3489967743699087,0.027543600677929037,6268,1942,-11172,-2962,0.04365739546089942,0.010886976764698426,-0.05454437222559788,50202,17440,0.2744628505822535,0.0982017676864973
10992,41039,Lane,Oregon,2012,102652,62509,6689,171850,0.5973348850741926,0.3637416351469305,0.038923479778876925,-11385,1651,-1326,-11060,-0.026124739877969594,0.011379879100947888,0.014744860777021751,40143,-10059,0.23359324992726216,-0.040869600654991345
10993,41039,Lane,Oregon,2016,102753,67141,22056,191950,0.5353112789789007,0.3497837978640271,0.11490492315707215,101,15367,4632,20100,-0.062023606095291894,0.07598144337819523,-0.013957837282903396,35612,-4531,0.18552748111487366,-0.0480657688123885
10994,41041,Lincoln,Oregon,2000,10861,8446,1811,21118,0.5143005966474098,0.3999431764371626,0.0857562269154276,0,0,0,0,0.0,0.0,0.0,2415,0,0.1143574202102472,0.0
10995,41041,Lincoln,Oregon,2004,13753,10160,412,24325,0.5653854059609456,0.41767728674203497,0.016937307297019526,2892,-1399,1714,3207,0.05108480931353576,-0.06881891961840808,0.017734110304872375,3593,1178,0.14770811921891058,0.03335069900866339
10996,41041,Lincoln,Oregon,2008,14258,8791,840,23889,0.5968437356105321,0.36799363723889655,0.03516262715057139,505,428,-1369,-436,0.0314583296495865,0.018225319853551865,-0.049683649503138416,5467,1874,0.2288500983716355,0.08114197915272492
10997,41041,Lincoln,Oregon,2012,13401,8686,897,22984,0.5830577793247477,0.3779150713539854,0.03902714932126697,-857,57,-105,-905,-0.013785956285784384,0.003864522170695578,0.009921434115088834,4715,-752,0.20514270797076228,-0.02370739040087322
10998,41041,Lincoln,Oregon,2016,12501,10039,2716,25256,0.49497149192271145,0.39748970541653467,0.10753880266075388,-900,1819,1353,2272,-0.08808628740203622,0.06851165333948692,0.01957463406254928,2462,-2253,0.09748178650617678,-0.1076609214645855
10999,41043,Linn,Oregon,2000,16682,25359,2347,44388,0.3758222943137785,0.5713030548796972,0.05287465080652429,0,0,0,0,0.0,0.0,0.0,-8677,0,-0.19548076056591873,0.0
11000,41043,Linn,Oregon,2004,19940,31260,841,52041,0.38315943198631847,0.6006802328932956,0.01616033512038585,3258,-1506,5901,7653,0.007337137672539962,-0.036714315686138435,0.029377178013598404,-11320,-2643,-0.21752080090697717,-0.022040040341058442
11001,41043,Linn,Oregon,2008,22163,28071,1748,51982,0.4263591243122619,0.5400138509484053,0.03362702473933284,2223,907,-3189,-59,0.04319969232594345,0.017466689618946995,-0.06066638194489038,-5908,5412,-0.11365472663614334,0.10386607427083383
11002,41043,Linn,Oregon,2012,20378,28944,2104,51426,0.3962587018239801,0.5628281414070704,0.040913156768949556,-1785,356,873,-556,-0.03010042248828182,0.007286132029616713,0.02281429045866512,-8566,-2658,-0.16656943958309028,-0.05291471294694694
11003,41043,Linn,Oregon,2016,17995,33488,7236,58719,0.3064595786712989,0.5703094398746573,0.12323098145404383,-2383,5132,4544,7293,-0.08979912315268118,0.08231782468509427,0.007481298467586939,-15493,-6927,-0.2638498612033584,-0.09728042162026812
11004,41045,Malheur,Oregon,2000,2336,7624,444,10404,0.2245290272971934,0.73279507881584,0.04267589388696655,0,0,0,0,0.0,0.0,0.0,-5288,0,-0.5082660515186467,0.0
11005,41045,Malheur,Oregon,2004,2577,8123,146,10846,0.23759911488106214,0.7489397012723584,0.013461183846579385,241,-298,499,442,0.01307008758386874,-0.029214710040387164,0.016144622456518376,-5546,-258,-0.5113405863912963,-0.003074534872649637
11006,41045,Malheur,Oregon,2008,2949,7157,327,10433,0.282660787884597,0.685996357711109,0.03134285440429407,372,181,-966,-413,0.045061673003534836,0.017881670557714682,-0.06294334356124942,-4208,1338,-0.40333556982651203,0.10800501656478428
11007,41045,Malheur,Oregon,2012,2759,6851,346,9956,0.2771193250301326,0.6881277621534753,0.034752912816392124,-190,19,-306,-477,-0.005541462854464385,0.0034100584120980576,0.002131404442366258,-4092,116,-0.4110084371233427,-0.007672867296830643
11008,41045,Malheur,Oregon,2016,2246,7194,995,10435,0.2152371825586967,0.68941063727839,0.09535218016291327,-513,649,343,479,-0.06188214247143589,0.06059926734652115,0.0012828751249147619,-4948,-856,-0.4741734547196933,-0.06316501759635063
11009,41047,Marion,Oregon,2000,49430,57443,6461,113334,0.4361444932676867,0.5068470185469497,0.057008488185363616,0,0,0,0,0.0,0.0,0.0,-8013,0,-0.07070252527926302,0.0
11010,41047,Marion,Oregon,2004,57671,69900,2048,129619,0.4449270554471181,0.5392727917974989,0.015800152755383084,8241,-4413,12457,16285,0.008782562179431408,-0.041208335429980536,0.032425773250549184,-12229,-4216,-0.0943457363503808,-0.023643211071117776
11011,41047,Marion,Oregon,2008,61816,59059,3688,124563,0.4962629352215345,0.47412955693103087,0.02960750784743463,4145,1640,-10841,-5056,0.05133587977441639,0.013807355092051547,-0.065143234866468,2757,14986,0.022133378290503603,0.1164791146408844
11012,41047,Marion,Oregon,2012,56376,60190,3810,120376,0.4683325579849804,0.500016614607563,0.03165082740745664,-5440,122,1131,-4187,-0.02793037723655406,0.0020433195600220062,0.0258870576765321,-3814,-6571,-0.03168405662258256,-0.05381743491308616
11013,41047,Marion,Oregon,2016,57788,63377,15675,136840,0.4223034200526162,0.463146740719088,0.11454983922829581,1412,11865,3187,16464,-0.04602913793236424,0.08289901182083917,-0.03686987388847496,-5589,-1775,-0.04084332066647184,-0.009159264043889281
11014,41049,Morrow,Oregon,2000,1197,2224,188,3609,0.3316708229426434,0.6162371848157384,0.052091992241618174,0,0,0,0,0.0,0.0,0.0,-1027,0,-0.28456636187309503,0.0
11015,41049,Morrow,Oregon,2004,1361,2732,56,4149,0.3280308508074235,0.658471920944806,0.013497228247770547,164,-132,508,540,-0.003639972135219882,-0.038594763993847626,0.042234736129067585,-1371,-344,-0.3304410701373825,-0.04587470826428747
11016,41049,Morrow,Oregon,2008,1410,2509,139,4058,0.34746180384425823,0.61828486939379,0.034253326761951704,49,83,-223,-91,0.01943095303683473,0.020756098514181157,-0.040187051551015984,-1099,272,-0.2708230655495318,0.059618004587850715
11017,41049,Morrow,Oregon,2012,1202,2532,148,3882,0.30963420917053064,0.652241112828439,0.0381246780010304,-208,9,23,-176,-0.037827594673727594,0.0038713512390786964,0.03395624343464898,-1330,-231,-0.34260690365790836,-0.07178383810837657
11018,41049,Morrow,Oregon,2016,1017,2721,429,4167,0.24406047516198703,0.6529877609791217,0.1029517638588913,-185,281,189,285,-0.0655737340085436,0.0648270858578609,0.000746648150682705,-1704,-374,-0.40892728581713467,-0.06632038215922631
11019,41051,Multnomah,Oregon,2000,188441,83677,24567,296685,0.6351551308626995,0.2820398739403745,0.08280499519692604,0,0,0,0,0.0,0.0,0.0,104764,0,0.353115256922325,0.0
11020,41051,Multnomah,Oregon,2004,259585,98439,4670,362694,0.7157135215912036,0.27141061059736304,0.01287586781143333,71144,-19897,14762,66009,0.08055839072850413,-0.0699291273854927,-0.010629263343011452,161146,56382,0.44430291099384056,0.09118765407151558
11021,41051,Multnomah,Oregon,2008,279696,75171,9843,364710,0.7668997285514518,0.20611170519042527,0.026988566258122893,20111,5173,-23268,2016,0.051186206960248226,0.014112698446689564,-0.06529890540693778,204525,43379,0.5607880233610265,0.11648511236718595
11022,41051,Multnomah,Oregon,2012,274887,75302,14533,364722,0.7536891111586359,0.20646410142519508,0.039846787416169024,-4809,4690,131,12,-0.013210617392815927,0.012858221158046131,0.0003523962347698195,199585,-4940,0.5472250097334408,-0.013563013627585718
11023,41051,Multnomah,Oregon,2016,292561,67954,38588,399103,0.7330463564543489,0.17026682335136545,0.09668682019428569,17674,24055,-7348,34381,-0.020642754704287003,0.05684003277811667,-0.036197278073829636,224607,25022,0.5627795331029835,0.015554523369542661
11024,41053,Polk,Oregon,2000,11921,14988,1540,28449,0.41903054588913496,0.5268374986818517,0.05413195542901332,0,0,0,0,0.0,0.0,0.0,-3067,0,-0.10780695279271674,0.0
11025,41053,Polk,Oregon,2004,15484,19508,497,35489,0.4363042069373609,0.5496914536898757,0.01400433937276339,3563,-1043,4520,7040,0.01727366104822592,-0.040127616056249926,0.022853955008024007,-4024,-957,-0.11338724675251483,-0.005580293959798088
11026,41053,Polk,Oregon,2008,17536,17714,957,36207,0.4843262352583754,0.48924241168834753,0.02643135305327699,2052,460,-1794,718,0.04802202832101454,0.012427013680513601,-0.060449042001528175,-178,3846,-0.004916176429972108,0.10847107032254272
11027,41053,Polk,Oregon,2012,16292,17819,1146,35257,0.462092634086848,0.5054031823467681,0.03250418356638398,-1244,189,105,-950,-0.02223360117152745,0.006072830513106989,0.01616077065842053,-1527,-1349,-0.04331054825992009,-0.03839437182994798
11028,41053,Polk,Oregon,2016,16420,18940,4935,40295,0.4074947263928527,0.47003350291599455,0.12247177069115275,128,3789,1121,5038,-0.05459790769399525,0.08996758712476877,-0.035369679430773515,-2520,-993,-0.06253877652314183,-0.019228228263221736
11029,41055,Sherman,Oregon,2000,326,679,57,1062,0.3069679849340866,0.6393596986817326,0.05367231638418079,0,0,0,0,0.0,0.0,0.0,-353,0,-0.332391713747646,0.0
11030,41055,Sherman,Oregon,2004,390,694,20,1104,0.3532608695652174,0.6286231884057971,0.018115942028985508,64,-37,15,42,0.04629288463113079,-0.03555637435519528,-0.010736510275935474,-304,49,-0.2753623188405797,0.057029394907066266
11031,41055,Sherman,Oregon,2008,385,634,28,1047,0.36771728748806115,0.6055396370582617,0.026743075453677174,-5,8,-60,-57,0.014456417922843745,0.008627133424691666,-0.02308355134753537,-249,55,-0.2378223495702006,0.037539969270379114
11032,41055,Sherman,Oregon,2012,319,678,29,1026,0.310916179337232,0.6608187134502924,0.028265107212475632,-66,1,44,-21,-0.05680110815082917,0.0015220317587984582,0.05527907639203067,-359,-110,-0.34990253411306044,-0.11208018454285984
11033,41055,Sherman,Oregon,2016,202,732,83,1017,0.19862340216322516,0.7197640117994101,0.08161258603736479,-117,54,54,-9,-0.11229277717400682,0.05334747882488916,0.05894529834911766,-530,-171,-0.5211406096361849,-0.17123807552312448
11034,41057,Tillamook,Oregon,2000,5762,5775,839,12376,0.4655785391079509,0.4666289592760181,0.06779250161603102,0,0,0,0,0.0,0.0,0.0,-13,0,-0.0010504201680672232,0.0
11035,41057,Tillamook,Oregon,2004,6750,7003,198,13951,0.4838362841373378,0.5019711848613002,0.01419253100136191,988,-641,1228,1575,0.01825774502938693,-0.05359997061466911,0.035342225585282105,-253,-240,-0.0181349007239624,-0.017084480555895176
11036,41057,Tillamook,Oregon,2008,7072,5757,468,13297,0.5318492893133789,0.4329548018350004,0.03519590885162067,322,270,-1246,-654,0.048013005176041124,0.021003377850258756,-0.06901638302629981,1315,1568,0.09889448747837853,0.11702938820234093
11037,41057,Tillamook,Oregon,2012,6293,5684,542,12519,0.5026759325824747,0.4540298745906223,0.04329419282690311,-779,74,-73,-778,-0.029173356730904265,0.008098283975282443,0.02107507275562187,609,-706,0.0486460579918524,-0.050248429486526136
11038,41057,Tillamook,Oregon,2016,5768,6538,1497,13803,0.4178801709773238,0.4736651452582772,0.10845468376439904,-525,955,854,1284,-0.0847957616051509,0.06516049093749593,0.019635270667654914,-770,-1379,-0.055784974280953414,-0.10443103227280581
11039,41059,Umatilla,Oregon,2000,7809,14140,1111,23060,0.3386383347788378,0.6131830008673027,0.0481786643538595,0,0,0,0,0.0,0.0,0.0,-6331,0,-0.2745446660884649,0.0
11040,41059,Umatilla,Oregon,2004,8884,17068,370,26322,0.3375123470860877,0.6484309702910113,0.014056682622900996,1075,-741,2928,3262,-0.00112598769275013,-0.034121981730958505,0.03524796942370856,-8184,-1853,-0.3109186232049236,-0.03637395711645869
11041,41059,Umatilla,Oregon,2008,9484,15254,785,25523,0.37158641225561256,0.597657015241155,0.03075657250323238,600,415,-1814,-799,0.03407406516952488,0.016699889880331383,-0.05077395504985627,-5770,2414,-0.22607060298554243,0.08484802021938115
11042,41059,Umatilla,Oregon,2012,8584,15499,886,24969,0.3437862950058072,0.6207297048339941,0.03548400016019865,-900,101,245,-554,-0.027800117249805356,0.004727427656966269,0.023072689592839146,-6915,-1145,-0.27694340982818694,-0.0508728068426445
11043,41059,Umatilla,Oregon,2016,7673,17059,2865,27597,0.2780374678407073,0.6181469000253651,0.1038156321339276,-911,1979,1560,2628,-0.06574882716509989,0.06833163197372895,-0.0025828048086290467,-9386,-2471,-0.3401094321846578,-0.06316602235647084
11044,41061,Union,Oregon,2000,3577,7836,663,12076,0.2962073534282875,0.6488903610467042,0.05490228552500828,0,0,0,0,0.0,0.0,0.0,-4259,0,-0.35268300761841664,0.0
11045,41061,Union,Oregon,2004,4428,8879,212,13519,0.32753901915822176,0.6567793475848805,0.015681633256897698,851,-451,1043,1443,0.03133166572993423,-0.039220652268110584,0.007888986538176379,-4451,-192,-0.3292403284266588,0.023442679191757854
11046,41061,Union,Oregon,2008,4613,7581,400,12594,0.36628553279339365,0.6019533111005241,0.03176115610608226,185,188,-1298,-925,0.0387465136351719,0.016079522849184562,-0.054826036484356466,-2968,1483,-0.23566777830713043,0.09357255011952836
11047,41061,Union,Oregon,2012,3973,7636,461,12070,0.3291632145816073,0.6326429163214582,0.03819386909693455,-640,61,55,-524,-0.037122318211786354,0.006432712990852289,0.030689605220934113,-3663,-695,-0.3034797017398509,-0.06781192343272047
11048,41061,Union,Oregon,2016,3249,8431,1288,12968,0.2505397902529303,0.6501388032078964,0.09932140653917335,-724,827,795,898,-0.07862342432867703,0.0611275374422388,0.017495886886438217,-5182,-1519,-0.39959901295496614,-0.09611931121511524
11049,41063,Wallowa,Oregon,2000,836,3279,179,4294,0.19469026548672566,0.763623660922217,0.04168607359105729,0,0,0,0,0.0,0.0,0.0,-2443,0,-0.5689333954354914,0.0
11050,41063,Wallowa,Oregon,2004,1269,3132,120,4521,0.28069011280690115,0.6927670869276709,0.026542800265428004,433,-59,-147,227,0.08599984732017549,-0.015143273325629286,-0.07085657399454615,-1863,580,-0.4120769741207697,0.15685642131472166
11051,41063,Wallowa,Oregon,2008,1492,2836,137,4465,0.3341545352743561,0.6351623740201567,0.030683090705487123,223,17,-296,-56,0.053464422467454975,0.004140290440059119,-0.05760471290751412,-1344,519,-0.3010078387458006,0.1110691353749691
11052,41063,Wallowa,Oregon,2012,1253,2804,148,4205,0.2979785969084423,0.6668252080856124,0.035196195005945306,-239,11,-32,-260,-0.03617593836591382,0.004513104300458183,0.03166283406545567,-1551,-207,-0.3688466111771701,-0.06783877243136949
11053,41063,Wallowa,Oregon,2016,1116,2848,402,4366,0.25561154374713696,0.652313330279432,0.09207512597343105,-137,254,44,161,-0.042367053161305346,0.056878930967485745,-0.014511877806180462,-1732,-181,-0.396701786532295,-0.027855175355124884
11054,41065,Wasco,Oregon,2000,4616,5356,692,10664,0.43285821455363843,0.5022505626406601,0.06489122280570142,0,0,0,0,0.0,0.0,0.0,-740,0,-0.06939234808702172,0.0
11055,41065,Wasco,Oregon,2004,5691,6119,192,12002,0.4741709715047492,0.5098316947175471,0.015997333777703716,1075,-500,763,1338,0.04131275695111075,-0.048893889027997704,0.007581132076886932,-428,312,-0.035660723212797896,0.03373162487422382
11056,41065,Wasco,Oregon,2008,5906,5103,371,11380,0.5189806678383129,0.4484182776801406,0.03260105448154657,215,179,-1016,-622,0.04480969633356369,0.016603720703842854,-0.06141341703740649,803,1231,0.07056239015817228,0.10622311337097018
11057,41065,Wasco,Oregon,2012,5211,5229,433,10873,0.47926055366504183,0.48091603053435117,0.039823415800607005,-695,62,126,-507,-0.03972011417327104,0.007222361319060434,0.03249775285421058,-18,-821,-0.0016554768693093358,-0.07221786702748162
11058,41065,Wasco,Oregon,2016,4781,5833,1350,11964,0.3996155132062855,0.48754597124707455,0.11283851554663991,-430,917,604,1091,-0.07964504045875631,0.0730150997460329,0.006629940712723381,-1052,-1034,-0.08793045804078903,-0.08627498117147969
11059,41067,Washington,Oregon,2000,90662,86091,9221,185974,0.48749825244389,0.4629195478937916,0.04958219966231839,0,0,0,0,0.0,0.0,0.0,4571,0,0.024578704550098418,0.0
11060,41067,Washington,Oregon,2004,121140,107223,2945,231308,0.5237172946893319,0.4635507634841856,0.012731941826482438,30478,-6276,21132,45334,0.036219042245441924,-0.03685025783583595,0.0006312155903940297,13917,9346,0.06016653120514631,0.035587826655047894
11061,41067,Washington,Oregon,2008,141544,89185,5903,236632,0.5981608573650224,0.37689323506541805,0.024945907569559486,20404,2958,-18038,5324,0.07444356267569052,0.012213965743077048,-0.08665752841876756,52359,38442,0.2212676222996044,0.16110109109445808
11062,41067,Washington,Oregon,2012,135291,93974,7758,237023,0.5707927078806698,0.3964762913303772,0.03273100078895297,-6253,1855,4789,391,-0.027368149484352622,0.007785093219393482,0.019583056264959153,41317,-11042,0.17431641655029262,-0.046951205749311775
11063,41067,Washington,Oregon,2016,153251,83197,32784,269232,0.5692153978724669,0.30901601592678435,0.12176858620074879,17960,25026,-10777,32209,-0.0015773100082029368,0.08903758541179582,-0.08746027540359286,70054,28737,0.26019938194568254,0.08588296539538992
11064,41069,Wheeler,Oregon,2000,202,584,55,841,0.24019024970273484,0.6944114149821641,0.06539833531510107,0,0,0,0,0.0,0.0,0.0,-382,0,-0.45422116527942924,0.0
11065,41069,Wheeler,Oregon,2004,245,612,23,880,0.2784090909090909,0.6954545454545454,0.026136363636363635,43,-32,28,39,0.03821884120635605,-0.039261971678737434,0.0010431304723813595,-367,15,-0.41704545454545455,0.03717571073397469
11066,41069,Wheeler,Oregon,2008,281,498,33,812,0.3460591133004926,0.6133004926108374,0.04064039408866995,36,10,-114,-68,0.06765002239140172,0.014504030452306315,-0.08215405284370803,-217,150,-0.2672413793103448,0.14980407523510975
11067,41069,Wheeler,Oregon,2012,266,545,47,858,0.31002331002331,0.6351981351981352,0.054778554778554776,-15,14,47,46,-0.03603580327718259,0.014138160689884827,0.02189764258729776,-279,-62,-0.32517482517482516,-0.05793344586448035
11068,41069,Wheeler,Oregon,2016,155,591,72,818,0.18948655256723718,0.7224938875305623,0.08801955990220049,-111,25,46,-40,-0.12053675745607284,0.033241005123645716,0.08729575233242715,-436,-157,-0.5330073349633251,-0.20783250978849993
11069,41071,Yamhill,Oregon,2000,14254,19193,2092,35539,0.40108050310926024,0.540054587917499,0.05886490897324066,0,0,0,0,0.0,0.0,0.0,-4939,0,-0.1389740848082388,0.0
11070,41071,Yamhill,Oregon,2004,17572,23839,731,42142,0.41697119263442645,0.5656826918513597,0.017346115514213847,3318,-1361,4646,6603,0.0158906895251662,-0.041518793459026815,0.025628103933860613,-6267,-1328,-0.14871149921693322,-0.009737414408694411
11071,41071,Yamhill,Oregon,2008,20797,21390,1339,43526,0.4778063686072692,0.4914304094104673,0.030763221982263476,3225,608,-2449,1384,0.06083517597284277,0.013417106468049628,-0.07425228244089238,-593,5674,-0.013624040803198068,0.13508745841373515
11072,41071,Yamhill,Oregon,2012,19260,22045,1602,42907,0.4488778054862843,0.5137856293844827,0.037336565129232994,-1537,263,655,-619,-0.028928563120984907,0.006573343146969519,0.022355219974015406,-2785,-2192,-0.06490782389819838,-0.05128378309500031
11073,41071,Yamhill,Oregon,2016,19301,23250,6202,48753,0.39589358603573116,0.47689372961663895,0.1272126843476299,41,4600,1205,5846,-0.05298421945055315,0.08987611921839689,-0.03689189976784374,-3949,-1164,-0.08100014358090779,-0.01609231968270941
11074,42001,Adams,Pennsylvania,2000,11682,20848,914,33444,0.34930032292787944,0.6233704102380098,0.02732926683411075,0,0,0,0,0.0,0.0,0.0,-9166,0,-0.27407008731013033,0.0
11075,42001,Adams,Pennsylvania,2004,13764,28247,217,42228,0.325944870701904,0.668916358814057,0.005138770484039026,2082,-697,7399,8784,-0.02335545222597546,-0.022190496350071726,0.04554594857604721,-14483,-5317,-0.342971488112153,-0.06890140080202267
11076,42001,Adams,Pennsylvania,2008,17633,26349,759,44741,0.394112782459042,0.5889229118705438,0.01696430567041416,3869,542,-1898,2513,0.06816791175713804,0.011825535186375136,-0.07999344694351318,-8716,5767,-0.19481012941150178,0.14816135870065122
11077,42001,Adams,Pennsylvania,2012,15091,26767,767,42625,0.35404105571847505,0.6279648093841642,0.017994134897360705,-2542,8,418,-2116,-0.04007172674056697,0.0010298292269465444,0.039041897513620416,-11676,-2960,-0.27392375366568916,-0.07911362425418739
11078,42001,Adams,Pennsylvania,2016,14219,31423,2348,47990,0.2962908939362367,0.6547822463013128,0.04892685976245051,-872,1581,4656,5365,-0.05775016178223835,0.030932724865089804,0.02681743691714855,-17204,-5528,-0.35849135236507607,-0.0845675986993869
11079,42003,Allegheny,Pennsylvania,2000,329963,235361,17154,582478,0.5664814808456285,0.40406847983958194,0.02945003931478957,0,0,0,0,0.0,0.0,0.0,94602,0,0.1624130010060466,0.0
11080,42003,Allegheny,Pennsylvania,2004,368912,271925,4632,645469,0.5715410035183719,0.4212828191594019,0.007176177322226164,38949,-12522,36564,62991,0.005059522672743344,-0.022273861992563405,0.01721433931981997,96987,2385,0.15025818435896998,-0.012154816647076627
11081,42003,Allegheny,Pennsylvania,2008,373153,272347,8539,654039,0.5705363135837466,0.4164078900493701,0.01305579636688332,4241,3907,422,8570,-0.0010046899346253246,0.0058796190446571564,-0.004874929110031789,100806,3819,0.15412842353437645,0.0038702391754064647
11082,42003,Allegheny,Pennsylvania,2012,352687,262039,9101,623827,0.5653602681512663,0.4200507512499459,0.014588980598787805,-20466,562,-10308,-30212,-0.005176045432480292,0.0015331842319044851,0.0036428612005757754,90648,-10158,0.14530951690132038,-0.008818906633056067
11083,42003,Allegheny,Pennsylvania,2016,367617,259480,30092,657189,0.5593778958564432,0.3948331454117461,0.04578895873181079,14930,20991,-2559,33362,-0.005982372294823124,0.031199978133022985,-0.02521760583819982,108137,17489,0.16454475044469707,0.019235233543376695
11084,42005,Armstrong,Pennsylvania,2000,11127,15508,788,27423,0.4057542938409364,0.5655107026948182,0.028735003464245342,0,0,0,0,0.0,0.0,0.0,-4381,0,-0.15975640885388176,0.0
11085,42005,Armstrong,Pennsylvania,2004,12025,18925,147,31097,0.38669325015274786,0.6085796057497508,0.004727144097501366,898,-641,3417,3674,-0.01906104368818856,-0.024007859366743975,0.043068903054932606,-6900,-2519,-0.22188635559700293,-0.06212994674312117
11086,42005,Armstrong,Pennsylvania,2008,11138,18542,583,30263,0.3680401810792056,0.6126953705845422,0.01926444833625219,-887,436,-383,-834,-0.01865306907354225,0.014537304238750822,0.004115764834791369,-7404,-504,-0.24465518950533655,-0.02276883390833362
11087,42005,Armstrong,Pennsylvania,2012,9045,20142,534,29721,0.3043302715251842,0.677702634500858,0.017967093973957807,-2093,-49,1600,-542,-0.0637099095540214,-0.0012973543622943826,0.06500726391631584,-11097,-3693,-0.3733723629756738,-0.12871717347033723
11088,42005,Armstrong,Pennsylvania,2016,7178,23484,1202,31864,0.22526989706251568,0.737007280944012,0.03772282199347226,-1867,668,3342,2143,-0.07906037446266853,0.019755728019514453,0.05930464644315403,-16306,-5209,-0.5117373838814964,-0.1383650209058226
11089,42007,Beaver,Pennsylvania,2000,38925,32491,2233,73649,0.5285204143980231,0.44116009721788485,0.03031948838409211,0,0,0,0,0.0,0.0,0.0,6434,0,0.08736031718013826,0.0
11090,42007,Beaver,Pennsylvania,2004,42146,39916,481,82543,0.5105944780296331,0.48357825618162653,0.005827265788740414,3221,-1752,7425,8894,-0.017925936368390016,-0.024492222595351696,0.04241815896374168,2230,-4204,0.02701622184800656,-0.0603440953321317
11091,42007,Beaver,Pennsylvania,2008,40499,42895,1638,85032,0.47627951829899334,0.5044571455452065,0.01926333615580017,-1647,1157,2979,2489,-0.03431495973063975,0.013436070367059755,0.020878889363579956,-2396,-4626,-0.028177627246213144,-0.055193849094219705
11092,42007,Beaver,Pennsylvania,2012,37055,42344,1394,80793,0.4586412189174805,0.5241048110603641,0.017253970022155386,-3444,-244,-551,-4239,-0.017638299381512845,-0.0020093661336447848,0.01964766551515762,-5289,-2893,-0.06546359214288361,-0.037285964896670465
11093,42007,Beaver,Pennsylvania,2016,32531,48167,3764,84462,0.3851554545239279,0.5702801259738107,0.04456441950226137,-4524,2370,5823,3669,-0.07348576439355259,0.027310449480105987,0.04617531491344662,-15636,-10347,-0.18512467144988282,-0.11966107930699921
11094,42009,Bedford,Pennsylvania,2000,5474,13598,363,19435,0.2816568047337278,0.6996655518394649,0.018677643426807305,0,0,0,0,0.0,0.0,0.0,-8124,0,-0.4180087471057371,0.0
11095,42009,Bedford,Pennsylvania,2004,6016,16606,57,22679,0.26526742801710834,0.7322192336522775,0.0025133383306142247,542,-306,3008,3244,-0.01638937671661944,-0.01616430509619308,0.032553681812812596,-10590,-2466,-0.46695180563516914,-0.04894305852943204
11096,42009,Bedford,Pennsylvania,2008,6059,16124,365,22548,0.26871562888061024,0.715096682632606,0.01618768848678375,43,308,-482,-131,0.0034482008635018935,0.013674350156169527,-0.017122551019671528,-10065,525,-0.4463810537519957,0.02057075188317342
11097,42009,Bedford,Pennsylvania,2012,4788,16702,257,21747,0.2201682990757346,0.7680139789396239,0.011817721984641559,-1271,-108,578,-801,-0.04854732980487564,-0.004369966502142192,0.052917296307017914,-11914,-1849,-0.5478456798638893,-0.10146462611189361
11098,42009,Bedford,Pennsylvania,2016,3645,19552,478,23675,0.15395987328405492,0.8258500527983105,0.020190073917634634,-1143,221,2850,1928,-0.06620842579167968,0.008372351932993075,0.05783607385868661,-15907,-3993,-0.6718901795142556,-0.12404449965036624
11099,42011,Berks,Pennsylvania,2000,59150,71273,4874,135297,0.43718633820409913,0.5267892118820078,0.03602444991389314,0,0,0,0,0.0,0.0,0.0,-12123,0,-0.08960287367790865,0.0
11100,42011,Berks,Pennsylvania,2004,76309,87122,1056,164487,0.46392116094281005,0.529658878817171,0.006419960240018968,17159,-3818,15849,29190,0.026734822738710917,-0.029604489673874173,0.0028696669351632176,-10813,1310,-0.06573771787436095,0.0238651558035477
11101,42011,Berks,Pennsylvania,2008,97047,80513,2951,180511,0.5376237459213012,0.4460282198868767,0.016348034191822104,20738,1895,-6609,16024,0.07370258497849119,0.009928073951803135,-0.08363065893029431,16534,27347,0.09159552603442456,0.1573332439087855
11102,42011,Berks,Pennsylvania,2012,83011,84702,2945,170658,0.48641727900244935,0.49632598530394123,0.01725673569360944,-14036,-6,4189,-9853,-0.05120646691885189,0.0009087015017873352,0.050297765417064544,-1691,-18225,-0.009908706301491876,-0.10150423233591643
11103,42011,Berks,Pennsylvania,2016,78437,96626,9022,184085,0.4260912078659315,0.5248988239128664,0.04900996822120216,-4574,6077,11924,13427,-0.060326071136517834,0.031753232527592726,0.028572838608925122,-18189,-16498,-0.09880761604693483,-0.08889890974544296
11104,42013,Blair,Pennsylvania,2000,15774,28376,990,45140,0.34944616747895435,0.6286220646876385,0.021931767833407178,0,0,0,0,0.0,0.0,0.0,-12602,0,-0.27917589720868413,0.0
11105,42013,Blair,Pennsylvania,2004,18105,35751,322,54178,0.3341762338956772,0.659880394255971,0.005943371848351729,2331,-668,7375,9038,-0.015269933583277162,-0.01598839598505545,0.03125832956833252,-17646,-5044,-0.3257041603602938,-0.04652826315160968
11106,42013,Blair,Pennsylvania,2008,19813,32708,777,53298,0.37174002776839654,0.6136815640361739,0.014578408195429472,1708,455,-3043,-880,0.03756379387271935,0.008635036347077744,-0.046198830219797093,-12895,4751,-0.24194153626777737,0.08376262409251645
11107,42013,Blair,Pennsylvania,2012,16276,33319,764,50359,0.3231994281061975,0.6616295001886455,0.015171071705156972,-3537,-13,611,-2939,-0.048540599662199035,0.0005926635097275,0.047947936152471615,-17043,-4148,-0.338430072082448,-0.09648853581467065
11108,42013,Blair,Pennsylvania,2016,13958,39135,2248,55341,0.25221806617155457,0.7071610559982653,0.04062087783018015,-2318,1484,5816,4982,-0.07098136193464294,0.02544980612502318,0.04553155580961976,-25177,-8134,-0.4549429898267107,-0.1165129177442627
11109,42015,Bradford,Pennsylvania,2000,7911,14660,781,23352,0.33877183967112023,0.6277834874957177,0.03344467283316204,0,0,0,0,0.0,0.0,0.0,-6749,0,-0.28901164782459743,0.0
11110,42015,Bradford,Pennsylvania,2004,8590,16942,120,25652,0.33486667706221734,0.6604553251208483,0.004677997816934352,679,-661,2282,2300,-0.00390516260890289,-0.028766675016227688,0.032671837625130595,-8352,-1603,-0.3255886480586309,-0.036577000234033485
11111,42015,Bradford,Pennsylvania,2008,10306,15057,526,25889,0.39808412839429874,0.5815983622387887,0.020317509366912588,1716,406,-1885,237,0.0632174513320814,0.015639511549978235,-0.07885696288205957,-4751,3601,-0.18351423384448995,0.14207441421414096
11112,42015,Bradford,Pennsylvania,2012,8624,14410,491,23525,0.3665887353878852,0.6125398512221042,0.020871413390010626,-1682,-35,-647,-2364,-0.03149539300641352,0.0005539040230980383,0.0309414889833155,-5786,-1035,-0.24595111583421897,-0.06243688198972902
11113,42015,Bradford,Pennsylvania,2016,6369,18141,1476,25986,0.24509351189101825,0.6981066728238282,0.05679981528515354,-2255,985,3731,2461,-0.12149522349686698,0.03592840189514292,0.08556682160172402,-11772,-5986,-0.45301316093280997,-0.207062045098591
11114,42017,Bucks,Pennsylvania,2000,132914,121927,8581,263422,0.504566816742717,0.4628580756352924,0.03257510762199057,0,0,0,0,0.0,0.0,0.0,10987,0,0.04170874110742456,0.0
11115,42017,Bucks,Pennsylvania,2004,163438,154469,1909,319816,0.5110375966180554,0.4829933461740501,0.005969057207894539,30524,-6672,32542,56394,0.006470779875338395,-0.02660605041409603,0.020135270538757688,8969,-2018,0.02804425044400527,-0.013664490663419293
11116,42017,Bucks,Pennsylvania,2008,179031,150248,4045,333324,0.5371080390250927,0.45075662118539317,0.012135339789514107,15593,2136,-4221,13508,0.026070442407037375,0.006166282581619568,-0.03223672498865693,28783,19814,0.08635141783969957,0.058307167395694304
11117,42017,Bucks,Pennsylvania,2012,160521,156579,4140,321240,0.4996918192005977,0.48742062009712367,0.01288756070227867,-18510,95,6331,-12084,-0.037416219824495056,0.0007522209127645632,0.0366639989117305,3942,-24841,0.012271199103474018,-0.07408021873622556
11118,42017,Bucks,Pennsylvania,2016,167060,164361,13621,345042,0.48417294126512134,0.4763507051315492,0.03947635360332945,6539,9481,7782,23802,-0.01551887793547635,0.026588792901050776,-0.011069914965574468,2699,-1243,0.007822236133572136,-0.004448962969901882
11119,42019,Butler,Pennsylvania,2000,25037,44009,1803,70849,0.3533853688831176,0.6211661420768112,0.02544848904007114,0,0,0,0,0.0,0.0,0.0,-18972,0,-0.2677807731936936,0.0
11120,42019,Butler,Pennsylvania,2004,30090,54959,376,85425,0.3522388059701492,0.6433596722270998,0.004401521802750951,5053,-1427,10950,14576,-0.0011465629129683852,-0.021046967237320188,0.022193530150288576,-24869,-5897,-0.29112086625695055,-0.02334009306325696
11121,42019,Butler,Pennsylvania,2008,32260,57074,1427,90761,0.3554390101475303,0.6288383777173014,0.01572261213516819,2170,1051,2115,5336,0.003200204177381094,0.011321090332417238,-0.014521294509798333,-24814,55,-0.2733993675697711,0.017721498687179427
11122,42019,Butler,Pennsylvania,2012,28550,59761,1388,89699,0.3182867144561255,0.6662393114750443,0.015473974068830198,-3710,-39,2687,-1062,-0.037152295691404824,-0.00024863806633799133,0.037400933757742894,-31211,-6397,-0.34795259701891884,-0.07455322944914772
11123,42019,Butler,Pennsylvania,2016,28584,64428,5032,98044,0.29154257272245115,0.6571335318836441,0.05132389539390478,34,3644,4667,8345,-0.026744141733674343,0.03584992132507458,-0.009105779591400243,-35844,-4633,-0.36559095916119294,-0.0176383621422741
11124,42021,Cambria,Pennsylvania,2000,30308,28001,1977,60286,0.5027369538532993,0.46446936270444217,0.03279368344225857,0,0,0,0,0.0,0.0,0.0,2307,0,0.03826759114885714,0.0
11125,42021,Cambria,Pennsylvania,2004,32591,34048,344,66983,0.4865562904020423,0.5083080781690876,0.005135631428870011,2283,-1633,6047,6697,-0.016180663451257016,-0.027658052013388557,0.04383871546464546,-1457,-3764,-0.02175178776704534,-0.06001937891590248
11126,42021,Cambria,Pennsylvania,2008,32451,31995,1560,66006,0.4916371238978275,0.48472866103081536,0.02363421507135715,-140,1216,-2053,-977,0.0050808334957851975,0.01849858364248714,-0.023579417138272274,456,1913,0.006908462867012133,0.02866025063405747
11127,42021,Cambria,Pennsylvania,2012,24249,35163,1114,60526,0.4006377424577867,0.5809569441231868,0.018405313419026535,-8202,-446,3168,-5480,-0.09099938144004077,-0.005228901652330614,0.09622828309237141,-10914,-11370,-0.18031920166540005,-0.18722766453241219
11128,42021,Cambria,Pennsylvania,2016,18867,42258,2464,63589,0.29670225982481246,0.6645488999669754,0.038748840208212114,-5382,1350,7095,3063,-0.10393548263297425,0.02034352678918558,0.08359195584378865,-23391,-12477,-0.36784664014216295,-0.1875274384767629
11129,42023,Cameron,Pennsylvania,2000,779,1383,84,2246,0.3468388245770258,0.6157613535173642,0.037399821905609976,0,0,0,0,0.0,0.0,0.0,-604,0,-0.26892252894033836,0.0
11130,42023,Cameron,Pennsylvania,2004,794,1599,13,2406,0.33000831255195345,0.6645885286783042,0.005403158769742311,15,-71,216,160,-0.016830512025072353,-0.031996663135867666,0.04882717516094004,-805,-201,-0.33458021612635075,-0.06565768718601239
11131,42023,Cameron,Pennsylvania,2008,879,1323,55,2257,0.3894550287992911,0.5861763402747009,0.024368630926007974,85,42,-276,-149,0.05944671624733766,0.018965472156265664,-0.07841218840360331,-444,361,-0.19672131147540978,0.13785890465094097
11132,42023,Cameron,Pennsylvania,2012,724,1359,42,2125,0.3407058823529412,0.6395294117647059,0.01976470588235294,-155,-13,36,-132,-0.04874914644634992,-0.004603925043655033,0.05335307149000501,-635,-191,-0.2988235294117647,-0.10210221793635493
11133,42023,Cameron,Pennsylvania,2016,531,1589,90,2210,0.2402714932126697,0.7190045248868778,0.04072398190045249,-193,48,230,85,-0.1004343891402715,0.02095927601809955,0.07947511312217193,-1058,-423,-0.4787330316742081,-0.1799095022624434
11134,42025,Carbon,Pennsylvania,2000,10668,9717,892,21277,0.5013864736570005,0.4566903228838652,0.04192320345913428,0,0,0,0,0.0,0.0,0.0,951,0,0.044696150773135324,0.0
11135,42025,Carbon,Pennsylvania,2004,12223,12519,301,25043,0.48808050153735577,0.499900171704668,0.012019326757976281,1555,-591,2802,3766,-0.013305972119644738,-0.029903876701157996,0.04320984882080281,-296,-1247,-0.011819670167312224,-0.05651582094044755
11136,42025,Carbon,Pennsylvania,2008,13464,12957,629,27050,0.4977449168207024,0.4790018484288355,0.023253234750462107,1241,328,438,2007,0.009664415283346606,0.011233907992485826,-0.02089832327583252,507,803,0.0187430683918669,0.030562738559179126
11137,42025,Carbon,Pennsylvania,2012,11580,13504,606,25690,0.4507590502140911,0.5256520046710782,0.023588945114830673,-1884,-23,547,-1360,-0.046985866606611304,0.00033571036436856605,0.046650156242242724,-1924,-2431,-0.07489295445698713,-0.09363602284885403
11138,42025,Carbon,Pennsylvania,2016,8936,18743,1314,28993,0.30821232711344115,0.6464663884385886,0.0453212844479702,-2644,708,5239,3303,-0.14254672310064992,0.021732339333139526,0.12081438376751041,-9807,-7883,-0.33825406132514746,-0.26336110686816033
11139,42027,Centre,Pennsylvania,2000,21409,26172,1994,49575,0.4318507312153303,0.5279273827534039,0.04022188603126576,0,0,0,0,0.0,0.0,0.0,-4763,0,-0.0960766515380736,0.0
11140,42027,Centre,Pennsylvania,2004,30733,33133,508,64374,0.47741324137073976,0.5146953739087209,0.007891384720539348,9324,-1486,6961,14799,0.045562510155409464,-0.032330501310726414,-0.013232008844683008,-2400,2363,-0.03728213253798113,0.05879451900009247
11141,42027,Centre,Pennsylvania,2008,41950,32992,1169,76111,0.5511686878375005,0.43347216565279656,0.015359146509702933,11217,661,-141,11737,0.07375544646676074,0.007467761789163585,-0.08122320825592433,8958,11358,0.11769652218470394,0.15497865472268507
11142,42027,Centre,Pennsylvania,2012,34176,34001,1690,69867,0.4891579715745631,0.486653212532383,0.024188815893053946,-7774,521,1009,-6244,-0.062010716262937415,0.008829669383351012,0.05318104687958641,175,-8783,0.002504759042180116,-0.11519176314252383
11143,42027,Centre,Pennsylvania,2016,37088,35274,4945,77307,0.47974956989664586,0.45628468314641624,0.06396574695693792,2912,3255,1273,7440,-0.009408401677917233,0.039776931063883976,-0.030368529385966736,1814,1639,0.02346488675022962,0.020960127708049503
11144,42029,Chester,Pennsylvania,2000,82047,100080,5549,187676,0.43717363967688994,0.5332594471322918,0.02956691319081822,0,0,0,0,0.0,0.0,0.0,-18033,0,-0.09608580745540185,0.0
11145,42029,Chester,Pennsylvania,2004,109708,120036,1079,230823,0.47529059062571755,0.520034831884171,0.004674577490111471,27661,-4470,19956,43147,0.03811695094882761,-0.024892335700706748,-0.013224615248120797,-10328,7705,-0.04474424125845344,0.05134156619694841
11146,42029,Chester,Pennsylvania,2008,137833,114421,2998,255252,0.5399879334931754,0.44826681083791703,0.011745255668907589,28125,1919,-5615,24429,0.06469734286745787,0.007070678178796118,-0.07176802104625396,23412,33740,0.09172112265525839,0.13646536391371183
11147,42029,Chester,Pennsylvania,2012,124311,124840,3425,252576,0.4921726529836564,0.49426707208919296,0.01356027492715064,-13522,427,10419,-2676,-0.047815280509519,0.0018150192582430513,0.04600026125127593,-529,-23941,-0.002094419105536538,-0.09381554176079493
11148,42029,Chester,Pennsylvania,2016,141682,116114,15202,272998,0.5189854870731654,0.4253291232902805,0.05568538963655412,17371,11777,-8726,20422,0.026812834089508963,0.04212511470940348,-0.06893794879891246,25568,26097,0.09365636378288489,0.09575078288842143
11149,42031,Clarion,Pennsylvania,2000,5605,9796,448,15849,0.3536500725597829,0.6180831598208089,0.028266767619408165,0,0,0,0,0.0,0.0,0.0,-4191,0,-0.26443308726102593,0.0
11150,42031,Clarion,Pennsylvania,2004,6049,11063,72,17184,0.3520135009310987,0.6437965549348231,0.004189944134078212,444,-376,1267,1335,-0.0016365716286842469,-0.024076823485329954,0.02571339511401427,-5014,-823,-0.29178305400372445,-0.027349966742698517
11151,42031,Clarion,Pennsylvania,2008,6756,10737,384,17877,0.37791575767746266,0.6006041282094311,0.021480114113106227,707,312,-326,693,0.025902256746363983,0.017290169979028016,-0.04319242672539203,-3981,1033,-0.22268837053196844,0.06909468347175601
11152,42031,Clarion,Pennsylvania,2012,5056,10828,385,16269,0.3107750937365542,0.6655602679943451,0.023664638269100743,-1700,1,91,-1608,-0.06714066394090845,0.002184524155994516,0.06495613978491399,-5772,-1791,-0.3547851742577909,-0.13209680372582244
11153,42031,Clarion,Pennsylvania,2016,4273,12576,811,17660,0.24195922989807475,0.7121177802944507,0.04592298980747452,-783,426,1748,1391,-0.06881586383847946,0.02225835153837378,0.04655751230010563,-8303,-2531,-0.470158550396376,-0.11537337613858512
11154,42033,Clearfield,Pennsylvania,2000,11718,18019,896,30633,0.3825286455782979,0.5882218522508406,0.02924950217086149,0,0,0,0,0.0,0.0,0.0,-6301,0,-0.20569320667254265,0.0
11155,42033,Clearfield,Pennsylvania,2004,13518,20533,182,34233,0.39488213127683813,0.5998013612596033,0.005316507463558554,1800,-714,2514,3600,0.012353485698540223,-0.023932994707302934,0.0115795090087627,-7015,-714,-0.20491922998276513,0.0007739766897775224
11156,42033,Clearfield,Pennsylvania,2008,14555,18662,805,34022,0.427811416142496,0.548527423431897,0.02366116042560696,1037,623,-1871,-211,0.03292928486565788,0.018344652962048406,-0.051273937827706284,-4107,2908,-0.12071600728940096,0.08420322269336417
11157,42033,Clearfield,Pennsylvania,2012,11121,20347,654,32122,0.3462113193449972,0.6334288026897453,0.020359877965257456,-3434,-151,1685,-1900,-0.0816000967974988,-0.003301282460349504,0.08490137925784835,-9226,-5119,-0.2872174833447481,-0.16650147605534715
11158,42033,Clearfield,Pennsylvania,2016,8200,24932,1418,34550,0.23733719247467439,0.7216208393632417,0.041041968162083935,-2921,764,4585,2428,-0.10887412687032283,0.02068209019682648,0.0881920366734964,-16732,-7506,-0.48428364688856734,-0.19706616354381923
11159,42035,Clinton,Pennsylvania,2000,5521,6064,409,11994,0.4603134900783725,0.5055861263965316,0.03410038352509588,0,0,0,0,0.0,0.0,0.0,-543,0,-0.04527263631815903,0.0
11160,42035,Clinton,Pennsylvania,2004,5823,8035,109,13967,0.4169112908999785,0.5752845994129019,0.007804109687119639,302,-300,1971,1973,-0.043402199178393996,-0.026296273837976242,0.06969847301637033,-2212,-1669,-0.15837330851292336,-0.11310067219476433
11161,42035,Clinton,Pennsylvania,2008,7097,7504,190,14791,0.47981880873504157,0.5073355418835779,0.012845649381380568,1274,81,-531,824,0.06290751783506304,0.005041539694260929,-0.06794905752932401,-407,1805,-0.02751673314853631,0.13085657536438705
11162,42035,Clinton,Pennsylvania,2012,5734,7303,274,13311,0.4307715423334085,0.5486439786642626,0.0205844790023289,-1363,84,-201,-1480,-0.049047266401633094,0.007738829620948332,0.04130843678068474,-1569,-1162,-0.11787243633085415,-0.09035570318231784
11163,42035,Clinton,Pennsylvania,2016,4744,10022,739,15505,0.3059658174782328,0.6463721380199936,0.04766204450177362,-990,465,2719,2194,-0.12480572485517566,0.027077565499444723,0.09772815935573098,-5278,-3709,-0.3404063205417608,-0.22253388421090664
11164,42037,Columbia,Pennsylvania,2000,8975,12095,841,21911,0.40961161060654466,0.5520058418146137,0.03838254757884168,0,0,0,0,0.0,0.0,0.0,-3120,0,-0.142394231208069,0.0
11165,42037,Columbia,Pennsylvania,2004,10679,16052,138,26869,0.397446871859764,0.5974170977706651,0.005136030369570881,1704,-703,3957,4958,-0.012164738746780646,-0.0332465172092708,0.045411255956051444,-5373,-2253,-0.19997022591090108,-0.05757599470283209
11166,42037,Columbia,Pennsylvania,2008,13230,14477,571,28278,0.4678548695098663,0.5119527547917109,0.0201923756984228,2551,433,-1575,1409,0.0704079976501023,0.01505634532885192,-0.08546434297895422,-1247,4126,-0.04409788528184455,0.15587234062905653
11167,42037,Columbia,Pennsylvania,2012,10937,14236,571,25744,0.4248368551895587,0.5529832193909261,0.022179925419515228,-2293,0,-241,-2534,-0.04301801432030761,0.001987549721092427,0.04103046459921522,-3299,-2052,-0.12814636420136738,-0.08404847891952283
11168,42037,Columbia,Pennsylvania,2016,8934,18004,1568,28506,0.3134077036413387,0.6315863327018874,0.055005963656774015,-2003,997,3768,2762,-0.11142915154822003,0.032826038237258784,0.07860311331096126,-9070,-5771,-0.31817862906054867,-0.1900322648591813
11169,42039,Crawford,Pennsylvania,2000,13250,18858,1220,33328,0.3975636101776284,0.5658305328852616,0.03660585693710994,0,0,0,0,0.0,0.0,0.0,-5608,0,-0.16826692270763322,0.0
11170,42039,Crawford,Pennsylvania,2004,16013,21965,344,38322,0.4178539742184646,0.5731694587965137,0.008976566985021658,2763,-876,3107,4994,0.020290364040836173,-0.027629289952088278,0.00733892591125207,-5952,-344,-0.1553154845780491,0.012951438129584103
11171,42039,Crawford,Pennsylvania,2008,16780,20750,777,38307,0.4380400449004098,0.5416764560002089,0.020283499099381316,767,433,-1215,-15,0.020186070681945223,0.011306932114359658,-0.03149300279630485,-3970,1982,-0.10363641109979904,0.05167907347825007
11172,42039,Crawford,Pennsylvania,2012,13883,20901,783,35567,0.39033373632861923,0.5876514746815868,0.02201478898979391,-2897,6,151,-2740,-0.04770630857179059,0.0017312898904125948,0.04597501868137799,-7018,-3048,-0.19731773835296762,-0.09368132725316858
11173,42039,Crawford,Pennsylvania,2016,10971,24987,1855,37813,0.29013831222066483,0.6608044852299474,0.04905720254938778,-2912,1072,4086,2246,-0.1001954241079544,0.02704241355959387,0.07315301054836054,-14016,-6998,-0.37066617300928256,-0.17334843465631494
11174,42041,Cumberland,Pennsylvania,2000,31053,54802,2289,88144,0.35229851152659286,0.6217326193501543,0.025968869123252858,0,0,0,0,0.0,0.0,0.0,-23749,0,-0.2694341078235615,0.0
11175,42041,Cumberland,Pennsylvania,2004,37928,67648,506,106082,0.35753473727870894,0.6376953677343942,0.004769894986896929,6875,-1783,12846,17938,0.005236225752116075,-0.02119897413635593,0.015962748384239833,-29720,-5971,-0.28016063045568523,-0.010726522632123758
11176,42041,Cumberland,Pennsylvania,2008,48306,63739,1780,113825,0.4243883153964419,0.5599736437513727,0.015638040852185373,10378,1274,-3909,7743,0.06685357811773296,0.010868145865288444,-0.07772172398302146,-15433,14287,-0.1355853283549308,0.14457530210075442
11177,42041,Cumberland,Pennsylvania,2012,44367,64809,1986,111162,0.39912020294705025,0.5830139795973445,0.017865817455605334,-3939,206,1070,-2663,-0.025268112449391644,0.0022277766034199606,0.02304033584597176,-20442,-5009,-0.18389377665029422,-0.048308448295363404
11178,42041,Cumberland,Pennsylvania,2016,47085,69076,7325,123486,0.38129828482581024,0.5593832499230682,0.05931846525112158,2718,5339,4267,12324,-0.01782191812124001,0.041452647795516245,-0.023630729674276263,-21991,-1549,-0.17808496509725796,0.005808811553036253
11179,42043,Dauphin,Pennsylvania,2000,44390,53631,2637,100658,0.4409982316358362,0.5328041487015438,0.02619761966261996,0,0,0,0,0.0,0.0,0.0,-9241,0,-0.09180591706570762,0.0
11180,42043,Dauphin,Pennsylvania,2004,55299,65296,613,121208,0.45623226189690447,0.5387103161507492,0.00505742195234638,10909,-2024,11665,20550,0.015234030261068288,-0.021140197710273582,0.005906167449205357,-9997,-756,-0.08247805425384469,0.00932786281186293
11181,42043,Dauphin,Pennsylvania,2008,69975,58238,1632,129845,0.5389117794293196,0.44851938850167505,0.012568832069005352,14676,1019,-7058,8637,0.08267951753241509,0.007511410116658972,-0.0901909276490741,11737,21734,0.0903923909276445,0.1728704451814892
11182,42043,Dauphin,Pennsylvania,2012,64965,57450,1886,124301,0.5226426175171559,0.462184535924892,0.015172846557952068,-5010,254,-788,-5544,-0.016269161912163654,0.0026040144889467164,0.01366514742321695,7515,-4222,0.0604580815922639,-0.029934309335380604
11183,42043,Dauphin,Pennsylvania,2016,64706,60863,6214,131783,0.49100415076299675,0.4618425745354105,0.04715327470159277,-259,4328,3413,7482,-0.031638466754159156,0.0319804281436407,-0.00034196138948150434,3843,-3672,0.02916157622758625,-0.03129650536467765
11184,42045,Delaware,Pennsylvania,2000,134861,105836,7380,248077,0.543625567868041,0.4266256041470995,0.02974882798485954,0,0,0,0,0.0,0.0,0.0,29025,0,0.11699996372094146,0.0
11185,42045,Delaware,Pennsylvania,2004,162601,120425,1512,284538,0.5714561851141148,0.42322993765331873,0.005313877232566476,27740,-5868,14589,36461,0.02783061724607383,-0.024434950752293065,-0.003395666493780758,42176,13151,0.14822624746079605,0.031226283739854588
11186,42045,Delaware,Pennsylvania,2008,178870,115273,3367,297510,0.601223488286108,0.3874592450673927,0.011317266646499277,16269,1855,-5152,12972,0.029767303171993276,0.006003389413932801,-0.03577069258592602,63597,21421,0.21376424321871534,0.0655379957579193
11187,42045,Delaware,Pennsylvania,2012,171792,110853,2919,285564,0.601588435517082,0.38818968777577006,0.01022187670714796,-7078,-448,-4420,-11946,0.000364947230973911,-0.0010953899393513176,0.0007304427083773546,60939,-2658,0.2133987477413119,-0.00036549547740344357
11188,42045,Delaware,Pennsylvania,2016,177402,110667,11267,299336,0.5926517358419969,0.3697082876767245,0.037639976481278564,5610,8348,-186,13772,-0.008936699675085036,0.027418099774130605,-0.018481400099045586,66735,5796,0.22294344816527245,0.00954470042396055
11189,42047,Elk,Pennsylvania,2000,5754,7347,479,13580,0.42371134020618556,0.5410162002945508,0.03527245949926362,0,0,0,0,0.0,0.0,0.0,-1593,0,-0.11730486008836521,0.0
11190,42047,Elk,Pennsylvania,2004,6602,7872,76,14550,0.45374570446735396,0.5410309278350516,0.005223367697594502,848,-403,525,970,0.0300343642611684,-0.03004909180166912,1.4727540500802938e-05,-1270,323,-0.08728522336769762,0.030019636720667597
11191,42047,Elk,Pennsylvania,2008,7290,6676,396,14362,0.507589472218354,0.4648377663278095,0.027572761453836515,688,320,-1196,-188,0.05384376775100008,0.022349393756242012,-0.07619316150724209,614,1884,0.042751705890544556,0.13003692925824217
11192,42047,Elk,Pennsylvania,2012,5463,7579,234,13276,0.4114944260319373,0.5708797830671889,0.017625790900873756,-1827,-162,903,-1086,-0.09609504618641673,-0.009946970552962758,0.10604201673937941,-2116,-2730,-0.15938535703525158,-0.20213706292579614
11193,42047,Elk,Pennsylvania,2016,3853,10025,669,14547,0.2648656080291469,0.6891455282876194,0.045988863683233655,-1610,435,2446,1271,-0.14662881800279043,0.0283630727823599,0.11826574522043054,-6172,-4056,-0.42427992025847255,-0.26489456322322097
11194,42049,Erie,Pennsylvania,2000,59399,49027,3909,112335,0.5287666355098589,0.43643566119197047,0.03479770329817065,0,0,0,0,0.0,0.0,0.0,10372,0,0.09233097431788845,0.0
11195,42049,Erie,Pennsylvania,2004,67921,57372,605,125898,0.5394922874072662,0.4557022351427346,0.004805477449999206,8522,-3304,8345,13563,0.010725651897407262,-0.02999222584817144,0.019266573950764143,10549,177,0.08379005226453157,-0.00854092205335688
11196,42049,Erie,Pennsylvania,2008,75775,50351,2145,128271,0.5907414770291024,0.3925361149441417,0.016722408026755852,7854,1540,-7021,2373,0.05124918962183622,0.011916930576756645,-0.06316612019859291,25424,14875,0.1982053620849607,0.11441530982042913
11197,42049,Erie,Pennsylvania,2012,68036,49025,2053,119114,0.5711839078529812,0.41158050271168795,0.01723558943533086,-7739,-92,-1326,-9157,-0.01955756917612117,0.0005131814085750086,0.019044387767546245,19011,-6413,0.1596034051412933,-0.038601956943667415
11198,42049,Erie,Pennsylvania,2016,58112,60069,6948,125129,0.46441672194295486,0.48005658160778075,0.05552669644926436,-9924,4895,11044,6015,-0.10676718591002637,0.0382911070139335,0.0684760788960928,-1957,-20968,-0.015639859664825895,-0.17524326480611918
11199,42051,Fayette,Pennsylvania,2000,28152,20013,1367,49532,0.568359848178955,0.40404183154324474,0.02759832027780021,0,0,0,0,0.0,0.0,0.0,8139,0,0.16431801663571027,0.0
11200,42051,Fayette,Pennsylvania,2004,29120,25045,542,54707,0.532290200522785,0.45780247500319887,0.009907324474016122,968,-825,5032,5175,-0.036069647656170045,-0.01769099580378409,0.05376064345995413,4075,-4064,0.0744877255195861,-0.08983029111612417
11201,42051,Fayette,Pennsylvania,2008,25866,26081,897,52844,0.48947846491560065,0.49354704412989175,0.016974490954507607,-3254,355,1036,-1863,-0.04281173560718432,0.007067166480491485,0.03574456912669288,-215,-4290,-0.0040685792142911015,-0.0785563047338772
11202,42051,Fayette,Pennsylvania,2012,21971,26018,652,48641,0.4516971279373368,0.5348985423819411,0.013404329680722025,-3895,-245,-63,-4203,-0.03778133697826386,-0.0035701612737855815,0.04135149825204937,-4047,-3832,-0.08320141444460433,-0.07913283523031323
11203,42051,Fayette,Pennsylvania,2016,17946,34590,1563,54099,0.33172517052071204,0.6393833527421948,0.028891476737093108,-4025,911,8572,5458,-0.11997195741662475,0.015487147056371083,0.1044848103602537,-16644,-12597,-0.3076581822214828,-0.22445676777687845
11204,42053,Forest,Pennsylvania,2000,843,1371,69,2283,0.3692509855453351,0.6005256241787122,0.030223390275952694,0,0,0,0,0.0,0.0,0.0,-528,0,-0.23127463863337716,0.0
11205,42053,Forest,Pennsylvania,2004,989,1571,13,2573,0.3843762145355616,0.6105713175281772,0.005052467936261173,146,-56,200,290,0.015125228990226502,-0.02517092233969152,0.010045693349464924,-582,-54,-0.22619510299261558,0.005079535640761579
11206,42053,Forest,Pennsylvania,2008,1038,1366,64,2468,0.4205834683954619,0.553484602917342,0.02593192868719611,49,51,-205,-105,0.03620725385990031,0.020879460750934935,-0.05708671461083514,-328,254,-0.13290113452188013,0.09329396847073546
11207,42053,Forest,Pennsylvania,2012,896,1383,45,2324,0.3855421686746988,0.5950946643717728,0.0193631669535284,-142,-19,17,-144,-0.035041299720763086,-0.006568761733667709,0.0416100614544308,-487,-159,-0.20955249569707401,-0.07665136117519389
11208,42053,Forest,Pennsylvania,2016,626,1683,110,2419,0.25878462174452255,0.6957420421661844,0.0454733360892931,-270,65,300,95,-0.12675754693017627,0.026110169135764697,0.10064737779441157,-1057,-570,-0.43695742042166186,-0.22740492472458784
11209,42055,Franklin,Pennsylvania,2000,14922,33042,1055,49019,0.3044125747159265,0.6740651584079642,0.021522266876109263,0,0,0,0,0.0,0.0,0.0,-18120,0,-0.36965258369203774,0.0
11210,42055,Franklin,Pennsylvania,2004,16562,41817,190,58569,0.2827775785825266,0.7139783844695999,0.0032440369478734486,1640,-865,8775,9550,-0.021634996133399864,-0.018278229928235815,0.03991322606163572,-25255,-7135,-0.4312008058870733,-0.061548222195035585
11211,42055,Franklin,Pennsylvania,2008,21169,41906,842,63917,0.3311951437019885,0.6556315221302627,0.0131733341677488,4607,652,89,5348,0.04841756511946188,0.00992929721987535,-0.05834686233933728,-20737,4518,-0.32443637842827416,0.10676442745879916
11212,42055,Franklin,Pennsylvania,2012,18995,43260,1065,63320,0.2999842072015161,0.6831964624131396,0.016819330385344285,-2174,223,1354,-597,-0.031210936500472408,0.0036459962175954853,0.027564940282876926,-24265,-3528,-0.3832122552116235,-0.058775876783349335
11213,42055,Franklin,Pennsylvania,2016,17465,49768,3273,70506,0.24770941480157718,0.7058690040563924,0.04642158114203047,-1530,2208,6508,7186,-0.0522747923999389,0.029602250756686183,0.02267254164325283,-32303,-8038,-0.45815958925481526,-0.07494733404319176
11214,42057,Fulton,Pennsylvania,2000,1425,3753,107,5285,0.2696310312204352,0.7101229895931883,0.020245979186376536,0,0,0,0,0.0,0.0,0.0,-2328,0,-0.4404919583727531,0.0
11215,42057,Fulton,Pennsylvania,2004,1475,4772,24,6271,0.23520969542337744,0.7609631637697337,0.0038271408068888536,50,-83,1019,986,-0.03442133579705775,-0.016418838379487682,0.050840174176545405,-3297,-969,-0.5257534683463563,-0.08526150997360316
11216,42057,Fulton,Pennsylvania,2008,1576,4642,88,6306,0.2499207104345068,0.7361243260386933,0.013954963526799874,101,64,-130,35,0.01471101501112937,0.01012782271991102,-0.024838837731040453,-3066,231,-0.48620361560418646,0.03954985274216982
11217,42057,Fulton,Pennsylvania,2012,1310,4814,92,6216,0.21074646074646075,0.7744530244530244,0.014800514800514801,-266,4,172,-90,-0.03917424968804606,0.0008455512737149274,0.038328698414331175,-3504,-438,-0.5637065637065637,-0.07750294810237723
11218,42057,Fulton,Pennsylvania,2016,912,5694,216,6822,0.13368513632365875,0.8346525945470537,0.0316622691292876,-398,124,880,606,-0.077061324422802,0.0168617543287728,0.06019957009402921,-4782,-1278,-0.7009674582233949,-0.1372608945168312
11219,42059,Greene,Pennsylvania,2000,7230,5890,533,13653,0.5295539441880905,0.4314070167728704,0.03903903903903904,0,0,0,0,0.0,0.0,0.0,1340,0,0.09814692741522013,0.0
11220,42059,Greene,Pennsylvania,2004,7674,7786,105,15565,0.4930292322518471,0.5002248634757469,0.006745904272406039,444,-428,1896,1912,-0.03652471193624346,-0.032293134766633,0.0688178467028765,-112,-1452,-0.007195631223899823,-0.10534255863911995
11221,42059,Greene,Pennsylvania,2008,7829,7889,396,16114,0.48585081295767657,0.4895742832319722,0.024574903810351247,155,291,103,549,-0.007178419294170513,0.017828999537945207,-0.010650580243774688,-60,52,-0.0037234702742956483,0.003472160949604175
11222,42059,Greene,Pennsylvania,2012,5852,8428,266,14546,0.40230991337824834,0.5794032723772858,0.01828681424446583,-1977,-130,539,-1568,-0.08354089957942823,-0.006288089565885415,0.08982898914531362,-2576,-2516,-0.1770933589990375,-0.17336988872474185
11223,42059,Greene,Pennsylvania,2016,4482,10849,537,15868,0.282455255860852,0.6837030501638518,0.0338416939752962,-1370,271,2421,1322,-0.11985465751739632,0.015554879730830366,0.10429977778656596,-6367,-3791,-0.4012477943029998,-0.22415443530396228
11224,42061,Huntingdon,Pennsylvania,2000,5073,10408,480,15961,0.31783722824384436,0.6520894680784411,0.03007330367771443,0,0,0,0,0.0,0.0,0.0,-5335,0,-0.3342522398345968,0.0
11225,42061,Huntingdon,Pennsylvania,2004,5879,12126,53,18058,0.32556207774947393,0.6715029349872632,0.00293498726326282,806,-427,1718,2097,0.007724849505629572,-0.027138316414451608,0.019413466908822063,-6247,-912,-0.3459408572377893,-0.011688617403192492
11226,42061,Huntingdon,Pennsylvania,2008,6621,11745,365,18731,0.35347819123378355,0.6270353958678128,0.019486412898403714,742,312,-381,673,0.027916113484309613,0.016551425635140893,-0.04446753911945045,-5124,1123,-0.2735572046340292,0.07238365260376006
11227,42061,Huntingdon,Pennsylvania,2012,5409,11979,304,17692,0.30573140402441784,0.6770856884467555,0.017182907528826587,-1212,-61,234,-1039,-0.047746787209365704,-0.0023035053695771267,0.05005029257894278,-6570,-1446,-0.3713542844223377,-0.09779707978830848
11228,42061,Huntingdon,Pennsylvania,2016,4539,14494,833,19866,0.2284808215040773,0.7295882412161482,0.04193093727977449,-870,529,2515,2174,-0.07725058252034053,0.024748029750947902,0.05250255276939264,-9955,-3385,-0.5011074197120708,-0.12975313528973315
11229,42063,Indiana,Pennsylvania,2000,13667,16799,935,31401,0.4352409158943983,0.5349829623260406,0.02977612177956116,0,0,0,0,0.0,0.0,0.0,-3132,0,-0.0997420464316423,0.0
11230,42063,Indiana,Pennsylvania,2004,15831,20254,163,36248,0.43674133745310084,0.5587618627234606,0.0044967998234385345,2164,-772,3455,4847,0.0015004215587025582,-0.025279321956122626,0.023778900397420033,-4423,-1291,-0.12202052527035978,-0.022278478838717475
11231,42063,Indiana,Pennsylvania,2008,17065,19727,510,37302,0.45748217253766554,0.5288456383035762,0.013672189158758244,1234,347,-527,1054,0.0207408350845647,0.009175389335319709,-0.029916224419884396,-2662,1761,-0.07136346576591068,0.0506570595044491
11232,42063,Indiana,Pennsylvania,2012,14473,21257,714,36444,0.39712984304686644,0.5832784546153001,0.01959170233783339,-2592,204,1530,-858,-0.060352329490799106,0.005919513179075145,0.05443281631172392,-6784,-4122,-0.1861486115684337,-0.11478514580252303
11233,42063,Indiana,Pennsylvania,2016,11528,24888,1706,38122,0.3023975657100887,0.6528513719112323,0.04475106237867898,-2945,992,3631,1678,-0.09473227733677775,0.02515936004084559,0.06957291729593218,-13360,-6576,-0.35045380620114364,-0.16430519463270993
11234,42065,Jefferson,Pennsylvania,2000,5566,11473,547,17586,0.31650176276583647,0.652393949732742,0.031104287501421586,0,0,0,0,0.0,0.0,0.0,-5907,0,-0.33589218696690554,0.0
11235,42065,Jefferson,Pennsylvania,2004,6073,13371,116,19560,0.310480572597137,0.6835889570552147,0.005930470347648262,507,-431,1898,1974,-0.006021190168699453,-0.025173817153773325,0.031195007322472712,-7298,-1391,-0.3731083844580777,-0.037216197491172165
11236,42065,Jefferson,Pennsylvania,2008,6447,12057,408,18912,0.3408946700507614,0.6375317258883249,0.021573604060913704,374,292,-1314,-648,0.03041409745362439,0.015643133713265443,-0.04605723116688987,-5610,1688,-0.29663705583756345,0.07647132862051426
11237,42065,Jefferson,Pennsylvania,2012,4787,13048,339,18174,0.2633982612523385,0.717948717948718,0.018653020798943546,-1660,-69,991,-738,-0.0774964087984229,-0.0029205832619701583,0.0804169920603931,-8261,-2651,-0.45455045669637945,-0.157913400858816
11238,42065,Jefferson,Pennsylvania,2016,3650,15192,753,19595,0.1862720081653483,0.7752998213830059,0.03842817045164583,-1137,414,2144,1421,-0.0771262530869902,0.019775149652702283,0.05735110343428795,-11542,-3281,-0.5890278132176576,-0.13447735652127818
11239,42067,Juniata,Pennsylvania,2000,2656,5795,216,8667,0.306449751932618,0.6686281296873198,0.024922118380062305,0,0,0,0,0.0,0.0,0.0,-3139,0,-0.3621783777547018,0.0
11240,42067,Juniata,Pennsylvania,2004,2797,7144,65,10006,0.27953228063162106,0.7139716170297822,0.006496102338596842,141,-151,1349,1339,-0.02691747130099692,-0.018426016041465463,0.04534348734246241,-4347,-1208,-0.4344393363981611,-0.07226095864345933
11241,42067,Juniata,Pennsylvania,2008,3068,6484,267,9819,0.31245544352785415,0.6603523780425705,0.027192178429575314,271,202,-660,-187,0.032923162896233094,0.020696076090978472,-0.05361923898721166,-3416,931,-0.34789693451471637,0.08654240188344475
11242,42067,Juniata,Pennsylvania,2012,2547,6862,186,9595,0.265450755601876,0.7151641479937467,0.01938509640437728,-521,-81,378,-224,-0.04700468792597817,-0.0078070820251980345,0.054811769951176204,-4315,-899,-0.44971339239187075,-0.10181645787715438
11243,42067,Juniata,Pennsylvania,2016,1821,8273,451,10545,0.17268847795163583,0.7845424371740162,0.04276908487434803,-726,265,1411,950,-0.09276227765024014,0.02338398846997075,0.06937828918026945,-6452,-2137,-0.6118539592223804,-0.16214056683050965
11244,42069,Lackawanna,Pennsylvania,2000,57471,35096,3814,96381,0.5962897251532978,0.3641381600107905,0.039572114835911644,0,0,0,0,0.0,0.0,0.0,22375,0,0.2321515651425073,0.0
11245,42069,Lackawanna,Pennsylvania,2004,59573,44766,1480,105819,0.5629707330441603,0.42304312080061235,0.013986146155227322,2102,-2334,9670,9438,-0.03331899210913747,-0.025585968680684322,0.058904960789821825,14807,-7568,0.139927612243548,-0.0922239528989593
11246,42069,Lackawanna,Pennsylvania,2008,67520,39488,1531,108539,0.6220805424778191,0.36381392863394724,0.014105528888233722,7947,51,-5278,2720,0.05910980943365873,0.00011938273300639984,-0.05922919216666511,28032,13225,0.25826661384387184,0.11833900160032385
11247,42069,Lackawanna,Pennsylvania,2012,61838,35085,1428,98351,0.6287480554341085,0.35673251924230565,0.014519425323585931,-5682,-103,-4403,-10188,0.006667512956289423,0.00041389643535220955,-0.007081409391641591,26753,-1279,0.27201553619180285,0.013748922347931014
11248,42069,Lackawanna,Pennsylvania,2016,51983,48384,4037,104404,0.497902379219187,0.46343051990345197,0.03866710087736102,-9855,2609,13299,6053,-0.1308456762149215,0.02414767555377509,0.10669800066114632,3599,-23154,0.03447185931573504,-0.2375436768760678
11249,42071,Lancaster,Pennsylvania,2000,54968,115900,4499,175367,0.31344551711553487,0.6608997131729458,0.02565476971151927,0,0,0,0,0.0,0.0,0.0,-60932,0,-0.34745419605741096,0.0
11250,42071,Lancaster,Pennsylvania,2004,74328,145591,1453,221372,0.3357606201326274,0.657675767486403,0.00656361238096959,19360,-3046,29691,46005,0.022315103017092552,-0.019091157330549682,-0.0032239456865428284,-71263,-10331,-0.3219151473537756,0.02553904870363538
11251,42071,Lancaster,Pennsylvania,2008,99586,126568,3095,229249,0.4344010224690184,0.5520983733843986,0.013500604146582973,25258,1642,-19023,7877,0.09864040233639099,0.006936991765613383,-0.1055773941020044,-26982,44281,-0.1176973509153802,0.20421779643839538
11252,42071,Lancaster,Pennsylvania,2012,88481,130669,4090,223240,0.3963492205697904,0.5853296900197097,0.01832108941049991,-11105,995,4101,-6009,-0.03805180189922802,0.004820485263916938,0.03323131663531109,-42188,-15206,-0.1889804694499193,-0.07128311853453911
11253,42071,Lancaster,Pennsylvania,2016,91093,137914,15825,244832,0.372063292380081,0.56330054894785,0.06463615867206901,2612,11735,7245,21592,-0.02428592818970937,0.0463150692615691,-0.022029141071859715,-46821,-4633,-0.19123725656776897,-0.002256787117849657
11254,42073,Lawrence,Pennsylvania,2000,20593,18060,987,39640,0.5195005045408678,0.4556004036326943,0.02489909182643794,0,0,0,0,0.0,0.0,0.0,2533,0,0.06390010090817355,0.0
11255,42073,Lawrence,Pennsylvania,2004,21387,21938,117,43442,0.4923115878642788,0.5049951659684176,0.002693246167303531,794,-870,3878,3802,-0.027188916676589014,-0.02220584565913441,0.049394762335723374,-551,-3084,-0.012683578104138837,-0.07658367901231239
11256,42073,Lawrence,Pennsylvania,2008,19711,21851,787,42349,0.46544192306784105,0.5159744031736286,0.018583673758530306,-1676,670,-87,-1093,-0.026869664796437764,0.015890427591226775,0.01097923720521099,-2140,-1589,-0.05053248010578759,-0.037848902001648754
11257,42073,Lawrence,Pennsylvania,2012,17513,21047,629,39189,0.44688560565464797,0.5370639720329684,0.016050422312383576,-2198,-158,-804,-3160,-0.01855631741319308,-0.002533251446146731,0.02108956885933977,-3534,-1394,-0.09017836637832044,-0.03964588627253285
11258,42073,Lawrence,Pennsylvania,2016,14009,25428,1639,41076,0.3410507352225144,0.6190476190476191,0.03990164572986659,-3504,1010,4381,1887,-0.10583487043213358,0.023851223417483015,0.08198364701465066,-11419,-7885,-0.2779968838251047,-0.18781851744678424
11259,42075,Lebanon,Pennsylvania,2000,16093,28534,1270,45897,0.3506329389720461,0.6216964071725821,0.02767065385537181,0,0,0,0,0.0,0.0,0.0,-12441,0,-0.271063468200536,0.0
11260,42075,Lebanon,Pennsylvania,2004,18109,37089,467,55665,0.3253211173987245,0.6662894098625707,0.008389472738704752,2016,-803,8555,9768,-0.025311821573321625,-0.01928118111666706,0.04459300268998856,-18980,-6539,-0.3409682924638462,-0.06990482426331018
11261,42075,Lebanon,Pennsylvania,2008,23310,34314,939,58563,0.39803288765944367,0.5859330976896675,0.016034014650888787,5201,472,-2775,2898,0.07271177026071918,0.007644541912184034,-0.08035631217290318,-11004,7976,-0.18790021003022384,0.15306808243362235
11262,42075,Lebanon,Pennsylvania,2012,19900,35872,1005,56777,0.35049403807879953,0.6318051323599345,0.017700829561266007,-3410,66,1558,-1786,-0.04753884958064414,0.0016668149103772206,0.045872034670267015,-15972,-4968,-0.281311094281135,-0.09341088425091115
11263,42075,Lebanon,Pennsylvania,2016,18953,40525,3025,62503,0.30323344479464986,0.6483688782938419,0.048397676911508244,-947,2020,4653,5726,-0.047260593284149666,0.030696847350242237,0.016563745933907414,-21572,-5600,-0.34513543349919207,-0.06382433921805708
11264,42077,Lehigh,Pennsylvania,2000,56667,55492,4148,116307,0.48721916995537673,0.47711659659349825,0.03566423345112504,0,0,0,0,0.0,0.0,0.0,1175,0,0.010102573361878475,0.0
11265,42077,Lehigh,Pennsylvania,2004,73940,70160,991,145091,0.5096112095167861,0.4835585942615324,0.006830196221681566,17273,-3157,14668,28784,0.022392039561409338,-0.02883403722944347,0.006441997668034161,3780,2605,0.026052615255253653,0.015950041893375178
11266,42077,Lehigh,Pennsylvania,2008,87089,63382,2002,152473,0.5711765361736176,0.4156932702839191,0.013130193542463255,13149,1011,-6778,7382,0.061565326656831565,0.006299997320781689,-0.0678653239776133,23707,19927,0.15548326588969852,0.12943065063444487
11267,42077,Lehigh,Pennsylvania,2012,78283,66874,2022,147179,0.5318897397047133,0.4543718872937036,0.013738373001583107,-8806,20,3492,-5294,-0.03928679646890432,0.0006081794591198519,0.03867861700978448,11409,-12298,0.07751785241100972,-0.0779654134786888
11268,42077,Lehigh,Pennsylvania,2016,81324,73690,7719,162733,0.4997388360074478,0.4528276379099507,0.04743352608260156,3041,5697,6816,15554,-0.03215090369726553,0.033695153081018454,-0.0015442493837529159,7634,-3775,0.04691119809749711,-0.030606654313512616
11269,42079,Luzerne,Pennsylvania,2000,62199,52328,5059,119586,0.520119411971301,0.43757630491863597,0.042304283110063054,0,0,0,0,0.0,0.0,0.0,9871,0,0.08254310705266499,0.0
11270,42079,Luzerne,Pennsylvania,2004,69573,64953,1502,136028,0.5114608757020613,0.4774972799717705,0.011041844326168141,7374,-3557,12625,16442,-0.008658536269239625,-0.03126243878389491,0.03992097505313452,4620,-5251,0.03396359573029084,-0.04857951132237415
11271,42079,Luzerne,Pennsylvania,2008,72492,61127,2349,135968,0.533154859967051,0.4495690162391151,0.017276123793833843,2919,847,-3826,-60,0.021693984264989696,0.006234279467665702,-0.02792826373265539,11365,6745,0.08358584372793593,0.049622247997645086
11272,42079,Luzerne,Pennsylvania,2012,64307,58325,2213,124845,0.5150947174496375,0.4671793023348953,0.017725980215467178,-8185,-136,-2802,-11123,-0.018060142517413502,0.00044985642163333436,0.017610286095780192,5982,-5383,0.04791541511474223,-0.035670428613193694
11273,42079,Luzerne,Pennsylvania,2016,52451,78688,4762,135901,0.3859500665925931,0.5790097203111089,0.03504021309629804,-11856,2549,20363,11056,-0.1291446508570444,0.017314232880830862,0.11183041797621357,-26237,-32219,-0.19305965371851574,-0.24097506883325798
11274,42081,Lycoming,Pennsylvania,2000,14663,27137,1393,43193,0.33947630403074575,0.6282730998078392,0.03225059616141505,0,0,0,0,0.0,0.0,0.0,-12474,0,-0.28879679577709344,0.0
11275,42081,Lycoming,Pennsylvania,2004,15681,33961,439,50081,0.31311275733312033,0.6781214432619157,0.008765799404963958,1018,-954,6824,6888,-0.026363546697625417,-0.02348479675645109,0.049848343454076516,-18280,-5806,-0.3650086859287954,-0.07621189015170193
11276,42081,Lycoming,Pennsylvania,2008,18381,30280,786,49447,0.3717313487168079,0.6123728436507776,0.015895807632414504,2700,347,-3681,-634,0.05861859138368758,0.007130008227450546,-0.0657485996111381,-11899,6381,-0.2406414949339697,0.12436719099482568
11277,42081,Lycoming,Pennsylvania,2012,15203,30658,808,46669,0.3257622833144057,0.6569242966423108,0.01731342004328355,-3178,22,378,-2778,-0.0459690654024022,0.0014176124108690458,0.04455145299153318,-15455,-3556,-0.33116201332790507,-0.09052051839393538
11278,42081,Lycoming,Pennsylvania,2016,13020,35627,2484,51131,0.254640042244431,0.6967788621384288,0.04858109561714029,-2183,1676,4969,4462,-0.07112224106997472,0.031267675573856735,0.03985456549611799,-22607,-7152,-0.4421388198939978,-0.11097680656609271
11279,42083,McKean,Pennsylvania,2000,5510,9661,635,15806,0.34860179678603065,0.6112235859800076,0.04017461723396178,0,0,0,0,0.0,0.0,0.0,-4151,0,-0.26262178919397694,0.0
11280,42083,McKean,Pennsylvania,2004,6294,10941,191,17426,0.36118443704808906,0.6278549294158154,0.01096063353609549,784,-444,1280,1620,0.012582640262058409,-0.02921398369786629,0.016631343435807855,-4647,-496,-0.2666704923677264,-0.004048703173749446
11281,42083,McKean,Pennsylvania,2008,6465,9224,321,16010,0.4038101186758276,0.5761399125546534,0.02004996876951905,171,130,-1717,-1416,0.042625681627738554,0.00908933523342356,-0.05171501686116209,-2759,1888,-0.17232979387882574,0.09434069848890064
11282,42083,McKean,Pennsylvania,2012,5297,9545,312,15154,0.3495446746733536,0.6298667018608948,0.020588623465751618,-1168,-9,321,-856,-0.05426544400247402,0.0005386546962325676,0.05372678930624142,-4248,-1489,-0.2803220271875412,-0.10799223330871544
11283,42083,McKean,Pennsylvania,2016,4025,11635,804,16464,0.24447278911564627,0.7066933916423712,0.048833819241982504,-1272,492,2090,1310,-0.10507188555770733,0.028245195776230886,0.07682668978147644,-7610,-3362,-0.4622206025267249,-0.18189857533918374
11284,42085,Mercer,Pennsylvania,2000,23817,23132,1783,48732,0.4887343018960847,0.4746778297627842,0.036587868341131084,0,0,0,0,0.0,0.0,0.0,685,0,0.014056472133300468,0.0
11285,42085,Mercer,Pennsylvania,2004,24831,26311,422,51564,0.48155690016290437,0.5102590954929797,0.00818400434411605,1014,-1361,3179,2832,-0.007177401733180322,-0.028403863997015034,0.03558126573019543,-1480,-2165,-0.028702195330075286,-0.042758667463375755
11286,42085,Mercer,Pennsylvania,2008,26411,26565,1192,54168,0.4875756904445429,0.4904186973859105,0.022005612169546596,1580,770,254,2604,0.006018790281638542,0.013821607825430546,-0.019840398107069168,-154,1326,-0.0028430069413675763,0.02585918838870771
11287,42085,Mercer,Pennsylvania,2012,24232,25925,882,51039,0.4747741922843316,0.507944904876663,0.017280902839005467,-2179,-310,-640,-3129,-0.012801498160211311,-0.00472470933054113,0.01752620749075251,-1693,-1539,-0.0331707125923314,-0.03032770565096382
11288,42085,Mercer,Pennsylvania,2016,18733,31544,2562,52839,0.3545297980658226,0.5969832888586082,0.04848691307556918,-5499,1680,5619,1800,-0.12024439421850902,0.031206010236563716,0.08903838398194519,-12811,-11118,-0.2424534907927856,-0.2092827782004542
11289,42087,Mifflin,Pennsylvania,2000,4835,9400,379,14614,0.33084713288627343,0.6432188312576981,0.025934035856028465,0,0,0,0,0.0,0.0,0.0,-4565,0,-0.31237169837142464,0.0
11290,42087,Mifflin,Pennsylvania,2004,4889,11726,187,16802,0.2909772646113558,0.6978931079633377,0.011129627425306512,54,-192,2326,2188,-0.03986986827491762,-0.014804408430721953,0.054674276705639624,-6837,-2272,-0.4069158433519819,-0.09454414498055724
11291,42087,Mifflin,Pennsylvania,2008,5375,10929,283,16587,0.32404895400012057,0.6588894917706638,0.01706155422921565,486,96,-797,-215,0.03307168938876476,0.005931926803909138,-0.039003616192673896,-5554,1283,-0.33484053777054323,0.07207530558143865
11292,42087,Mifflin,Pennsylvania,2012,4273,11939,204,16416,0.2602948343079922,0.7272782651072125,0.012426900584795321,-1102,-79,1010,-171,-0.06375411969212835,-0.004634653644420329,0.06838877333654869,-7666,-2112,-0.4669834307992203,-0.13214289302867704
11293,42087,Mifflin,Pennsylvania,2016,3877,14094,750,18721,0.20709363816035467,0.7528443993376422,0.0400619625020031,-396,546,2155,2305,-0.05320119614763755,0.027635061917207777,0.02556613423042975,-10217,-2551,-0.5457507611772876,-0.07876733037806732
11294,42089,Monroe,Pennsylvania,2000,21939,23265,1674,46878,0.4680020478689364,0.4962882375527966,0.03570971457826699,0,0,0,0,0.0,0.0,0.0,-1326,0,-0.028286189683860208,0.0
11295,42089,Monroe,Pennsylvania,2004,27967,27971,404,56342,0.496379255262504,0.49645025025735684,0.00717049448013915,6028,-1270,4706,9464,0.028377207393567583,-0.028539220098127843,0.00016201270456023265,-4,1322,-7.099499485285765e-05,0.02821519468900735
11296,42089,Monroe,Pennsylvania,2008,39453,28293,872,68618,0.5749657524264771,0.4123262117811653,0.012708035792357691,11486,468,322,12276,0.07858649716397309,0.005537541312218541,-0.08412403847619154,11160,11164,0.16263954064531178,0.16271053564016463
11297,42089,Monroe,Pennsylvania,2012,35221,26867,927,63015,0.5589304133936365,0.4263588034594938,0.014710783146869792,-4232,55,-1426,-5603,-0.0160353390328406,0.002002747354512101,0.014032591678328488,8354,-2806,0.1325716099341427,-0.03006793071116909
11298,42089,Monroe,Pennsylvania,2016,33918,33386,2704,70008,0.4844874871443264,0.47688835561650095,0.03862415723917267,-1303,1777,6519,6993,-0.07444292624931009,0.023913374092302875,0.05052955215700716,532,-7822,0.007599131527825431,-0.12497247840631726
11299,42091,Montgomery,Pennsylvania,2000,177990,145623,8809,332422,0.5354338762175789,0.438066674287502,0.02649944949491911,0,0,0,0,0.0,0.0,0.0,32367,0,0.09736720193007686,0.0
11300,42091,Montgomery,Pennsylvania,2004,222048,175741,1802,399591,0.555688191175477,0.43980219774719653,0.004509611077326566,44058,-7007,30118,67169,0.02025431495789809,-0.021989838417592545,0.0017355234596945213,46307,13940,0.11588599342828043,0.01851879149820357
11301,42091,Montgomery,Pennsylvania,2008,253393,165552,3796,422741,0.5994048365311148,0.3916156701147984,0.00897949335408678,31345,1994,-10189,23150,0.043716645355637795,0.004469882276760214,-0.04818652763239811,87841,41534,0.20778916641631634,0.09190317298803591
11302,42091,Montgomery,Pennsylvania,2012,233356,174381,5095,412832,0.565256569258197,0.4224018486938997,0.012341582047903263,-20037,1299,8829,-9909,-0.034148267272917754,0.0033620886938164826,0.030786178579101264,58975,-28866,0.14285472056429732,-0.06493444585201902
11303,42091,Montgomery,Pennsylvania,2016,256082,162731,19839,438652,0.5837930751484092,0.3709797288055224,0.04522719604606841,22726,14744,-11650,25820,0.018536505890212163,0.03288561399816515,-0.051422119888377305,93351,34376,0.2128133463428868,0.06995862577858947
11304,42093,Montour,Pennsylvania,2000,2356,3960,179,6495,0.3627405696689761,0.6096997690531177,0.027559661277906083,0,0,0,0,0.0,0.0,0.0,-1604,0,-0.24695919938414163,0.0
11305,42093,Montour,Pennsylvania,2004,2666,4903,55,7624,0.3496852046169989,0.6431007345225603,0.007214060860440714,310,-124,943,1129,-0.013055365051977186,-0.02034560041746537,0.0334009654694426,-2237,-633,-0.2934155299055614,-0.046456330521419786
11306,42093,Montour,Pennsylvania,2008,3364,4574,138,8076,0.41654284299158,0.5663694898464586,0.017087667161961365,698,83,-329,452,0.06685763837458109,0.009873606301520652,-0.0767312446761017,-1210,1027,-0.14982664685487862,0.1435888830506828
11307,42093,Montour,Pennsylvania,2012,3053,4652,154,7859,0.3884718157526403,0.5919328158798829,0.019595368367476777,-311,16,78,-217,-0.028071027238939728,0.0025077012055154113,0.02556332603342426,-1599,-389,-0.2034610001272426,-0.05363435327236399
11308,42093,Montour,Pennsylvania,2016,2857,5288,411,8556,0.3339177185600748,0.6180458158017765,0.048036465638148666,-196,257,636,697,-0.05455409719256549,0.02844109727067189,0.026112999921893643,-2431,-832,-0.28412809724170174,-0.08066709711445913
11309,42095,Northampton,Pennsylvania,2000,53097,47396,4197,104690,0.5071831120450855,0.45272709905435093,0.04008978890056357,0,0,0,0,0.0,0.0,0.0,5701,0,0.05445601299073455,0.0
11310,42095,Northampton,Pennsylvania,2004,63446,62102,1301,126849,0.5001694928615913,0.4895742181649047,0.010256288973503929,10349,-2896,14706,22159,-0.007013619183494191,-0.02983349992705964,0.03684711911055377,1344,-4357,0.010595274696686585,-0.04386073829404796
11311,42095,Northampton,Pennsylvania,2008,75255,58551,2148,135954,0.5535328125689571,0.43066772584844876,0.015799461582594113,11809,847,-3551,9105,0.05336331970736585,0.0055431726090901835,-0.05890649231645595,16704,15360,0.12286508672050839,0.1122698120238218
11312,42095,Northampton,Pennsylvania,2012,67606,61446,1962,131014,0.5160211885752668,0.4690033126230784,0.014975498801654785,-7649,-186,2895,-4940,-0.037511623993690346,-0.0008239627809393281,0.03833558677462967,6160,-10544,0.04701787595218837,-0.07584721076832002
11313,42095,Northampton,Pennsylvania,2016,66272,71736,6558,144566,0.45842037546864406,0.4962162610849024,0.045363363446453524,-1334,4596,10290,13552,-0.05760081310662274,0.03038786464479874,0.027212948461823983,-5464,-11624,-0.03779588561625835,-0.08481376156844672
11314,42097,Northumberland,Pennsylvania,2000,13670,18142,1442,33254,0.4110783665122993,0.5455584290611656,0.04336320442653516,0,0,0,0,0.0,0.0,0.0,-4472,0,-0.1344800625488663,0.0
11315,42097,Northumberland,Pennsylvania,2004,14602,22262,270,37134,0.39322453815909947,0.5995044972262616,0.007270964614638876,932,-1172,4120,3880,-0.01785382835319982,-0.036092239811896284,0.05394606816509606,-7660,-3188,-0.20627995906716218,-0.07179989651829588
11316,42097,Northumberland,Pennsylvania,2008,14329,19018,767,34114,0.4200328310957378,0.5574837310195228,0.022483437884739402,-273,497,-3244,-3020,0.026808292936638334,0.015212473270100526,-0.04202076620673889,-4689,2971,-0.13745089992378495,0.06882905914337722
11317,42097,Northumberland,Pennsylvania,2012,13072,19518,766,33356,0.3918935124115601,0.5851421033697086,0.022964384218731263,-1257,-1,500,-758,-0.028139318684177683,0.0004809463339918614,0.027658372350185867,-6446,-1757,-0.1932485909581485,-0.05579769103436355
11318,42097,Northumberland,Pennsylvania,2016,9788,25427,1673,36888,0.26534374322272825,0.6893027542832357,0.045353502494036003,-3284,907,5909,3532,-0.12654976918883187,0.02238911827530474,0.10416065091352711,-15639,-9193,-0.4239590110605075,-0.23071042010235898
11319,42099,Perry,Pennsylvania,2000,4459,11184,436,16079,0.27731824118415327,0.6955656446296411,0.02711611418620561,0,0,0,0,0.0,0.0,0.0,-6725,0,-0.41824740344548783,0.0
11320,42099,Perry,Pennsylvania,2004,5423,13919,85,19427,0.2791475781129356,0.7164770679981469,0.004375353888917486,964,-351,2735,3348,0.0018293369287823436,-0.022740760297288123,0.02091142336850582,-8496,-1771,-0.4373294898852113,-0.019082086439723478
11321,42099,Perry,Pennsylvania,2008,6396,13058,394,19848,0.3222490931076179,0.6579000403063281,0.01985086658605401,973,309,-861,421,0.04310151499468229,0.015475512697136522,-0.05857702769181883,-6662,1834,-0.3356509471987102,0.10167854268650112
11322,42099,Perry,Pennsylvania,2012,5685,13120,410,19215,0.29586260733801717,0.6827998959146501,0.021337496747332815,-711,16,62,-633,-0.02638648576960073,0.0014866301612788055,0.024899855608321975,-7435,-773,-0.3869372885766329,-0.051286341377922706
11323,42099,Perry,Pennsylvania,2016,4632,15616,1123,21371,0.21674231435122362,0.7307098404379767,0.05254784521079968,-1053,713,2496,2156,-0.07912029298679354,0.031210348463466864,0.04790994452332664,-10984,-3549,-0.5139675260867531,-0.12703023751012021
11324,42101,Philadelphia,Pennsylvania,2000,449182,100959,11039,561180,0.8004241063473395,0.17990484336576498,0.01967105028689547,0,0,0,0,0.0,0.0,0.0,348223,0,0.6205192629815746,0.0
11325,42101,Philadelphia,Pennsylvania,2004,542205,130099,1765,674069,0.8043761098641237,0.19300546383233763,0.0026184263035386587,93023,-9274,29140,112889,0.003952003516784153,-0.017052623983356812,0.013100620466572649,412106,63883,0.611370646031786,-0.009148616949788524
11326,42101,Philadelphia,Pennsylvania,2008,595980,117221,4824,718025,0.8300268096514746,0.16325476132446642,0.0067184290240590505,53775,3059,-12878,43956,0.025650699787350906,0.004100002720520392,-0.029750702507871207,478759,66653,0.6667720483270081,0.05540140229522206
11327,42101,Philadelphia,Pennsylvania,2012,588806,96467,5503,690776,0.8523834064877761,0.13965019051038252,0.007966403001841408,-7174,679,-20754,-27249,0.022356596836301534,0.0012479739777823571,-0.023604570814083903,492339,13580,0.7127332159773936,0.04596116765038549
11328,42101,Philadelphia,Pennsylvania,2016,584025,108748,16845,709618,0.8230132268347196,0.15324864927327098,0.023738123892009504,-4781,11342,12281,18842,-0.02937017965305655,0.015771720890168095,0.013598458762888455,475277,-17062,0.6697645775614486,-0.042968638415945004
11329,42103,Pike,Pennsylvania,2000,7330,9339,695,17364,0.42213775627735545,0.5378369039391845,0.04002533978346003,0,0,0,0,0.0,0.0,0.0,-2009,0,-0.11569914766182904,0.0
11330,42103,Pike,Pennsylvania,2004,8656,12444,199,21299,0.4064040565284755,0.5842527818207428,0.009343161650781726,1326,-496,3105,3935,-0.015733699748879948,-0.030682178132678307,0.04641587788155832,-3788,-1779,-0.1778487252922673,-0.06214957763043827
11331,42103,Pike,Pennsylvania,2008,11493,12518,273,24284,0.4732745840882886,0.5154834458902982,0.011241970021413276,2837,74,74,2985,0.0668705275598131,0.0018988083706315498,-0.06876933593044465,-1025,2763,-0.042208861802009556,0.13563986349025775
11332,42103,Pike,Pennsylvania,2012,10210,12786,283,23279,0.43859272305511404,0.5492503973538382,0.012156879591047725,-1283,10,268,-1005,-0.034681861033174555,0.0009149095696344492,0.03376695146354003,-2576,-1551,-0.11065767429872414,-0.06844881249671458
11333,42103,Pike,Pennsylvania,2016,9256,16056,972,26284,0.35215340130878103,0.6108659260386547,0.0369806726525643,-954,689,3270,3005,-0.08643932174633301,0.024823793061516573,0.06161552868481657,-6800,-4224,-0.2587125247298737,-0.14805485043114958
11334,42105,Potter,Pennsylvania,2000,2037,4858,199,7094,0.2871440654073865,0.6848040597688188,0.028051874823794756,0,0,0,0,0.0,0.0,0.0,-2821,0,-0.39765999436143223,0.0
11335,42105,Potter,Pennsylvania,2004,2268,5640,54,7962,0.2848530519969857,0.7083647324792766,0.006782215523737754,231,-145,782,868,-0.002291013410400833,-0.021269659300057003,0.02356067271045781,-3372,-551,-0.4235116804822909,-0.02585168612085864
11336,42105,Potter,Pennsylvania,2008,2300,5109,142,7551,0.3045954178254536,0.6765991259435836,0.018805456230962785,32,88,-531,-411,0.01974236582846789,0.012023240707225031,-0.031765606535692936,-2809,563,-0.37200370811813005,0.051507972364160826
11337,42105,Potter,Pennsylvania,2012,1897,5231,151,7279,0.2606127215276824,0.7186426706965242,0.02074460777579338,-403,9,122,-272,-0.043982696297771184,0.001939151544830594,0.04204354475294059,-3334,-525,-0.4580299491688418,-0.08602624105071177
11338,42105,Potter,Pennsylvania,2016,1302,6251,311,7864,0.1655645981688708,0.7948880976602238,0.03954730417090539,-595,160,1020,585,-0.09504812335881158,0.018802696395112013,0.07624542696369963,-4949,-1615,-0.629323499491353,-0.1712935503225112
11339,42107,Schuylkill,Pennsylvania,2000,26215,29841,2244,58300,0.44965694682675816,0.511852487135506,0.038490566037735846,0,0,0,0,0.0,0.0,0.0,-3626,0,-0.062195540308747854,0.0
11340,42107,Schuylkill,Pennsylvania,2004,29231,35640,398,65269,0.44785426465856687,0.5460478940998024,0.00609784124163079,3016,-1846,5799,6969,-0.0018026821681912941,-0.032392724796105055,0.03419540696429635,-6409,-2783,-0.0981936294412355,-0.03599808913248764
11341,42107,Schuylkill,Pennsylvania,2008,28300,33767,1538,63605,0.44493357440452797,0.5308859366402012,0.02418048895527081,-931,1140,-1873,-1664,-0.0029206902540389046,0.018082647713640022,-0.015161957459601139,-5467,942,-0.08595236223567326,0.012241267205562234
11342,42107,Schuylkill,Pennsylvania,2012,24546,32278,1212,58036,0.4229443793507478,0.5561720311530775,0.02088358949617479,-3754,-326,-1489,-5569,-0.021989195053780164,-0.0032968994590960206,0.025286094512876223,-7732,-2265,-0.13322765180232965,-0.04727528956665639
11343,42107,Schuylkill,Pennsylvania,2016,16770,44001,2614,63385,0.2645736372958902,0.6941863216849412,0.041240041019168575,-7776,1402,11723,5349,-0.15837074205485763,0.020356451522993785,0.13801429053186376,-27231,-19499,-0.42961268438905104,-0.2963850325867214
11344,42109,Snyder,Pennsylvania,2000,3536,8963,342,12841,0.27536796199672925,0.6979985982400124,0.026633439763258313,0,0,0,0,0.0,0.0,0.0,-5427,0,-0.4226306362432832,0.0
11345,42109,Snyder,Pennsylvania,2004,4348,10566,69,14983,0.2901955549622906,0.7051992257892278,0.004605219248481613,812,-273,1603,2142,0.014827592965561354,-0.0220282205147767,0.007200627549215355,-6218,-791,-0.4150036708269372,0.007626965416345999
11346,42109,Snyder,Pennsylvania,2008,5382,9900,284,15566,0.345753565463189,0.6360015418219196,0.01824489271489143,1034,215,-666,583,0.055558010500898425,0.013639673466409817,-0.06919768396730819,-4518,1700,-0.29024797635873056,0.12475569446820661
11347,42109,Snyder,Pennsylvania,2012,4687,10073,308,15068,0.3110565436687019,0.6685027873639501,0.020440668967348023,-695,24,173,-498,-0.03469702179448714,0.002195776252456594,0.03250124554203049,-5386,-868,-0.3574462436952482,-0.06719826733651763
11348,42109,Snyder,Pennsylvania,2016,4002,11725,759,16486,0.24275142545189857,0.7112095111003276,0.04603906344777387,-685,451,1652,1418,-0.06830511821680332,0.02559839448042585,0.042706723736377517,-7723,-2337,-0.46845808564842906,-0.11101184195318087
11349,42111,Somerset,Pennsylvania,2000,12028,20218,739,32985,0.3646505987570108,0.6129452781567379,0.022404123086251327,0,0,0,0,0.0,0.0,0.0,-8190,0,-0.24829467939972716,0.0
11350,42111,Somerset,Pennsylvania,2004,12842,23802,134,36778,0.34917613790853225,0.6471803795747457,0.0036434825167219534,814,-605,3584,3793,-0.015474460848478533,-0.018760640569529374,0.034235101418007785,-10960,-2770,-0.2980042416662135,-0.04970956226648632
11351,42111,Somerset,Pennsylvania,2008,12878,21686,804,35368,0.36411445374349694,0.6131531327753902,0.02273241348111287,36,670,-2116,-1410,0.014938315834964688,0.01908893096439092,-0.03402724679935554,-8808,2152,-0.24903867903189325,0.048965562634320225
11352,42111,Somerset,Pennsylvania,2012,9436,23984,658,34078,0.27689418393098186,0.7037971711954927,0.019308644873525443,-3442,-146,2298,-1290,-0.08722026981251507,-0.003423768607587429,0.09064403842010249,-14548,-5740,-0.4269029872645108,-0.17786430823261756
11353,42111,Somerset,Pennsylvania,2016,7376,27379,1318,36073,0.20447426052726417,0.7589887173232057,0.03653702214953012,-2060,660,3395,1995,-0.0724199234037177,0.017228377276004677,0.05519154612771304,-20003,-5455,-0.5545144567959416,-0.12761146953143077
11354,42113,Sullivan,Pennsylvania,2000,1066,1928,111,3105,0.343317230273752,0.6209339774557165,0.035748792270531404,0,0,0,0,0.0,0.0,0.0,-862,0,-0.27761674718196455,0.0
11355,42113,Sullivan,Pennsylvania,2004,1213,2056,16,3285,0.36925418569254187,0.6258751902587519,0.004870624048706241,147,-95,128,180,0.025936955418789875,-0.030878168221825163,0.004941212803035389,-843,19,-0.25662100456621006,0.020995742615754487
11356,42113,Sullivan,Pennsylvania,2008,1233,1841,52,3126,0.3944337811900192,0.5889315419065899,0.016634676903390915,20,36,-215,-159,0.025179595497477336,0.011764052854684674,-0.03694364835216202,-608,235,-0.1944977607165707,0.062123243849639354
11357,42113,Sullivan,Pennsylvania,2012,1034,1868,47,2949,0.35062733129874535,0.6334350627331299,0.01593760596812479,-199,-5,27,-177,-0.04380644989127386,-0.000697070935266126,0.044503520826539966,-834,-226,-0.28280773143438453,-0.08830997071781382
11358,42113,Sullivan,Pennsylvania,2016,750,2291,111,3152,0.23794416243654823,0.7268401015228426,0.03521573604060914,-284,64,423,203,-0.11268316886219712,0.01927813007248435,0.09340503878971274,-1541,-707,-0.48889593908629436,-0.20608820765190983
11359,42115,Susquehanna,Pennsylvania,2000,6481,10226,564,17271,0.3752533148051647,0.592090788026171,0.03265589716866423,0,0,0,0,0.0,0.0,0.0,-3745,0,-0.21683747322100627,0.0
11360,42115,Susquehanna,Pennsylvania,2004,7351,11573,116,19040,0.38608193277310926,0.6078256302521008,0.006092436974789916,870,-448,1347,1769,0.010828617967944543,-0.026563460193874316,0.0157348422259298,-4222,-477,-0.22174369747899153,-0.004906224257985259
11361,42115,Susquehanna,Pennsylvania,2008,8381,10633,401,19415,0.4316765387586917,0.5476693278392996,0.020654133402008758,1030,285,-940,375,0.04559460598558246,0.014561696427218843,-0.06015630241280123,-2252,1970,-0.11599278908060784,0.10575090839838369
11362,42115,Susquehanna,Pennsylvania,2012,6935,10800,381,18116,0.38281077500551997,0.5961580922941047,0.02103113270037536,-1446,-20,167,-1299,-0.048865763753171754,0.00037699929836660165,0.0484887644548051,-3865,-1613,-0.2133473172885847,-0.09735452820797685
11363,42115,Susquehanna,Pennsylvania,2016,5123,12891,1029,19043,0.26902273801396837,0.6769416583521504,0.05403560363388121,-1812,648,2091,927,-0.1137880369915516,0.03300447093350585,0.08078356605804571,-7768,-3903,-0.407918920338182,-0.1945716030495973
11364,42117,Tioga,Pennsylvania,2000,4617,9635,520,14772,0.31255077173030055,0.6522474952613052,0.035201733008394256,0,0,0,0,0.0,0.0,0.0,-5018,0,-0.33969672353100466,0.0
11365,42117,Tioga,Pennsylvania,2004,5437,12019,115,17571,0.30943031130840587,0.6840248136133401,0.006544875078253941,820,-405,2384,2799,-0.0031204604218946774,-0.028656857930140316,0.0317773183520349,-6582,-1564,-0.37459450230493424,-0.03489777877392958
11366,42117,Tioga,Pennsylvania,2008,6390,11326,410,18126,0.35253227408143,0.6248482842325941,0.022619441685975947,953,295,-693,555,0.04310196277302414,0.016074566607722007,-0.059176529380746024,-4936,1646,-0.2723160101511641,0.10227849215377016
11367,42117,Tioga,Pennsylvania,2012,5357,11342,395,17094,0.3133848133848134,0.6635076635076635,0.023107523107523106,-1033,-15,16,-1032,-0.03914746069661662,0.0004880814215471596,0.03865937927506946,-5985,-1049,-0.35012285012285016,-0.07780683997168608
11368,42117,Tioga,Pennsylvania,2016,3901,13614,992,18507,0.21078510833738584,0.7356135516291133,0.05360134003350084,-1456,597,2272,1413,-0.10259970504742755,0.030493816925977732,0.0721058881214498,-9713,-3728,-0.5248284432917275,-0.17470559316887735
11369,42119,Union,Pennsylvania,2000,4209,8523,443,13175,0.3194686907020873,0.6469070208728652,0.03362428842504744,0,0,0,0,0.0,0.0,0.0,-4314,0,-0.32743833017077795,0.0
11370,42119,Union,Pennsylvania,2004,5700,10334,89,16123,0.35353222105067295,0.6409477144452025,0.005520064504124542,1491,-354,1811,2948,0.03406353034858567,-0.028104223920922895,-0.005959306427662736,-4634,-320,-0.28741549339452954,0.040022836776248405
11371,42119,Union,Pennsylvania,2008,7333,9859,283,17475,0.4196280400572246,0.5641773962804005,0.01619456366237482,1633,194,-475,1352,0.06609581900655165,0.010674499158250278,-0.07677031816480195,-2526,2108,-0.14454935622317594,0.1428661371713536
11372,42119,Union,Pennsylvania,2012,6109,9896,325,16330,0.37409675443968154,0.6060012247397428,0.019902020820575628,-1224,42,37,-1145,-0.04553128561754305,0.0037074571582008074,0.041823828459342294,-3787,-1261,-0.23190447030006128,-0.08735511407688534
11373,42119,Union,Pennsylvania,2016,6180,10622,894,17696,0.3492314647377939,0.6002486437613019,0.050519891500904156,71,569,726,1366,-0.024865289701887672,0.030617870680328528,-0.005752580978440891,-4442,-655,-0.25101717902350806,-0.01911270872344678
11374,42121,Venango,Pennsylvania,2000,8196,11642,703,20541,0.3990068643201402,0.5667689012219463,0.03422423445791344,0,0,0,0,0.0,0.0,0.0,-3446,0,-0.16776203690180613,0.0
11375,42121,Venango,Pennsylvania,2004,9024,14472,163,23659,0.3814193330233738,0.6116911112050383,0.00688955577158798,828,-540,2830,3118,-0.017587531296766434,-0.027334678686325463,0.04492220998309193,-5448,-2002,-0.2302717781816645,-0.06250974127985837
11376,42121,Venango,Pennsylvania,2008,9238,13718,525,23481,0.39342447084877136,0.5842170265320897,0.022358502619138878,214,362,-754,-178,0.012005137825397583,0.015468946847550898,-0.02747408467294854,-4480,968,-0.19079255568331838,0.03947922249834612
11377,42121,Venango,Pennsylvania,2012,7945,13815,497,22257,0.35696634766590285,0.6207035988677719,0.0223300534663252,-1293,-28,97,-1224,-0.03645812318286851,-2.8449152813678213e-05,0.0364865723356822,-5870,-1390,-0.2637372512018691,-0.0729446955185507
11378,42121,Venango,Pennsylvania,2016,6309,16021,1200,23530,0.26812579685507865,0.6808754781130472,0.050998725031874206,-1636,703,2206,1273,-0.0888405508108242,0.028668671565549007,0.06017187924527523,-9712,-3842,-0.4127496812579685,-0.14901243005609943
11379,42123,Warren,Pennsylvania,2000,7537,9290,725,17552,0.4294097538742024,0.5292844120328167,0.04130583409298086,0,0,0,0,0.0,0.0,0.0,-1753,0,-0.09987465815861435,0.0
11380,42123,Warren,Pennsylvania,2004,8044,10999,230,19273,0.4173714522907695,0.5706947543195143,0.011933793389716183,507,-495,1709,1721,-0.012038301583432887,-0.029372040703264678,0.0414103422866976,-2955,-1202,-0.15332330202874483,-0.053448643870130486
11381,42123,Warren,Pennsylvania,2008,8537,9685,441,18663,0.45742913786636663,0.518941220596903,0.02362964153673043,493,211,-1314,-610,0.040057685575597135,0.011695848147014248,-0.05175353372261138,-1148,1807,-0.06151208273053632,0.09181121929820851
11382,42123,Warren,Pennsylvania,2012,6995,10010,294,17299,0.40435863344702005,0.5786461645181803,0.0169952020347997,-1542,-147,325,-1364,-0.053070504419346576,-0.006634439501930732,0.05970494392127734,-3015,-1867,-0.17428753107116024,-0.11277544834062392
11383,42123,Warren,Pennsylvania,2016,5145,12477,812,18434,0.2791038298795704,0.6768471303027015,0.04404903981772811,-1850,518,2467,1135,-0.12525480356744967,0.027053837782928414,0.0982009657845212,-7332,-4317,-0.3977433004231311,-0.22345576935197087
11384,42125,Washington,Pennsylvania,2000,44961,37339,2141,84441,0.5324546132802785,0.4421904051349463,0.025354981584775168,0,0,0,0,0.0,0.0,0.0,7622,0,0.09026420814533226,0.0
11385,42125,Washington,Pennsylvania,2004,48225,47673,279,96177,0.5014192582426151,0.4956798402944571,0.002900901462927727,3264,-1862,10334,11736,-0.031035355037663415,-0.02245408012184744,0.05348943515951082,552,-7070,0.005739417948158021,-0.08452479019717424
11386,42125,Washington,Pennsylvania,2008,46122,50752,1642,98516,0.4681676072922165,0.5151650493320882,0.01666734337569532,-2103,1363,3079,2339,-0.033251650950398615,0.013766441912767593,0.019485209037631068,-4630,-5182,-0.04699744203987166,-0.05273685998802968
11387,42125,Washington,Pennsylvania,2012,40345,53230,1403,94978,0.4247825812293373,0.5604455768704332,0.014771841900229527,-5777,-239,2478,-3538,-0.043385026062879195,-0.0018955014754657926,0.045280527538344995,-12885,-8255,-0.13566299564109585,-0.08866555360122419
11388,42125,Washington,Pennsylvania,2016,36322,61386,4559,102267,0.3551683338711412,0.6002522807943912,0.04457938533446762,-4023,3156,8156,7289,-0.0696142473581961,0.029807543434238092,0.03980670392395802,-25064,-12179,-0.24508394692324997,-0.10942095128215412
11389,42127,Wayne,Pennsylvania,2000,6904,11201,811,18916,0.364982025798266,0.5921442165362656,0.04287375766546839,0,0,0,0,0.0,0.0,0.0,-4297,0,-0.2271621907379996,0.0
11390,42127,Wayne,Pennsylvania,2004,8060,13713,194,21967,0.3669140073746984,0.6242545636636774,0.008831428961624255,1156,-617,2512,3051,0.0019319815764324288,-0.03404232870384413,0.03211034712741179,-5653,-1356,-0.25734055628897895,-0.030178365550979358
11391,42127,Wayne,Pennsylvania,2008,9892,12702,338,22932,0.43136228850514563,0.553898482469911,0.01473922902494331,1832,144,-1011,965,0.0644482811304472,0.005907800063319056,-0.07035608119376635,-2810,2843,-0.1225361939647654,0.13480436232421356
11392,42127,Wayne,Pennsylvania,2012,8396,12896,371,21663,0.3875732816322762,0.5953007432026959,0.017125975165027927,-1496,33,194,-1269,-0.04378900687286941,0.002386746140084616,0.04140226073278486,-4500,-1690,-0.20772746157041966,-0.08519126760565426
11393,42127,Wayne,Pennsylvania,2016,7008,16244,766,24018,0.2917811641269048,0.6763260887667583,0.03189274710633691,-1388,395,3348,2355,-0.09579211750537142,0.014766771941308984,0.08102534556406238,-9236,-4736,-0.38454492463985346,-0.1768174630694338
11394,42129,Westmoreland,Pennsylvania,2000,71792,80858,4059,156709,0.4581230178228436,0.5159754704579826,0.025901511719173754,0,0,0,0,0.0,0.0,0.0,-9066,0,-0.05785245263513905,0.0
11395,42129,Westmoreland,Pennsylvania,2004,77774,100087,835,178696,0.43523078300577517,0.5600964766978556,0.004672740296369253,5982,-3224,19229,21987,-0.022892234817068424,-0.0212287714228045,0.04412100623987292,-22313,-13247,-0.12486569369208039,-0.06701324105694134
11396,42129,Westmoreland,Pennsylvania,2008,72721,102294,2532,177547,0.4095873205404766,0.5761516668825719,0.014261012576951455,-5053,1697,2207,-1149,-0.025643462465298583,0.009588272280582202,0.01605519018471635,-29573,-7260,-0.16656434634209533,-0.041698652650014933
11397,42129,Westmoreland,Pennsylvania,2012,63722,103932,1918,169572,0.3757813790012502,0.6129077913806524,0.011310829618097328,-8999,-614,1638,-7975,-0.03380594153922639,-0.002950182958854127,0.03675612449808052,-40210,-10637,-0.23712641237940224,-0.07056206603730691
11398,42129,Westmoreland,Pennsylvania,2016,59669,116522,7301,183492,0.3251858391646502,0.6350249602162492,0.03978920061910056,-4053,5383,12590,13920,-0.05059553983659998,0.02847837100100323,0.02211716883559678,-56853,-16643,-0.309839121051599,-0.07271270867219676
11399,42131,Wyoming,Pennsylvania,2000,4363,6922,424,11709,0.3726193526347254,0.5911691860961653,0.036211461269109235,0,0,0,0,0.0,0.0,0.0,-2559,0,-0.2185498334614399,0.0
11400,42131,Wyoming,Pennsylvania,2004,4982,7782,68,12832,0.38824812967581046,0.6064526184538653,0.00529925187032419,619,-356,860,1123,0.015628777041085062,-0.030912209398785046,0.015283432357700022,-2800,-241,-0.21820448877805487,0.00034534468338504043
11401,42131,Wyoming,Pennsylvania,2008,5985,6983,255,13223,0.4526204340921122,0.5280949860092263,0.019284579898661423,1003,187,-799,391,0.06437230441630176,0.013985328028337234,-0.078357632444639,-998,1802,-0.07547455191711411,0.14272993686094076
11402,42131,Wyoming,Pennsylvania,2012,5061,6587,270,11918,0.4246517872126196,0.5526934049337137,0.022654807853666723,-924,15,-396,-1305,-0.02796864687949263,0.0033702279550053005,0.02459841892448733,-1526,-528,-0.12804161772109407,-0.05256706580397996
11403,42131,Wyoming,Pennsylvania,2016,3811,8837,607,13255,0.2875141456054319,0.6666918144096567,0.045794039984911356,-1250,337,2250,1337,-0.13713764160718767,0.023139232131244632,0.11399840947594309,-5026,-3500,-0.3791776688042248,-0.25113605108313075
11404,42133,York,Pennsylvania,2000,51958,87652,4676,144286,0.36010423741735165,0.6074879059645426,0.032407856618105704,0,0,0,0,0.0,0.0,0.0,-35694,0,-0.24738366854719096,0.0
11405,42133,York,Pennsylvania,2004,63701,114270,1298,179269,0.3553375095526834,0.6374219747976505,0.007240515649666144,11743,-3378,26618,34983,-0.004766727864668252,-0.02516734096843956,0.029934068833107896,-50569,-14875,-0.2820844652449671,-0.03470079669777615
11406,42133,York,Pennsylvania,2008,82839,109268,3179,195286,0.4241932345380621,0.559528076769456,0.016278688692481797,19138,1881,-5002,16017,0.06885572498537873,0.009038173042815654,-0.07789389802819446,-26429,24140,-0.13533484223139391,0.1467496230135732
11407,42133,York,Pennsylvania,2012,73191,113304,3440,189935,0.3853476189222629,0.5965409218943323,0.01811145918340485,-9648,261,4036,-5351,-0.038845615615799245,0.0018327704909230531,0.03701284512487624,-40113,-13684,-0.2111933029720694,-0.07585846074067548
11408,42133,York,Pennsylvania,2016,68524,128528,10977,208029,0.32939638223516915,0.6178369361963957,0.05276668156843517,-4667,7537,15224,18094,-0.05595123668709373,0.03465522238503032,0.021296014302063404,-60004,-19891,-0.28844055396122653,-0.07724725098915713
11409,44001,Bristol,Rhode Island,2000,13424,8375,1473,23272,0.576830525953936,0.359874527328979,0.06329494671708491,0,0,0,0,0.0,0.0,0.0,5049,0,0.216955998624957,0.0
11410,44001,Bristol,Rhode Island,2004,14448,9855,429,24732,0.58418243571082,0.39847161572052403,0.017345948568655994,1024,-1044,1480,1460,0.007351909756883934,-0.04594899814842891,0.03859708839154502,4593,-456,0.18571081999029593,-0.031245178634661086
11411,44001,Bristol,Rhode Island,2008,16162,9260,483,25905,0.6238950009650647,0.3574599498166377,0.018645049218297627,1714,54,-595,1173,0.039712565254244714,0.001299100649641633,-0.04101166590388633,6902,2309,0.26643505114842697,0.08072423115813104
11412,44001,Bristol,Rhode Island,2012,14974,9231,471,24676,0.6068244448046685,0.37408818284973255,0.01908737234559896,-1188,-12,-29,-1229,-0.01707055616039621,0.0004423231273013341,0.016628233033094852,5743,-1159,0.2327362619549359,-0.03369878919349106
11413,44001,Bristol,Rhode Island,2016,14609,8965,1901,25475,0.5734641805691855,0.35191364082433757,0.07462217860647694,-365,1430,-266,799,-0.033360264235482995,0.05553480626087798,-0.022174542025394983,5644,-99,0.2215505397448479,-0.011185722210088012
11414,44003,Kent,Rhode Island,2000,43265,25291,4914,73470,0.5888798148904315,0.3442357424799238,0.06688444262964476,0,0,0,0,0.0,0.0,0.0,17974,0,0.24464407241050773,0.0
11415,44003,Kent,Rhode Island,2004,42830,33699,1489,78018,0.5489758773616344,0.4319387833576867,0.019085339280678817,-435,-3425,8408,4548,-0.03990393752879706,-0.047799103348965935,0.08770304087776293,9131,-8843,0.11703709400394774,-0.12760697840656
11416,44003,Kent,Rhode Island,2008,48406,33780,1888,84074,0.5757546922948831,0.4017889002545377,0.022456407450579252,5576,399,81,6056,0.02677881493324863,0.0033710681699004354,-0.030149883103149033,14626,5495,0.1739657920403454,0.05692869803639766
11417,44003,Kent,Rhode Island,2012,45564,31567,1792,78923,0.5773222001191034,0.3999721247291664,0.022705675151730168,-2842,-96,-2213,-5151,0.0015675078242203266,0.00024926770115091604,-0.0018167755253712947,13997,-629,0.17735007538993702,0.0033842833495916214
11418,44003,Kent,Rhode Island,2016,37788,38336,5929,82053,0.4605316076194655,0.4672102177860651,0.07225817459446943,-7776,4137,6769,3130,-0.11679059249963791,0.04955249944273926,0.0672380930568987,-548,-14545,-0.006678610166599597,-0.18402868555653662
11419,44005,Newport,Rhode Island,2000,20790,14258,2790,37838,0.5494476452243776,0.37681695649875785,0.07373539827686452,0,0,0,0,0.0,0.0,0.0,6532,0,0.17263068872561976,0.0
11420,44005,Newport,Rhode Island,2004,22992,16622,812,40426,0.5687428882402414,0.41117102854598525,0.020086083213773313,2202,-1978,2364,2588,0.019295243015863828,-0.053649315063091216,0.0343540720472274,6370,-162,0.1575718596942562,-0.015058829031363574
11421,44005,Newport,Rhode Island,2008,25479,15717,801,41997,0.6066861918708479,0.3742410172155154,0.01907279091363669,2487,-11,-905,1571,0.037943303630606495,-0.0010132923001366229,-0.03693001133046986,9762,3392,0.23244517465533254,0.07487331496107635
11422,44005,Newport,Rhode Island,2012,23463,15202,787,39452,0.5947227010037514,0.3853290074013992,0.019948291594849437,-2016,-14,-515,-2545,-0.011963490867096582,0.0008755006812127472,0.0110879901858838,8261,-1501,0.20939369360235216,-0.023051481052980383
11423,44005,Newport,Rhode Island,2016,22851,15077,3117,41045,0.5567304178340845,0.36732854184431724,0.07594104032159825,-612,2330,-125,1593,-0.03799228316966685,0.05599274872674881,-0.018000465557081957,7774,-487,0.18940187598976727,-0.019991817612584895
11424,44007,Providence,Rhode Island,2000,142469,61378,14461,218308,0.6526054931564579,0.2811532330468879,0.06624127379665427,0,0,0,0,0.0,0.0,0.0,81091,0,0.37145226010957,0.0
11425,44007,Providence,Rhode Island,2004,144811,82337,4176,231324,0.6260094067195795,0.35593799173453683,0.018052601545883694,2342,-10285,20959,13016,-0.026596086436878386,-0.04818867225077058,0.07478475868764894,62474,-18617,0.27007141498504267,-0.10138084512452733
11426,44007,Providence,Rhode Island,2008,167442,81010,5178,253630,0.6601821551078343,0.31940227891022355,0.020415565981942198,22631,1002,-1327,22306,0.03417274838825479,0.002362964436058504,-0.03653571282431328,86432,23958,0.34077987619761074,0.07070846121256807
11427,44007,Providence,Rhode Island,2012,159520,75785,4481,239786,0.6652598567055624,0.31605264694352464,0.018687496350912897,-7922,-697,-5225,-13844,0.005077701597728135,-0.0017280696310293005,-0.003349631966698907,83735,-2697,0.3492072097620378,0.008427333564427042
11428,44007,Providence,Rhode Island,2016,142899,90882,14693,248474,0.5751064497693924,0.36576060271899674,0.05913294751161087,-16621,10212,15097,8688,-0.09015340693617002,0.040445451160697976,0.0497079557754721,52017,-31718,0.20934584705039566,-0.13986136271164212
11429,44009,Washington,Rhode Island,2000,29560,21253,5411,56224,0.5257541263517359,0.37800583380762665,0.09624003984063745,0,0,0,0,0.0,0.0,0.0,8307,0,0.14774829254410926,0.0
11430,44009,Washington,Rhode Island,2004,34679,26533,1422,62634,0.5536769166906154,0.4236197592361976,0.022703324073187085,5119,-3989,5280,6410,0.027922790338879455,-0.07353671576745036,0.045613925428570956,8146,-161,0.13005715745441776,-0.0176911350896915
11431,44009,Washington,Rhode Island,2008,39082,25624,1454,66160,0.5907194679564691,0.38730350665054414,0.0219770253929867,4403,32,-909,3526,0.03704255126585376,-0.0007262986802003858,-0.036316252585653463,13458,5312,0.20341596130592499,0.07335880385150723
11432,44009,Washington,Rhode Island,2012,35888,25366,1625,62879,0.5707469902511172,0.40340972343707754,0.025843286311805214,-3194,171,-258,-3281,-0.019972477705351932,0.003866260918818514,0.0161062167865334,10522,-2936,0.16733726681403965,-0.03607869449188533
11433,44009,Washington,Rhode Island,2016,33741,27230,5398,66369,0.5083849387515256,0.41028190872244574,0.08133315252602871,-2147,3773,1864,3490,-0.06236205149959162,0.0554898662142235,0.006872185285368204,6511,-4011,0.09810303002907983,-0.06923423678495982
11434,45001,Abbeville,South Carolina,2000,3766,4450,158,8374,0.44972534033914496,0.5314067351325531,0.018867924528301886,0,0,0,0,0.0,0.0,0.0,-684,0,-0.08168139479340814,0.0
11435,45001,Abbeville,South Carolina,2004,4389,5436,100,9925,0.44221662468513856,0.5477078085642317,0.010075566750629723,623,-58,986,1551,-0.007508715654006404,-0.008792357777672163,0.016301073431678637,-1047,-363,-0.10549118387909318,-0.02380978908568504
11436,45001,Abbeville,South Carolina,2008,4593,6264,144,11001,0.41750749931824377,0.5694027815653122,0.01308971911644396,204,44,828,1076,-0.02470912536689479,0.0030141523658142374,0.021694973001080475,-1671,-624,-0.15189528224706844,-0.046404098367975266
11437,45001,Abbeville,South Carolina,2012,4543,5981,147,10671,0.4257332958485615,0.56049105051073,0.013775653640708463,-50,3,-283,-330,0.008225796530317742,0.0006859345242645025,-0.008911731054582206,-1438,233,-0.1347577546621685,0.017137527584899948
11438,45001,Abbeville,South Carolina,2016,3741,6763,271,10775,0.3471925754060325,0.6276566125290023,0.025150812064965198,-802,124,782,104,-0.07854072044252902,0.011375158424256735,0.06716556201827228,-3022,-1584,-0.2804640371229698,-0.1457062824608013
11439,45003,Aiken,South Carolina,2000,16409,33203,1170,50782,0.32312630459611674,0.6538340356819345,0.023039659721948724,0,0,0,0,0.0,0.0,0.0,-16794,0,-0.3307077310858178,0.0
11440,45003,Aiken,South Carolina,2004,19799,39077,616,59492,0.33280104888052175,0.6568446177637329,0.01035433335574531,3390,-554,5874,8710,0.009674744284405012,-0.012685326366203413,0.0030105820817983853,-19278,-2484,-0.3240435688832112,0.006664162202606627
11441,45003,Aiken,South Carolina,2008,26101,42849,820,69770,0.37410061631073527,0.6141464812956858,0.011752902393578903,6302,204,3772,10278,0.04129956743021351,0.0013985690378335927,-0.0426981364680471,-16748,2530,-0.24004586498495056,0.08399770389826061
11442,45003,Aiken,South Carolina,2012,25322,44042,999,70363,0.35987663971121187,0.625925557466282,0.014197802822506147,-779,179,1193,593,-0.014223976599523402,0.0024449004289272443,0.011779076170596148,-18720,-1972,-0.2660489177550701,-0.02600305277011955
11443,45003,Aiken,South Carolina,2016,25455,46025,3371,74851,0.3400756168922259,0.6148882446460301,0.045036138461744,133,2372,1983,4488,-0.01980102281898599,0.03083833563923785,-0.011037312820251888,-20570,-1850,-0.2748126277538042,-0.008763709998734104
11444,45005,Allendale,South Carolina,2000,2338,967,35,3340,0.7,0.2895209580838323,0.010479041916167664,0,0,0,0,0.0,0.0,0.0,1371,0,0.41047904191616763,0.0
11445,45005,Allendale,South Carolina,2004,2565,985,41,3591,0.7142857142857143,0.27429685324422165,0.011417432470064048,227,6,18,251,0.014285714285714346,0.0009383905538963844,-0.015224104839610675,1580,209,0.43998886104149265,0.02950981912532502
11446,45005,Allendale,South Carolina,2008,3029,947,48,4024,0.7527335984095428,0.235337972166998,0.011928429423459244,464,7,-38,433,0.03844788412382849,0.0005109969533951958,-0.038958881077223645,2082,502,0.5173956262425448,0.07740676520105211
11447,45005,Allendale,South Carolina,2012,3297,838,28,4163,0.7919769397069422,0.20129714148450636,0.006725918808551525,268,-20,-109,139,0.03924334129739937,-0.005202510614907719,-0.03404083068249164,2459,377,0.5906797982224358,0.07328417197989101
11448,45005,Allendale,South Carolina,2016,2735,789,68,3592,0.7614142538975501,0.21965478841870825,0.01893095768374165,-562,40,-49,-571,-0.03056268580939203,0.012205038875190123,0.018357646934201888,1946,-513,0.5417594654788419,-0.048920332743593864
11449,45007,Anderson,South Carolina,2000,19606,35827,1248,56681,0.34590074275330357,0.6320812970836789,0.02201796016301759,0,0,0,0,0.0,0.0,0.0,-16221,0,-0.2861805543303753,0.0
11450,45007,Anderson,South Carolina,2004,20697,43355,670,64722,0.31978307221655694,0.669864960909737,0.010351966873706004,1091,-578,7528,8041,-0.02611767053674663,-0.011665993289311585,0.037783663826058134,-22658,-6437,-0.3500818886931801,-0.06390133436280476
11451,45007,Anderson,South Carolina,2008,24132,48690,965,73787,0.32704948026075054,0.659872335235204,0.013078184504045428,3435,295,5335,9065,0.007266408044193595,0.0027262176303394243,-0.009992625674532962,-24558,-1900,-0.3328228549744535,0.017259033718726557
11452,45007,Anderson,South Carolina,2012,22405,48709,1098,72212,0.31026699163573923,0.6745277793164571,0.015205229047803689,-1727,133,19,-1575,-0.016782488625011305,0.0021270445437582605,0.014655444081253077,-26304,-1746,-0.3642607876807179,-0.03143793270626438
11453,45007,Anderson,South Carolina,2016,21097,56232,3154,80483,0.26212989078438925,0.6986817091808208,0.039188400034789954,-1308,2056,7523,8271,-0.04813710085134998,0.023983170986986265,0.02415392986436371,-35135,-8831,-0.4365518183964316,-0.07229103071571369
11454,45009,Bamberg,South Carolina,2000,3451,2047,53,5551,0.6216897856242118,0.36876238515582777,0.009547829219960368,0,0,0,0,0.0,0.0,0.0,1404,0,0.2529274004683841,0.0
11455,45009,Bamberg,South Carolina,2004,3841,2138,57,6036,0.6363485752153745,0.35420808482438704,0.009443339960238568,390,4,91,485,0.014658789591162624,-0.00010448925972180063,-0.014554300331440728,1703,299,0.28214049039098743,0.029213089922603352
11456,45009,Bamberg,South Carolina,2008,4426,2309,79,6814,0.6495450542999707,0.3388611681831523,0.011593777516877018,585,22,171,778,0.013196479084596202,0.0021504375566384504,-0.01534691664123472,2117,414,0.31068388611681835,0.028543395725830922
11457,45009,Bamberg,South Carolina,2012,4624,2194,64,6882,0.6718977041557687,0.3188026736413833,0.00929962220284801,198,-15,-115,68,0.02235264985579799,-0.0022941553140290085,-0.020058494541769,2430,313,0.35309503051438534,0.04241114439756699
11458,45009,Bamberg,South Carolina,2016,3898,2204,112,6214,0.6272932088831671,0.35468297392983583,0.018023817186997103,-726,48,10,-668,-0.044604495272601574,0.008724194984149093,0.035880300288452516,1694,-736,0.27261023495333125,-0.08048479556105409
11459,45011,Barnwell,South Carolina,2000,3661,4521,94,8276,0.44236346060898984,0.5462783953600774,0.011358144030932818,0,0,0,0,0.0,0.0,0.0,-860,0,-0.10391493475108754,0.0
11460,45011,Barnwell,South Carolina,2004,3982,4606,97,8685,0.4584916522740357,0.5303396660909614,0.011168681635002878,321,3,85,409,0.016128191665045866,-0.0001894623959299395,-0.015938729269115992,-624,236,-0.07184801381692568,0.03206692093416186
11461,45011,Barnwell,South Carolina,2008,4931,4769,98,9798,0.5032659726474791,0.48673198611961627,0.010002041232904674,949,1,163,1113,0.044774320373443366,-0.0011666404020982037,-0.043607679971345126,162,786,0.01653398652786281,0.08838200034478849
11462,45011,Barnwell,South Carolina,2012,5188,4659,76,9923,0.522825758339212,0.46951526756021367,0.007658974100574423,257,-22,-110,125,0.01955978569173289,-0.0023430671323302517,-0.0172167185594026,529,367,0.0533104907789983,0.03677650425113549
11463,45011,Barnwell,South Carolina,2016,4400,4889,196,9485,0.46389035318924615,0.5154454401686874,0.020664206642066422,-788,120,230,-438,-0.058935405149965814,0.013005232541491999,0.04593017260847376,-489,-1018,-0.05155508697944128,-0.10486557775843958
11464,45013,Beaufort,South Carolina,2000,17487,25561,1100,44148,0.39609948355531394,0.5789843254507565,0.02491619099392951,0,0,0,0,0.0,0.0,0.0,-8074,0,-0.18288484189544257,0.0
11465,45013,Beaufort,South Carolina,2004,21505,33331,399,55235,0.38933647144021,0.6034398479225129,0.007223680637277088,4018,-701,7770,11087,-0.006763012115103939,-0.01769251035665242,0.02445552247175642,-11826,-3752,-0.21410337648230293,-0.031218534586860358
11466,45013,Beaufort,South Carolina,2008,30396,37821,653,68870,0.4413532742848846,0.5491650936547118,0.00948163206040366,8891,254,4490,13635,0.05201680284467458,0.0022579514231265713,-0.05427475426780115,-7425,4401,-0.1078118193698272,0.10629155711247573
11467,45013,Beaufort,South Carolina,2012,29848,42687,762,73297,0.4072199407888454,0.5823839993451301,0.01039605986602453,-548,109,4866,4427,-0.0341333334960392,0.000914427805620871,0.0332189056904183,-12839,-5414,-0.1751640585562847,-0.0673522391864575
11468,45013,Beaufort,South Carolina,2016,32138,42922,3464,78524,0.4092761448729051,0.5466099536447455,0.044113901482349345,2290,2702,235,5227,0.0020562040840597096,0.033717841616324816,-0.03577404570038456,-10784,2055,-0.13733380877184043,0.03783024978444427
11469,45015,Berkeley,South Carolina,2000,17707,24796,813,43316,0.4087865915597008,0.5724443623603287,0.01876904607997045,0,0,0,0,0.0,0.0,0.0,-7089,0,-0.16365777080062788,0.0
11470,45015,Berkeley,South Carolina,2004,20142,32104,691,52937,0.3804900164346298,0.606456731586603,0.013053251978767213,2435,-122,7308,9621,-0.028296575125071,-0.005715794101203238,0.034012369226274264,-11962,-4873,-0.22596671515197314,-0.06230894435134526
11471,45015,Berkeley,South Carolina,2008,27755,36205,821,64781,0.4284435251076705,0.5588830058196076,0.01267346907272194,7613,130,4101,11844,0.04795350867304066,-0.0003797829060452739,-0.04757372576699537,-8450,3512,-0.13043948071193712,0.09552723444003602
11472,45015,Berkeley,South Carolina,2012,28542,38475,1178,68195,0.41853508321724464,0.564190923088203,0.017273993694552386,787,357,2270,3414,-0.009908441890425834,0.0046005246218304464,0.0053079172685953635,-9933,-1483,-0.14565583987095831,-0.015216359159021198
11473,45015,Berkeley,South Carolina,2016,30705,44587,4225,79517,0.3861438434548587,0.56072286429317,0.053133292251971276,2163,3047,6112,11322,-0.03239123976238595,0.03585929855741889,-0.00346805879503298,-13882,-3949,-0.17457902083831128,-0.02892318096735297
11474,45017,Calhoun,South Carolina,2000,3063,3216,94,6373,0.48062137141063865,0.5046289031853131,0.01474972540404833,0,0,0,0,0.0,0.0,0.0,-153,0,-0.024007531774674407,0.0
11475,45017,Calhoun,South Carolina,2004,3393,3448,78,6919,0.4903887845064316,0.49833791010261597,0.01127330539095245,330,-16,232,546,0.009767413095792932,-0.0034764200130958794,-0.006290993082697094,-55,98,-0.007949125596184381,0.016058406178490026
11476,45017,Calhoun,South Carolina,2008,3970,3695,73,7738,0.5130524683380718,0.4775135693977772,0.009433962264150943,577,-5,247,819,0.022663683831640247,-0.001839343126801507,-0.02082434070483874,275,330,0.035538898940294605,0.043488024536478986
11477,45017,Calhoun,South Carolina,2012,4045,3707,82,7834,0.5163390349757467,0.4731937707429155,0.010467194281337758,75,9,12,96,0.0032865666376749036,0.0010332320171868147,-0.004319798654861706,338,63,0.043145264232831215,0.00760636529253661
11478,45017,Calhoun,South Carolina,2016,3573,3787,189,7549,0.4733077228772023,0.5016558484567493,0.025036428666048483,-472,107,80,-285,-0.04303131209854444,0.014569234384710725,0.028462077713833744,-214,-552,-0.028348125579546968,-0.07149338981237818
11479,45019,Charleston,South Carolina,2000,49520,58229,3727,111476,0.4442211776525889,0.5223456169937923,0.03343320535361872,0,0,0,0,0.0,0.0,0.0,-8709,0,-0.07812443934120344,0.0
11480,45019,Charleston,South Carolina,2004,63758,70297,2261,136316,0.4677220575721119,0.5156914815575574,0.0165864608703307,14238,-1466,12068,24840,0.023500879919522988,-0.016846744483288018,-0.0066541354362349425,-6539,2170,-0.047969423985445514,0.03015501535575793
11481,45019,Charleston,South Carolina,2008,82698,69822,1914,154434,0.5354908893119391,0.452115466801352,0.012393643886708886,18940,-347,-475,18118,0.06776883173982723,-0.0041928169836218145,-0.06357601475620539,12876,19415,0.0833754225105871,0.13134484649603262
11482,45019,Charleston,South Carolina,2012,81487,77629,2591,161707,0.5039175793255704,0.48005961399320995,0.016022806681219737,-1211,677,7807,7273,-0.03157330998636876,0.0036291627945108512,0.02794414719185795,3858,-9018,0.023857965332360398,-0.05951745717822671
11483,45019,Charleston,South Carolina,2016,89299,75443,11603,176345,0.5063880461595168,0.4278147948623437,0.06579715897813944,7812,9012,-2186,14638,0.002470466833946472,0.049774352296919705,-0.05224481913086626,13856,9998,0.07857325129717313,0.05471528596481273
11484,45021,Cherokee,South Carolina,2000,6138,9900,285,16323,0.37603381731299396,0.6065061569564418,0.017460025730564235,0,0,0,0,0.0,0.0,0.0,-3762,0,-0.23047233964344788,0.0
11485,45021,Cherokee,South Carolina,2004,6466,12090,158,18714,0.34551672544619,0.6460403975633215,0.008442876990488405,328,-127,2190,2391,-0.030517091866803958,-0.00901714874007583,0.03953424060687971,-5624,-1862,-0.30052367211713155,-0.07005133247368367
11486,45021,Cherokee,South Carolina,2008,7215,13305,246,20766,0.34744293556775496,0.6407107772320139,0.011846287200231146,749,88,1215,2052,0.001926210121564964,0.0034034102097427413,-0.005329620331307683,-6090,-466,-0.2932678416642589,0.007255830452872647
11487,45021,Cherokee,South Carolina,2012,7231,13314,228,20773,0.34809608626582583,0.6409281278582776,0.010975785875896597,16,-18,9,7,0.0006531506980708701,-0.0008705013243345498,0.0002173506262637126,-6083,7,-0.29283204159245174,0.0004358000718071575
11488,45021,Cherokee,South Carolina,2016,6092,15167,500,21759,0.27997610184291555,0.6970449009605221,0.02297899719656234,-1139,272,1853,986,-0.06811998442291028,0.012003211320665744,0.0561167731022445,-9075,-2992,-0.4170687991176065,-0.12423675752515478
11489,45023,Chester,South Carolina,2000,5242,4986,204,10432,0.5024923312883436,0.47795245398773006,0.019555214723926382,0,0,0,0,0.0,0.0,0.0,256,0,0.024539877300613522,0.0
11490,45023,Chester,South Carolina,2004,5790,5798,141,11729,0.49364822235484696,0.49433029243754795,0.01202148520760508,548,-63,812,1297,-0.00884410893349663,-0.007533729516321301,0.016377838449817883,-8,-264,-0.0006820700827009918,-0.025221947383314514
11491,45023,Chester,South Carolina,2008,7478,6318,185,13981,0.5348687504470353,0.451899005793577,0.013232243759387741,1688,44,520,2252,0.04122052809218835,0.0012107585517826605,-0.042431286643970945,1160,1168,0.0829697446534583,0.08365181473615929
11492,45023,Chester,South Carolina,2012,7891,6367,149,14407,0.5477198584021656,0.4419379468314014,0.010342194766432984,413,-36,49,426,0.012851107955130336,-0.0028900489929547576,-0.009961058962175584,1524,364,0.10578191157076422,0.02281216691730592
11493,45023,Chester,South Carolina,2016,6579,7265,348,14192,0.46357102593010147,0.5119081172491544,0.02452085682074408,-1312,199,898,-215,-0.08414883247206417,0.014178662054311097,0.069970170417753,-686,-2210,-0.04833709131905295,-0.15411900288981717
11494,45025,Chesterfield,South Carolina,2000,6111,6266,149,12526,0.48786524030017564,0.5002395018361807,0.011895257863643621,0,0,0,0,0.0,0.0,0.0,-155,0,-0.012374261536005071,0.0
11495,45025,Chesterfield,South Carolina,2004,6729,7252,68,14049,0.47896647448216956,0.5161933233682112,0.00484020214961919,618,-81,986,1523,-0.008898765818006082,-0.007055055714024431,0.01595382153203051,-523,-368,-0.037226848886041664,-0.024852587350036592
11496,45025,Chesterfield,South Carolina,2008,7842,8325,192,16359,0.4793691545938016,0.5088941866862278,0.011736658719970658,1113,124,1073,2310,0.00040268011163202555,0.006896456570351468,-0.0072991366819834536,-483,40,-0.029525032092426184,0.007701816793615479
11497,45025,Chesterfield,South Carolina,2012,7958,8490,146,16594,0.4795709292515367,0.5116307098951428,0.008798360853320477,116,-46,165,235,0.00020177465773513203,-0.0029382978666501816,0.0027365232089150426,-532,-49,-0.032059780643606095,-0.0025347485511799106
11498,45025,Chesterfield,South Carolina,2016,6858,9312,411,16581,0.4136059345033472,0.5616066582232676,0.0247874072733852,-1100,265,822,-13,-0.06596499474818951,0.015989046420064726,0.0499759483281248,-2454,-1922,-0.1480007237199204,-0.1159409430763143
11499,45027,Clarendon,South Carolina,2000,5999,5186,105,11290,0.5313551815766164,0.45934455270150576,0.009300265721877768,0,0,0,0,0.0,0.0,0.0,813,0,0.07201062887511067,0.0
11500,45027,Clarendon,South Carolina,2004,7087,6061,52,13200,0.5368939393939394,0.45916666666666667,0.00393939393939394,1088,-53,875,1910,0.005538757817322937,-0.005360871782483828,-0.00017788603483909204,1026,213,0.0777272727272727,0.005716643852162029
11501,45027,Clarendon,South Carolina,2008,8673,6758,121,15552,0.5576774691358025,0.43454218106995884,0.007780349794238683,1586,69,697,2352,0.02078352974186315,0.0038409558548447437,-0.024624485596707824,1915,889,0.12313528806584367,0.04540801533857097
11502,45027,Clarendon,South Carolina,2012,9091,7071,130,16292,0.5580039283083722,0.4340166953105819,0.007979376381045912,418,9,313,740,0.00032645917256968193,0.0001990265868072284,-0.0005254857593769424,2020,105,0.1239872329977903,0.0008519449319466244
11503,45027,Clarendon,South Carolina,2016,7732,7386,277,15395,0.5022409873335498,0.47976615784345567,0.017992854822994477,-1359,147,315,-897,-0.05576294097482237,0.010013478441948566,0.045749462532873764,346,-1674,0.02247482949009416,-0.10151240350769614
11504,45029,Colleton,South Carolina,2000,6449,6767,174,13390,0.48162808065720686,0.5053771471247199,0.01299477221807319,0,0,0,0,0.0,0.0,0.0,-318,0,-0.02374906646751307,0.0
11505,45029,Colleton,South Carolina,2004,6699,7264,143,14106,0.4749042960442365,0.5149581738267404,0.01013753012902311,250,-31,497,716,-0.006723784612970352,-0.0028572420890500792,0.009581026702020434,-565,-247,-0.040053877782503855,-0.016304811314990786
11506,45029,Colleton,South Carolina,2008,8616,8525,180,17321,0.49743086426880667,0.49217712603198427,0.010392009699209052,1917,37,1261,3215,0.022526568224570165,0.00025447957018594203,-0.022781047794756093,91,656,0.005253738236822403,0.04530761601932626
11507,45029,Colleton,South Carolina,2012,8475,8443,168,17086,0.49602013344258455,0.49414725506262436,0.009832611494791057,-141,-12,-82,-235,-0.0014107308262221174,-0.0005593982044179956,0.0019701290306400887,32,-59,0.0018728783799601967,-0.003380859856862206
11508,45029,Colleton,South Carolina,2016,7627,9091,533,17251,0.44211929743203293,0.5269839429598284,0.03089675960813866,-848,365,648,165,-0.05390083601055162,0.021064148113347603,0.032836687897204064,-1464,-1496,-0.08486464552779549,-0.08673752390775569
11509,45031,Darlington,South Carolina,2000,10253,11290,320,21863,0.46896583268535885,0.516397566665142,0.014636600649499154,0,0,0,0,0.0,0.0,0.0,-1037,0,-0.047431733979783175,0.0
11510,45031,Darlington,South Carolina,2004,11829,13416,209,25454,0.4647206725858411,0.5270684371807968,0.008210890233362144,1576,-111,2126,3591,-0.004245160099517753,-0.00642571041613701,0.01067087051565474,-1587,-550,-0.06234776459495567,-0.014916030615172493
11511,45031,Darlington,South Carolina,2008,14505,14544,285,29334,0.49447739824094905,0.4958069134792391,0.009715688279811823,2676,76,1128,3880,0.029756725655107952,0.001504798046449679,-0.03126152370155766,-39,1548,-0.0013295152382900577,0.06101824935666561
11512,45031,Darlington,South Carolina,2012,15457,14434,259,30150,0.512669983416252,0.4787396351575456,0.008590381426202321,952,-26,-110,816,0.018192585175302978,-0.001125306853609502,-0.017067278321693524,1023,1062,0.033930348258706444,0.0352598634969965
11513,45031,Darlington,South Carolina,2016,13888,14989,797,29674,0.46801914133584954,0.5051223293118555,0.02685852935229494,-1569,538,555,-476,-0.044650842080402486,0.018268147926092618,0.026382694154309938,-1101,-2124,-0.03710318797600598,-0.07103353623471242
11514,45033,Dillon,South Carolina,2000,4930,3975,85,8990,0.5483870967741935,0.4421579532814238,0.009454949944382647,0,0,0,0,0.0,0.0,0.0,955,0,0.10622914349276968,0.0
11515,45033,Dillon,South Carolina,2004,4832,4301,102,9235,0.5232268543584191,0.46572820790471037,0.0110449377368706,-98,17,326,245,-0.025160242415774414,0.001589987792487953,0.023570254623286546,531,-424,0.057498646453708724,-0.04873049703906096
11516,45033,Dillon,South Carolina,2008,7408,5874,135,13417,0.5521353506745174,0.43780278750838486,0.010061861817097712,2576,33,1573,4182,0.028908496316098264,-0.000983075919772888,-0.027925420396325507,1534,1003,0.1143325631661325,0.05683391671242377
11517,45033,Dillon,South Carolina,2012,7523,5427,85,13035,0.577138473341005,0.41634062140391254,0.00652090525508247,115,-50,-447,-382,0.02500312266648763,-0.003540956562015242,-0.021462166104472324,2096,562,0.16079785193709245,0.046465288770959956
11518,45033,Dillon,South Carolina,2016,5834,5637,227,11698,0.4987177295264148,0.48187724397332876,0.019405026500256453,-1689,142,210,-1337,-0.07842074381459019,0.012884121245173984,0.06553662256941623,197,-1899,0.016840485553086038,-0.1439573663840064
11519,45035,Dorchester,South Carolina,2000,12168,20734,739,33641,0.3617014951993104,0.6163312624476086,0.021967242353081062,0,0,0,0,0.0,0.0,0.0,-8566,0,-0.2546297672482982,0.0
11520,45035,Dorchester,South Carolina,2004,14733,26006,578,41317,0.3565844567611395,0.6294261442021444,0.013989399036716121,2565,-161,5272,7676,-0.005117038438170907,-0.007977843316364941,0.01309488175453577,-11273,-2707,-0.2728416874410049,-0.018211920192706677
11521,45035,Dorchester,South Carolina,2008,21806,29929,670,52405,0.4161053334605477,0.5711096269439939,0.012785039595458448,7073,92,3923,11088,0.0595208766994082,-0.001204359441257673,-0.05831651725815046,-8123,3150,-0.15500429348344624,0.11783739395755866
11522,45035,Dorchester,South Carolina,2012,23445,32531,879,56855,0.4123647876176238,0.5721748307097001,0.015460381672676106,1639,209,2602,4450,-0.0037405458429238814,0.0026753420772176583,0.0010652037657061797,-9086,-963,-0.1598100430920763,-0.004805749608630061
11523,45035,Dorchester,South Carolina,2016,24055,34987,3525,62567,0.38446785046430226,0.5591925455911263,0.056339603944571416,610,2646,2456,5712,-0.027896937153321533,0.04087922227189531,-0.0129822851185738,-10932,-1846,-0.17472469512682404,-0.014914652034747733
11524,45037,Edgefield,South Carolina,2000,3950,4760,124,8834,0.4471360652026262,0.5388272583201268,0.014036676477247,0,0,0,0,0.0,0.0,0.0,-810,0,-0.09169119311750057,0.0
11525,45037,Edgefield,South Carolina,2004,4051,5611,84,9746,0.4156577057254258,0.575723373691771,0.008618920582803202,101,-40,851,912,-0.0314783594772004,-0.005417755894443798,0.03689611537164417,-1560,-750,-0.16006566796634514,-0.06837447484884457
11526,45037,Edgefield,South Carolina,2008,5075,6334,111,11520,0.4405381944444444,0.5498263888888889,0.009635416666666667,1024,27,723,1774,0.0248804887190186,0.0010164960838634652,-0.02589698480288205,-1259,301,-0.10928819444444449,0.05077747352190065
11527,45037,Edgefield,South Carolina,2012,4967,6512,107,11586,0.42870706024512345,0.5620576557914725,0.009235283963404109,-108,-4,178,66,-0.01183113419932097,-0.0004001327032625585,0.012231266902583582,-1545,-286,-0.13335059554634904,-0.02406240110190455
11528,45037,Edgefield,South Carolina,2016,4491,6842,311,11644,0.3856922019924425,0.5875987633115768,0.026709034695980762,-476,204,330,58,-0.043014858252680976,0.017473750732576655,0.0255411075201043,-2351,-806,-0.20190656131913431,-0.06855596577278528
11529,45039,Fairfield,South Carolina,2000,5263,3011,124,8398,0.6266968325791855,0.35853774708263875,0.014765420338175756,0,0,0,0,0.0,0.0,0.0,2252,0,0.26815908549654677,0.0
11530,45039,Fairfield,South Carolina,2004,5764,3531,140,9435,0.6109167991520933,0.3742448330683625,0.01483836777954425,501,16,520,1037,-0.01578003342709222,7.294744136849413e-05,0.015707085985723734,2233,-19,0.2366719660837308,-0.031487119412815956
11531,45039,Fairfield,South Carolina,2008,7591,3912,116,11619,0.6533264480592134,0.33668990446682157,0.009983647473965056,1827,-24,381,2184,0.04240964890712007,-0.004854720305579194,-0.037554928601540916,3679,1446,0.3166365435923918,0.07996457750866098
11532,45039,Fairfield,South Carolina,2012,7777,3999,119,11895,0.6538041193778898,0.33619167717528375,0.010004203446826399,186,3,87,276,0.00047767131867648693,2.055597286134206e-05,-0.0004982272915378116,3778,99,0.3176124422026061,0.0009758986102142986
11533,45039,Fairfield,South Carolina,2016,6945,4027,295,11267,0.6164018816011361,0.3574154610810331,0.026182657317830833,-832,176,28,-628,-0.03740223777675378,0.016178453871004434,0.02122378390574936,2918,-860,0.25898642052010296,-0.05862602168250314
11534,45041,Florence,South Carolina,2000,17157,23678,602,41437,0.4140502449501653,0.5714216762796535,0.01452807877018124,0,0,0,0,0.0,0.0,0.0,-6521,0,-0.15737143132948817,0.0
11535,45041,Florence,South Carolina,2004,21442,27689,414,49545,0.432778282369563,0.5588656776667675,0.008356039963669392,4285,-188,4011,8108,0.018728037419397714,-0.006172038806511848,-0.012555998612885921,-6247,274,-0.12608739529720453,0.031284036032283635
11536,45041,Florence,South Carolina,2008,28012,29861,500,58373,0.47987939629623283,0.5115549997430319,0.00856560396073527,6570,86,2172,8828,0.047101113926669824,0.00020956399706587893,-0.04731067792373567,-1849,4398,-0.03167560344679904,0.09441179185040549
11537,45041,Florence,South Carolina,2012,28614,28961,547,58122,0.4923092804789925,0.4982794810914972,0.009411238429510341,602,47,-900,-251,0.012429884182759643,0.0008456344687750705,-0.013275518651534646,-347,1502,-0.00597020061250475,0.02570540283429429
11538,45041,Florence,South Carolina,2016,26710,29573,1648,57931,0.4610657506343754,0.5104866133848889,0.028447635980735703,-1904,1101,612,-191,-0.03124352984461709,0.01903639755122536,0.012207132293391654,-2863,-2516,-0.049420862750513495,-0.043450662138008744
11539,45043,Georgetown,South Carolina,2000,9445,10535,371,20351,0.4641049579873225,0.5176649796078817,0.018230062404795834,0,0,0,0,0.0,0.0,0.0,-1090,0,-0.05356002162055923,0.0
11540,45043,Georgetown,South Carolina,2004,10602,12606,385,23593,0.44937057601831054,0.5343110244564065,0.016318399525282922,1157,14,2071,3242,-0.014734381969011945,-0.0019116628795129119,0.016646044848524832,-2004,-914,-0.084940448438096,-0.03138042681753678
11541,45043,Georgetown,South Carolina,2008,14199,15790,301,30290,0.4687685704853087,0.5212941564872895,0.009937273027401782,3597,-84,3184,6697,0.019397994466998136,-0.00638112649788114,-0.013016867969117052,-1591,413,-0.05252558600198082,0.03241486243611519
11542,45043,Georgetown,South Carolina,2012,14163,16526,276,30965,0.45738737284030356,0.5336993379622154,0.008913289197481028,-36,-25,736,675,-0.011381197645005114,-0.0010239838299207545,0.012405181474925864,-2363,-772,-0.0763119651219118,-0.023786379119930978
11543,45043,Georgetown,South Carolina,2016,13310,17389,958,31657,0.42044413557822913,0.5492939950090028,0.030261869412768108,-853,682,863,692,-0.036943237262074435,0.02134858021528708,0.015594657046787419,-4079,-1716,-0.12884985943077365,-0.052537894308861854
11544,45045,Greenville,South Carolina,2000,43810,92714,3769,140293,0.3122750244131924,0.6608597720484986,0.02686520353830911,0,0,0,0,0.0,0.0,0.0,-48904,0,-0.34858474763530617,0.0
11545,45045,Greenville,South Carolina,2004,55347,111481,2005,168833,0.32782098286472433,0.6603033767095295,0.011875640425746152,11537,-1764,18767,28540,0.01554595845153195,-0.014989563112562958,-0.0005563953389690068,-56134,-7230,-0.3324823938448052,0.016102353790500956
11546,45045,Greenville,South Carolina,2008,70886,116363,3408,190657,0.3717985702072308,0.6103263976670146,0.017875032125754628,15539,1403,4882,21824,0.04397758734250645,0.005999391700008476,-0.04997697904251497,-45477,10657,-0.2385278274597838,0.09395456638502142
11547,45045,Greenville,South Carolina,2012,68070,121685,3434,193189,0.35234925383950433,0.6298754069848698,0.017775339175625942,-2816,26,5322,2532,-0.019449316367726455,-9.969295012868598e-05,0.019549009317855193,-53615,-8138,-0.27752615314536544,-0.03899832568558165
11548,45045,Greenville,South Carolina,2016,74483,127832,12850,215165,0.34616689517347154,0.5941114958287825,0.059721608997745916,6413,9416,6147,21976,-0.006182358666032783,0.04194626982211998,-0.035763911156087236,-53349,266,-0.247944600655311,0.029581552490054452
11549,45047,Greenwood,South Carolina,2000,8139,12193,528,20860,0.3901725790987536,0.5845158197507191,0.025311601150527326,0,0,0,0,0.0,0.0,0.0,-4054,0,-0.1943432406519655,0.0
11550,45047,Greenwood,South Carolina,2004,8954,14264,224,23442,0.3819639962460541,0.6084805050763586,0.009555498677587237,815,-304,2071,2582,-0.008208582852699486,-0.01575610247294009,0.023964685325639556,-5310,-1256,-0.22651650883030455,-0.03217326817833904
11551,45047,Greenwood,South Carolina,2008,12348,16995,324,29667,0.4162200424714329,0.5728587319243604,0.010921225604206695,3394,100,2731,6225,0.03425604622537881,0.0013657269266194576,-0.035621773151998215,-4647,663,-0.15663868945292753,0.06987781937737703
11552,45047,Greenwood,South Carolina,2012,11972,16348,352,28672,0.4175502232142857,0.5701729910714286,0.012276785714285714,-376,28,-647,-995,0.0013301807428527934,0.0013555601100790193,-0.0026857408529318283,-4376,271,-0.1526227678571429,0.004015921595784622
11553,45047,Greenwood,South Carolina,2016,10711,16961,1091,28763,0.37238813753780897,0.5896811876368946,0.037930674825296384,-1261,739,613,91,-0.045162085676476726,0.025653889111010672,0.019508196565465985,-6250,-1874,-0.21729305009908562,-0.06467028224194271
11554,45049,Hampton,South Carolina,2000,4896,2798,65,7759,0.6310091506637453,0.36061348111870084,0.008377368217553808,0,0,0,0,0.0,0.0,0.0,2098,0,0.27039566954504446,0.0
11555,45049,Hampton,South Carolina,2004,4832,3097,87,8016,0.6027944111776448,0.38635229540918165,0.010853293413173653,-64,22,299,257,-0.028214739486100537,0.0024759251956198453,0.025738814290480805,1735,-363,0.21644211576846312,-0.05395355377658134
11556,45049,Hampton,South Carolina,2008,5816,3439,95,9350,0.6220320855614974,0.36780748663101603,0.010160427807486631,984,8,342,1334,0.0192376743838526,-0.0006928656056870222,-0.01854480877816561,2377,642,0.2542245989304813,0.03778248316201821
11557,45049,Hampton,South Carolina,2012,5834,3312,60,9206,0.6337171409950033,0.3597653704106018,0.00651748859439496,18,-35,-127,-144,0.011685055433505953,-0.0036429392130916715,-0.00804211622041423,2522,145,0.2739517705844015,0.019727171653920184
11558,45049,Hampton,South Carolina,2016,5170,3488,148,8806,0.5870997047467635,0.3960935725641608,0.01680672268907563,-664,88,176,-400,-0.046617436248239774,0.01028923409468067,0.036328202153558975,1682,-840,0.19100613218260276,-0.08294563840179875
11559,45051,Horry,South Carolina,2000,29113,40300,1852,71265,0.4085175050866484,0.565494983512243,0.02598751140110854,0,0,0,0,0.0,0.0,0.0,-11187,0,-0.15697747842559462,0.0
11560,45051,Horry,South Carolina,2004,29547,50447,1353,81347,0.36322175372171067,0.6201457951737618,0.016632451104527518,434,-499,10147,10082,-0.04529575136493774,-0.009355060296581022,0.05465081166151875,-20900,-9713,-0.2569240414520511,-0.09994656302645649
11561,45051,Horry,South Carolina,2008,38879,64609,1310,104798,0.3709899043874883,0.6165098570583408,0.012500238554170881,9332,-43,14162,23451,0.007768150665777629,-0.004132212550356637,-0.003635938115420956,-25730,-4830,-0.24551995267085253,0.011404088781198585
11562,45051,Horry,South Carolina,2012,38885,72127,1381,112393,0.3459735036879521,0.6417392542240176,0.012287242088030394,6,71,7518,7595,-0.0250164006995362,-0.00021299646614048734,0.025229397165676737,-33242,-7512,-0.29576575053606546,-0.05024579786521294
11563,45051,Horry,South Carolina,2016,39410,89288,4222,132920,0.2964941318086067,0.6717424014444778,0.031763466746915436,525,2841,17161,20527,-0.049479371879345424,0.019476224658885044,0.03000314722046027,-49878,-16636,-0.37524826963587116,-0.07948251909980569
11564,45053,Jasper,South Carolina,2000,3646,2414,409,6469,0.5636110681712784,0.3731643221518009,0.0632246096769207,0,0,0,0,0.0,0.0,0.0,1232,0,0.19044674601947748,0.0
11565,45053,Jasper,South Carolina,2004,3840,2933,73,6846,0.5609114811568799,0.4284253578732106,0.010663160969909435,194,-336,519,377,-0.00269958701439843,-0.052561448707011266,0.055261035721409724,907,-325,0.13248612328366932,-0.057960622735808154
11566,45053,Jasper,South Carolina,2008,5389,3365,100,8854,0.6086514569686018,0.38005421278518187,0.0112943302462164,1549,27,432,2008,0.047739975811721846,0.0006311692763069643,-0.048371145088028755,2024,1117,0.22859724418341992,0.0961111208997506
11567,45053,Jasper,South Carolina,2012,5757,4169,95,10021,0.5744935635166151,0.41602634467618005,0.00948009180720487,368,-5,804,1167,-0.03415789345198672,-0.0018142384390115295,0.03597213189099818,1588,-436,0.15846721884043502,-0.0701300253429849
11568,45053,Jasper,South Carolina,2016,5956,5187,284,11427,0.5212216679793472,0.4539249146757679,0.024853417344884922,199,189,1018,1406,-0.053271895537267855,0.015373325537680052,0.03789856999958785,769,-819,0.06729675330357932,-0.0911704655368557
11569,45055,Kershaw,South Carolina,2000,7428,11911,338,19677,0.3774965695990242,0.6053260151445851,0.01717741525639071,0,0,0,0,0.0,0.0,0.0,-4483,0,-0.22782944554556084,0.0
11570,45055,Kershaw,South Carolina,2004,8515,14160,240,22915,0.3715906611389919,0.6179358498799913,0.010473488981016802,1087,-98,2249,3238,-0.005905908460032305,-0.006703926275373907,0.012609834735406222,-5645,-1162,-0.24634518874099937,-0.018515743195438528
11571,45055,Kershaw,South Carolina,2008,11226,16466,293,27985,0.40114346971591924,0.5883866356976952,0.010469894586385564,2711,53,2306,5070,0.029552808576927325,-3.5943946312382707e-06,-0.029549214182296057,-5240,405,-0.18724316598177598,0.05910202275922338
11572,45055,Kershaw,South Carolina,2012,11259,16324,363,27946,0.4028841336863952,0.5841265297359193,0.012989336577685537,33,70,-142,-39,0.001740663970475953,0.0025194419912999734,-0.004260105961775951,-5065,175,-0.18124239604952408,0.006000769932251904
11573,45055,Kershaw,South Carolina,2016,10330,17542,1123,28995,0.3562683221245042,0.6050008622176237,0.03873081565787205,-929,760,1218,1049,-0.046615811561890985,0.025741479080186515,0.02087433248170445,-7212,-2147,-0.24873254009311951,-0.06749014404359543
11574,45057,Lancaster,South Carolina,2000,8782,11676,247,20705,0.4241487563390485,0.5639217580294614,0.011929485631489978,0,0,0,0,0.0,0.0,0.0,-2894,0,-0.1397730016904129,0.0
11575,45057,Lancaster,South Carolina,2004,7631,12916,267,20814,0.3666282309983665,0.6205438647064476,0.012827904295185932,-1151,20,1240,109,-0.05752052534068203,0.0008984186636959539,0.056622106676986195,-5285,-2391,-0.2539156337080811,-0.11414263201766822
11576,45057,Lancaster,South Carolina,2008,12139,16441,341,28921,0.41972960824314515,0.5684796514643339,0.011790740292521005,4508,74,3525,8107,0.05310137724477865,-0.0010371640026649274,-0.052064213242113744,-4302,983,-0.14875004322118873,0.10516559048689239
11577,45057,Lancaster,South Carolina,2012,13419,19333,392,33144,0.404869659666908,0.5833031619599324,0.011827178373159546,1280,51,2892,4223,-0.014859948576237125,3.643808063854073e-05,0.014823510495598491,-5914,-1612,-0.17843350229302435,-0.029683459071835616
11578,45057,Lancaster,South Carolina,2016,13812,23719,1407,38938,0.3547177564333042,0.6091478761107402,0.03613436745595562,393,1015,4386,5794,-0.0501519032336038,0.024307189082796075,0.0258447141508078,-9907,-3993,-0.25443011967743595,-0.0759966173844116
11579,45059,Laurens,South Carolina,2000,7920,12102,388,20410,0.3880450759431651,0.5929446349828515,0.01901028907398334,0,0,0,0,0.0,0.0,0.0,-4182,0,-0.20489955903968643,0.0
11580,45059,Laurens,South Carolina,2004,9205,14466,158,23829,0.38629401149859416,0.6070754123127282,0.006630576188677662,1285,-230,2364,3419,-0.00175106444457096,-0.012379712885305677,0.014130777329876665,-5261,-1079,-0.22078140081413405,-0.015881841774447625
11581,45059,Laurens,South Carolina,2008,10578,15334,370,26282,0.4024807853283616,0.5834411384217335,0.014078076249904878,1373,212,868,2453,0.016186773829767465,0.007447500061227216,-0.023634273890994706,-4756,505,-0.18096035309337188,0.03982104772076217
11582,45059,Laurens,South Carolina,2012,10318,14746,352,25416,0.4059647466163047,0.5801857097891092,0.013849543594586088,-260,-18,-588,-866,0.0034839612879430937,-0.0002285326553187906,-0.003255428632624291,-4428,328,-0.1742209631728045,0.006739389920567385
11583,45059,Laurens,South Carolina,2016,8889,16816,861,26566,0.33460061733042235,0.6329895354964993,0.03240984717307837,-1429,509,2070,1150,-0.07136412928588237,0.018560303578492282,0.05280382570739006,-7927,-3499,-0.29838891816607693,-0.12416795499327243
11584,45061,Lee,South Carolina,2000,3899,2675,68,6642,0.5870219813309244,0.40274013851249624,0.010237880156579343,0,0,0,0,0.0,0.0,0.0,1224,0,0.1842818428184282,0.0
11585,45061,Lee,South Carolina,2004,4960,2901,37,7898,0.6280070904026336,0.36730817928589515,0.004684730311471258,1061,-31,226,1256,0.04098510907170916,-0.0055531498451080845,-0.035431959226601084,2059,835,0.26069891111673843,0.07641706829831024
11586,45061,Lee,South Carolina,2008,5960,3074,119,9153,0.6511526275538075,0.33584617065443023,0.013001201791762264,1000,82,173,1255,0.023145537151173956,0.008316471480291006,-0.03146200863146492,2886,827,0.3153064568993773,0.05460754578263888
11587,45061,Lee,South Carolina,2012,5977,2832,98,8907,0.6710452453126754,0.3179521724486359,0.011002582238688672,17,-21,-242,-246,0.01989261775886786,-0.0019986195530735922,-0.017893998205794348,3145,259,0.3530930728640395,0.03778661596466221
11588,45061,Lee,South Carolina,2016,5199,2803,154,8156,0.6374448258950466,0.3436733692986758,0.01888180480627759,-778,56,-29,-751,-0.03360041941762881,0.007879222567588917,0.02572119685003993,2396,-749,0.2937714565963708,-0.05932161626766874
11589,45063,Lexington,South Carolina,2000,22830,58095,2156,83081,0.27479207038913833,0.6992573512596141,0.025950578351247578,0,0,0,0,0.0,0.0,0.0,-35265,0,-0.42446528087047575,0.0
11590,45063,Lexington,South Carolina,2004,25393,67132,907,93432,0.2717805462796472,0.7185118588920284,0.009707594828324343,2563,-1249,9037,10351,-0.003011524109491126,-0.016242983522923235,0.01925450763241432,-41739,-6474,-0.4467313126123812,-0.022266031741905445
11591,45063,Lexington,South Carolina,2008,33303,74960,1249,109512,0.3041036598728906,0.6844911973117102,0.011405142815399226,7910,342,7828,16080,0.03232311359324341,0.0016975479870748825,-0.034020661580318245,-41657,82,-0.38038753743881953,0.06634377517356166
11592,45063,Lexington,South Carolina,2012,34148,76662,1813,112623,0.3032062722534473,0.6806957726219334,0.016097955124619305,845,564,1702,3111,-0.0008973876194433017,0.004692812309220079,-0.003795424689776783,-42514,-857,-0.37748950036848605,0.0028980370703334812
11593,45063,Lexington,South Carolina,2016,35230,80026,6837,122093,0.28855053115248214,0.65545117246689,0.05599829638062788,1082,5024,3364,9470,-0.01465574110096518,0.039900341256008574,-0.025244600155043373,-44796,-2282,-0.36690064131440786,0.010588859054078192
11594,45065,McCormick,South Carolina,2000,1896,1704,61,3661,0.517891286533734,0.4654465992898115,0.01666211417645452,0,0,0,0,0.0,0.0,0.0,192,0,0.05244468724392243,0.0
11595,45065,McCormick,South Carolina,2004,2648,2396,78,5122,0.5169855525185475,0.4677860210855135,0.015228426395939087,752,17,692,1461,-0.0009057340151864546,-0.001433687780515433,0.002339421795701957,252,60,0.049199531433034016,-0.0032451558108884115
11596,45065,McCormick,South Carolina,2008,2755,2437,40,5232,0.5265672782874617,0.4657874617737003,0.00764525993883792,107,-38,41,110,0.009581725768914251,-0.0075831664571011665,-0.0019985593118131972,318,66,0.060779816513761464,0.011580285080727448
11597,45065,McCormick,South Carolina,2012,2653,2467,40,5160,0.5141472868217054,0.47810077519379846,0.007751937984496124,-102,0,30,-72,-0.012419991465756341,0.00010667804565820359,0.012313313420098171,186,-132,0.03604651162790695,-0.024733304885854512
11598,45065,McCormick,South Carolina,2016,2479,2652,85,5216,0.47526840490797545,0.5084355828220859,0.01629601226993865,-174,45,185,56,-0.03887888191372996,0.008544074285442526,0.03033480762828744,-173,-359,-0.033167177914110446,-0.0692136895420174
11599,45067,Marion,South Carolina,2000,7358,4687,104,12149,0.6056465552720388,0.38579306938842706,0.008560375339534118,0,0,0,0,0.0,0.0,0.0,2671,0,0.21985348588361175,0.0
11600,45067,Marion,South Carolina,2004,7767,5589,151,13507,0.5750351669504701,0.4137854445842896,0.011179388465240246,409,47,902,1358,-0.030611388321568733,0.0026190131257061277,0.027992375195862562,2178,-493,0.16124972236618046,-0.058603763517431295
11601,45067,Marion,South Carolina,2008,9608,5416,150,15174,0.6331883484908396,0.3569263213391327,0.009885330170027679,1841,-1,-173,1667,0.058153181540369525,-0.001294058295212567,-0.056859123245156906,4192,2014,0.2762620271517069,0.11501230478552643
11602,45067,Marion,South Carolina,2012,9688,5164,134,14986,0.6464700387027893,0.34458828239690376,0.008941678900306954,80,-16,-252,-188,0.013281690211949693,-0.0009436512697207251,-0.012338038942228957,4524,332,0.30188175630588554,0.02561972915417865
11603,45067,Marion,South Carolina,2016,8569,5444,263,14276,0.6002381619501261,0.3813393107312973,0.01842252731857663,-1119,129,280,-710,-0.04623187675266316,0.009480848418269678,0.03675102833439353,3125,-1399,0.21889885121882885,-0.08298290508705669
11604,45069,Marlboro,South Carolina,2000,5060,2699,124,7883,0.6418876062412787,0.3423823417480655,0.015730052010655842,0,0,0,0,0.0,0.0,0.0,2361,0,0.29950526449321324,0.0
11605,45069,Marlboro,South Carolina,2004,4984,3423,153,8560,0.5822429906542056,0.39988317757009345,0.017873831775700934,-76,29,724,677,-0.059644615587073124,0.0021437797650450917,0.057500835822027974,1561,-800,0.18235981308411214,-0.1171454514091011
11606,45069,Marlboro,South Carolina,2008,6794,3996,86,10876,0.6246781905112173,0.367414490621552,0.0079073188672306,1810,-67,573,2316,0.04243519985701172,-0.009966512908470334,-0.032468686948541436,2798,1237,0.2572636998896653,0.07490388680555315
11607,45069,Marlboro,South Carolina,2012,6100,3676,77,9853,0.6191007814878717,0.3730843397949863,0.007814878717141987,-694,-9,-320,-1023,-0.005577409023345581,-9.24401500886126e-05,0.0056698491734342715,2424,-374,0.24601644169288545,-0.011247258196779852
11608,45069,Marlboro,South Carolina,2016,5954,4267,168,10389,0.5731061699874868,0.4107228799691982,0.016170950043315046,-146,91,591,536,-0.045994611500384974,0.008356071326173059,0.03763854017421192,1687,-737,0.16238329001828855,-0.0836331516745969
11609,45071,Newberry,South Carolina,2000,4428,7492,452,12372,0.35790494665373423,0.6055609440672486,0.03653410927901714,0,0,0,0,0.0,0.0,0.0,-3064,0,-0.24765599741351435,0.0
11610,45071,Newberry,South Carolina,2004,4483,7654,272,12409,0.36127004593440243,0.6168103795632203,0.021919574502377307,55,-180,162,37,0.0033650992806681934,-0.01461453477663983,0.011249435495971682,-3171,-107,-0.25554033362881784,-0.007884336215303489
11611,45071,Newberry,South Carolina,2008,6708,9616,200,16524,0.4059549745824256,0.5819414185427257,0.012103606874848705,2225,-72,1962,4115,0.04468492864802315,-0.009815967627528602,-0.03486896102049453,-2908,263,-0.17598644396030017,0.07955388966851767
11612,45071,Newberry,South Carolina,2012,6913,9260,178,16351,0.42278759708886304,0.5663262185799034,0.010886184331233563,205,-22,-356,-173,0.016832622506437467,-0.0012174225436151417,-0.015615199962822346,-2347,561,-0.14353862149104035,0.03244782246925981
11613,45071,Newberry,South Carolina,2016,6217,10017,573,16807,0.3699053965609567,0.5960016659725115,0.0340929374665318,-696,395,757,456,-0.05288220052790632,0.02320675313529824,0.02967544739260808,-3800,-1453,-0.22609626941155475,-0.0825576479205144
11614,45073,Oconee,South Carolina,2000,7571,15364,640,23575,0.3211452810180276,0.6517073170731708,0.027147401908801695,0,0,0,0,0.0,0.0,0.0,-7793,0,-0.33056203605514317,0.0
11615,45073,Oconee,South Carolina,2004,8395,18811,326,27532,0.3049179137004213,0.6832413191922126,0.011840767107365974,824,-314,3447,3957,-0.016227367317606267,-0.015306634801435721,0.03153400211904189,-10416,-2623,-0.37832340549179133,-0.04776136943664816
11616,45073,Oconee,South Carolina,2008,9481,21164,487,31132,0.30454195040472826,0.6798149813696518,0.015643068225619942,1086,161,2353,3600,-0.0003759632956930603,0.0038023011182539684,-0.0034263378225608543,-11683,-1267,-0.37527303096492354,0.003050374526867794
11617,45073,Oconee,South Carolina,2012,8550,21611,505,30666,0.2788104089219331,0.7047218417791691,0.016467749298897803,-931,18,447,-466,-0.02573154148279516,0.0008246810732778602,0.024906860409517284,-13061,-1378,-0.425911432857236,-0.050638401892312446
11618,45073,Oconee,South Carolina,2016,7998,24178,1459,33635,0.23778801843317973,0.7188345473465141,0.04337743422030623,-552,954,2567,2969,-0.04102239048875336,0.02690968492140843,0.014112705567345007,-16180,-3119,-0.4810465289133343,-0.05513509605609834
11619,45075,Orangeburg,South Carolina,2000,19802,12657,275,32734,0.6049367629987169,0.3866621861061893,0.008401050895093786,0,0,0,0,0.0,0.0,0.0,7145,0,0.2182745768925276,0.0
11620,45075,Orangeburg,South Carolina,2004,24698,12695,171,37564,0.6574912149930785,0.33795655414758813,0.004552230859333404,4896,-104,38,4830,0.052554451994361595,-0.003848820035760382,-0.04870563195860117,12003,4858,0.31953466084549037,0.10126008395296276
11621,45075,Orangeburg,South Carolina,2008,27263,12115,376,39754,0.6857926246415456,0.3047492076269055,0.009458167731549026,2565,205,-580,2190,0.028301409648467057,0.004905936872215622,-0.033207346520682635,15148,3145,0.38104341701464006,0.06150875616914969
11622,45075,Orangeburg,South Carolina,2012,30720,12022,299,43041,0.7137380637066982,0.27931507167584396,0.006946864617457773,3457,-77,-93,3287,0.027945439065152677,-0.0025113031140912533,-0.02543413595106153,18698,3550,0.43442299203085427,0.05337957501621421
11623,45075,Orangeburg,South Carolina,2016,26318,11931,661,38910,0.6763813929581085,0.3066306861989206,0.016987920842970957,-4402,362,-91,-4131,-0.037356670748589726,0.010041056225513184,0.027315614523076626,14387,-4311,0.3697507067591879,-0.06467228527166635
11624,45077,Pickens,South Carolina,2000,8927,24681,974,34582,0.25814007287027935,0.7136949858307791,0.028164941298941645,0,0,0,0,0.0,0.0,0.0,-15754,0,-0.4555549129604997,0.0
11625,45077,Pickens,South Carolina,2004,10287,29759,464,40510,0.25393729943223897,0.7346087385830659,0.011453961984695137,1360,-510,5078,5928,-0.004202773438040375,-0.016710979314246508,0.020913752752286796,-19472,-3718,-0.4806714391508269,-0.02511652619032717
11626,45077,Pickens,South Carolina,2008,11691,32552,885,45128,0.2590631093777699,0.7213260060273001,0.019610884594929975,1404,421,2793,4618,0.0051258099455309125,0.008156922610234839,-0.01328273255576573,-20861,-1389,-0.46226289664953024,0.018408542501296643
11627,45077,Pickens,South Carolina,2012,11156,33474,919,45549,0.244923049902303,0.7349008759797142,0.02017607411798283,-535,34,922,421,-0.01414005947546687,0.0005651895230528552,0.013574869952414081,-22318,-1457,-0.4899778260774112,-0.027714929427880952
11628,45077,Pickens,South Carolina,2016,10354,36236,2459,49049,0.21109502742155803,0.7387714326489837,0.0501335399294583,-802,1540,2762,3500,-0.033828022480744985,0.02995746581147547,0.003870556669269498,-25882,-3564,-0.5276764052274256,-0.037698579150014455
11629,45079,Richland,South Carolina,2000,63179,50164,3138,116481,0.5423974725491711,0.4306625114825594,0.026940015968269504,0,0,0,0,0.0,0.0,0.0,13015,0,0.11173496106661174,0.0
11630,45079,Richland,South Carolina,2004,76283,56212,1306,133801,0.5701227942989963,0.4201164415811541,0.009760764119849627,13104,-1832,6048,17320,0.027725321749825116,-0.017179251848419876,-0.01054606990140533,20071,7056,0.15000635271784218,0.038271391651230446
11631,45079,Richland,South Carolina,2008,105656,57941,1440,165037,0.640195834873392,0.35107884898537906,0.008725316141228937,29373,134,1729,31236,0.07007304057439578,-0.0010354479786206898,-0.06903759259577502,47715,27644,0.289116985888013,0.1391106331701708
11632,45079,Richland,South Carolina,2012,103989,53105,2060,159154,0.6533860286263619,0.33367053294293575,0.012943438430702338,-1667,620,-4836,-5883,0.013190193752969814,0.004218122289473401,-0.017408316042443306,50884,3169,0.3197154956834261,0.03059850979541312
11633,45079,Richland,South Carolina,2016,108000,52469,8253,168722,0.640106210215621,0.31097900688706864,0.04891478289731037,4011,6193,-636,9568,-0.013279818410740885,0.03597134446660803,-0.022691526055867106,55531,4647,0.32912720332855233,0.009411707645126222
11634,45081,Saluda,South Carolina,2000,2682,4098,111,6891,0.3892033086634741,0.5946887244231607,0.01610796691336526,0,0,0,0,0.0,0.0,0.0,-1416,0,-0.2054854157596866,0.0
11635,45081,Saluda,South Carolina,2004,3001,4537,40,7578,0.3960147796252309,0.5987067827922935,0.005278437582475587,319,-71,439,687,0.006811470961756827,-0.010829529330889672,0.0040180583691328264,-1536,-120,-0.2026920031670626,0.0027934125926240005
11636,45081,Saluda,South Carolina,2008,3323,5191,89,8603,0.38626060676508195,0.6033941648262234,0.010345228408694642,322,49,654,1025,-0.009754172860148957,0.005066790826219055,0.004687382033929932,-1868,-332,-0.21713355806114149,-0.01444155489407889
11637,45081,Saluda,South Carolina,2012,3328,5135,101,8564,0.3886034563288183,0.5996029892573563,0.011793554413825316,5,12,-56,-39,0.002342849563736371,0.0014483260051306734,-0.0037911755688671,-1807,61,-0.21099953292853801,0.006134025132603471
11638,45081,Saluda,South Carolina,2016,2813,5526,225,8564,0.32846800560485756,0.6452592246613732,0.026272769733769265,-515,124,391,0,-0.06013545072396076,0.01447921531994395,0.045656235404016865,-2713,-906,-0.31679121905651564,-0.10579168612797762
11639,45083,Spartanburg,South Carolina,2000,29559,52114,1880,83553,0.3537754479192848,0.6237238638947734,0.022500688185941857,0,0,0,0,0.0,0.0,0.0,-22555,0,-0.26994841597548863,0.0
11640,45083,Spartanburg,South Carolina,2004,33633,62004,1121,96758,0.3475991649269311,0.6408152297484446,0.011585605324624321,4074,-759,9890,13205,-0.006176282992353677,-0.010915082861317536,0.017091365853671214,-28371,-5816,-0.2932160648215135,-0.02326764884602489
11641,45083,Spartanburg,South Carolina,2008,41632,65042,1654,108328,0.3843143047042316,0.6004172513108338,0.015268443984934642,7999,533,3038,11570,0.03671513977730051,0.003682838660310321,-0.04039797843761084,-23410,4961,-0.21610294660660218,0.07711311821491135
11642,45083,Spartanburg,South Carolina,2012,41461,66969,1476,109906,0.37724055101632303,0.609329790912234,0.01342965807144287,-171,-178,1927,1578,-0.007073753687908579,-0.0018387859134917726,0.00891253960140026,-25508,-2098,-0.23208923989591101,-0.01598629328930884
11643,45083,Spartanburg,South Carolina,2016,39997,76277,4816,121090,0.3303080353456107,0.6299198942935007,0.039772070360888596,-1464,3340,9308,11184,-0.04693251567071233,0.026342412289445727,0.020590103381266656,-36280,-10772,-0.29961185894789,-0.06752261905197898
11644,45085,Sumter,South Carolina,2000,14365,15915,392,30672,0.46834246218049036,0.518877151799687,0.01278038601982264,0,0,0,0,0.0,0.0,0.0,-1550,0,-0.050534689619196604,0.0
11645,45085,Sumter,South Carolina,2004,18695,18074,234,37003,0.5052293057319677,0.4884468826851877,0.006323811582844634,4330,-158,2159,6331,0.03688684355147731,-0.0064565744369780055,-0.030430269114499253,621,2171,0.01678242304677996,0.06731711266597656
11646,45085,Sumter,South Carolina,2008,25431,18581,346,44358,0.5733125929933721,0.4188872356733847,0.007800171333243158,6736,112,507,7355,0.06808328726140445,0.0014763597503985237,-0.069559647011803,6850,6229,0.1544253573199874,0.13764293427320745
11647,45085,Sumter,South Carolina,2012,27589,19274,446,47309,0.5831659937855377,0.40740662453233,0.009427381682132363,2158,100,693,2951,0.009853400792165568,0.0016272103488892053,-0.011480611141054697,8315,1465,0.17575936925320768,0.021334011933220265
11648,45085,Sumter,South Carolina,2016,24047,18745,1294,44086,0.5454566075398085,0.42519167082520526,0.029351721634986165,-3542,848,-529,-3223,-0.03770938624572917,0.019924339952853802,0.01778504629287525,5302,-3013,0.12026493671460325,-0.05549443253860442
11649,45087,Union,South Carolina,2000,4662,5768,159,10589,0.44026820285201623,0.5447162149400321,0.015015582207951648,0,0,0,0,0.0,0.0,0.0,-1106,0,-0.10444801208801585,0.0
11650,45087,Union,South Carolina,2004,5236,6592,106,11934,0.43874643874643876,0.5523713759007877,0.008882185352773589,574,-53,824,1345,-0.0015217641055774722,-0.00613339685517806,0.00765516096075558,-1356,-250,-0.1136249371543489,-0.009176925066333053
11651,45087,Union,South Carolina,2008,5935,7449,167,13551,0.4379750571913512,0.5497011290679654,0.012323813740683344,699,61,857,1617,-0.0007713815550875469,0.003441628387909755,-0.002670246832822243,-1514,-158,-0.11172607187661421,0.001898865277734696
11652,45087,Union,South Carolina,2012,5796,6584,161,12541,0.4621641017462722,0.5249980065385536,0.012837891715174228,-139,-6,-865,-1010,0.02418904455492099,0.0005140779744908838,-0.02470312252941187,-788,726,-0.06283390479228135,0.04889216708433286
11653,45087,Union,South Carolina,2016,4729,7061,302,12092,0.39108501488587494,0.5839397949057228,0.024975190208402248,-1067,141,477,-449,-0.07107908686039727,0.01213729849322802,0.058941788367169234,-2332,-1544,-0.19285478001984785,-0.1300208752275665
11654,45089,Williamsburg,South Carolina,2000,6723,4524,84,11331,0.5933280381254964,0.39925867090283296,0.007413290971670638,0,0,0,0,0.0,0.0,0.0,2199,0,0.19406936722266344,0.0
11655,45089,Williamsburg,South Carolina,2004,9044,4795,79,13918,0.6498060066101451,0.34451789050150883,0.005676102888346027,2321,-5,271,2587,0.0564779684846487,-0.0017371880833246117,-0.05474078040132413,4249,2050,0.30528811610863626,0.11121874888597283
11656,45089,Williamsburg,South Carolina,2008,11279,5004,160,16443,0.6859453870948123,0.3043240284619595,0.009730584443228121,2235,81,209,2525,0.03613938048466725,0.004054481554882095,-0.04019386203954933,6275,2026,0.38162135863285285,0.07633324252421658
11657,45089,Williamsburg,South Carolina,2012,11335,4824,145,16304,0.6952281648675172,0.2958783120706575,0.00889352306182532,56,-15,-180,-139,0.009282777772704809,-0.0008370613814028018,-0.008445716391301983,6511,236,0.39934985279685964,0.01772849416400679
11658,45089,Williamsburg,South Carolina,2016,9953,4864,237,15054,0.6611531818785705,0.32310349408795,0.015743324033479472,-1382,92,40,-1250,-0.03407498298894662,0.006849800971654153,0.027225182017292515,5089,-1422,0.3380496877906205,-0.06130016500623914
11659,45091,York,South Carolina,2000,19251,33776,1324,54351,0.3541977148534526,0.6214421077809056,0.024360177365641847,0,0,0,0,0.0,0.0,0.0,-14525,0,-0.267244392927453,0.0
11660,45091,York,South Carolina,2004,24226,45234,721,70181,0.3451931434433821,0.6445334207264074,0.010273435830210455,4975,-603,11458,15830,-0.009004571410070494,-0.014086741535431392,0.02309131294550182,-21008,-6483,-0.2993402772830253,-0.03209588435557231
11661,45091,York,South Carolina,2008,37918,54500,1278,93696,0.40469176912568305,0.5816683743169399,0.01363985655737705,13692,557,9266,23515,0.059498625682300965,0.0033664207271665945,-0.06286504640946755,-16582,4426,-0.1769766051912568,0.12236367209176852
11662,45091,York,South Carolina,2012,39131,59546,1533,100210,0.3904899710607724,0.5942121544756013,0.015297874463626385,1213,255,5046,6514,-0.014201798064910676,0.0016580179062493355,0.012543780158661422,-20415,-3833,-0.2037221834148289,-0.026745578223572097
11663,45091,York,South Carolina,2016,41593,66754,6010,114357,0.36371188471191096,0.5837333962940616,0.05255471899402748,2462,4477,7208,14147,-0.02677808634886142,0.037256844530401095,-0.010478758181539649,-25161,-4746,-0.22002151158215066,-0.01629932816732177
11664,46003,Aurora,South Dakota,2000,513,847,53,1413,0.3630573248407643,0.5994338287331918,0.03750884642604388,0,0,0,0,0.0,0.0,0.0,-334,0,-0.23637650389242754,0.0
11665,46003,Aurora,South Dakota,2004,620,1009,20,1649,0.3759854457246816,0.6118859915100061,0.01212856276531231,107,-33,162,236,0.012928120883917316,-0.02538028366073157,0.012452162776814268,-389,-55,-0.2359005457853245,0.0004759581071030472
11666,46003,Aurora,South Dakota,2008,655,794,46,1495,0.43812709030100333,0.5311036789297658,0.03076923076923077,35,26,-215,-154,0.06214164457632171,0.018640668003918462,-0.08078231258024027,-139,250,-0.09297658862876251,0.14292395715656198
11667,46003,Aurora,South Dakota,2012,556,804,40,1400,0.39714285714285713,0.5742857142857143,0.02857142857142857,-99,-6,10,-95,-0.0409842331581462,-0.0021978021978022004,0.043182035355948445,-248,-109,-0.17714285714285716,-0.08416626851409464
11668,46003,Aurora,South Dakota,2016,340,974,93,1407,0.24164889836531628,0.6922530206112296,0.06609808102345416,-216,53,170,7,-0.15549395877754085,0.03752665245202559,0.11796730632551533,-634,-386,-0.45060412224591334,-0.2734612651030562
11669,46005,Beadle,South Dakota,2000,3216,4347,176,7739,0.41555756557694795,0.5617004780979454,0.022741956325106602,0,0,0,0,0.0,0.0,0.0,-1131,0,-0.14614291252099748,0.0
11670,46005,Beadle,South Dakota,2004,3443,4917,120,8480,0.4060141509433962,0.5798349056603773,0.014150943396226415,227,-56,570,741,-0.009543414633551739,-0.008591012928880187,0.018134427562431887,-1474,-343,-0.1738207547169811,-0.027677842195983626
11671,46005,Beadle,South Dakota,2008,3493,4054,167,7714,0.4528130671506352,0.5255379828882552,0.02164894996110967,50,47,-863,-766,0.04679891620723897,0.007498006564883256,-0.05429692277212217,-561,913,-0.07272491573761997,0.10109583897936114
11672,46005,Beadle,South Dakota,2012,2881,4230,152,7263,0.3966680435081922,0.5824039653035935,0.020927991188214236,-612,-15,176,-451,-0.056145023642443004,-0.0007209587728954359,0.056865982415338356,-1349,-788,-0.18573592179540133,-0.11301100605778136
11673,46005,Beadle,South Dakota,2016,1912,4455,405,6772,0.28233904311872415,0.6578558771411696,0.05980507974010632,-969,253,225,-491,-0.11432900038946803,0.038877088551892085,0.07545191183757605,-2543,-1194,-0.3755168340224454,-0.18978091222704407
11674,46007,Bennett,South Dakota,2000,377,712,27,1116,0.3378136200716846,0.6379928315412187,0.024193548387096774,0,0,0,0,0.0,0.0,0.0,-335,0,-0.3001792114695341,0.0
11675,46007,Bennett,South Dakota,2004,759,833,38,1630,0.4656441717791411,0.5110429447852761,0.023312883435582823,382,11,121,514,0.1278305517074565,-0.0008806649515139507,-0.12694988675594254,-74,261,-0.04539877300613504,0.25478043846339904
11676,46007,Bennett,South Dakota,2008,557,614,37,1208,0.4610927152317881,0.5082781456953642,0.030629139072847682,-202,-1,-219,-422,-0.0045514565473530055,0.00731625563726486,-0.0027647990899118957,-57,17,-0.04718543046357615,-0.0017866574574411098
11677,46007,Bennett,South Dakota,2012,548,626,29,1203,0.45552784704904403,0.5203657522859518,0.024106400665004156,-9,-8,12,-5,-0.005564868182744043,-0.0065227384078435265,0.012087606590587607,-78,-21,-0.0648379052369078,-0.01765247477333165
11678,46007,Bennett,South Dakota,2016,412,666,71,1149,0.35857267188859876,0.5796344647519582,0.06179286335944299,-136,42,40,-54,-0.09695517516044527,0.03768646269443884,0.0592687124660064,-254,-176,-0.22106179286335947,-0.15622388762645167
11679,46009,Bon Homme,South Dakota,2000,1162,1901,76,3139,0.37018158649251354,0.6056068811723478,0.024211532335138577,0,0,0,0,0.0,0.0,0.0,-739,0,-0.2354252946798343,0.0
11680,46009,Bon Homme,South Dakota,2004,1293,2063,52,3408,0.37940140845070425,0.6053403755868545,0.015258215962441314,131,-24,162,269,0.00921982195819071,-0.008953316372697263,-0.00026650558549334846,-770,-31,-0.22593896713615025,0.009486327543684059
11681,46009,Bon Homme,South Dakota,2008,1367,1712,96,3175,0.4305511811023622,0.5392125984251969,0.030236220472440945,74,44,-351,-233,0.05114977265165793,0.01497800450999963,-0.06612777716165763,-345,425,-0.10866141732283469,0.11727754981331556
11682,46009,Bon Homme,South Dakota,2012,1167,1830,77,3074,0.3796356538711776,0.5953155497722836,0.025048796356538713,-200,-19,118,-101,-0.05091552723118459,-0.005187424115902232,0.05610295134708676,-663,-318,-0.21567989590110603,-0.10701847857827135
11683,46009,Bon Homme,South Dakota,2016,704,2105,165,2974,0.2367182246133154,0.7078009414929388,0.0554808338937458,-463,88,275,-100,-0.1429174292578622,0.030432037537207086,0.11248539172065519,-1401,-738,-0.47108271687962344,-0.2554028209785174
11684,46011,Brookings,South Dakota,2000,4546,6212,226,10984,0.41387472687545523,0.5655498907501821,0.02057538237436271,0,0,0,0,0.0,0.0,0.0,-1666,0,-0.1516751638747269,0.0
11685,46011,Brookings,South Dakota,2004,5443,7662,270,13375,0.40695327102803736,0.5728598130841122,0.020186915887850466,897,44,1450,2391,-0.006921455847417879,-0.0003884664865122442,0.007309922333930019,-2219,-553,-0.1659065420560748,-0.014231378181347898
11686,46011,Brookings,South Dakota,2008,7207,6431,307,13945,0.5168160631050556,0.4611688777339548,0.022015059160989604,1764,37,-1231,570,0.10986279207701821,0.0018281432731391371,-0.11169093535015734,776,2995,0.05564718537110075,0.22155372742717555
11687,46011,Brookings,South Dakota,2012,5827,6220,353,12400,0.46991935483870967,0.5016129032258064,0.028467741935483872,-1380,46,-211,-1545,-0.0468967082663459,0.006452682774494269,0.04044402549185161,-393,-1169,-0.03169354838709676,-0.08734073375819751
11688,46011,Brookings,South Dakota,2016,4879,6748,1053,12680,0.38477917981072557,0.5321766561514195,0.08304416403785489,-948,700,528,280,-0.0851401750279841,0.054576422102371014,0.030563752925613086,-1869,-1476,-0.14739747634069394,-0.11570392795359719
11689,46013,Brown,South Dakota,2000,7173,9060,323,16556,0.43325682532012566,0.547233631311911,0.019509543367963275,0,0,0,0,0.0,0.0,0.0,-1887,0,-0.11397680599178539,0.0
11690,46013,Brown,South Dakota,2004,7943,10386,270,18599,0.427065971288779,0.558417119199957,0.014516909511264046,770,-53,1326,2043,-0.006190854031346671,-0.004992633856699229,0.011183487888045907,-2443,-556,-0.13135114791117797,-0.017374341919392577
11691,46013,Brown,South Dakota,2008,9041,8067,318,17426,0.5188224492138185,0.462928956731321,0.018248594054860554,1098,48,-2319,-1173,0.09175647792503949,0.003731684543596507,-0.09548816246863595,974,3417,0.055893492482497475,0.18724464039367544
11692,46013,Brown,South Dakota,2012,7250,8321,497,16068,0.45120736868309685,0.5178615882499378,0.030931043066965397,-1791,179,254,-1358,-0.06761508053072163,0.012682449012104843,0.05493263151861677,-1071,-2045,-0.06665421956684092,-0.1225477120493384
11693,46013,Brown,South Dakota,2016,5452,9613,1049,16114,0.33833933225766416,0.596561995780067,0.06509867196226883,-1798,552,1292,46,-0.1128680364254327,0.034167628895303434,0.07870040753012919,-4161,-3090,-0.2582226635224028,-0.19156844395556188
11694,46015,Brule,South Dakota,2000,818,1268,81,2167,0.3774803876326719,0.5851407475772958,0.0373788647900323,0,0,0,0,0.0,0.0,0.0,-450,0,-0.20766035994462395,0.0
11695,46015,Brule,South Dakota,2004,1040,1544,45,2629,0.39558767592240396,0.5872955496386458,0.017116774438950173,222,-36,276,462,0.01810728828973207,-0.02026209035108213,0.002154802061349992,-504,-54,-0.19170787371624187,0.01595248622838208
11696,46015,Brule,South Dakota,2008,965,1407,67,2439,0.3956539565395654,0.5768757687576875,0.027470274702747027,-75,22,-137,-190,6.628061716146272e-05,0.010353500263796854,-0.010419780880958296,-442,62,-0.1812218122181221,0.010486061498119759
11697,46015,Brule,South Dakota,2012,824,1499,56,2379,0.346364018495166,0.6300966792770072,0.023539302227826818,-141,-11,92,-60,-0.049289938044399406,-0.003930972474920209,0.05322091051931965,-675,-233,-0.2837326607818412,-0.10251084856371906
11698,46015,Brule,South Dakota,2016,571,1565,152,2288,0.24956293706293706,0.6840034965034965,0.06643356643356643,-253,96,66,-91,-0.09680108143222896,0.042894264205739614,0.05390681722648927,-994,-319,-0.43444055944055937,-0.1507078986587182
11699,46017,Buffalo,South Dakota,2000,256,140,12,408,0.6274509803921569,0.3431372549019608,0.029411764705882353,0,0,0,0,0.0,0.0,0.0,116,0,0.28431372549019607,0.0
11700,46017,Buffalo,South Dakota,2004,603,223,15,841,0.7170035671819263,0.26516052318668254,0.0178359096313912,347,3,83,433,0.0895525867897694,-0.011575855074491152,-0.07797673171527825,380,264,0.4518430439952437,0.16752931850504765
11701,46017,Buffalo,South Dakota,2008,454,156,9,619,0.7334410339256866,0.2520193861066236,0.014539579967689823,-149,-6,-67,-222,0.016437466743760343,-0.0032963296637013775,-0.013141137080058929,298,-82,0.481421647819063,0.02957860382381927
11702,46017,Buffalo,South Dakota,2012,472,166,3,641,0.7363494539781591,0.2589703588143526,0.0046801872074883,18,-6,10,22,0.0029084200524724935,-0.009859392760201523,0.006950972707728986,306,8,0.4773790951638065,-0.004042552655256493
11703,46017,Buffalo,South Dakota,2016,296,171,23,490,0.6040816326530613,0.3489795918367347,0.04693877551020408,-176,20,5,-151,-0.13226782132509785,0.04225858830271578,0.09000923302238212,125,-181,0.25510204081632654,-0.22227705434747996
11704,46019,Butte,South Dakota,2000,840,2760,89,3689,0.22770398481973433,0.74817023583627,0.024125779343995662,0,0,0,0,0.0,0.0,0.0,-1920,0,-0.5204662510165357,0.0
11705,46019,Butte,South Dakota,2004,1009,3166,96,4271,0.23624443924139546,0.7412783891360337,0.022477171622570825,169,7,406,582,0.008540454421661126,-0.0016486077214248364,-0.006891846700236237,-2157,-237,-0.5050339498946382,0.015432301121897418
11706,46019,Butte,South Dakota,2008,1306,2821,129,4256,0.3068609022556391,0.662828947368421,0.03031015037593985,297,33,-345,-15,0.07061646301424365,0.007832978753369024,-0.0784494417676127,-1515,642,-0.3559680451127819,0.14906590478185633
11707,46019,Butte,South Dakota,2012,1002,3073,133,4208,0.23811787072243346,0.7302756653992395,0.031606463878326996,-304,4,252,-48,-0.06874303153320566,0.001296313502387146,0.06744671803081848,-2071,-556,-0.49215779467680604,-0.13618974956402413
11708,46019,Butte,South Dakota,2016,696,3357,298,4351,0.1599632268444036,0.7715467708572742,0.06849000229832222,-306,165,284,143,-0.07815464387802987,0.03688353841999523,0.041271105458034696,-2661,-590,-0.6115835440128706,-0.11942574933606459
11709,46021,Campbell,South Dakota,2000,147,739,31,917,0.16030534351145037,0.8058887677208287,0.03380588876772083,0,0,0,0,0.0,0.0,0.0,-592,0,-0.6455834242093783,0.0
11710,46021,Campbell,South Dakota,2004,239,708,12,959,0.2492179353493222,0.7382690302398331,0.01251303441084463,92,-19,-31,42,0.08891259183787184,-0.021292854356876202,-0.06761973748099559,-469,123,-0.4890510948905109,0.1565323293188674
11711,46021,Campbell,South Dakota,2008,243,591,20,854,0.28454332552693207,0.6920374707259953,0.0234192037470726,4,8,-117,-105,0.035325390177609856,0.010906169336227971,-0.04623155951383784,-348,121,-0.40749414519906324,0.08155694969144767
11712,46021,Campbell,South Dakota,2012,153,616,18,787,0.19440914866581957,0.7827191867852605,0.022871664548919948,-90,-2,25,-67,-0.0901341768611125,-0.0005475391981526537,0.09068171605926523,-463,-115,-0.5883100381194409,-0.1808158929203777
11713,46021,Campbell,South Dakota,2016,105,704,22,831,0.1263537906137184,0.8471720818291215,0.026474127557160047,-48,4,88,44,-0.06805535805210117,0.0036024630082400998,0.06445289504386098,-599,-136,-0.7208182912154031,-0.13250825309596215
11714,46023,Charles Mix,South Dakota,2000,1300,2205,74,3579,0.3632299525006985,0.6160938809723386,0.020676166526962837,0,0,0,0,0.0,0.0,0.0,-905,0,-0.25286392847164013,0.0
11715,46023,Charles Mix,South Dakota,2004,2155,2556,87,4798,0.44914547728220094,0.5327219674864527,0.018132555231346395,855,13,351,1219,0.08591552478150244,-0.0025436112956164422,-0.0833719134858859,-401,504,-0.08357649020425179,0.16928743826738835
11716,46023,Charles Mix,South Dakota,2008,1807,2109,62,3978,0.4542483660130719,0.5301659125188537,0.01558572146807441,-348,-25,-447,-820,0.005102888730870947,-0.0025468337632719856,-0.0025560549675990307,-302,99,-0.07591754650578181,0.007658943698469978
11717,46023,Charles Mix,South Dakota,2012,1483,2230,51,3764,0.39399574920297553,0.5924548352816154,0.01354941551540914,-324,-11,121,-214,-0.06025261681009636,-0.00203630595266527,0.062288922762761656,-747,-445,-0.19845908607863982,-0.12254153957285802
11718,46023,Charles Mix,South Dakota,2016,935,2382,116,3433,0.27235653946985144,0.6938537722108943,0.033789688319254295,-548,65,152,-331,-0.12163920973312409,0.020240272803845154,0.10139893692927893,-1447,-700,-0.42149723274104284,-0.22303814666240301
11719,46025,Clark,South Dakota,2000,791,1272,45,2108,0.3752371916508539,0.603415559772296,0.021347248576850095,0,0,0,0,0.0,0.0,0.0,-481,0,-0.2281783681214421,0.0
11720,46025,Clark,South Dakota,2004,875,1435,17,2327,0.3760206274172755,0.6166738289643318,0.00730554361839278,84,-28,163,219,0.0007834357664215919,-0.014041704958457316,0.013258269192035765,-560,-79,-0.24065320154705627,-0.012474833425614174
11721,46025,Clark,South Dakota,2008,830,1065,45,1940,0.42783505154639173,0.5489690721649485,0.023195876288659795,-45,28,-370,-387,0.05181442412911624,0.015890332670267016,-0.06770475679938326,-235,325,-0.12113402061855677,0.1195191809284995
11722,46025,Clark,South Dakota,2012,713,1067,41,1821,0.3915431081823174,0.585941790225151,0.022515101592531575,-117,-4,2,-119,-0.03629194336407432,-0.0006807746961282196,0.036972718060202525,-354,-119,-0.19439868204283361,-0.07326466142427684
11723,46025,Clark,South Dakota,2016,398,1139,120,1657,0.24019312009656005,0.6873868436934218,0.07242003621001811,-315,79,72,-164,-0.15134998808575736,0.04990493461748653,0.10144505346827082,-741,-387,-0.4471937235968618,-0.2527950415540282
11724,46027,Clay,South Dakota,2000,2638,2363,104,5105,0.5167482859941234,0.46287952987267383,0.020372184133202742,0,0,0,0,0.0,0.0,0.0,275,0,0.053868756121449535,0.0
11725,46027,Clay,South Dakota,2004,3315,2692,129,6136,0.5402542372881356,0.438722294654498,0.02102346805736636,677,25,329,1031,0.02350595129401223,0.0006512839241636197,-0.02415723521817581,623,348,0.10153194263363757,0.04766318651218804
11726,46027,Clay,South Dakota,2008,3808,2296,138,6242,0.6100608779237424,0.3678308234540211,0.022108298622236462,493,9,-396,106,0.06980664063560682,0.0010848305648701005,-0.0708914712004769,1512,889,0.2422300544697213,0.14069811183608372
11727,46027,Clay,South Dakota,2012,2955,2147,132,5234,0.5645777607948033,0.41020252197172336,0.025219717233473445,-853,-6,-149,-1008,-0.045483117128939154,0.0031114186112369824,0.04237169851770223,808,-704,0.1543752388230799,-0.08785481564664138
11728,46027,Clay,South Dakota,2016,2608,2109,352,5069,0.5144999013612153,0.41605839416058393,0.06944170447820083,-347,220,-38,-165,-0.050077859433588,0.04422198724472739,0.005855872188860578,499,-309,0.09844150720063133,-0.05593373162244858
11729,46029,Codington,South Dakota,2000,4192,6718,228,11138,0.3763691865685042,0.6031603519482851,0.02047046148321063,0,0,0,0,0.0,0.0,0.0,-2526,0,-0.2267911653797809,0.0
11730,46029,Codington,South Dakota,2004,4803,7778,170,12751,0.376676339110658,0.6099913732256294,0.01333228766371265,611,-58,1060,1613,0.00030715254215379906,-0.007138173819497979,0.006831021277344251,-2975,-449,-0.23331503411497134,-0.006523868735190452
11731,46029,Codington,South Dakota,2008,5595,6374,216,12185,0.45917111202297906,0.5231021748050882,0.017726713171932706,792,46,-1404,-566,0.08249477291232105,0.004394425508220055,-0.0868891984205411,-779,2196,-0.0639310627821092,0.16938397133286215
11732,46029,Codington,South Dakota,2012,4588,6696,240,11524,0.398125650815689,0.581048247136411,0.020826102047900034,-1007,24,322,-661,-0.06104546120729004,0.003099388875967328,0.05794607233132276,-2108,-1329,-0.182922596320722,-0.1189915335386128
11733,46029,Codington,South Dakota,2016,3174,7764,731,11669,0.2720027423086811,0.6653526437569629,0.06264461393435598,-1414,491,1068,145,-0.1261229085070079,0.04181851188645595,0.08430439662055189,-4590,-2482,-0.3933499014482818,-0.2104273051275598
11734,46031,Corson,South Dakota,2000,549,629,65,1243,0.4416733708769107,0.5060337892196299,0.05229283990345937,0,0,0,0,0.0,0.0,0.0,-80,0,-0.06436041834271922,0.0
11735,46031,Corson,South Dakota,2004,972,720,32,1724,0.5638051044083526,0.4176334106728538,0.018561484918793503,423,-33,91,481,0.12213173353144191,-0.03373135498466587,-0.08840037854677613,252,332,0.14617169373549882,0.21053211207821804
11736,46031,Corson,South Dakota,2008,837,535,34,1406,0.5953058321479374,0.38051209103840683,0.02418207681365576,-135,2,-185,-318,0.03150072773958479,0.005620591894862258,-0.03712131963444698,302,50,0.2147937411095306,0.06862204737403177
11737,46031,Corson,South Dakota,2012,648,515,37,1200,0.54,0.42916666666666664,0.030833333333333334,-189,3,-20,-206,-0.055305832147937384,0.006651256519677573,0.04865457562825981,133,-169,0.1108333333333334,-0.1039604077761972
11738,46031,Corson,South Dakota,2016,535,588,52,1175,0.4553191489361702,0.5004255319148936,0.04425531914893617,-113,15,73,-25,-0.08468085106382983,0.013421985815602836,0.07125886524822694,-53,-186,-0.04510638297872338,-0.15593971631205678
11739,46033,Custer,South Dakota,2000,955,2495,123,3573,0.2672823957458718,0.6982927511894766,0.03442485306465155,0,0,0,0,0.0,0.0,0.0,-1540,0,-0.43101035544360483,0.0
11740,46033,Custer,South Dakota,2004,1272,2922,110,4304,0.2955390334572491,0.6789033457249071,0.025557620817843865,317,-13,427,731,0.028256637711377264,-0.008867232246807688,-0.019389405464569576,-1650,-110,-0.383364312267658,0.04764604317594684
11741,46033,Custer,South Dakota,2008,1475,2909,123,4507,0.3272686931439982,0.6454404260039938,0.02729088085200799,203,13,-13,203,0.03172965968674912,0.0017332600341641233,-0.03346291972091331,-1434,216,-0.31817173285999556,0.06519257940766243
11742,46033,Custer,South Dakota,2012,1335,3062,123,4520,0.29535398230088494,0.6774336283185841,0.027212389380530975,-140,0,153,13,-0.03191471084311326,-7.849147147701366e-05,0.03199320231459035,-1727,-293,-0.38207964601769917,-0.06390791315770361
11743,46033,Custer,South Dakota,2016,1121,3293,307,4721,0.23744969286168185,0.6975217115018004,0.06502859563651768,-214,184,231,201,-0.05790428943920309,0.03781620625598671,0.02008808318321631,-2172,-445,-0.4600720186401186,-0.07799237262241943
11744,46035,Davison,South Dakota,2000,2936,4445,147,7528,0.3900106269925611,0.5904622741764081,0.019527098831030817,0,0,0,0,0.0,0.0,0.0,-1509,0,-0.20045164718384695,0.0
11745,46035,Davison,South Dakota,2004,3263,5561,128,8952,0.3644995531724754,0.6212019660411081,0.014298480786416443,327,-19,1116,1424,-0.025511073820085717,-0.005228618044614374,0.030739691864700047,-2298,-789,-0.2567024128686327,-0.056250765684785764
11746,46035,Davison,South Dakota,2008,3554,4731,170,8455,0.42034299231224126,0.5595505617977528,0.020106445890005913,291,42,-830,-497,0.05584343913976586,0.00580796510358947,-0.06165140424335536,-1177,1121,-0.1392075694855115,0.11749484338312122
11747,46035,Davison,South Dakota,2012,3042,4757,172,7971,0.3816334211516748,0.5967883577970142,0.021578221051311002,-512,2,26,-484,-0.03870957116056645,0.001471775161305089,0.03723779599926147,-1715,-538,-0.2151549366453394,-0.07594736715982792
11748,46035,Davison,South Dakota,2016,2355,5157,440,7952,0.29615191146881287,0.6485160965794768,0.05533199195171026,-687,268,400,-19,-0.08548150968286194,0.03375377090039926,0.05172773878246262,-2802,-1087,-0.352364185110664,-0.13720924846532456
11749,46037,Day,South Dakota,2000,1492,1623,82,3197,0.4666875195495777,0.5076634344698154,0.02564904598060682,0,0,0,0,0.0,0.0,0.0,-131,0,-0.04097591492023772,0.0
11750,46037,Day,South Dakota,2004,1817,1671,52,3540,0.5132768361581921,0.47203389830508474,0.014689265536723164,325,-30,48,343,0.04658931660861437,-0.010959780443883656,-0.03562953616473069,146,277,0.04124293785310734,0.08221885277334506
11751,46037,Day,South Dakota,2008,1785,1372,48,3205,0.5569422776911076,0.4280811232449298,0.01497659906396256,-32,-4,-299,-335,0.04366544153291552,0.00028733352723939523,-0.043952775060154936,413,267,0.1288611544461778,0.08761821659307045
11752,46037,Day,South Dakota,2012,1497,1320,56,2873,0.521058127392969,0.4594500522102332,0.01949182039679777,-288,8,-52,-332,-0.03588415029813863,0.004515221332835212,0.03136892896530341,177,-236,0.061608075182735755,-0.06725307926344204
11753,46037,Day,South Dakota,2016,974,1627,146,2747,0.3545686203130688,0.592282489989079,0.053148889697852204,-523,90,307,-126,-0.16648950707990018,0.03365706930105443,0.13283243777884574,-653,-830,-0.23771386967601016,-0.2993219448587459
11754,46039,Deuel,South Dakota,2000,926,1245,53,2224,0.41636690647482016,0.5598021582733813,0.023830935251798562,0,0,0,0,0.0,0.0,0.0,-319,0,-0.14343525179856115,0.0
11755,46039,Deuel,South Dakota,2004,961,1406,45,2412,0.398424543946932,0.5829187396351575,0.018656716417910446,35,-8,161,188,-0.017942362527888167,-0.005174218833888116,0.02311658136177619,-445,-126,-0.1844941956882255,-0.04105894388966436
11756,46039,Deuel,South Dakota,2008,1054,1088,76,2218,0.47520288548241657,0.4905320108205591,0.034265103697024346,93,31,-318,-194,0.07677834153548457,0.0156083872791139,-0.09238672881459842,-34,411,-0.015329125338142513,0.169165070350083
11757,46039,Deuel,South Dakota,2012,941,1175,55,2171,0.4334408106863197,0.5412252418240442,0.025333947489636112,-113,-21,87,-47,-0.04176207479609689,-0.008931156207388234,0.050693231003485106,-234,-200,-0.10778443113772451,-0.092455305799582
11758,46039,Deuel,South Dakota,2016,570,1366,144,2080,0.27403846153846156,0.6567307692307692,0.06923076923076923,-371,89,191,-91,-0.1594023491478581,0.04389682174113312,0.11550552740672504,-796,-562,-0.38269230769230766,-0.27490787655458315
11759,46041,Dewey,South Dakota,2000,880,761,40,1681,0.5234979179060083,0.4527067221891731,0.02379535990481856,0,0,0,0,0.0,0.0,0.0,119,0,0.07079119571683518,0.0
11760,46041,Dewey,South Dakota,2004,1606,921,37,2564,0.6263650546021841,0.359204368174727,0.014430577223088924,726,-3,160,883,0.10286713669617575,-0.009364782681729635,-0.09350235401444612,685,566,0.26716068642745705,0.19636949071062187
11761,46041,Dewey,South Dakota,2008,1328,659,32,2019,0.657751362060426,0.32639920752847945,0.0158494304110946,-278,-5,-262,-545,0.03138630745824189,0.0014188531880056764,-0.032805160646247555,669,-16,0.3313521545319465,0.06419146810448945
11762,46041,Dewey,South Dakota,2012,1207,663,25,1895,0.6369393139841689,0.34986807387862795,0.013192612137203167,-121,-7,4,-124,-0.020812048076257028,-0.002656818273891434,0.0234688663501485,544,-125,0.28707124010554097,-0.04428091442640553
11763,46041,Dewey,South Dakota,2016,888,723,97,1708,0.5199063231850117,0.42330210772833726,0.056791569086651054,-319,72,60,-187,-0.11703299079915719,0.04359895694944789,0.07343403384970931,165,-379,0.09660421545667447,-0.1904670246488665
11764,46043,Douglas,South Dakota,2000,363,1311,35,1709,0.21240491515506144,0.7671152720889409,0.02047981275599766,0,0,0,0,0.0,0.0,0.0,-948,0,-0.5547103569338795,0.0
11765,46043,Douglas,South Dakota,2004,393,1596,23,2012,0.19532803180914513,0.7932405566600398,0.01143141153081511,30,-12,285,303,-0.01707688334591631,-0.00904840122518255,0.02612528457109886,-1203,-255,-0.5979125248508946,-0.043202167917015144
11766,46043,Douglas,South Dakota,2008,424,1293,39,1756,0.24145785876993167,0.7363325740318907,0.022209567198177675,31,16,-303,-256,0.046129826960786546,0.010778155667362566,-0.05690798262814911,-869,334,-0.49487471526195903,0.1030378095889356
11767,46043,Douglas,South Dakota,2012,332,1334,24,1690,0.19644970414201182,0.7893491124260354,0.014201183431952662,-92,-15,41,-66,-0.04500815462791985,-0.008008383766225013,0.053016538394144774,-1002,-133,-0.5928994082840237,-0.09802469302206462
11768,46043,Douglas,South Dakota,2016,214,1338,53,1605,0.13333333333333333,0.8336448598130841,0.03302180685358255,-118,29,4,-85,-0.06311637080867849,0.018820623421629892,0.04429574738704867,-1124,-122,-0.7003115264797508,-0.10741211819572716
11769,46045,Edmunds,South Dakota,2000,676,1257,53,1986,0.3403826787512588,0.6329305135951662,0.026686807653575024,0,0,0,0,0.0,0.0,0.0,-581,0,-0.29254783484390734,0.0
11770,46045,Edmunds,South Dakota,2004,765,1434,35,2234,0.3424350940017905,0.6418979409131602,0.01566696508504924,89,-18,177,248,0.0020524152505316806,-0.011019842568525784,0.008967427317994048,-669,-88,-0.2994628469113697,-0.006915012067462367
11771,46045,Edmunds,South Dakota,2008,819,1213,44,2076,0.3945086705202312,0.5842967244701349,0.02119460500963391,54,9,-221,-158,0.05207357651844069,0.00552763992458467,-0.057601216443025294,-394,275,-0.18978805394990372,0.10967479296146598
11772,46045,Edmunds,South Dakota,2012,622,1264,50,1936,0.3212809917355372,0.6528925619834711,0.025826446280991736,-197,6,51,-140,-0.073227678784694,0.004631841271357826,0.0685958375133362,-642,-248,-0.3316115702479339,-0.1418235162980302
11773,46045,Edmunds,South Dakota,2016,380,1433,105,1918,0.1981230448383733,0.7471324296141815,0.05474452554744526,-242,55,169,-18,-0.12315794689716389,0.028918079266453522,0.09423986763071035,-1053,-411,-0.5490093847758082,-0.21739781452787427
11774,46047,Fall River,South Dakota,2000,1133,2185,111,3429,0.3304170312044328,0.6372120151647711,0.03237095363079615,0,0,0,0,0.0,0.0,0.0,-1052,0,-0.30679498396033833,0.0
11775,46047,Fall River,South Dakota,2004,1326,2413,106,3845,0.3448634590377113,0.6275682704811444,0.027568270481144342,193,-5,228,416,0.014446427833278541,-0.00480268314965181,-0.00964374468362672,-1087,-35,-0.28270481144343307,0.02409017251690526
11776,46047,Fall River,South Dakota,2008,1338,2348,123,3809,0.35127330007876084,0.6164347597794697,0.03229194014176949,12,17,-65,-36,0.006409841041049524,0.004723669660625148,-0.011133510701674676,-1010,77,-0.26516145970070887,0.0175433517427242
11777,46047,Fall River,South Dakota,2012,1140,2258,118,3516,0.3242320819112628,0.6422070534698521,0.0335608646188851,-198,-5,-90,-293,-0.02704121816749805,0.0012689244771156086,0.025772293690382364,-1118,-108,-0.3179749715585893,-0.05281351185788041
11778,46047,Fall River,South Dakota,2016,821,2511,231,3563,0.23042380016839742,0.7047431939376929,0.06483300589390963,-319,113,253,47,-0.09380828174286537,0.03127214127502453,0.06253614046784084,-1690,-572,-0.4743193937692955,-0.1563444222107062
11779,46049,Faulk,South Dakota,2000,388,904,37,1329,0.29194883370955604,0.6802106847253574,0.02784048156508653,0,0,0,0,0.0,0.0,0.0,-516,0,-0.38826185101580135,0.0
11780,46049,Faulk,South Dakota,2004,418,945,6,1369,0.30533235938641345,0.6902848794740687,0.004382761139517896,30,-31,41,40,0.01338352567685741,-0.023457720425568634,0.010074194748711296,-527,-11,-0.38495252008765524,0.0033093309281461147
11781,46049,Faulk,South Dakota,2008,426,739,27,1192,0.3573825503355705,0.6199664429530202,0.022651006711409395,8,21,-206,-177,0.05205019094915703,0.0182682455718915,-0.07031843652104852,-313,214,-0.2625838926174497,0.12236862747020555
11782,46049,Faulk,South Dakota,2012,331,765,31,1127,0.2937000887311446,0.678793256433008,0.027506654835847383,-95,4,26,-65,-0.06368246160442587,0.004855648124437988,0.05882681347998786,-434,-121,-0.3850931677018634,-0.12250927508441373
11783,46049,Faulk,South Dakota,2016,204,858,56,1118,0.18246869409660108,0.7674418604651163,0.05008944543828265,-127,25,93,-9,-0.11123139463454354,0.022582790602435267,0.08864860403210828,-654,-220,-0.5849731663685153,-0.19987999866665185
11784,46051,Grant,South Dakota,2000,1475,2235,120,3830,0.38511749347258484,0.5835509138381201,0.031331592689295036,0,0,0,0,0.0,0.0,0.0,-760,0,-0.19843342036553524,0.0
11785,46051,Grant,South Dakota,2004,1633,2392,65,4090,0.3992665036674817,0.5848410757946211,0.01589242053789731,158,-55,157,260,0.014149010194896838,-0.015439172151397725,0.0012901619565010014,-759,1,-0.1855745721271394,0.012858848238395837
11786,46051,Grant,South Dakota,2008,1786,1951,93,3830,0.46631853785900784,0.5093994778067885,0.024281984334203654,153,28,-441,-260,0.06705203419152617,0.008389563796306343,-0.07544159798783256,-165,594,-0.04308093994778067,0.14249363217935873
11787,46051,Grant,South Dakota,2012,1493,2034,79,3606,0.4140321686078758,0.5640599001663894,0.021907931225734888,-293,-14,83,-224,-0.05228636925113206,-0.002374053108468766,0.05466042235960089,-541,-376,-0.15002773155851362,-0.10694679161073295
11788,46051,Grant,South Dakota,2016,971,2382,211,3564,0.2724466891133558,0.6683501683501684,0.05920314253647587,-522,132,348,-42,-0.14158547949452,0.03729521131074098,0.10429026818377896,-1411,-870,-0.39590347923681257,-0.24587574767829895
11789,46053,Gregory,South Dakota,2000,718,1487,52,2257,0.3181214000886132,0.6588391670358883,0.02303943287549845,0,0,0,0,0.0,0.0,0.0,-769,0,-0.34071776694727507,0.0
11790,46053,Gregory,South Dakota,2004,813,1685,48,2546,0.319324430479183,0.6618224666142969,0.018853102906520033,95,-4,198,289,0.0012030303905697926,-0.004186329968978417,0.0029832995784085936,-872,-103,-0.34249803613511387,-0.001780269187838801
11791,46053,Gregory,South Dakota,2008,771,1423,53,2247,0.3431241655540721,0.6332888295505118,0.02358700489541611,-42,5,-262,-299,0.023799735074889083,0.004733901988896078,-0.02853363706378509,-652,220,-0.2901646639964397,0.05233337213867417
11792,46053,Gregory,South Dakota,2012,599,1507,45,2151,0.27847512784751277,0.700604370060437,0.02092050209205021,-172,-8,84,-96,-0.06464903770655933,-0.0026665028033659027,0.06731554050992516,-908,-256,-0.4221292422129242,-0.1319645782164845
11793,46053,Gregory,South Dakota,2016,391,1600,100,2091,0.18699186991869918,0.7651841224294595,0.04782400765184122,-208,55,93,-60,-0.0914832579288136,0.026903505559791013,0.06457975236902258,-1209,-301,-0.5781922525107603,-0.15606301029783615
11794,46055,Haakon,South Dakota,2000,164,938,27,1129,0.14526129317980513,0.8308237378210807,0.023914968999114262,0,0,0,0,0.0,0.0,0.0,-774,0,-0.6855624446412756,0.0
11795,46055,Haakon,South Dakota,2004,219,1007,14,1240,0.17661290322580644,0.8120967741935484,0.01129032258064516,55,-13,69,111,0.031351610046001316,-0.012624646418469101,-0.018726963627532234,-788,-14,-0.635483870967742,0.05007857367353363
11796,46055,Haakon,South Dakota,2008,187,939,27,1153,0.16218560277536861,0.8143972246313964,0.023417172593235037,-32,13,-68,-87,-0.01442730045043783,0.012126850012589877,0.0023004504378479895,-752,36,-0.6522116218560278,-0.01672775088828582
11797,46055,Haakon,South Dakota,2012,138,940,14,1092,0.12637362637362637,0.8608058608058609,0.01282051282051282,-49,-13,1,-61,-0.035811976401742246,-0.010596659772722217,0.046408636174464446,-802,-50,-0.7344322344322345,-0.08222061257620672
11798,46055,Haakon,South Dakota,2016,77,936,31,1044,0.07375478927203065,0.896551724137931,0.029693486590038315,-61,17,-4,-48,-0.05261883710159572,0.016872973769525495,0.035745863332070194,-859,-57,-0.8227969348659004,-0.08836470043366595
11799,46057,Hamlin,South Dakota,2000,923,1731,69,2723,0.33896437752478886,0.6356959236136615,0.025339698861549763,0,0,0,0,0.0,0.0,0.0,-808,0,-0.2967315460888726,0.0
11800,46057,Hamlin,South Dakota,2004,1015,1946,50,3011,0.33709730986383263,0.6462969113251411,0.016605778811026237,92,-19,215,288,-0.0018670676609562342,-0.008733920050523526,0.010600987711479659,-931,-123,-0.3091996014613085,-0.012468055372435893
11801,46057,Hamlin,South Dakota,2008,1043,1661,83,2787,0.37423753139576604,0.5959813419447435,0.02978112665949049,28,33,-285,-224,0.037140221531933415,0.013175347848464254,-0.05031556938039761,-618,313,-0.22174381054897746,0.08745579091233102
11802,46057,Hamlin,South Dakota,2012,921,1803,69,2793,0.3297529538131042,0.6455424274973147,0.024704618689581095,-122,-14,142,6,-0.04448457758266183,-0.005076507969909397,0.049561085552571216,-882,-264,-0.3157894736842105,-0.09404566313523305
11803,46057,Hamlin,South Dakota,2016,555,2051,156,2762,0.20094134685010862,0.7425778421433744,0.056480811006517015,-366,87,248,-31,-0.1288116069629956,0.03177619231693592,0.09703541464605969,-1496,-614,-0.5416364952932657,-0.22584702160905523
11804,46059,Hand,South Dakota,2000,565,1419,47,2031,0.2781880846873461,0.6986706056129985,0.023141309699655343,0,0,0,0,0.0,0.0,0.0,-854,0,-0.4204825209256524,0.0
11805,46059,Hand,South Dakota,2004,668,1482,37,2187,0.30544124371284864,0.6776406035665294,0.016918152720621856,103,-10,63,156,0.027253159025502516,-0.006223156979033487,-0.0210300020464691,-814,40,-0.3721993598536808,0.048283161071971614
11806,46059,Hand,South Dakota,2008,718,1247,46,2011,0.35703630034808553,0.6200895077076082,0.022874191944306316,50,9,-235,-176,0.05159505663523689,0.00595603922368446,-0.057551095858921264,-529,285,-0.26305320735952264,0.10914615249415816
11807,46059,Hand,South Dakota,2012,575,1242,31,1848,0.31114718614718617,0.672077922077922,0.016774891774891776,-143,-15,-5,-163,-0.04588911420089936,-0.00609930016941454,0.05198841437031387,-667,-138,-0.3609307359307359,-0.09787752857121323
11808,46059,Hand,South Dakota,2016,334,1391,93,1818,0.18371837183718373,0.7651265126512651,0.05115511551155116,-241,62,149,-30,-0.12742881431000244,0.03438022373665938,0.09304859057334303,-1057,-390,-0.5814081408140813,-0.22047740488334544
11809,46061,Hanson,South Dakota,2000,457,944,20,1421,0.3216045038705137,0.6643209007741028,0.014074595355383532,0,0,0,0,0.0,0.0,0.0,-487,0,-0.34271639690358907,0.0
11810,46061,Hanson,South Dakota,2004,745,1379,26,2150,0.34651162790697676,0.6413953488372093,0.012093023255813953,288,6,435,729,0.024907124036463058,-0.001981572099569579,-0.022925551936893496,-634,-147,-0.2948837209302325,0.04783267597335655
11811,46061,Hanson,South Dakota,2008,961,1426,44,2431,0.39531057178116,0.5865898807075277,0.01809954751131222,216,18,47,281,0.048798943874183265,0.006006524255498266,-0.05480546812968157,-465,169,-0.19127930892636769,0.10360441200386483
11812,46061,Hanson,South Dakota,2012,760,1627,29,2416,0.31456953642384106,0.6734271523178808,0.012003311258278146,-201,-15,201,-15,-0.08074103535731897,-0.0060962362530340725,0.08683727161035304,-867,-402,-0.3588576158940397,-0.167578306967672
11813,46061,Hanson,South Dakota,2016,424,1497,85,2006,0.21136590229312063,0.7462612163509471,0.0423728813559322,-336,56,-130,-410,-0.10320363413072042,0.030369570097654057,0.07283406403306636,-1073,-206,-0.5348953140578265,-0.17603769816378684
11814,46063,Harding,South Dakota,2000,64,650,17,731,0.08755129958960328,0.8891928864569083,0.023255813953488372,0,0,0,0,0.0,0.0,0.0,-586,0,-0.801641586867305,0.0
11815,46063,Harding,South Dakota,2004,94,704,17,815,0.11533742331288344,0.8638036809815951,0.020858895705521473,30,0,54,84,0.027786123723280154,-0.0023969182479668984,-0.025389205475313203,-610,-24,-0.7484662576687117,0.05317532919859336
11816,46063,Harding,South Dakota,2008,135,575,24,734,0.18392370572207084,0.7833787465940054,0.0326975476839237,41,7,-129,-81,0.0685862824091874,0.01183865197840223,-0.08042493438758969,-440,170,-0.5994550408719346,0.1490112167967771
11817,46063,Harding,South Dakota,2012,82,638,19,739,0.11096075778078485,0.8633288227334236,0.02571041948579161,-53,-5,63,5,-0.072962947941286,-0.006987128198132093,0.07995007613941818,-556,-116,-0.7523680649526387,-0.15291302408070417
11818,46063,Harding,South Dakota,2016,38,695,37,770,0.04935064935064935,0.9025974025974026,0.048051948051948054,-44,18,57,31,-0.06161010843013549,0.022341528566156444,0.039268579863979025,-657,-101,-0.8532467532467533,-0.1008786882941145
11819,46065,Hughes,South Dakota,2000,2212,5188,134,7534,0.2936023360764534,0.6886116272896204,0.0177860366339262,0,0,0,0,0.0,0.0,0.0,-2976,0,-0.395009291213167,0.0
11820,46065,Hughes,South Dakota,2004,2697,6017,121,8835,0.30526315789473685,0.681041312959819,0.013695529145444255,485,-13,829,1301,0.011660821818283429,-0.004090507488481946,-0.007570314329801486,-3320,-344,-0.3757781550650821,0.019231136148084915
11821,46065,Hughes,South Dakota,2008,3037,5298,133,8468,0.3586443079829948,0.6256495040151158,0.015706188001889467,340,12,-719,-367,0.053381150088257945,0.002010658856445212,-0.05539180894470319,-2261,1059,-0.267005196032121,0.10877295903296114
11822,46065,Hughes,South Dakota,2012,2786,5219,150,8155,0.34163090128755363,0.6399754751686082,0.018393623543838136,-251,17,-79,-313,-0.017013406695441158,0.0026874355419486684,0.014325971153492434,-2433,-172,-0.29834457388105456,-0.03133937784893359
11823,46065,Hughes,South Dakota,2016,2450,5174,551,8175,0.2996941896024465,0.6329051987767584,0.06740061162079511,-336,401,-45,20,-0.04193671168510715,0.04900698807695697,-0.007070276391849761,-2724,-291,-0.33321100917431196,-0.03486643529325739
11824,46067,Hutchinson,South Dakota,2000,1052,2497,76,3625,0.29020689655172416,0.6888275862068965,0.020965517241379312,0,0,0,0,0.0,0.0,0.0,-1445,0,-0.3986206896551724,0.0
11825,46067,Hutchinson,South Dakota,2004,1177,2899,71,4147,0.2838196286472148,0.6990595611285266,0.0171208102242585,125,-5,402,522,-0.006387267904509331,-0.003844707017120811,0.010231974921630083,-1722,-277,-0.4152399324813118,-0.016619242826139413
11826,46067,Hutchinson,South Dakota,2008,1242,2285,81,3608,0.3442350332594235,0.6333148558758315,0.02245011086474501,65,10,-614,-539,0.06041540461220868,0.00532930064048651,-0.06574470525269516,-1043,679,-0.28907982261640797,0.12616010986490384
11827,46067,Hutchinson,South Dakota,2012,923,2451,51,3425,0.2694890510948905,0.7156204379562043,0.01489051094890511,-319,-30,166,-183,-0.07474598216453299,-0.007559599915839901,0.08230558208037286,-1528,-485,-0.4461313868613138,-0.15705156424490585
11828,46067,Hutchinson,South Dakota,2016,692,2517,156,3365,0.20564635958395244,0.7479940564635958,0.04635958395245171,-231,105,66,-60,-0.06384269151093808,0.0314690730035466,0.03237361850739151,-1825,-297,-0.5423476968796435,-0.09621631001832964
11829,46069,Hyde,South Dakota,2000,218,592,25,835,0.26107784431137726,0.7089820359281437,0.029940119760479042,0,0,0,0,0.0,0.0,0.0,-374,0,-0.4479041916167664,0.0
11830,46069,Hyde,South Dakota,2004,259,631,10,900,0.2877777777777778,0.7011111111111111,0.011111111111111112,41,-15,39,65,0.02669993346640054,-0.01882900864936793,-0.007870924817032554,-372,2,-0.41333333333333333,0.03457085828343309
11831,46069,Hyde,South Dakota,2008,226,547,12,785,0.2878980891719745,0.6968152866242038,0.015286624203821656,-33,2,-84,-115,0.00012031139419671488,0.004175513092710545,-0.004295824486907351,-321,51,-0.40891719745222926,0.004416135881104066
11832,46069,Hyde,South Dakota,2012,189,531,13,733,0.2578444747612551,0.7244201909959073,0.017735334242837655,-37,1,-16,-52,-0.03005361441071941,0.0024487100390159985,0.027604904371703487,-342,-21,-0.46657571623465216,-0.057658518782422896
11833,46069,Hyde,South Dakota,2016,125,543,22,690,0.18115942028985507,0.7869565217391304,0.03188405797101449,-64,9,12,-43,-0.07668505447140003,0.014148723728176837,0.06253633074322318,-418,-76,-0.6057971014492753,-0.13922138521462318
11834,46071,Jackson,South Dakota,2000,319,687,34,1040,0.30673076923076925,0.6605769230769231,0.032692307692307694,0,0,0,0,0.0,0.0,0.0,-368,0,-0.3538461538461538,0.0
11835,46071,Jackson,South Dakota,2004,508,726,37,1271,0.3996852871754524,0.5712037765538945,0.029110936270653028,189,3,39,231,0.09295451794468312,-0.003581371421654666,-0.08937314652302852,-218,150,-0.17151848937844216,0.18232766446771165
11836,46071,Jackson,South Dakota,2008,435,668,30,1133,0.38393645189761694,0.589585172109444,0.0264783759929391,-73,-7,-58,-138,-0.015748835277835438,-0.0026325602777139273,0.018381395555549407,-233,-15,-0.205648720211827,-0.034130230833384845
11837,46071,Jackson,South Dakota,2012,426,661,19,1106,0.38517179023508136,0.5976491862567812,0.017179023508137433,-9,-11,-7,-27,0.00123533833746442,-0.009299352484801668,0.008064014147337262,-235,-2,-0.21247739602169985,-0.006828675809872842
11838,46071,Jackson,South Dakota,2016,323,722,50,1095,0.29497716894977166,0.6593607305936073,0.045662100456621,-103,31,61,-11,-0.0901946212853097,0.02848307694848357,0.06171154433682613,-399,-164,-0.3643835616438357,-0.15190616562213582
11839,46073,Jerauld,South Dakota,2000,468,624,30,1122,0.41711229946524064,0.5561497326203209,0.026737967914438502,0,0,0,0,0.0,0.0,0.0,-156,0,-0.13903743315508021,0.0
11840,46073,Jerauld,South Dakota,2004,482,736,18,1236,0.38996763754045305,0.5954692556634305,0.014563106796116505,14,-12,112,114,-0.027144661924787594,-0.012174861118321997,0.039319523043109594,-254,-98,-0.2055016181229774,-0.06646418496789719
11841,46073,Jerauld,South Dakota,2008,542,546,17,1105,0.49049773755656106,0.49411764705882355,0.015384615384615385,60,-1,-190,-131,0.10053010001610801,0.0008215085884988801,-0.1013516086046069,-4,250,-0.003619909502262486,0.20188170862071492
11842,46073,Jerauld,South Dakota,2012,452,538,16,1006,0.44930417495029823,0.5347912524850894,0.015904572564612324,-90,-1,-8,-99,-0.041193562606262835,0.0005199571799969389,0.04067360542626586,-86,-82,-0.08548707753479118,-0.08186716803252869
11843,46073,Jerauld,South Dakota,2016,264,648,55,967,0.2730093071354705,0.6701137538779731,0.05687693898655636,-188,39,110,-39,-0.17629486781482773,0.04097236642194403,0.1353225013928837,-384,-298,-0.3971044467425026,-0.31161736920771144
11844,46075,Jones,South Dakota,2000,137,509,18,664,0.2063253012048193,0.766566265060241,0.02710843373493976,0,0,0,0,0.0,0.0,0.0,-372,0,-0.5602409638554217,0.0
11845,46075,Jones,South Dakota,2004,134,565,18,717,0.18688981868898186,0.7880055788005579,0.02510460251046025,-3,0,56,53,-0.019435482515837432,-0.002003831224479509,0.021439313740316934,-431,-59,-0.601115760111576,-0.04087479625615431
11846,46075,Jones,South Dakota,2008,147,463,17,627,0.23444976076555024,0.7384370015948963,0.02711323763955343,13,-1,-102,-90,0.047559942076568384,0.002008635129093179,-0.049568577205661546,-316,115,-0.5039872408293461,0.09712851928222987
11847,46075,Jones,South Dakota,2012,108,490,11,609,0.17733990147783252,0.8045977011494253,0.0180623973727422,-39,-6,27,-18,-0.057109859287717724,-0.00905084026681123,0.06616069955452897,-382,-66,-0.6272577996715928,-0.12327055884224669
11848,46075,Jones,South Dakota,2016,69,450,39,558,0.12365591397849462,0.8064516129032258,0.06989247311827956,-39,28,-40,-51,-0.05368398749933789,0.051830075745537364,0.0018539117538004524,-381,1,-0.6827956989247311,-0.055537899253138345
11849,46077,Kingsbury,South Dakota,2000,1049,1612,66,2727,0.3846718005133847,0.5911257792445911,0.0242024202420242,0,0,0,0,0.0,0.0,0.0,-563,0,-0.2064539787312064,0.0
11850,46077,Kingsbury,South Dakota,2004,1163,1804,47,3014,0.3858659588586596,0.5985401459854015,0.015593895155938951,114,-19,192,287,0.0011941583452749205,-0.00860852508608525,0.007414366740810419,-641,-78,-0.2126741871267419,-0.006220208395535498
11851,46077,Kingsbury,South Dakota,2008,1277,1435,72,2784,0.4586925287356322,0.5154454022988506,0.02586206896551724,114,25,-369,-230,0.07282656987697261,0.01026817380957829,-0.0830947436865509,-158,483,-0.0567528735632184,0.1559213135635235
11852,46077,Kingsbury,South Dakota,2012,1092,1451,65,2608,0.4187116564417178,0.5563650306748467,0.02492331288343558,-185,-7,16,-176,-0.03998087229391439,-0.0009387560820816598,0.04091962837599605,-359,-201,-0.13765337423312884,-0.08090050066991045
11853,46077,Kingsbury,South Dakota,2016,703,1680,168,2551,0.275578204625637,0.6585652685221481,0.06585652685221481,-389,103,229,-57,-0.14313345181608084,0.04093321396877923,0.10220023784730148,-977,-618,-0.38298706389651116,-0.24533368966338231
11854,46079,Lake,South Dakota,2000,2331,2724,99,5154,0.4522700814901048,0.5285215366705471,0.01920838183934808,0,0,0,0,0.0,0.0,0.0,-393,0,-0.07625145518044235,0.0
11855,46079,Lake,South Dakota,2004,2509,3359,139,6007,0.41767937406359246,0.5591809555518562,0.023139670384551357,178,40,635,853,-0.034590707426512324,0.003931288545203276,0.030659418881309075,-850,-457,-0.14150158148826375,-0.0652501263078214
11856,46079,Lake,South Dakota,2008,3033,2993,131,6157,0.4926100373558551,0.48611336689946405,0.02127659574468085,524,-8,-366,150,0.07493066329226267,-0.0018630746398705066,-0.07306758865239216,40,890,0.006496670456391074,0.14799825194465482
11857,46079,Lake,South Dakota,2012,2724,3419,142,6285,0.4334128878281623,0.5439936356404137,0.022593476531424024,-309,11,426,128,-0.05919714952769284,0.0013168807867431735,0.05788026874094965,-695,-735,-0.11058074781225141,-0.11707741826864249
11858,46079,Lake,South Dakota,2016,2314,4038,434,6786,0.34099616858237547,0.5950486295313882,0.06395520188623637,-410,292,619,501,-0.09241671924578682,0.04136172535481234,0.051054993890974454,-1724,-1029,-0.2540524609490127,-0.14347171313676127
11859,46081,Lawrence,South Dakota,2000,2797,6327,282,9406,0.2973633850733574,0.6726557516478844,0.02998086327875824,0,0,0,0,0.0,0.0,0.0,-3530,0,-0.37529236657452697,0.0
11860,46081,Lawrence,South Dakota,2004,3857,7489,273,11619,0.3319562785093382,0.6445477235562441,0.023495997934417763,1060,-9,1162,2213,0.034592893435980765,-0.006484865344340476,-0.028108028091640258,-3632,-102,-0.31259144504690595,0.06270092152762102
11861,46081,Lawrence,South Dakota,2008,4932,6787,336,12055,0.4091248444628785,0.5630029033596018,0.0278722521775197,1075,63,-702,436,0.07716856595354032,0.0043762542431019374,-0.08154482019664233,-1855,1777,-0.1538780588967233,0.15871338615018266
11862,46081,Lawrence,South Dakota,2012,3973,7025,361,11359,0.34976670481556477,0.6184523285500484,0.03178096663438683,-959,25,238,-696,-0.059358139647313735,0.003908714456867128,0.0554494251904466,-3052,-1197,-0.2686856237344836,-0.11480756483776033
11863,46081,Lawrence,South Dakota,2016,3356,7411,1075,11842,0.28339807464955247,0.6258233406519169,0.09077858469853066,-617,714,386,483,-0.0663686301660123,0.05899761806414383,0.007371012101868524,-4055,-1003,-0.34242526600236445,-0.07373964226788082
11864,46083,Lincoln,South Dakota,2000,3844,6546,166,10556,0.36415308829101933,0.6201212580522926,0.01572565365668814,0,0,0,0,0.0,0.0,0.0,-2702,0,-0.25596816976127323,0.0
11865,46083,Lincoln,South Dakota,2004,5703,11161,202,17066,0.33417320989101135,0.6539903902496191,0.011836399859369507,1859,36,4615,6510,-0.029979878400007987,-0.0038892537973186335,0.03386913219732657,-5458,-2756,-0.3198171803586078,-0.06384901059733455
11866,46083,Lincoln,South Dakota,2008,8642,11803,322,20767,0.41614099292146195,0.5683536379833389,0.015505369095199114,2939,120,642,3701,0.0819677830304506,0.003668969235829607,-0.0856367522662802,-3161,2297,-0.15221264506187698,0.1676045352967308
11867,46083,Lincoln,South Dakota,2012,7982,13611,359,21952,0.3636115160349854,0.6200346209912536,0.016353862973760933,-660,37,1808,1185,-0.05252947688647652,0.0008484938785618193,0.05168098300791468,-5629,-2468,-0.2564231049562682,-0.1042104598943912
11868,46083,Lincoln,South Dakota,2016,8076,15499,1656,25231,0.3200824382703817,0.6142840156949784,0.06563354603463993,94,1297,1888,3279,-0.04352907776460374,0.049279683060879,-0.005750605296275246,-7423,-1794,-0.2942015774245967,-0.037778472468328494
11869,46085,Lyman,South Dakota,2000,482,875,29,1386,0.3477633477633478,0.6313131313131313,0.020923520923520924,0,0,0,0,0.0,0.0,0.0,-393,0,-0.2835497835497835,0.0
11870,46085,Lyman,South Dakota,2004,872,1029,39,1940,0.44948453608247424,0.5304123711340206,0.020103092783505156,390,10,154,554,0.10172118831912647,-0.0008204281400157679,-0.10090076017911065,-157,236,-0.08092783505154638,0.20262194849823711
11871,46085,Lyman,South Dakota,2008,710,894,37,1641,0.43266301035953686,0.5447897623400365,0.02254722730042657,-162,-2,-135,-299,-0.01682152572293738,0.0024441345169214125,0.014377391206015888,-184,-27,-0.11212675198049965,-0.03119891692895327
11872,46085,Lyman,South Dakota,2012,605,933,31,1569,0.38559592096876993,0.5946462715105163,0.019757807520713832,-105,-6,39,-72,-0.047067089390766925,-0.0027894197797127367,0.04985650917047979,-328,-144,-0.20905035054174637,-0.09692359856124672
11873,46085,Lyman,South Dakota,2016,369,977,75,1421,0.25967628430682616,0.6875439831104856,0.05277973258268825,-236,44,44,-148,-0.12591963666194378,0.03302192506197442,0.09289771159996929,-608,-280,-0.42786769880365944,-0.21881734826191307
11874,46087,McCook,South Dakota,2000,965,1610,56,2631,0.3667806917521855,0.6119346256176359,0.021284682630178638,0,0,0,0,0.0,0.0,0.0,-645,0,-0.24515393386545042,0.0
11875,46087,McCook,South Dakota,2004,1201,2017,53,3271,0.3671660042800367,0.6166309996942831,0.01620299602568022,236,-3,407,640,0.0003853125278512337,-0.0050816866044984185,0.004696374076647247,-816,-171,-0.24946499541424644,-0.0043110615487960136
11876,46087,McCook,South Dakota,2008,1219,1646,80,2945,0.41392190152801356,0.5589134125636672,0.027164685908319185,18,27,-371,-326,0.04675589724797685,0.010961689882638966,-0.05771758713061592,-427,389,-0.14499151103565366,0.10447348437859277
11877,46087,McCook,South Dakota,2012,905,1655,53,2613,0.3463451970914658,0.6333716035208573,0.020283199387677,-314,-27,9,-332,-0.06757670443654779,-0.006881486520642185,0.07445819095719008,-750,-323,-0.28702640642939153,-0.14203489539373787
11878,46087,McCook,South Dakota,2016,623,1794,170,2587,0.24081948202551218,0.6934673366834171,0.06571318129107073,-282,117,139,-26,-0.1055257150659536,0.04542998190339373,0.060095733162559783,-1171,-421,-0.4526478546579049,-0.16562144822851338
11879,46089,McPherson,South Dakota,2000,295,1073,49,1417,0.2081863091037403,0.7572335920959774,0.03458009880028229,0,0,0,0,0.0,0.0,0.0,-778,0,-0.549047282992237,0.0
11880,46089,McPherson,South Dakota,2004,369,1180,30,1579,0.233692210259658,0.747308423052565,0.018999366687777075,74,-19,107,162,0.025505901155917693,-0.015580732112505213,-0.009925169043412452,-811,-33,-0.5136162127929069,0.03543107019933012
11881,46089,McPherson,South Dakota,2008,441,915,19,1375,0.32072727272727275,0.6654545454545454,0.013818181818181818,72,-11,-265,-204,0.08703506246761475,-0.005181184869595257,-0.08185387759801954,-474,337,-0.34472727272727266,0.16888894006563426
11882,46089,McPherson,South Dakota,2012,272,921,22,1215,0.22386831275720165,0.7580246913580246,0.01810699588477366,-169,3,6,-160,-0.0968589599700711,0.004288814066591843,0.09257014590347923,-649,-175,-0.534156378600823,-0.18942910587355033
11883,46089,McPherson,South Dakota,2016,192,892,53,1137,0.16886543535620052,0.7845206684256816,0.04661389621811785,-80,31,-29,-78,-0.05500287740100113,0.02850690033334419,0.02649597706765694,-700,-51,-0.6156552330694811,-0.08149885446865812
11884,46091,Marshall,South Dakota,2000,939,1097,43,2079,0.45165945165945165,0.5276575276575276,0.02068302068302068,0,0,0,0,0.0,0.0,0.0,-158,0,-0.07599807599807595,0.0
11885,46091,Marshall,South Dakota,2004,1099,1242,23,2364,0.46489001692047377,0.5253807106598984,0.00972927241962775,160,-20,145,285,0.01323056526102212,-0.010953748263392932,-0.002276816997629161,-143,15,-0.06049069373942467,0.015507382258651281
11886,46091,Marshall,South Dakota,2008,1261,900,30,2191,0.5755362848014606,0.4107713372889092,0.013692377909630305,162,7,-342,-173,0.1106462678809868,0.003963105490002556,-0.11460937337098925,361,504,0.16476494751255139,0.22525564125197606
11887,46091,Marshall,South Dakota,2012,1061,889,37,1987,0.5339708102667338,0.447408152994464,0.018621036738802214,-200,7,-11,-204,-0.04156547453472681,0.004928658829171909,0.036636815705554826,172,-189,0.08656265727226975,-0.07820229024028164
11888,46091,Marshall,South Dakota,2016,754,1056,137,1947,0.3872624550590652,0.5423728813559322,0.07036466358500257,-307,100,167,-40,-0.14670835520766856,0.051743626846200354,0.09496472836146819,-302,-474,-0.155110426296867,-0.24167308356913675
11889,46093,Meade,South Dakota,2000,2267,6870,229,9366,0.24204569720264787,0.7335041639974376,0.024450138799914586,0,0,0,0,0.0,0.0,0.0,-4603,0,-0.49145846679478966,0.0
11890,46093,Meade,South Dakota,2004,2941,8347,216,11504,0.2556502086230876,0.7255737134909597,0.018776077885952713,674,-13,1477,2138,0.013604511420439752,-0.005674060913961873,-0.007930450506477893,-5406,-803,-0.46992350486787204,0.021534961926917617
11891,46093,Meade,South Dakota,2008,3751,7515,340,11606,0.3231948991900741,0.6475099086679303,0.02929519214199552,810,124,-832,102,0.06754469056698648,0.010519114256042808,-0.07806380482302933,-3764,1642,-0.32431500947785624,0.1456084953900158
11892,46093,Meade,South Dakota,2012,2928,7566,323,10817,0.2706850328187113,0.6994545622631043,0.02986040491818434,-823,-17,51,-789,-0.05250986637136279,0.0005652127761888205,0.05194465359517397,-4638,-874,-0.428769529444393,-0.10445451996653676
11893,46093,Meade,South Dakota,2016,2223,8441,957,11621,0.19129162722657259,0.7263574563290595,0.08235091644436796,-705,634,875,804,-0.07939340559213873,0.052490511526183614,0.02690289406595514,-6218,-1580,-0.5350658291024869,-0.1062962996580939
11894,46095,Mellette,South Dakota,2000,222,495,16,733,0.30286493860845837,0.6753069577080492,0.021828103683492497,0,0,0,0,0.0,0.0,0.0,-273,0,-0.3724420190995908,0.0
11895,46095,Mellette,South Dakota,2004,361,553,17,931,0.3877551020408163,0.5939849624060151,0.018259935553168637,139,1,58,198,0.08489016343235795,-0.0035681681303238594,-0.0813219953020341,-192,81,-0.20622986036519875,0.16621215873439205
11896,46095,Mellette,South Dakota,2008,373,445,25,843,0.4424673784104389,0.527876631079478,0.02965599051008304,12,8,-108,-88,0.054712276369622614,0.011396054956914401,-0.06610833132653704,-72,120,-0.08540925266903909,0.12082060769615965
11897,46095,Mellette,South Dakota,2012,375,381,13,769,0.48764629388816644,0.49544863459037713,0.016905071521456438,2,-12,-64,-74,0.04517891547772751,-0.0127509189886266,-0.032427996489100885,-6,66,-0.007802340702210697,0.0776069119668284
11898,46095,Mellette,South Dakota,2016,238,402,43,683,0.3484626647144949,0.5885797950219619,0.0629575402635432,-137,30,21,-86,-0.13918362917367155,0.04605246874208675,0.09313116043158476,-164,-158,-0.240117130307467,-0.2323147896052563
11899,46097,Miner,South Dakota,2000,523,724,19,1266,0.41311216429699843,0.5718799368088467,0.015007898894154818,0,0,0,0,0.0,0.0,0.0,-201,0,-0.15876777251184832,0.0
11900,46097,Miner,South Dakota,2004,641,810,19,1470,0.43605442176870746,0.5510204081632653,0.01292517006802721,118,0,86,204,0.022942257471709027,-0.002082728826127608,-0.020859528645581493,-169,32,-0.1149659863945578,0.04380178611729052
11901,46097,Miner,South Dakota,2008,605,577,36,1218,0.4967159277504105,0.47372742200328405,0.029556650246305417,-36,17,-233,-252,0.06066150598170306,0.01663148017827821,-0.0772929861599812,28,197,0.022988505747126464,0.13795449214168426
11902,46097,Miner,South Dakota,2012,479,636,25,1140,0.4201754385964912,0.5578947368421052,0.021929824561403508,-126,-11,59,-78,-0.07654048915391931,-0.00762682568490191,0.08416731483882117,-157,-185,-0.13771929824561402,-0.16070780399274048
11903,46097,Miner,South Dakota,2016,281,706,77,1064,0.2640977443609023,0.6635338345864662,0.07236842105263158,-198,52,70,-76,-0.15607769423558893,0.050438596491228074,0.10563909774436098,-425,-268,-0.3994360902255639,-0.2617167919799499
11904,46099,Minnehaha,South Dakota,2000,27042,33428,899,61369,0.4406459287262299,0.5447049813423716,0.014649089931398589,0,0,0,0,0.0,0.0,0.0,-6386,0,-0.10405905261614168,0.0
11905,46099,Minnehaha,South Dakota,2004,32314,44189,1129,77632,0.41624587798845836,0.5692111500412201,0.014542971970321518,5272,230,10761,16263,-0.024400050737771517,-0.00010611796107707142,0.024506168698848585,-11875,-5489,-0.15296527205276178,-0.0489062194366201
11906,46099,Minnehaha,South Dakota,2008,39838,39251,1463,80552,0.49456251862151157,0.48727530042705336,0.018162180951435097,7524,334,-4938,2920,0.07831664063305321,0.0036192089811135798,-0.08193584961416678,587,12462,0.0072872181944582115,0.16025249024722
11907,46099,Minnehaha,South Dakota,2012,34674,40342,1567,76583,0.4527636681770106,0.5267748717078202,0.020461460115169163,-5164,104,1091,-3969,-0.04179885044450099,0.002299279163734066,0.039499571280766865,-5668,-6255,-0.07401120353080964,-0.08129842172526786
11908,46099,Minnehaha,South Dakota,2016,30610,42043,5610,78263,0.39111713070033094,0.5372014872928459,0.07168138200682314,-4064,4043,1701,1680,-0.06164653747667964,0.051219921891653974,0.010426615585025667,-11433,-5765,-0.14608435659251495,-0.07207315306170531
11909,46101,Moody,South Dakota,2000,1318,1361,56,2735,0.4819012797074954,0.4976234003656307,0.020475319926873858,0,0,0,0,0.0,0.0,0.0,-43,0,-0.015722120658135275,0.0
11910,46101,Moody,South Dakota,2004,1609,1790,52,3451,0.46624166908142567,0.5186902347145755,0.015068096203998842,291,-4,429,716,-0.015659610626069742,-0.005407223722875016,0.021066834348944852,-181,-138,-0.05244856563314987,-0.036726444975014594
11911,46101,Moody,South Dakota,2008,1663,1508,83,3254,0.5110633066994469,0.4634296250768285,0.025507068223724647,54,31,-282,-197,0.044821637618021215,0.010438972019725806,-0.05526060963774704,155,336,0.047633681622618385,0.10008224725576825
11912,46101,Moody,South Dakota,2012,1429,1535,69,3033,0.4711506758984504,0.5060995713814704,0.02274975272007913,-234,-14,27,-221,-0.039912630800996496,-0.0027573155036455174,0.04266994630464194,-106,-261,-0.03494889548302005,-0.08258257710563843
11913,46101,Moody,South Dakota,2016,1043,1731,159,2933,0.3556085918854415,0.59018070235254,0.05421070576201841,-386,90,196,-100,-0.11554208401300886,0.031460953041939285,0.08408113097106962,-688,-582,-0.23457211046709853,-0.19962321498407848
11914,46103,Pennington,South Dakota,2000,11123,24696,738,36557,0.30426457313236865,0.6755477747079902,0.02018765215964111,0,0,0,0,0.0,0.0,0.0,-13573,0,-0.37128320157562156,0.0
11915,46103,Pennington,South Dakota,2004,14213,29976,779,44968,0.3160692047678349,0.6666073652375022,0.01732342999466287,3090,41,5280,8411,0.011804631635466245,-0.002864222164978239,-0.00894040947048802,-15763,-2190,-0.3505381604696673,0.020745041105954265
11916,46103,Pennington,South Dakota,2008,17802,27603,875,46280,0.3846585998271392,0.5964347450302506,0.0189066551426102,3589,96,-2373,1312,0.06858939505930428,0.0015832251479473286,-0.07017262020725157,-9801,5962,-0.21177614520311144,0.13876201526655585
11917,46103,Pennington,South Dakota,2012,15125,28232,1107,44464,0.3401628283555236,0.6349406261245052,0.02489654551997121,-2677,232,629,-1816,-0.0444957714716156,0.005989890377361012,0.03850588109425457,-13107,-3306,-0.2947777977689816,-0.08300165256587017
11918,46103,Pennington,South Dakota,2016,14074,29804,3865,47743,0.29478667029721634,0.6242590536832625,0.08095427601952118,-1051,2758,1572,3279,-0.04537615805830725,0.05605773049954997,-0.010681572441242682,-15730,-2623,-0.3294723833860462,-0.034694585617064566
11919,46105,Perkins,South Dakota,2000,297,1237,80,1614,0.18401486988847585,0.7664188351920694,0.04956629491945477,0,0,0,0,0.0,0.0,0.0,-940,0,-0.5824039653035936,0.0
11920,46105,Perkins,South Dakota,2004,418,1329,66,1813,0.23055708769994485,0.7330391616105901,0.03640375068946498,121,-14,92,199,0.046542217811469,-0.013162544229989796,-0.03337967358147931,-911,29,-0.5024820739106453,0.07992189139294836
11921,46105,Perkins,South Dakota,2008,499,1102,85,1686,0.2959667852906287,0.6536180308422301,0.05041518386714116,81,19,-227,-127,0.06540969759068385,0.014011433177676183,-0.07942113076836,-603,308,-0.35765124555160144,0.14483082835904382
11922,46105,Perkins,South Dakota,2012,319,1205,66,1590,0.20062893081761007,0.7578616352201258,0.04150943396226415,-180,-19,103,-96,-0.09533785447301862,-0.008905749904877011,0.1042436043778957,-886,-283,-0.5572327044025158,-0.19958145885091438
11923,46105,Perkins,South Dakota,2016,188,1333,85,1606,0.11706102117061021,0.8300124533001245,0.05292652552926526,-131,19,128,16,-0.08356790964699987,0.01141709156700111,0.07215081807999868,-1145,-259,-0.7129514321295143,-0.15571872772699846
11924,46107,Potter,South Dakota,2000,356,1112,26,1494,0.23828647925033467,0.7443105756358769,0.01740294511378849,0,0,0,0,0.0,0.0,0.0,-756,0,-0.5060240963855422,0.0
11925,46107,Potter,South Dakota,2004,463,1143,12,1618,0.2861557478368356,0.7064276885043264,0.007416563658838072,107,-14,31,124,0.04786926858650095,-0.009986381454950417,-0.037882887131550524,-680,76,-0.42027194066749074,0.0857521557180515
11926,46107,Potter,South Dakota,2008,482,937,21,1440,0.3347222222222222,0.6506944444444445,0.014583333333333334,19,9,-206,-178,0.04856647438538658,0.007166769674495262,-0.05573324405988189,-455,225,-0.31597222222222227,0.10429971844526847
11927,46107,Potter,South Dakota,2012,339,1029,13,1381,0.24547429398986242,0.7451122375090514,0.00941346850108617,-143,-8,92,-59,-0.08924792823235977,-0.005169864832247163,0.09441779306460696,-690,-235,-0.499637943519189,-0.18366572129696673
11928,46107,Potter,South Dakota,2016,215,1071,51,1337,0.16080777860882572,0.8010471204188482,0.0381451009723261,-124,38,42,-44,-0.0846665153810367,0.028731632471239932,0.05593488290979676,-856,-166,-0.6402393418100225,-0.1406013982908335
11929,46109,Roberts,South Dakota,2000,1700,2237,137,4074,0.4172803141875307,0.5490918016691213,0.03362788414334806,0,0,0,0,0.0,0.0,0.0,-537,0,-0.1318114874815906,0.0
11930,46109,Roberts,South Dakota,2004,2527,2396,59,4982,0.5072260136491369,0.4809313528703332,0.011842633480529908,827,-78,159,908,0.08994569946160619,-0.021785250662818154,-0.06816044879878813,131,668,0.026294660778803713,0.15810614826039432
11931,46109,Roberts,South Dakota,2008,2672,1781,83,4536,0.5890652557319224,0.39263668430335097,0.01829805996472663,145,24,-615,-446,0.08183924208278548,0.006455426484196723,-0.0882946685669822,891,760,0.1964285714285714,0.17013391064976768
11932,46109,Roberts,South Dakota,2012,2302,1883,71,4256,0.5408834586466166,0.44243421052631576,0.01668233082706767,-370,-12,102,-280,-0.04818179708530579,-0.0016157291376589604,0.049797526222964794,419,-472,0.09844924812030081,-0.09797932330827058
11933,46109,Roberts,South Dakota,2016,1540,2144,205,3889,0.3959886860375418,0.5512985343275907,0.052712779634867576,-762,134,261,-367,-0.1448947726090748,0.0360304488077999,0.10886432380127492,-604,-1023,-0.1553098482900489,-0.2537590964103497
11934,46111,Sanborn,South Dakota,2000,468,767,33,1268,0.36908517350157727,0.6048895899053628,0.026025236593059938,0,0,0,0,0.0,0.0,0.0,-299,0,-0.23580441640378552,0.0
11935,46111,Sanborn,South Dakota,2004,581,817,28,1426,0.4074333800841515,0.5729312762973352,0.019635343618513323,113,-5,50,158,0.03834820658257421,-0.006389892974546615,-0.03195831360802759,-236,63,-0.16549789621318373,0.0703065201906018
11936,46111,Sanborn,South Dakota,2008,500,669,38,1207,0.4142502071251036,0.5542667771333886,0.03148301574150787,-81,10,-148,-219,0.0068168270409521,0.011847672122994549,-0.018664499163946635,-169,67,-0.140016570008285,0.025481326204898735
11937,46111,Sanborn,South Dakota,2012,389,688,38,1115,0.3488789237668161,0.6170403587443947,0.034080717488789235,-111,0,19,-92,-0.06537128335828746,0.0025977017472813627,0.0627735816110061,-299,-130,-0.26816143497757855,-0.12814486496929356
11938,46111,Sanborn,South Dakota,2016,241,819,63,1123,0.21460373998219057,0.7292965271593945,0.05609973285841496,-148,25,131,8,-0.13427518378462555,0.022019015369625722,0.11225616841499986,-578,-279,-0.514692787177204,-0.24653135219962546
11939,46113,Oglala Lakota,South Dakota,2000,1667,252,34,1953,0.8535586277521762,0.12903225806451613,0.017409114183307733,0,0,0,0,0.0,0.0,0.0,1415,0,0.72452636968766,0.0
11940,46113,Oglala Lakota,South Dakota,2004,3566,526,122,4214,0.8462268628381585,0.12482202183198861,0.02895111532985287,1899,88,274,2261,-0.007331764914017658,0.011542001146545137,-0.004210236232527517,3040,1625,0.7214048410061699,-0.003121528681490182
11941,46113,Oglala Lakota,South Dakota,2008,2971,331,48,3350,0.8868656716417911,0.09880597014925373,0.014328358208955224,-595,-74,-195,-864,0.040638808803632576,-0.014622757120897646,-0.02601605168273488,2640,-400,0.7880597014925373,0.06665486048636748
11942,46113,Oglala Lakota,South Dakota,2012,2937,188,20,3145,0.9338632750397456,0.059777424483306835,0.006359300476947536,-34,-28,-143,-205,0.04699760339795456,-0.007969057732007689,-0.03902854566594689,2749,109,0.8740858505564388,0.08602614906390149
11943,46113,Oglala Lakota,South Dakota,2016,2510,241,154,2905,0.8640275387263339,0.08296041308089501,0.05301204819277108,-427,134,53,-240,-0.06983573631341178,0.04665274771582355,0.023182988597588175,2269,-480,0.7810671256454389,-0.09301872491099994
11944,46115,Spink,South Dakota,2000,1274,1957,53,3284,0.3879415347137637,0.5959196102314251,0.016138855054811205,0,0,0,0,0.0,0.0,0.0,-683,0,-0.20797807551766145,0.0
11945,46115,Spink,South Dakota,2004,1478,2259,37,3774,0.39162692103868574,0.5985691573926868,0.00980392156862745,204,-16,302,490,0.0036853863249220464,-0.006334933486183754,0.002649547161261645,-781,-98,-0.20694223635400105,0.0010358391636604014
11946,46115,Spink,South Dakota,2008,1550,1660,59,3269,0.4741511165494035,0.507800550627103,0.018048332823493423,72,22,-599,-505,0.08252419551071777,0.008244411254865972,-0.09076860676558374,-110,671,-0.03364943407769955,0.1732928022763015
11947,46115,Spink,South Dakota,2012,1300,1670,71,3041,0.4274909569220651,0.5491614600460375,0.023347583031897403,-250,12,10,-228,-0.04666015962733838,0.00529925020840398,0.041360909418934444,-370,-260,-0.12167050312397237,-0.08802106904627283
11948,46115,Spink,South Dakota,2016,919,1854,178,2951,0.3114198576753643,0.6282616062351745,0.0603185360894612,-381,107,184,-90,-0.11607109924670084,0.0369709530575638,0.07910014618913697,-935,-565,-0.3168417485598102,-0.1951712454358378
11949,46117,Stanley,South Dakota,2000,402,955,24,1381,0.29109341057204924,0.6915278783490224,0.017378711078928313,0,0,0,0,0.0,0.0,0.0,-553,0,-0.40043446777697317,0.0
11950,46117,Stanley,South Dakota,2004,464,1129,30,1623,0.2858903265557609,0.6956253850893407,0.018484288354898338,62,6,174,242,-0.0052030840162883285,0.0011055772759700246,0.00409750674031828,-665,-112,-0.4097350585335798,-0.009300590756606608
11951,46117,Stanley,South Dakota,2008,510,1017,26,1553,0.3283966516419833,0.6548615582743078,0.01674179008370895,46,-4,-112,-70,0.042506325086222374,-0.001742498271189389,-0.04076382681503288,-507,158,-0.3264649066323245,0.08327015190125525
11952,46117,Stanley,South Dakota,2012,435,1063,42,1540,0.2824675324675325,0.6902597402597402,0.02727272727272727,-75,16,46,-13,-0.045929119174450805,0.010530937189018322,0.03539818198543243,-628,-121,-0.40779220779220776,-0.08132730115988324
11953,46117,Stanley,South Dakota,2016,329,1148,90,1567,0.209955328653478,0.7326100829610721,0.0574345883854499,-106,48,85,27,-0.07251220381405449,0.03016186111272263,0.04235034270133187,-819,-191,-0.5226547543075941,-0.11486254651538635
11954,46119,Sully,South Dakota,2000,209,633,29,871,0.2399540757749713,0.7267508610792193,0.03329506314580941,0,0,0,0,0.0,0.0,0.0,-424,0,-0.48679678530424797,0.0
11955,46119,Sully,South Dakota,2004,201,702,14,917,0.21919302071973829,0.7655398037077427,0.015267175572519083,-8,-15,69,46,-0.020761055055233013,-0.01802788757329033,0.03878894262852339,-501,-77,-0.5463467829880044,-0.05954999768375646
11956,46119,Sully,South Dakota,2008,233,581,19,833,0.2797118847539016,0.6974789915966386,0.022809123649459785,32,5,-121,-84,0.06051886403416329,0.007541948076940702,-0.06806081211110404,-348,153,-0.41776710684273705,0.12857967614526739
11957,46119,Sully,South Dakota,2012,186,613,19,818,0.2273838630806846,0.7493887530562348,0.023227383863080684,-47,0,32,-15,-0.052328021673216984,0.0004182602136208989,0.05190976145959614,-427,-79,-0.5220048899755502,-0.10423778313281312
11958,46119,Sully,South Dakota,2016,137,679,45,861,0.15911730545876887,0.7886178861788617,0.05226480836236934,-49,26,66,43,-0.06826655762191572,0.029037424499288655,0.03922913312262699,-542,-115,-0.6295005807200929,-0.10749569074454268
11959,46121,Todd,South Dakota,2000,993,478,23,1494,0.6646586345381527,0.31994645247657294,0.015394912985274432,0,0,0,0,0.0,0.0,0.0,515,0,0.3447121820615797,0.0
11960,46121,Todd,South Dakota,2004,2543,889,92,3524,0.7216231555051078,0.2522701475595914,0.026106696935300794,1550,69,411,2030,0.056964520966955146,0.010711783950026362,-0.06767630491698157,1654,1139,0.46935300794551643,0.12464082588393671
11961,46121,Todd,South Dakota,2008,2208,571,49,2828,0.7807637906647807,0.20190947666195191,0.017326732673267328,-335,-43,-318,-696,0.05914063515967294,-0.008779964262033466,-0.05036067089763946,1637,-17,0.5788543140028288,0.1095013060573124
11962,46121,Todd,South Dakota,2012,1976,498,23,2497,0.7913496195434522,0.19943932719263116,0.0092110532639167,-232,-26,-73,-331,0.010585828878671433,-0.008115679409350629,-0.0024701494693207537,1478,-159,0.591910292350821,0.013055978347992214
11963,46121,Todd,South Dakota,2016,1505,487,133,2125,0.7082352941176471,0.2291764705882353,0.06258823529411765,-471,110,-11,-372,-0.0831143254258051,0.053377182030200955,0.029737143395604126,1018,-460,0.47905882352941176,-0.11285146882140928
11964,46123,Tripp,South Dakota,2000,799,1909,57,2765,0.2889692585895118,0.6904159132007234,0.02061482820976492,0,0,0,0,0.0,0.0,0.0,-1110,0,-0.4014466546112116,0.0
11965,46123,Tripp,South Dakota,2004,972,2230,43,3245,0.299537750385208,0.687211093990755,0.01325115562403698,173,-14,321,480,0.010568491795696244,-0.007363672585727938,-0.0032048192099684014,-1258,-148,-0.38767334360554695,0.013773311005664646
11966,46123,Tripp,South Dakota,2008,914,1859,66,2839,0.3219443466009158,0.6548080309968298,0.023247622402254316,-58,23,-371,-406,0.022406596215707786,0.009996466778217335,-0.03240306299392515,-945,313,-0.332863684395914,0.05480965920963293
11967,46123,Tripp,South Dakota,2012,737,1905,49,2691,0.2738758825715347,0.7079152731326644,0.018208844295800816,-177,-17,46,-148,-0.048068464029381086,-0.0050387781064534995,0.05310724213583462,-1168,-223,-0.4340393905611297,-0.1011757061652157
11968,46123,Tripp,South Dakota,2016,462,2069,99,2630,0.17566539923954372,0.7866920152091255,0.0376425855513308,-275,50,164,-61,-0.098210483331991,0.019433741255529983,0.07877674207646101,-1607,-439,-0.6110266159695817,-0.17698722540845202
11969,46125,Turner,South Dakota,2000,1414,2514,76,4004,0.3531468531468531,0.6278721278721279,0.01898101898101898,0,0,0,0,0.0,0.0,0.0,-1100,0,-0.27472527472527475,0.0
11970,46125,Turner,South Dakota,2004,1646,3084,104,4834,0.3405047579644187,0.6379809681423252,0.0215142738932561,232,28,570,830,-0.01264209518243442,0.0025332549122371213,0.010108840270197317,-1438,-338,-0.2974762101779065,-0.022750935452631738
11971,46125,Turner,South Dakota,2008,1681,2538,133,4352,0.38625919117647056,0.5831801470588235,0.03056066176470588,35,29,-546,-482,0.04575443321205186,0.00904638787144978,-0.054800821083501705,-857,581,-0.19692095588235292,0.10055525429555356
11972,46125,Turner,South Dakota,2012,1411,2715,84,4210,0.3351543942992874,0.6448931116389549,0.019952494061757718,-270,-49,177,-142,-0.05110479687718317,-0.010608167702948163,0.061712964580131424,-1304,-447,-0.3097387173396675,-0.11281776145731459
11973,46125,Turner,South Dakota,2016,961,2937,252,4150,0.23156626506024097,0.707710843373494,0.060722891566265064,-450,168,222,-60,-0.10358812923904642,0.040770397504507346,0.06281773173453908,-1976,-672,-0.476144578313253,-0.1664058609735855
11974,46127,Union,South Dakota,2000,2358,3265,149,5772,0.4085239085239085,0.5656618156618156,0.025814275814275815,0,0,0,0,0.0,0.0,0.0,-907,0,-0.1571379071379071,0.0
11975,46127,Union,South Dakota,2004,3000,3987,61,7048,0.42565266742338254,0.5656923950056754,0.008654937570942111,642,-88,722,1276,0.017128758899474017,-0.017159338243333704,3.057934385974903e-05,-987,-80,-0.14003972758229283,0.017098179555614268
11976,46127,Union,South Dakota,2008,3244,4310,147,7701,0.4212439942864563,0.5596675756395273,0.019088430074016362,244,86,323,653,-0.004408673136926222,0.010433492503074251,-0.006024819366148071,-1066,-79,-0.13842358135307098,0.0016161462292218487
11977,46127,Union,South Dakota,2012,2782,4698,116,7596,0.366245392311743,0.6184834123222749,0.015271195365982097,-462,-31,388,-105,-0.05499860197471329,-0.003817234708034266,0.05881583668274759,-1916,-850,-0.25223802001053186,-0.11381443865746088
11978,46127,Union,South Dakota,2016,2227,5290,380,7897,0.28200582499683424,0.6698746359376979,0.0481195390654679,-555,264,592,301,-0.08423956731490878,0.032848343699485805,0.05139122361542303,-3063,-1147,-0.3878688109408637,-0.1356307909303318
11979,46129,Walworth,South Dakota,2000,721,1758,74,2553,0.28241284763023894,0.6886016451233843,0.028985507246376812,0,0,0,0,0.0,0.0,0.0,-1037,0,-0.40618879749314535,0.0
11980,46129,Walworth,South Dakota,2004,878,1967,35,2880,0.30486111111111114,0.6829861111111111,0.012152777777777778,157,-39,209,327,0.0224482634808722,-0.016832729468599032,-0.005615534012273216,-1089,-52,-0.37812499999999993,0.028063797493145415
11981,46129,Walworth,South Dakota,2008,923,1668,59,2650,0.34830188679245283,0.6294339622641509,0.022264150943396226,45,24,-299,-230,0.04344077568134169,0.010111373165618448,-0.053552148846960135,-745,344,-0.2811320754716981,0.09699292452830183
11982,46129,Walworth,South Dakota,2012,671,1731,60,2462,0.2725426482534525,0.7030869212022746,0.024370430544272948,-252,1,63,-188,-0.07575923853900035,0.0021062796008767225,0.07365295893812362,-1060,-315,-0.4305442729488221,-0.14941219747712398
11983,46129,Walworth,South Dakota,2016,457,1896,124,2477,0.1844973758578926,0.7654420670165523,0.05006055712555511,-214,64,165,15,-0.08804527239555987,0.02569012658128216,0.0623551458142777,-1439,-379,-0.5809446911586597,-0.15040041820983757
11984,46135,Yankton,South Dakota,2000,3596,4904,240,8740,0.411441647597254,0.5610983981693364,0.02745995423340961,0,0,0,0,0.0,0.0,0.0,-1308,0,-0.1496567505720824,0.0
11985,46135,Yankton,South Dakota,2004,4237,6003,191,10431,0.40619307832422585,0.5754961173425367,0.018310804333237465,641,-49,1099,1691,-0.005248569273028136,-0.009149149900172144,0.014397719173200318,-1766,-458,-0.16930303901831084,-0.019646288446228455
11986,46135,Yankton,South Dakota,2008,4838,5039,257,10134,0.4774028024472074,0.4972370238800079,0.025360173672784685,601,66,-964,-297,0.07120972412298154,0.00704936933954722,-0.0782590934625288,-201,1565,-0.019834221432800503,0.14946881758551034
11987,46135,Yankton,South Dakota,2012,4226,5495,253,9974,0.42370162422297974,0.5509324243031883,0.025365951473831964,-612,-4,456,-160,-0.05370117822422765,5.777801047279069e-06,0.05369540042318044,-1269,-1068,-0.1272308000802086,-0.10739657864740809
11988,46135,Yankton,South Dakota,2016,3301,5659,663,9623,0.34303231840382414,0.5880702483632962,0.06889743323287956,-925,410,164,-351,-0.0806693058191556,0.04353148175904759,0.037137824060107905,-2358,-1089,-0.2450379299594721,-0.1178071298792635
11989,46137,Ziebach,South Dakota,2000,314,384,23,721,0.435506241331484,0.5325936199722607,0.0319001386962552,0,0,0,0,0.0,0.0,0.0,-70,0,-0.09708737864077671,0.0
11990,46137,Ziebach,South Dakota,2004,641,447,28,1116,0.5743727598566308,0.40053763440860213,0.025089605734767026,327,5,63,395,0.1388665185251468,-0.006810532961488175,-0.1320559855636586,194,264,0.1738351254480287,0.2709225040888054
11991,46137,Ziebach,South Dakota,2008,554,312,25,891,0.621773288439955,0.3501683501683502,0.028058361391694726,-87,-3,-135,-225,0.04740052858332422,0.0029687556569276997,-0.050369284240251944,242,48,0.27160493827160487,0.09776981282357616
11992,46137,Ziebach,South Dakota,2012,439,314,8,761,0.5768725361366623,0.4126149802890933,0.010512483574244415,-115,-17,2,-130,-0.04490075230329271,-0.01754587781745031,0.06244663012074314,125,-117,0.16425755584756901,-0.10734738242403585
11993,46137,Ziebach,South Dakota,2016,353,368,46,767,0.4602346805736636,0.47979139504563234,0.05997392438070404,-86,38,54,6,-0.11663785556299872,0.04946144080645963,0.06717641475653902,-15,-140,-0.019556714471968717,-0.18381427031953773
11994,47001,Anderson,Tennessee,2000,13556,14688,535,28779,0.47103790958685154,0.5103721463567185,0.018589944056430035,0,0,0,0,0.0,0.0,0.0,-1132,0,-0.039334236769866915,0.0
11995,47001,Anderson,Tennessee,2004,12896,18510,276,31682,0.4070450097847358,0.5842434189760748,0.008711571239189446,-660,-259,3822,2903,-0.06399289980211575,-0.00987837281724059,0.07387127261935633,-5614,-4482,-0.177198409191339,-0.1378641724214721
11996,47001,Anderson,Tennessee,2008,11396,19675,499,31570,0.36097560975609755,0.6232182451694647,0.01580614507443776,-1500,223,1165,-112,-0.04606940002863824,0.007094573835248313,0.03897482619338988,-8279,-2665,-0.2622426354133671,-0.08504422622202812
11997,47001,Anderson,Tennessee,2012,10122,18968,515,29605,0.3419017057929404,0.6407025840229691,0.017395710184090526,-1274,16,-707,-1965,-0.01907390396315717,0.0015895651096527671,0.017484338853504422,-8846,-567,-0.2988008782300287,-0.03655824281666159
11998,47001,Anderson,Tennessee,2016,9013,19212,1656,29881,0.3016297981995248,0.6429503698002075,0.055419832000267726,-1109,1141,244,276,-0.04027190759341559,0.0380241218161772,0.002247785777238387,-10199,-1353,-0.3413205716006827,-0.04251969337065398
11999,47003,Bedford,Tennessee,2000,6136,5911,160,12207,0.5026624068157615,0.48423035962972066,0.0131072335545179,0,0,0,0,0.0,0.0,0.0,225,0,0.0184320471860408,0.0
12000,47003,Bedford,Tennessee,2004,5268,8351,87,13706,0.38435721581788995,0.6092951991828396,0.006347584999270393,-868,-73,2440,1499,-0.11830519099787151,-0.006759648555247507,0.12506483955311892,-3083,-3308,-0.22493798336494963,-0.24337003055099043
12001,47003,Bedford,Tennessee,2008,5027,10217,263,15507,0.3241761785000322,0.6588637389566002,0.016960082543367512,-241,176,1866,1801,-0.06018103731785773,0.01061249754409712,0.049568539773760634,-5190,-2107,-0.334687560456568,-0.10974957709161837
12002,47003,Bedford,Tennessee,2012,4211,10034,183,14428,0.2918630440809537,0.6954532852786249,0.012683670640421403,-816,-80,-183,-1079,-0.032313134419078515,-0.004276411902946109,0.03658954632202471,-5823,-633,-0.40359024119767123,-0.06890268074110323
12003,47003,Bedford,Tennessee,2016,3395,11486,474,15355,0.22110061869098013,0.7480299576685119,0.030869423640507977,-816,291,1452,927,-0.07076242538997357,0.018185753000086576,0.05257667238988695,-8091,-2268,-0.5269293389775318,-0.12333909777986057
12004,47005,Benton,Tennessee,2000,3700,2484,127,6311,0.5862779274282998,0.39359847884645854,0.020123593725241643,0,0,0,0,0.0,0.0,0.0,1216,0,0.19267944858184122,0.0
12005,47005,Benton,Tennessee,2004,3869,3161,60,7090,0.5456981664315937,0.4458392101551481,0.00846262341325811,169,-67,677,779,-0.040579760996706016,-0.011660970311983532,0.05224073130868956,708,-508,0.09985895627644564,-0.09282049230539557
12006,47005,Benton,Tennessee,2008,2645,3696,138,6479,0.40824201265627413,0.5704584040747029,0.021299583269023,-1224,78,535,-611,-0.1374561537753196,0.012836959855764888,0.12461919391955484,-1051,-1759,-0.1622163914184288,-0.26207534769487445
12007,47005,Benton,Tennessee,2012,2258,3850,104,6212,0.3634900193174501,0.6197681905988409,0.01674179008370895,-387,-34,154,-267,-0.044751993338824014,-0.00455779318531405,0.04930978652413798,-1592,-541,-0.2562781712813908,-0.09406177986296199
12008,47005,Benton,Tennessee,2016,1474,4716,138,6328,0.2329329962073325,0.7452591656131479,0.021807838179519597,-784,34,866,116,-0.13055702311011763,0.005066048095810648,0.12549097501430695,-3242,-1650,-0.5123261694058154,-0.25604799812442464
12009,47007,Bledsoe,Tennessee,2000,1756,2380,60,4196,0.4184938036224976,0.567206863679695,0.014299332697807437,0,0,0,0,0.0,0.0,0.0,-624,0,-0.14871306005719737,0.0
12010,47007,Bledsoe,Tennessee,2004,1927,2849,33,4809,0.40070700769390727,0.5924308588064047,0.006862133499688085,171,-27,469,613,-0.017786795928590338,-0.007437199198119352,0.025223995126709697,-922,-298,-0.1917238511124974,-0.043010791055300035
12011,47007,Bledsoe,Tennessee,2008,1517,3166,101,4784,0.3170986622073579,0.6617892976588629,0.021112040133779264,-410,68,317,-25,-0.08360834548654938,0.014249906634091179,0.06935843885245818,-1649,-727,-0.34469063545150497,-0.15296678433900757
12012,47007,Bledsoe,Tennessee,2012,1267,3022,64,4353,0.2910636342752125,0.6942338617045716,0.014702504020215943,-250,-37,-144,-431,-0.026035027932145405,-0.006409536113563321,0.032444564045708724,-1755,-106,-0.4031702274293591,-0.05847959197785413
12013,47007,Bledsoe,Tennessee,2016,897,3622,145,4664,0.19232418524871356,0.7765866209262435,0.031089193825042882,-370,81,600,311,-0.09873944902649892,0.016386689804826937,0.08235275922167196,-2725,-970,-0.58426243567753,-0.1810922082481709
12014,47009,Blount,Tennessee,2000,14688,25273,701,40662,0.3612217795484728,0.621538537209188,0.017239683242339286,0,0,0,0,0.0,0.0,0.0,-10585,0,-0.26031675766071516,0.0
12015,47009,Blount,Tennessee,2004,15047,33241,424,48712,0.30889719165708657,0.6823985876170143,0.008704220725899162,359,-277,7968,8050,-0.05232458789138622,-0.008535462516440124,0.06086005040782638,-18194,-7609,-0.37350139595992776,-0.1131846382992126
12016,47009,Blount,Tennessee,2008,15253,35571,821,51645,0.29534320844225,0.6887598024978216,0.015896989059928358,206,397,2330,2933,-0.013553983214836585,0.007192768334029195,0.00636121488080732,-20318,-2124,-0.39341659405557167,-0.019915198095643905
12017,47009,Blount,Tennessee,2012,12934,35441,803,49178,0.26300378217902315,0.7206677782748383,0.016328439546138517,-2319,-18,-130,-2467,-0.032339426263226834,0.00043145048621015883,0.03190797577701665,-22507,-2189,-0.45766399609581515,-0.06424740204024348
12018,47009,Blount,Tennessee,2016,12100,37443,2665,52208,0.23176524670548576,0.7171889365614466,0.05104581673306773,-834,1862,2002,3030,-0.031238535473537388,0.034717377186929216,-0.003478841713391745,-25343,-2836,-0.4854236898559608,-0.027759693760145643
12019,47011,Bradley,Tennessee,2000,8768,20167,508,29443,0.29779574092313965,0.6849505824814047,0.017253676595455625,0,0,0,0,0.0,0.0,0.0,-11399,0,-0.3871548415582651,0.0
12020,47011,Bradley,Tennessee,2004,9431,25951,255,35637,0.26464068243679323,0.7282038330948172,0.0071554844683895955,663,-253,5784,6194,-0.03315505848634642,-0.01009819212706603,0.04325325061341245,-16520,-5121,-0.46356315065802395,-0.07640830909975888
12021,47011,Bradley,Tennessee,2008,9357,28333,501,38191,0.24500536775680135,0.7418763583043125,0.013118273938886125,-74,246,2382,2554,-0.019635314679991883,0.005962789470496529,0.013672525209495356,-18976,-2456,-0.49687099054751116,-0.03330783988948721
12022,47011,Bradley,Tennessee,2012,8037,27422,607,36066,0.22284145732823157,0.7603282870293351,0.016830255642433317,-1320,106,-911,-2125,-0.022163910428569772,0.0037119817035471923,0.01845192872502255,-19385,-409,-0.5374868297011035,-0.04061583915359235
12023,47011,Bradley,Tennessee,2016,7070,29768,1828,38666,0.18284798013758857,0.769875342678322,0.04727667718408938,-967,1221,2346,2600,-0.039993477190643,0.03044642154165606,0.009547055648986946,-22698,-3313,-0.5870273625407334,-0.04954053283962989
12024,47013,Campbell,Tennessee,2000,6492,5784,145,12421,0.5226632316238629,0.4656629900974157,0.01167377827872152,0,0,0,0,0.0,0.0,0.0,708,0,0.05700024152644717,0.0
12025,47013,Campbell,Tennessee,2004,6163,7859,96,14118,0.43653491996033433,0.5566652500354158,0.006799830004249894,-329,-49,2075,1697,-0.08612831166352852,-0.004873948274471627,0.0910022599380001,-1696,-2404,-0.12013033007508145,-0.17713057160152862
12026,47013,Campbell,Tennessee,2008,3867,8535,226,12628,0.3062242635413367,0.6758789990497308,0.01789673740893253,-2296,130,676,-1490,-0.13031065641899764,0.011096907404682636,0.11921374901431503,-4668,-2972,-0.3696547355083941,-0.24952440543331267
12027,47013,Campbell,Tennessee,2012,3328,8604,148,12080,0.27549668874172184,0.7122516556291391,0.012251655629139073,-539,-78,69,-548,-0.030727574799614854,-0.005645081779793457,0.03637265657940825,-5276,-608,-0.4367549668874172,-0.0671002313790231
12028,47013,Campbell,Tennessee,2016,2248,9870,414,12532,0.17938078518991382,0.7875837855090967,0.03303542930098947,-1080,266,1266,452,-0.09611590355180802,0.020783773671850393,0.07533212987995763,-7622,-2346,-0.6082030003191828,-0.17144803343176562
12029,47015,Cannon,Tennessee,2000,2697,1924,76,4697,0.574196295507771,0.40962316372152435,0.016180540770704705,0,0,0,0,0.0,0.0,0.0,773,0,0.1645731317862466,0.0
12030,47015,Cannon,Tennessee,2004,2515,2931,35,5481,0.4588578726509761,0.5347564313081554,0.006385696040868455,-182,-41,1007,784,-0.11533842285679485,-0.009794844729836251,0.12513326758663107,-416,-1189,-0.07589855865717932,-0.24047169044342592
12031,47015,Cannon,Tennessee,2008,2011,3322,124,5457,0.3685175004581272,0.6087593916071101,0.02272310793476269,-504,89,391,-24,-0.0903403721928489,0.016337411893894236,0.0740029602989547,-1311,-895,-0.24024189114898292,-0.1643433324918036
12032,47015,Cannon,Tennessee,2012,1564,3309,89,4962,0.31519548569125355,0.6668681983071342,0.017936316001612253,-447,-35,-13,-495,-0.05332201476687365,-0.0047867919331504374,0.05810880670002405,-1745,-434,-0.3516727126158806,-0.1114308214668977
12033,47015,Cannon,Tennessee,2016,1127,4007,180,5314,0.2120812946932631,0.7540459164471208,0.03387278885961611,-437,91,698,352,-0.10311419099799046,0.015936472858003856,0.08717771813998665,-2880,-1135,-0.5419646217538577,-0.1902919091379771
12034,47017,Carroll,Tennessee,2000,5239,5465,123,10827,0.48388288537914476,0.5047566269511407,0.011360487669714602,0,0,0,0,0.0,0.0,0.0,-226,0,-0.020873741571995896,0.0
12035,47017,Carroll,Tennessee,2004,5070,6605,82,11757,0.431232457259505,0.5617929743982308,0.006974568342264183,-169,-41,1140,930,-0.05265042811963977,-0.0043859193274504195,0.057036347447090185,-1535,-1309,-0.13056051713872585,-0.10968677556672995
12036,47017,Carroll,Tennessee,2008,3980,7455,211,11646,0.3417482397389662,0.640133951571355,0.01811780868967886,-1090,129,850,-111,-0.08948421752053881,0.011143240347414676,0.07834097717312416,-3475,-1940,-0.2983857118323888,-0.16782519469366297
12037,47017,Carroll,Tennessee,2012,3475,7225,139,10839,0.32060153150659654,0.6665744072331395,0.012824061260263862,-505,-72,-230,-807,-0.021146708232369638,-0.005293747429414996,0.026440455661784545,-3750,-275,-0.345972875726543,-0.04758716389415418
12038,47017,Carroll,Tennessee,2016,2327,7756,301,10384,0.22409476117103236,0.7469183359013868,0.028986902927580892,-1148,162,531,-455,-0.09650677033556418,0.016162841667317032,0.08034392866824724,-5429,-1679,-0.5228235747303545,-0.17685069900381145
12039,47019,Carter,Tennessee,2000,6724,12111,267,19102,0.3520050256517642,0.6340173803790179,0.013977593969217883,0,0,0,0,0.0,0.0,0.0,-5387,0,-0.28201235472725367,0.0
12040,47019,Carter,Tennessee,2004,6395,15768,150,22313,0.28660422175413436,0.7066732398153542,0.006722538430511361,-329,-117,3657,3211,-0.06540080389762987,-0.007255055538706522,0.07265585943633635,-9373,-3986,-0.4200690180612199,-0.1380566633339662
12041,47019,Carter,Tennessee,2008,5587,15852,330,21769,0.2566493637741743,0.72819146492719,0.015159171298635674,-808,180,84,-544,-0.02995485797996006,0.008436632868124313,0.021518225111835765,-10265,-892,-0.4715421011530157,-0.051473083091795824
12042,47019,Carter,Tennessee,2012,4789,15503,300,20592,0.23256604506604506,0.7528651903651904,0.014568764568764568,-798,-30,-349,-1177,-0.024083318708129242,-0.0005904067298711062,0.024673725438000393,-10714,-449,-0.5202991452991453,-0.048757044146129636
12043,47019,Carter,Tennessee,2016,3453,16898,733,21084,0.16377347751849744,0.8014608233731739,0.03476569910832859,-1336,433,1395,492,-0.06879256754754762,0.020196934539564025,0.04859563300798353,-13445,-2731,-0.6376873458546765,-0.11738820055553112
12044,47021,Cheatham,Tennessee,2000,6062,6356,198,12616,0.48050095117311353,0.5038046924540266,0.01569435637285986,0,0,0,0,0.0,0.0,0.0,-294,0,-0.02330374128091306,0.0
12045,47021,Cheatham,Tennessee,2004,5918,9676,103,15697,0.3770147161878066,0.6164235204179143,0.006561763394279161,-144,-95,3320,3081,-0.10348623498530696,-0.0091325929785807,0.11261882796388767,-3758,-3464,-0.23940880423010769,-0.21610506294919463
12046,47021,Cheatham,Tennessee,2008,5498,10702,228,16428,0.334672510348186,0.6514487460433407,0.013878743608473338,-420,125,1026,731,-0.04234220583962056,0.007316980214194177,0.035025225625426426,-5204,-1446,-0.3167762356951547,-0.07736743146504699
12047,47021,Cheatham,Tennessee,2012,4659,10268,229,15156,0.307403008709422,0.6774874637107416,0.01510952757983637,-839,1,-434,-1272,-0.027269501638764015,0.0012307839713630309,0.026038717667400957,-5609,-405,-0.37008445500131965,-0.05330821930616497
12048,47021,Cheatham,Tennessee,2016,3878,11297,749,15924,0.24353177593569456,0.7094323034413464,0.047035920622959054,-781,520,1029,768,-0.06387123277372744,0.03192639304312268,0.0319448397306048,-7419,-1810,-0.4659005275056519,-0.09581607250433227
12049,47023,Chester,Tennessee,2000,2192,3487,49,5728,0.38268156424581007,0.608763966480447,0.008554469273743016,0,0,0,0,0.0,0.0,0.0,-1295,0,-0.22608240223463688,0.0
12050,47023,Chester,Tennessee,2004,2242,4086,29,6357,0.35268208274343243,0.6427560169891459,0.00456190026742174,50,-20,599,629,-0.029999481502377634,-0.0039925690063212765,0.03399205050869891,-1844,-549,-0.2900739342457134,-0.06399153201107655
12051,47023,Chester,Tennessee,2008,1797,4587,75,6459,0.2782164421737111,0.7101718532280539,0.011611704598235021,-445,46,501,102,-0.07446564056972133,0.007049804330813281,0.06741583623890801,-2790,-946,-0.43195541105434276,-0.14188147680862934
12052,47023,Chester,Tennessee,2012,1624,4684,91,6399,0.2537896546335365,0.7319893733395844,0.0142209720268792,-173,16,97,-60,-0.024426787540174633,0.0026092674286441794,0.021817520111530486,-3060,-270,-0.4781997187060479,-0.04624430765170512
12053,47023,Chester,Tennessee,2016,1243,5081,183,6507,0.19102504994621178,0.7808513908098971,0.028123559243891195,-381,92,397,108,-0.0627646046873247,0.013902587217011994,0.04886201747031271,-3838,-778,-0.5898263408636852,-0.11162662215763736
12054,47025,Claiborne,Tennessee,2000,3841,5023,136,9000,0.42677777777777776,0.5581111111111111,0.015111111111111112,0,0,0,0,0.0,0.0,0.0,-1182,0,-0.13133333333333336,0.0
12055,47025,Claiborne,Tennessee,2004,4034,6448,58,10540,0.38273244781783683,0.611764705882353,0.0055028462998102465,193,-78,1425,1540,-0.044045329959940926,-0.009608264811300865,0.053653594771241875,-2414,-1232,-0.22903225806451616,-0.0976989247311828
12056,47025,Claiborne,Tennessee,2008,3078,7175,167,10420,0.29539347408829175,0.6885796545105566,0.01602687140115163,-956,109,727,-120,-0.08733897372954508,0.010524025101341384,0.0768149486282036,-4097,-1683,-0.39318618042226483,-0.16415392235774867
12057,47025,Claiborne,Tennessee,2012,2433,7617,109,10159,0.23949207599173147,0.7497785215080225,0.010729402500246087,-645,-58,442,-261,-0.05590139809656028,-0.005297468900905544,0.061198866997465906,-5184,-1087,-0.510286445516291,-0.11710026509402616
12058,47025,Claiborne,Tennessee,2016,1832,8602,306,10740,0.17057728119180632,0.8009310986964618,0.028491620111731845,-601,197,985,581,-0.06891479479992516,0.017762217611485758,0.05115257718843935,-6770,-1586,-0.6303538175046555,-0.12006737198836448
12059,47027,Clay,Tennessee,2000,1931,1468,43,3442,0.5610110400929692,0.4264962231260895,0.012492736780941312,0,0,0,0,0.0,0.0,0.0,463,0,0.13451481696687972,0.0
12060,47027,Clay,Tennessee,2004,1675,1650,32,3357,0.4989574024426571,0.4915102770330652,0.009532320524277629,-256,-11,182,-85,-0.06205363765031208,-0.002960416256663684,0.06501405390697573,25,-438,0.007447125409591915,-0.1270676915572878
12061,47027,Clay,Tennessee,2008,1248,1676,70,2994,0.4168336673346693,0.5597862391449566,0.02338009352037408,-427,38,26,-363,-0.08212373510798782,0.013847772996096453,0.06827596211189141,-428,-453,-0.1429525718102873,-0.15039969721987922
12062,47027,Clay,Tennessee,2012,1037,1747,32,2816,0.3682528409090909,0.6203835227272727,0.011363636363636364,-211,-38,71,-178,-0.04858082642557843,-0.012016457156737718,0.060597283582316086,-710,-282,-0.2521306818181818,-0.10917811000789451
12063,47027,Clay,Tennessee,2016,707,2141,72,2920,0.24212328767123287,0.7332191780821918,0.024657534246575342,-330,40,394,104,-0.12612955323785802,0.013293897882938978,0.11283565535491913,-1434,-724,-0.49109589041095897,-0.23896520859277715
12064,47029,Cocke,Tennessee,2000,3872,6185,182,10239,0.3781619298759645,0.6040628967672624,0.017775173356773123,0,0,0,0,0.0,0.0,0.0,-2313,0,-0.22590096689129796,0.0
12065,47029,Cocke,Tennessee,2004,3935,8297,79,12311,0.31963284867191943,0.6739501259036634,0.006417025424417188,63,-103,2112,2072,-0.05852908120404504,-0.011358147932355935,0.069887229136401,-4362,-2049,-0.354317277231744,-0.12841631034044604
12066,47029,Cocke,Tennessee,2008,3340,8945,196,12481,0.2676067622786636,0.7166893678391154,0.015703869882220976,-595,117,648,170,-0.052026086393255844,0.009286844457803787,0.04273924193545198,-5605,-1243,-0.4490826055604518,-0.09476532832870782
12067,47029,Cocke,Tennessee,2012,2804,8459,172,11435,0.24521206821163097,0.739746392654132,0.015041539134236991,-536,-24,-486,-1046,-0.022394694067032622,-0.0006623307479839847,0.02305702481501659,-5655,-50,-0.494534324442501,-0.045451718882049186
12068,47029,Cocke,Tennessee,2016,1981,9791,354,12126,0.16336796965198747,0.8074385617681016,0.029193468579910935,-823,182,1332,691,-0.0818440985596435,0.014151929445673945,0.06769216911396958,-7810,-2155,-0.6440705921161141,-0.14953626767361305
12069,47031,Coffee,Tennessee,2000,8741,8788,259,17788,0.49139869574994377,0.4940409264672813,0.014560377782774905,0,0,0,0,0.0,0.0,0.0,-47,0,-0.002642230717337546,0.0
12070,47031,Coffee,Tennessee,2004,8243,11793,131,20167,0.40873704566866664,0.5847671939306789,0.0064957604006545345,-498,-128,3005,2379,-0.08266165008127713,-0.00806461738212037,0.09072626746339757,-3550,-3503,-0.17603014826201224,-0.1733879175446747
12071,47031,Coffee,Tennessee,2008,7132,13250,408,20790,0.34304954304954305,0.6373256373256373,0.019624819624819625,-1111,277,1457,623,-0.0656875026191236,0.013129059224165091,0.05255844339495841,-6118,-2568,-0.29427609427609425,-0.118245946014082
12072,47031,Coffee,Tennessee,2012,5870,13023,338,19231,0.30523633716395404,0.677187873745515,0.017575789090530914,-1262,-70,-227,-1559,-0.03781320588558901,-0.002049030534288711,0.03986223641987774,-7153,-1035,-0.371951536581561,-0.07767544230546675
12073,47031,Coffee,Tennessee,2016,4743,14417,811,19971,0.23749436683190625,0.7218967502879174,0.04060888288017626,-1127,473,1394,740,-0.06774197033204779,0.023033093789645343,0.04470887654240241,-9674,-2521,-0.48440238345601117,-0.11245084687445017
12074,47033,Crockett,Tennessee,2000,2705,2676,59,5440,0.49724264705882354,0.4919117647058823,0.010845588235294117,0,0,0,0,0.0,0.0,0.0,29,0,0.005330882352941213,0.0
12075,47033,Crockett,Tennessee,2004,2459,3242,21,5722,0.429744844459979,0.5665851101013631,0.003670045438657812,-246,-38,566,282,-0.06749780259884453,-0.0071755427966363056,0.07467334539548082,-783,-812,-0.13684026564138413,-0.14217114799432534
12076,47033,Crockett,Tennessee,2008,1967,3994,76,6037,0.32582408481033626,0.6615868809011098,0.012589034288553918,-492,55,752,315,-0.10392075964964276,0.008918988849896106,0.0950017707997467,-2027,-1244,-0.3357627960907736,-0.19892253044938946
12077,47033,Crockett,Tennessee,2012,1669,3783,41,5493,0.3038412525031859,0.6886947023484434,0.007464045148370653,-298,-35,-211,-544,-0.02198283230715037,-0.005124989140183264,0.02710782144733359,-2114,-87,-0.38485344984525754,-0.04909065375448396
12078,47033,Crockett,Tennessee,2016,1303,3982,112,5397,0.24143042430980174,0.7378173059106912,0.020752269779507133,-366,71,199,-96,-0.062410828193384144,0.01328822463113648,0.049122603562247735,-2679,-565,-0.4963868816008894,-0.11153343175563185
12079,47035,Cumberland,Tennessee,2000,7644,10994,379,19017,0.40195614450228745,0.5781143187674186,0.019929536730293948,0,0,0,0,0.0,0.0,0.0,-3350,0,-0.17615817426513114,0.0
12080,47035,Cumberland,Tennessee,2004,8327,15144,166,23637,0.35228666920505985,0.6406904429496129,0.007022887845327242,683,-213,4150,4620,-0.049669475297227594,-0.012906648884966707,0.06257612418219427,-6817,-3467,-0.288403773744553,-0.11224559947942186
12081,47035,Cumberland,Tennessee,2008,7889,17436,387,25712,0.30682171748599874,0.6781269446172993,0.01505133789670193,-438,221,2292,2075,-0.04546495171906112,0.008028450051374689,0.03743650166768642,-9547,-2730,-0.37130522713130054,-0.08290145338674754
12082,47035,Cumberland,Tennessee,2012,6261,18653,358,25272,0.24774453941120608,0.7380895853118076,0.014165875276986388,-1628,-29,1217,-440,-0.05907717807479265,-0.0008854626197155411,0.059962640694508296,-12392,-2845,-0.49034504590060146,-0.11903981876930092
12083,47035,Cumberland,Tennessee,2016,5202,20413,745,26360,0.19734446130500757,0.7743930197268589,0.028262518968133536,-1059,387,1760,1088,-0.05040007810619851,0.014096643691147147,0.03630343441505135,-15211,-2819,-0.5770485584218513,-0.08670351252124986
12084,47037,Davidson,Tennessee,2000,120508,84117,3963,208588,0.5777321801829444,0.40326864440907434,0.018999175407981284,0,0,0,0,0.0,0.0,0.0,36391,0,0.17446353577387003,0.0
12085,47037,Davidson,Tennessee,2004,132737,107839,1726,242302,0.547816361400236,0.4450602966545881,0.007123341945175855,12229,-2237,23722,33714,-0.029915818782708326,-0.011875833462805428,0.04179165224551373,24898,-11493,0.10275606474564797,-0.07170747102822206
12086,47037,Davidson,Tennessee,2008,158423,102915,3885,265223,0.5973199911018275,0.3880319580126912,0.014648050885481274,25686,2159,-4924,22921,0.0495036297015915,0.007524708940305419,-0.05702833864189688,55508,30610,0.20928803308913635,0.10653196834348838
12087,47037,Davidson,Tennessee,2012,143120,97622,4549,245291,0.5834702455450873,0.3979844348141595,0.01854531964075323,-15303,664,-5293,-19932,-0.013849745556740234,0.003897268755271955,0.009952476801468324,45498,-10010,0.1854858107309278,-0.023802222358208558
12088,47037,Davidson,Tennessee,2016,148864,84550,15654,249068,0.5976841665729841,0.3394655274864696,0.06285030594054636,5744,11105,-13072,3777,0.014213921027896759,0.044304986299793125,-0.05851890732768994,64314,18816,0.2582186390865145,0.0727328283555867
12089,47039,Decatur,Tennessee,2000,2278,2046,46,4370,0.5212814645308924,0.46819221967963387,0.010526315789473684,0,0,0,0,0.0,0.0,0.0,232,0,0.053089244851258544,0.0
12090,47039,Decatur,Tennessee,2004,2268,2566,45,4879,0.4648493543758967,0.5259274441483911,0.009223201475712236,-10,-1,520,509,-0.05643211015499572,-0.0013031143137614484,0.05773522446875723,-298,-530,-0.061078089772494404,-0.11416733462375295
12091,47039,Decatur,Tennessee,2008,1566,3101,96,4763,0.3287843795926937,0.6510602561410875,0.02015536426621877,-702,51,535,-116,-0.136064974783203,0.010932162790506536,0.12513281199269644,-1535,-1237,-0.32227587654839385,-0.26119778677589944
12092,47039,Decatur,Tennessee,2012,1303,2874,66,4243,0.30709403723780343,0.677350930945086,0.015555031817110534,-263,-30,-227,-520,-0.021690342354890257,-0.004600332449108237,0.026290674803998493,-1571,-36,-0.3702568937072826,-0.04798101715888875
12093,47039,Decatur,Tennessee,2016,894,3588,110,4592,0.1946864111498258,0.7813588850174216,0.023954703832752614,-409,44,714,349,-0.11240762608797764,0.00839967201564208,0.10400795407233554,-2694,-1123,-0.5866724738675958,-0.2164155801603132
12094,47041,DeKalb,Tennessee,2000,3765,2411,89,6265,0.6009577015163607,0.3848363926576217,0.014205905826017558,0,0,0,0,0.0,0.0,0.0,1354,0,0.21612130885873904,0.0
12095,47041,DeKalb,Tennessee,2004,3445,3685,43,7173,0.48027324689809003,0.5137320507458525,0.005994702356057437,-320,-46,1274,908,-0.12068445461827071,-0.00821120346996012,0.12889565808823078,-240,-1594,-0.03345880384776245,-0.2495801127065015
12096,47041,DeKalb,Tennessee,2008,2832,4085,148,7065,0.40084925690021234,0.5782024062278839,0.020948336871903752,-613,105,400,-108,-0.0794239899978777,0.014953634515846314,0.0644703554820314,-1253,-1013,-0.17735314932767154,-0.1438943454799091
12097,47041,DeKalb,Tennessee,2012,2174,4143,110,6427,0.33826046366889684,0.644624241481251,0.017115294849852185,-658,-38,58,-638,-0.0625887932313155,-0.003833042022051567,0.06642183525336709,-1969,-716,-0.30636377781235413,-0.1290106284846826
12098,47041,DeKalb,Tennessee,2016,1569,5171,215,6955,0.22559309849029474,0.7434938892882819,0.030913012221423435,-605,105,1028,528,-0.1126673651786021,0.01379771737157125,0.09886964780703089,-3602,-1633,-0.5179007907979871,-0.211537012985633
12099,47043,Dickson,Tennessee,2000,8332,7016,208,15556,0.5356132681923373,0.4510156852661353,0.013371046541527385,0,0,0,0,0.0,0.0,0.0,1316,0,0.08459758292620206,0.0
12100,47043,Dickson,Tennessee,2004,8597,10567,134,19298,0.44548657892009536,0.5475696963415898,0.006943724738314851,265,-74,3551,3742,-0.09012668927224199,-0.0064273218032125335,0.09655401107545453,-1970,-3286,-0.10208311742149445,-0.18668070034769652
12101,47043,Dickson,Tennessee,2008,7506,11677,336,19519,0.38454838874942365,0.5982376146318972,0.017213996618679235,-1091,202,1110,221,-0.0609381901706717,0.010270271880364383,0.05066791829030737,-4171,-2201,-0.21368922588247352,-0.11160610846097907
12102,47043,Dickson,Tennessee,2012,6233,11296,282,17811,0.34995227668294876,0.6342148110718095,0.015832912245241703,-1273,-54,-381,-1708,-0.03459611206647489,-0.001381084373437532,0.03597719643991237,-5063,-892,-0.2842625343888608,-0.07057330850638727
12103,47043,Dickson,Tennessee,2016,4722,13233,744,18699,0.2525268730948179,0.7076849029359858,0.039788223969196214,-1511,462,1937,888,-0.09742540358813084,0.02395531172395451,0.0734700918641763,-8511,-3448,-0.45515802984116793,-0.17089549545230714
12104,47045,Dyer,Tennessee,2000,5425,6282,134,11841,0.4581538721391774,0.5305295160881682,0.011316611772654337,0,0,0,0,0.0,0.0,0.0,-857,0,-0.07237564394899082,0.0
12105,47045,Dyer,Tennessee,2004,5287,8447,75,13809,0.38286624665073504,0.6117025128539358,0.005431240495329133,-138,-59,2165,1968,-0.07528762548844237,-0.005885371277325204,0.08117299676576761,-3160,-2303,-0.2288362662032008,-0.15646062225420998
12106,47045,Dyer,Tennessee,2008,4411,9859,180,14450,0.3052595155709343,0.6822837370242214,0.01245674740484429,-876,105,1412,641,-0.07760673107980076,0.007025506909515158,0.07058122417028556,-5448,-2288,-0.3770242214532871,-0.14818795525008632
12107,47045,Dyer,Tennessee,2012,3757,9921,124,13802,0.2722069265323866,0.7188088682799594,0.008984205187653964,-654,-56,62,-648,-0.033052589038547686,-0.003472542217190327,0.036525131255737975,-6164,-716,-0.4466019417475728,-0.06957772029428566
12108,47045,Dyer,Tennessee,2016,2816,10180,340,13336,0.21115776844631073,0.7633473305338933,0.02549490101979604,-941,216,259,-466,-0.06104915808607586,0.016510695832142076,0.044538462253933875,-7364,-1200,-0.5521895620875825,-0.10558762034000974
12109,47047,Fayette,Tennessee,2000,5037,6402,90,11529,0.4368982565703877,0.5552953421805881,0.0078064012490242,0,0,0,0,0.0,0.0,0.0,-1365,0,-0.11839708561020035,0.0
12110,47047,Fayette,Tennessee,2004,5696,8962,79,14737,0.3865101445341657,0.6081291986157291,0.005360656850105177,659,-11,2560,3208,-0.05038811203622201,-0.0024457443989190225,0.05283385643514105,-3266,-1901,-0.2216190540815634,-0.10322196847136306
12111,47047,Fayette,Tennessee,2008,6892,12173,189,19254,0.35795159447387553,0.6322322634257816,0.009816142100342786,1196,110,3211,4517,-0.028558550060290178,0.004455485250237609,0.024103064810052532,-5281,-2015,-0.2742806689519061,-0.05266161487034271
12112,47047,Fayette,Tennessee,2012,6688,12689,176,19553,0.3420446990231678,0.6489541246867488,0.009001176290083363,-204,-13,516,299,-0.015906895450707725,-0.0008149658102594229,0.016721861260967197,-6001,-720,-0.30690942566358104,-0.03262875671167492
12113,47047,Fayette,Tennessee,2016,5874,13055,465,19394,0.3028771785088172,0.6731463339177065,0.023976487573476334,-814,289,366,-159,-0.03916752051435063,0.01497531128339297,0.024192209230957662,-7181,-1180,-0.37026915540888933,-0.06335972974530829
12114,47049,Fentress,Tennessee,2000,2529,3417,83,6029,0.4194725493448333,0.5667606568253442,0.013766793829822524,0,0,0,0,0.0,0.0,0.0,-888,0,-0.14728810748051085,0.0
12115,47049,Fentress,Tennessee,2004,2371,4293,36,6700,0.35388059701492536,0.6407462686567165,0.005373134328358209,-158,-47,876,671,-0.06559195232990794,-0.008393659501464316,0.07398561183137231,-1922,-1034,-0.2868656716417911,-0.13957756416128025
12116,47049,Fentress,Tennessee,2008,1831,4789,119,6739,0.27170203294257306,0.7106395607656922,0.01765840629173468,-540,83,496,39,-0.0821785640723523,0.012285271963376471,0.06989329210897577,-2958,-1036,-0.4389375278231192,-0.15207185618132807
12117,47049,Fentress,Tennessee,2012,1561,5243,76,6880,0.22688953488372093,0.7620639534883721,0.011046511627906977,-270,-43,454,141,-0.044812498058852124,-0.006611894663827703,0.051424392722679846,-3682,-724,-0.5351744186046512,-0.09623689078153203
12118,47049,Fentress,Tennessee,2016,1100,6038,195,7333,0.15000681849174963,0.8234010636847129,0.026592117823537435,-461,119,795,453,-0.0768827163919713,0.015545606195630458,0.061337110196340805,-4938,-1256,-0.6733942451929633,-0.1382198265883121
12119,47051,Franklin,Tennessee,2000,7828,6560,303,14691,0.5328432373562044,0.44653189027295626,0.02062487237083929,0,0,0,0,0.0,0.0,0.0,1268,0,0.08631134708324817,0.0
12120,47051,Franklin,Tennessee,2004,7800,9129,148,17077,0.4567546993031563,0.5345786730690403,0.008666627627803479,-28,-155,2569,2386,-0.0760885380530481,-0.01195824474303581,0.08804678279608402,-1329,-2597,-0.07782397376588396,-0.16413532084913213
12121,47051,Franklin,Tennessee,2008,6613,10539,280,17432,0.3793597980725103,0.6045777879761358,0.016062413951353834,-1187,132,1410,355,-0.07739490123064602,0.007395786323550355,0.06999911490709554,-3926,-2597,-0.22521798990362552,-0.14739401613774156
12122,47051,Franklin,Tennessee,2012,5603,10262,237,16102,0.34796919637312135,0.6373121351384922,0.014718668488386535,-1010,-43,-277,-1330,-0.031390601699388954,-0.0013437454629672985,0.03273434716235635,-4659,-733,-0.2893429387653708,-0.0641249488617453
12123,47051,Franklin,Tennessee,2016,4374,11532,498,16404,0.26664228237015364,0.7029992684711046,0.03035844915874177,-1229,261,1270,302,-0.08132691400296771,0.015639780670355236,0.06568713333261245,-7158,-2499,-0.43635698610095097,-0.14701404733558016
12124,47053,Gibson,Tennessee,2000,8663,8286,188,17137,0.5055143840812277,0.48351520102701756,0.010970414891754683,0,0,0,0,0.0,0.0,0.0,377,0,0.02199918305421017,0.0
12125,47053,Gibson,Tennessee,2004,8511,10596,114,19221,0.4427969408459497,0.5512720461994693,0.005931012954580927,-152,-74,2310,2084,-0.062717443235278,-0.005039401937173757,0.06775684517245179,-2085,-2462,-0.10847510535351962,-0.1304742884077298
12126,47053,Gibson,Tennessee,2008,7406,13516,331,21253,0.3484684515127276,0.6359572766197713,0.01557427186750106,-1105,217,2920,2032,-0.09432848933322213,0.009643258912920134,0.08468523042030196,-6110,-4025,-0.2874888251070437,-0.1790137197535241
12127,47053,Gibson,Tennessee,2012,6564,12883,202,19649,0.3340628021782279,0.6556567764262813,0.010280421395490865,-842,-129,-633,-1604,-0.01440564933449967,-0.005293850472010194,0.01969949980650998,-6319,-209,-0.32159397424805336,-0.03410514914100965
12128,47053,Gibson,Tennessee,2016,5258,13786,503,19547,0.268992684299381,0.7052744666700772,0.025732849030541773,-1306,301,903,-102,-0.06507011787884692,0.015452427635050907,0.04961769024379592,-8528,-2209,-0.4362817823706962,-0.11468780812264284
12129,47055,Giles,Tennessee,2000,5527,4377,162,10066,0.5490760977548182,0.43483012120007947,0.016093781045102326,0,0,0,0,0.0,0.0,0.0,1150,0,0.11424597655473878,0.0
12130,47055,Giles,Tennessee,2004,5273,6163,101,11537,0.45705122648868857,0.5341943312819624,0.008754442229349051,-254,-61,1786,1471,-0.09202487126612968,-0.007339338815753275,0.0993642100818829,-890,-2040,-0.0771431047932738,-0.19138908134801258
12131,47055,Giles,Tennessee,2008,4614,6902,173,11689,0.3947300881170331,0.5904696723415177,0.014800239541449225,-659,72,739,152,-0.06232113837165548,0.006045797312100174,0.05627534105955534,-2288,-1398,-0.19573958422448462,-0.11859647943121082
12132,47055,Giles,Tennessee,2012,3760,6915,110,10785,0.3486323597589244,0.6411682892906815,0.010199350950394067,-854,-63,13,-904,-0.04609772835810866,-0.004600888591055159,0.05069861694916378,-3155,-867,-0.29253592953175706,-0.09679634530727244
12133,47055,Giles,Tennessee,2016,2917,7970,250,11137,0.2619197270360061,0.7156325760976924,0.022447696866301516,-843,140,1055,352,-0.08671263272291835,0.01224834591590745,0.0744642868070109,-5053,-1898,-0.4537128490616863,-0.16117691952992924
12134,47057,Grainger,Tennessee,2000,2361,3746,87,6194,0.3811753309654504,0.6047788182111721,0.014045850823377462,0,0,0,0,0.0,0.0,0.0,-1385,0,-0.22360348724572165,0.0
12135,47057,Grainger,Tennessee,2004,2569,4907,51,7527,0.3413046366414242,0.6519197555466986,0.006775607811877242,208,-36,1161,1333,-0.039870694324026235,-0.00727024301150022,0.04714093733552649,-2338,-953,-0.3106151189052744,-0.08701163165955272
12136,47057,Grainger,Tennessee,2008,2066,5297,140,7503,0.27535652405704386,0.7059842729574837,0.018659202985472478,-503,89,390,-24,-0.06594811258438033,0.011883595173595236,0.05406451741078511,-3231,-893,-0.4306277489004398,-0.12001262999516543
12137,47057,Grainger,Tennessee,2012,1668,5470,104,7242,0.23032311516155757,0.7553162109914389,0.01436067384700359,-398,-36,173,-261,-0.04503340889548629,-0.004298529138468888,0.04933193803395519,-3802,-571,-0.5249930958298813,-0.09436534692944148
12138,47057,Grainger,Tennessee,2016,1154,6626,228,8008,0.1441058941058941,0.8274225774225774,0.028471528471528472,-514,124,1156,766,-0.08621722105566346,0.014110854624524882,0.07210636643113855,-5472,-1670,-0.6833166833166833,-0.15832358748680198
12139,47059,Greene,Tennessee,2000,7909,12540,367,20816,0.37994811683320523,0.6024212144504227,0.017630668716372023,0,0,0,0,0.0,0.0,0.0,-4631,0,-0.2224730976172175,0.0
12140,47059,Greene,Tennessee,2004,7635,16382,177,24194,0.3155741092832934,0.6771100272794908,0.007315863437215839,-274,-190,3842,3378,-0.06437400754991185,-0.010314805279156184,0.07468881282906803,-8747,-4116,-0.3615359179961974,-0.13906282037897988
12141,47059,Greene,Tennessee,2008,7110,17151,409,24670,0.2882042967166599,0.695216862586137,0.01657884069720308,-525,232,769,476,-0.027369812566633456,0.009262977259987242,0.018106835306646252,-10041,-1294,-0.4070125658694771,-0.04547664787327971
12142,47059,Greene,Tennessee,2012,6225,17245,387,23857,0.26092970616590516,0.7228486398122145,0.01622165402188037,-885,-22,94,-813,-0.027274590550754763,-0.00035718667532270987,0.02763177722607746,-11020,-979,-0.4619189336463093,-0.05490636777683222
12143,47059,Greene,Tennessee,2016,4216,18562,805,23583,0.17877284484586353,0.7870923970656829,0.034134758088453544,-2009,418,1317,-274,-0.08215686132004163,0.017913104066573173,0.06424375725346843,-14346,-3326,-0.6083195522198194,-0.14640061857351006
12144,47061,Grundy,Tennessee,2000,2970,1553,73,4596,0.6462140992167101,0.3379025239338555,0.01588337684943429,0,0,0,0,0.0,0.0,0.0,1417,0,0.30831157528285463,0.0
12145,47061,Grundy,Tennessee,2004,2789,2107,33,4929,0.5658348549401502,0.4274700750659363,0.006695069993913573,-181,-40,554,333,-0.08037924427655996,-0.009188306855520719,0.08956755113208081,682,-735,0.13836477987421386,-0.16994679540864077
12146,47061,Grundy,Tennessee,2008,1971,2563,98,4632,0.4255181347150259,0.5533246977547496,0.021157167530224525,-818,65,456,-297,-0.14031672022512426,0.014462097536310952,0.12585462268881326,-592,-1274,-0.12780656303972365,-0.2661713429139375
12147,47061,Grundy,Tennessee,2012,1643,2516,69,4228,0.38859981078524125,0.5950804162724692,0.0163197729422895,-328,-29,-47,-404,-0.03691832392978467,-0.004837394587935025,0.04175571851771964,-873,-281,-0.20648060548722796,-0.07867404244750431
12148,47061,Grundy,Tennessee,2016,999,3636,128,4763,0.20974175939533907,0.7633844215830359,0.026873819021625025,-644,59,1120,535,-0.17885805138990218,0.010554046079335525,0.16830400531056666,-2637,-1764,-0.5536426621876969,-0.3471620567004689
12149,47063,Hamblen,Tennessee,2000,7564,11824,311,19699,0.38397888217676024,0.6002335143915934,0.015787603431646275,0,0,0,0,0.0,0.0,0.0,-4260,0,-0.2162546322148332,0.0
12150,47063,Hamblen,Tennessee,2004,7433,14742,143,22318,0.33304955641186484,0.660543059413926,0.006407384174209159,-131,-168,2918,2619,-0.050929325764895395,-0.009380219257437115,0.060309545022332545,-7309,-3049,-0.32749350300206115,-0.11123887078722794
12151,47063,Hamblen,Tennessee,2008,6807,15508,354,22669,0.3002779125678239,0.6841060479068332,0.01561603952534298,-626,211,766,351,-0.032771643844040965,0.00920865535113382,0.023562988492907166,-8701,-1392,-0.3838281353390093,-0.05633463233694813
12152,47063,Hamblen,Tennessee,2012,5234,14522,251,20007,0.2616084370470335,0.7258459539161294,0.012545609036837107,-1573,-103,-986,-2662,-0.038669475520790364,-0.003070430488505872,0.041739906009296224,-9288,-587,-0.46423751686909587,-0.08040938153008659
12153,47063,Hamblen,Tennessee,2016,4075,15857,760,20692,0.19693601391842258,0.7663348153875894,0.03672917069398801,-1159,509,1335,685,-0.06467242312861093,0.024183561657150902,0.040488861471460025,-11782,-2494,-0.5693988014691669,-0.10516128460007101
12154,47065,Hamilton,Tennessee,2000,51708,66605,2066,120379,0.429543358891501,0.5532941792173054,0.017162461891193647,0,0,0,0,0.0,0.0,0.0,-14897,0,-0.12375082032580437,0.0
12155,47065,Hamilton,Tennessee,2004,57302,78547,1087,136936,0.4184582578722907,0.5736037272886604,0.007938014839048898,5594,-979,11942,16557,-0.011085101019210342,-0.009224447052144749,0.020309548071354988,-21245,-6348,-0.1551454694163697,-0.03139464909056533
12156,47065,Hamilton,Tennessee,2008,64246,81702,2086,148034,0.4339948930651067,0.5519137495440237,0.014091357390869665,6944,999,3155,11098,0.015536635192816006,0.006153342551820767,-0.021689977744636657,-17456,3789,-0.11791885647891703,0.03722661293745266
12157,47065,Hamilton,Tennessee,2012,58836,79933,2852,141621,0.4154468616942403,0.5644148819737186,0.02013825633204115,-5410,766,-1769,-6413,-0.018548031370866414,0.0060468989411714864,0.012501132429694861,-21097,-3641,-0.1489680202794783,-0.031049163800561275
12158,47065,Hamilton,Tennessee,2016,55316,78733,8359,142408,0.3884332340879726,0.5528692208302904,0.05869754508173698,-3520,5507,-1200,787,-0.027013627606267687,0.03855928874969583,-0.011545661143428143,-23417,-2320,-0.16443598674231785,-0.015467966462839544
12159,47067,Hancock,Tennessee,2000,690,1343,42,2075,0.3325301204819277,0.6472289156626506,0.020240963855421686,0,0,0,0,0.0,0.0,0.0,-653,0,-0.3146987951807229,0.0
12160,47067,Hancock,Tennessee,2004,777,1756,18,2551,0.30458643669149355,0.6883575068600549,0.007056056448451587,87,-24,413,476,-0.02794368379043416,-0.0131849074069701,0.04112859119740431,-979,-326,-0.3837710701685614,-0.06907227498783847
12161,47067,Hancock,Tennessee,2008,604,1588,49,2241,0.26952253458277553,0.7086122266845158,0.02186523873270861,-173,31,-168,-310,-0.035063902108718015,0.014809182284257025,0.02025471982446092,-984,-5,-0.4390896921017403,-0.055318621933178935
12162,47067,Hancock,Tennessee,2012,475,1527,43,2045,0.23227383863080683,0.7466992665036675,0.021026894865525673,-129,-6,-61,-196,-0.0372486959519687,-0.0008383438671829384,0.038087039819151625,-1052,-68,-0.5144254278728606,-0.0753357357711203
12163,47067,Hancock,Tennessee,2016,322,1843,66,2231,0.14432989690721648,0.8260869565217391,0.029583146571044376,-153,23,316,186,-0.08794394172359035,0.008556251705518703,0.07938769001807167,-1521,-469,-0.6817570596145226,-0.167331631741662
12164,47069,Hardeman,Tennessee,2000,4953,3729,121,8803,0.5626490968987845,0.42360558900374873,0.013745314097466772,0,0,0,0,0.0,0.0,0.0,1224,0,0.13904350789503578,0.0
12165,47069,Hardeman,Tennessee,2004,5685,4704,77,10466,0.5431874641696923,0.4494553793235238,0.007357156506783872,732,-44,975,1663,-0.019461632729092182,-0.0063881575906829,0.02584979031977508,981,-243,0.09373208484616852,-0.04531142304886726
12166,47069,Hardeman,Tennessee,2008,5919,5225,93,11237,0.5267420129927917,0.4649817566966272,0.008276230310581115,234,16,521,771,-0.01644545117690066,0.0009190738037972435,0.015526377373103417,694,-287,0.06176025629616444,-0.03197182855000408
12167,47069,Hardeman,Tennessee,2012,5482,4865,82,10429,0.5256496308370889,0.46648767858855117,0.007862690574359957,-437,-11,-360,-808,-0.0010923821557027313,-0.0004135397362211579,0.0015059218919239448,617,-77,0.059161952248537764,-0.002598304047626676
12168,47069,Hardeman,Tennessee,2016,4185,4919,169,9273,0.4513102555807182,0.5304647902512671,0.018224954168014666,-1297,87,54,-1156,-0.07433937525637074,0.010362263593654709,0.06397711166271597,-734,-1351,-0.07915453467054895,-0.1383164869190867
12169,47071,Hardin,Tennessee,2000,3735,4951,96,8782,0.42530175358688227,0.5637667957185152,0.010931450694602596,0,0,0,0,0.0,0.0,0.0,-1216,0,-0.1384650421316329,0.0
12170,47071,Hardin,Tennessee,2004,3834,6087,33,9954,0.38517179023508136,0.6115129596142255,0.003315250150693189,99,-63,1136,1172,-0.04012996335180091,-0.007616200543909407,0.04774616389571029,-2253,-1037,-0.2263411693791441,-0.0878761272475112
12171,47071,Hardin,Tennessee,2008,2794,7077,164,10035,0.2784255107125062,0.7052316890881913,0.01634280019930244,-1040,131,990,81,-0.10674627952257515,0.013027550048609251,0.09371872947396587,-4283,-2030,-0.42680617837568513,-0.20046500899654102
12172,47071,Hardin,Tennessee,2012,2467,7886,111,10464,0.2357607033639144,0.753631498470948,0.010607798165137615,-327,-53,809,429,-0.04266480734859182,-0.005735002034164825,0.048399809382756676,-5419,-1136,-0.5178707951070336,-0.09106461673134847
12173,47071,Hardin,Tennessee,2016,1622,8012,315,9949,0.16303146044828626,0.8053070660367876,0.031661473514926125,-845,204,126,-515,-0.07272924291562813,0.02105367534978851,0.051675567565839575,-6390,-971,-0.6422756055885013,-0.12440481048146768
12174,47073,Hawkins,Tennessee,2000,6753,10071,274,17098,0.39495847467540063,0.5890162592116037,0.01602526611299567,0,0,0,0,0.0,0.0,0.0,-3318,0,-0.1940577845362031,0.0
12175,47073,Hawkins,Tennessee,2004,6684,13447,102,20233,0.33035140611871694,0.6646073246676222,0.005041269213660851,-69,-172,3376,3135,-0.06460706855668369,-0.010983996899334821,0.07559106545601846,-6763,-3445,-0.33425591854890524,-0.14019813401270215
12176,47073,Hawkins,Tennessee,2008,5930,14756,354,21040,0.2818441064638783,0.7013307984790874,0.01682509505703422,-754,252,1309,807,-0.04850729965483863,0.011783825843373369,0.036723473811465235,-8826,-2063,-0.4194866920152091,-0.08523077346630387
12177,47073,Hawkins,Tennessee,2012,5088,14382,342,19812,0.25681405208964264,0.725923682616596,0.017262265293761358,-842,-12,-374,-1228,-0.025030054374235666,0.0004371702367271385,0.024592884137508597,-9294,-468,-0.46910963052695337,-0.04962293851174426
12178,47073,Hawkins,Tennessee,2016,3507,16648,619,20774,0.1688167902185424,0.8013863483200154,0.029796861461442187,-1581,277,2266,962,-0.08799726187110024,0.01253459616768083,0.07546266570341942,-13141,-3847,-0.632569558101473,-0.1634599275745196
12179,47075,Haywood,Tennessee,2000,3887,2554,37,6478,0.6000308737264588,0.39425748687866624,0.005711639394874961,0,0,0,0,0.0,0.0,0.0,1333,0,0.20577338684779256,0.0
12180,47075,Haywood,Tennessee,2004,4359,3140,49,7548,0.5775039745627981,0.4160042395336513,0.006491785903550609,472,12,586,1070,-0.022526899163660685,0.0007801465086756483,0.021746752654985047,1219,-114,0.16149973502914683,-0.04427365181864573
12181,47075,Haywood,Tennessee,2008,4893,3165,63,8121,0.6025120059106022,0.3897303287772442,0.007757665312153676,534,14,25,573,0.02500803134780405,0.0012658794086030664,-0.026273910756407115,1728,509,0.212781677133358,0.051281942104211165
12182,47075,Haywood,Tennessee,2012,4569,2960,34,7563,0.6041253470844903,0.391379082374719,0.004495570540790692,-324,-29,-205,-558,0.0016133411738881165,-0.003262094771362984,0.0016487535974748502,1609,-119,0.21274626470977126,-3.541242358673369e-05
12183,47075,Haywood,Tennessee,2016,3711,3013,110,6834,0.5430201931518877,0.4408838162130524,0.016095990635059995,-858,76,53,-729,-0.06110515393260263,0.011600420094269304,0.04950473383833337,698,-911,0.10213637693883526,-0.110609887770936
12184,47077,Henderson,Tennessee,2000,3166,5153,80,8399,0.37694963686153116,0.6135254196928206,0.009524943445648292,0,0,0,0,0.0,0.0,0.0,-1987,0,-0.23657578283128944,0.0
12185,47077,Henderson,Tennessee,2004,3448,6585,63,10096,0.3415213946117274,0.6522385103011094,0.0062400950871632326,282,-17,1432,1697,-0.03542824224980373,-0.0032848483584850593,0.03871309060828876,-3137,-1150,-0.31071711568938193,-0.07414133285809249
12186,47077,Henderson,Tennessee,2008,3021,7669,144,10834,0.278844378807458,0.7078641314380654,0.013291489754476648,-427,81,1084,738,-0.06267701580426943,0.007051394667313415,0.055625621136956016,-4648,-1511,-0.4290197526306074,-0.11830263694122545
12187,47077,Henderson,Tennessee,2012,2517,7421,106,10044,0.2505973715651135,0.7388490641178813,0.010553564317005177,-504,-38,-248,-790,-0.02824700724234447,-0.002737925437471471,0.030984932679815946,-4904,-256,-0.4882516925527678,-0.059231939922160415
12188,47077,Henderson,Tennessee,2016,1800,8138,279,10217,0.17617695996867966,0.796515611236175,0.027307428795145347,-717,173,717,173,-0.07442041159643387,0.01675386447814017,0.057666547118293665,-6338,-1434,-0.6203386512674953,-0.13208695871472753
12189,47079,Henry,Tennessee,2000,6093,5944,272,12309,0.4950036558615647,0.4828986920139735,0.022097652124461777,0,0,0,0,0.0,0.0,0.0,149,0,0.012104963847591188,0.0
12190,47079,Henry,Tennessee,2004,5732,7340,105,13177,0.43500037944904,0.5570311907110875,0.007968429839872506,-361,-167,1396,868,-0.060003276412524675,-0.01412922228458927,0.07413249869711402,-1608,-1757,-0.12203081126204751,-0.1341357751096387
12191,47079,Henry,Tennessee,2008,5153,8182,210,13545,0.38043558508674785,0.6040605389442599,0.015503875968992248,-579,105,842,368,-0.05456479436229217,0.007535446129119742,0.0470293482331724,-3029,-1421,-0.22362495385751208,-0.10159414259546456
12192,47079,Henry,Tennessee,2012,4339,8193,188,12720,0.34111635220125786,0.6441037735849057,0.014779874213836478,-814,-22,11,-825,-0.039319232885489996,-0.0007240017551557697,0.04004323464064574,-3854,-825,-0.3029874213836478,-0.07936246752613574
12193,47079,Henry,Tennessee,2016,3063,9508,374,12945,0.23661645422943223,0.7344920818848977,0.028891463885670144,-1276,186,1315,225,-0.10449989797182563,0.014111589671833666,0.090388308299992,-6445,-2591,-0.49787562765546545,-0.19488820627181763
12194,47081,Hickman,Tennessee,2000,4239,2914,111,7264,0.5835627753303965,0.40115638766519823,0.015280837004405287,0,0,0,0,0.0,0.0,0.0,1325,0,0.18240638766519823,0.0
12195,47081,Hickman,Tennessee,2004,4263,4359,51,8673,0.4915254237288136,0.5025942580421999,0.00588031822898651,24,-60,1445,1409,-0.09203735160158288,-0.009400518775418778,0.1014378703770017,-96,-1421,-0.011068834313386344,-0.19347522197858458
12196,47081,Hickman,Tennessee,2008,3563,4784,151,8498,0.41927512355848434,0.5629559896446222,0.017768886796893386,-700,100,425,-175,-0.07225030017032924,0.011888568567906876,0.06036173160242231,-1221,-1125,-0.1436808660861379,-0.13261203177275155
12197,47081,Hickman,Tennessee,2012,2698,4758,137,7593,0.3553272751218227,0.6266297905966022,0.018042934281575135,-865,-14,-26,-905,-0.06394784843666163,0.0002740474846817491,0.06367380095197994,-2060,-839,-0.27130251547477946,-0.12762164938864157
12198,47081,Hickman,Tennessee,2016,1824,5695,294,7813,0.2334570587482401,0.728913349545629,0.03762959170613081,-874,157,937,220,-0.12187021637358261,0.019586657424555676,0.10228355894902685,-3871,-1811,-0.49545629079738895,-0.2241537753226095
12199,47083,Houston,Tennessee,2000,2081,993,53,3127,0.6654940837863768,0.3175567636712504,0.01694915254237288,0,0,0,0,0.0,0.0,0.0,1088,0,0.34793732011512635,0.0
12200,47083,Houston,Tennessee,2004,2126,1440,32,3598,0.5908838243468594,0.4002223457476376,0.008893829905503057,45,-21,447,471,-0.07461025943951738,-0.008055322636869824,0.08266558207638719,686,-402,0.19066147859922178,-0.15727584151590457
12201,47083,Houston,Tennessee,2008,1678,1608,68,3354,0.5002981514609421,0.47942754919499103,0.020274299344066785,-448,36,168,-244,-0.09058567288591723,0.011380469438563728,0.07920520344735343,70,-616,0.02087060226595111,-0.16979087633327067
12202,47083,Houston,Tennessee,2012,1400,1579,40,3019,0.46372971182510764,0.5230208678370322,0.013249420337860219,-278,-28,-29,-335,-0.036568439635834504,-0.007024879006206566,0.043593318642041134,-179,-249,-0.05929115601192453,-0.08016175827787564
12203,47083,Houston,Tennessee,2016,866,2182,120,3168,0.27335858585858586,0.6887626262626263,0.03787878787878788,-534,80,603,149,-0.19037112596652178,0.024629367540927663,0.16574175842559413,-1316,-1137,-0.41540404040404044,-0.3561128843921159
12204,47085,Humphreys,Tennessee,2000,4205,2387,89,6681,0.6293967968866936,0.35728184403532404,0.013321359077982337,0,0,0,0,0.0,0.0,0.0,1818,0,0.27211495285136955,0.0
12205,47085,Humphreys,Tennessee,2004,4485,3261,47,7793,0.5755164891569358,0.41845245733350445,0.006031053509559861,280,-42,874,1112,-0.053880307729757826,-0.007290305568422476,0.06117061329818041,1224,-594,0.15706403182343132,-0.11505092102793824
12206,47085,Humphreys,Tennessee,2008,3600,3818,162,7580,0.47493403693931396,0.5036939313984169,0.021372031662269128,-885,115,557,-213,-0.1005824522176218,0.015340978152709267,0.08524147406491245,-218,-1442,-0.02875989445910293,-0.18582392628253425
12207,47085,Humphreys,Tennessee,2012,2905,3833,114,6852,0.4239638061879743,0.5593987157034442,0.016637478108581436,-695,-48,15,-728,-0.05097023075133966,-0.004734553553687692,0.055704784305027344,-928,-710,-0.13543490951546994,-0.106675015056367
12208,47085,Humphreys,Tennessee,2016,1967,4930,256,7153,0.2749895148888578,0.689221305745841,0.03578917936530127,-938,142,1097,301,-0.1489742912991165,0.019151701256719837,0.1298225900423967,-2963,-2035,-0.41423179085698314,-0.2787968813415132
12209,47087,Jackson,Tennessee,2000,3304,1384,66,4754,0.6949936895246108,0.29112326461926796,0.013883045856121162,0,0,0,0,0.0,0.0,0.0,1920,0,0.40387042490534286,0.0
12210,47087,Jackson,Tennessee,2004,2998,2026,32,5056,0.5929588607594937,0.4007120253164557,0.006329113924050633,-306,-34,642,302,-0.10203482876511716,-0.007553931932070529,0.10958876069718776,972,-948,0.19224683544303794,-0.21162358946230492
12211,47087,Jackson,Tennessee,2008,2224,2185,92,4501,0.4941124194623417,0.4854476782937125,0.02043990224394579,-774,60,159,-555,-0.09884644129715198,0.014110788319895158,0.08473565297725677,39,-933,0.008664741168629198,-0.18358209427440875
12212,47087,Jackson,Tennessee,2012,1739,2383,61,4183,0.4157303370786517,0.5696868276356681,0.014582835285680135,-485,-31,198,-318,-0.07838208238368999,-0.005857066958265655,0.08423914934195564,-644,-683,-0.15395649055701643,-0.16262123172564563
12213,47087,Jackson,Tennessee,2016,1129,3236,101,4466,0.2527989252127183,0.7245857590685177,0.022615315718763993,-610,40,853,283,-0.1629314118659334,0.008032480433083859,0.1548989314328496,-2107,-1463,-0.47178683385579945,-0.317830343298783
12214,47089,Jefferson,Tennessee,2000,5226,8657,204,14087,0.370980336480443,0.6145382267338682,0.014481436785688933,0,0,0,0,0.0,0.0,0.0,-3431,0,-0.24355789025342517,0.0
12215,47089,Jefferson,Tennessee,2004,5469,11625,121,17215,0.31768806273598604,0.6752831832704037,0.007028753993610224,243,-83,2968,3128,-0.05329227374445694,-0.007452682792078709,0.060744956536535555,-6156,-2725,-0.35759512053441767,-0.1140372302809925
12216,47089,Jefferson,Tennessee,2008,5178,13092,262,18532,0.27940859054608247,0.7064537017051586,0.014137707748758903,-291,141,1467,1317,-0.038279472189903574,0.007108953755148679,0.031170518434754935,-7914,-1758,-0.4270451111590762,-0.06944999062465851
12217,47089,Jefferson,Tennessee,2012,4232,13038,266,17536,0.24133211678832117,0.7434990875912408,0.015168795620437957,-946,4,-54,-996,-0.0380764737577613,0.0010310878716790536,0.037045385886082194,-8806,-892,-0.5021669708029197,-0.07512185964384355
12218,47089,Jefferson,Tennessee,2016,3494,14776,802,19072,0.1832005033557047,0.774748322147651,0.04205117449664429,-738,536,1738,1536,-0.05813161343261647,0.026882378876206335,0.031249234556410155,-11282,-2476,-0.5915478187919463,-0.08938084798902657
12219,47091,Johnson,Tennessee,2000,1813,3740,104,5657,0.32048789110836134,0.6611278062577338,0.018384302633904896,0,0,0,0,0.0,0.0,0.0,-1927,0,-0.3406399151493725,0.0
12220,47091,Johnson,Tennessee,2004,1812,4634,34,6480,0.2796296296296296,0.7151234567901235,0.005246913580246914,-1,-70,894,823,-0.04085826147873173,-0.013137389053657982,0.05399565053238964,-2822,-895,-0.43549382716049384,-0.09485391201112137
12221,47091,Johnson,Tennessee,2008,1837,4621,133,6591,0.2787133970565923,0.7011075709300562,0.02017903201335154,25,99,-13,111,-0.0009162325730373011,0.014932118433104628,-0.0140158858600673,-2784,38,-0.42239417387346384,0.01309965328703
12222,47091,Johnson,Tennessee,2012,1483,4611,97,6191,0.23954126958488128,0.7447908253916976,0.015667905023421094,-354,-36,-10,-400,-0.03917212747171103,-0.004511126989930447,0.04368325446164145,-3128,-344,-0.5052495558068163,-0.08285538193335246
12223,47091,Johnson,Tennessee,2016,988,5410,181,6579,0.15017479860161118,0.8223134214926281,0.027511779905760755,-495,84,799,388,-0.08936647098327011,0.01184387488233966,0.07752259610093049,-4422,-1294,-0.6721386228910169,-0.1668890670842006
12224,47093,Knox,Tennessee,2000,60969,86851,2766,150586,0.4048782755369025,0.5767534830595141,0.018368241403583334,0,0,0,0,0.0,0.0,0.0,-25882,0,-0.17187520752261165,0.0
12225,47093,Knox,Tennessee,2004,66013,110803,1603,178419,0.369988622287985,0.6210269085691547,0.008984469142860345,5044,-1163,23952,27833,-0.03488965324891746,-0.009383772260722989,0.04427342550964053,-44790,-18908,-0.25103828628116964,-0.07916307875855799
12226,47093,Knox,Tennessee,2008,70215,113015,2856,186086,0.3773255376546328,0.6073267199037005,0.015347742441666756,4202,1253,2212,7667,0.007336915366647767,0.006363273298806411,-0.013700188665454194,-42800,1990,-0.23000118224906768,0.02103710403210196
12227,47093,Knox,Tennessee,2012,59399,109707,3226,172332,0.34467771510804723,0.6366026042754683,0.01871968061648446,-10816,370,-3308,-13754,-0.03264782254658555,0.0033719381748177034,0.02927588437176787,-50308,-7508,-0.2919248891674211,-0.061923706918353416
12228,47093,Knox,Tennessee,2016,62878,105767,12052,180697,0.34797478652108227,0.5853279246473378,0.06669728883157994,3479,8826,-3940,8365,0.0032970714130350354,0.047977608215095474,-0.05127467962813048,-42889,7419,-0.23735313812625558,0.05457175104116552
12229,47095,Lake,Tennessee,2000,1419,781,24,2224,0.6380395683453237,0.3511690647482014,0.01079136690647482,0,0,0,0,0.0,0.0,0.0,638,0,0.2868705035971223,0.0
12230,47095,Lake,Tennessee,2004,1317,1039,14,2370,0.5556962025316455,0.4383966244725738,0.00590717299578059,-102,-10,258,146,-0.08234336581367818,-0.00488419391069423,0.0872275597243724,278,-360,0.11729957805907171,-0.1695709255380506
12231,47095,Lake,Tennessee,2008,1024,1175,39,2238,0.4575513851653262,0.5250223413762288,0.01742627345844504,-293,25,136,-132,-0.09814481736631936,0.011519100462664451,0.086625716903655,-151,-429,-0.06747095621090266,-0.18477053426997436
12232,47095,Lake,Tennessee,2012,884,1163,31,2078,0.42540904716073147,0.5596727622714148,0.014918190567853706,-140,-8,-12,-160,-0.032142338004594706,-0.002508082890591335,0.034650420895185996,-279,-128,-0.13426371511068336,-0.0667927588997807
12233,47095,Lake,Tennessee,2016,577,1357,36,1970,0.2928934010152284,0.6888324873096446,0.018274111675126905,-307,5,194,-108,-0.13251564614550304,0.0033559211072731986,0.1291597250382298,-780,-501,-0.3959390862944162,-0.26167537118373285
12234,47097,Lauderdale,Tennessee,2000,4224,3329,65,7618,0.5544762404830664,0.43699133630874243,0.008532423208191127,0,0,0,0,0.0,0.0,0.0,895,0,0.117484904174324,0.0
12235,47097,Lauderdale,Tennessee,2004,4474,4164,44,8682,0.5153190509099286,0.479612992398065,0.00506795669200645,250,-21,835,1064,-0.03915718957313785,-0.003464466516184677,0.04262165608932256,310,-585,0.03570605851186359,-0.08177884566246041
12236,47097,Lauderdale,Tennessee,2008,4322,4933,83,9338,0.462840008567145,0.528271578496466,0.008888412936388949,-152,39,769,656,-0.052479042342783555,0.0038204562443824993,0.04865858609840101,-611,-921,-0.06543156992932098,-0.10113762844118457
12237,47097,Lauderdale,Tennessee,2012,4011,4616,54,8681,0.4620435433705794,0.5317359751180739,0.006220481511346619,-311,-29,-317,-657,-0.0007964651965656211,-0.0026679314250423304,0.0034643966216079125,-605,6,-0.06969243174749451,-0.004260861818173534
12238,47097,Lauderdale,Tennessee,2016,3056,4884,147,8087,0.3778904414492395,0.6039322369234574,0.018177321627303077,-955,93,268,-594,-0.0841531019213399,0.01195684011595646,0.07219626180538352,-1828,-1223,-0.22604179547421793,-0.15634936372672342
12239,47099,Lawrence,Tennessee,2000,6643,7613,214,14470,0.45908776779543886,0.526123013130615,0.014789219073946095,0,0,0,0,0.0,0.0,0.0,-970,0,-0.06703524533517619,0.0
12240,47099,Lawrence,Tennessee,2004,6592,9959,107,16658,0.3957257774042502,0.5978508824588786,0.006423340136871173,-51,-107,2346,2188,-0.06336199039118867,-0.008365878937074921,0.07172786932826358,-3367,-2397,-0.20212510505462844,-0.13508985971945225
12241,47099,Lawrence,Tennessee,2008,5161,10566,293,16020,0.3221598002496879,0.6595505617977528,0.0182896379525593,-1431,186,607,-638,-0.07356597715456231,0.011866297815688126,0.061699679338874214,-5405,-2038,-0.33739076154806497,-0.13526565649343653
12242,47099,Lawrence,Tennessee,2012,4237,10770,191,15198,0.2787866824582182,0.7086458744571654,0.012567443084616397,-924,-102,204,-822,-0.043373117791469684,-0.005722194867942903,0.04909531265941258,-6533,-1128,-0.42985919199894723,-0.09246843045088227
12243,47099,Lawrence,Tennessee,2016,2821,12420,425,15666,0.18007149240393208,0.7927996936039832,0.02712881399208477,-1416,234,1650,468,-0.09871519005428611,0.014561370907468374,0.08415381914681774,-9599,-3066,-0.6127282012000511,-0.18286900920110388
12244,47101,Lewis,Tennessee,2000,2281,2037,102,4420,0.5160633484162896,0.4608597285067873,0.023076923076923078,0,0,0,0,0.0,0.0,0.0,244,0,0.055203619909502344,0.0
12245,47101,Lewis,Tennessee,2004,2192,2819,43,5054,0.4337158686189157,0.5577760189948555,0.00850811238622873,-89,-59,782,634,-0.08234747979737395,-0.014568810690694349,0.09691629048806821,-627,-871,-0.12406015037593981,-0.17926377028544216
12246,47101,Lewis,Tennessee,2008,1804,2951,79,4834,0.37318990484071163,0.6104675217211419,0.016342573438146463,-388,36,132,-220,-0.06052596377820407,0.007834461051917733,0.05269150272628642,-1147,-520,-0.2372776168804303,-0.1132174665044905
12247,47101,Lewis,Tennessee,2012,1447,3117,117,4681,0.30912198248237555,0.6658833582567827,0.0249946592608417,-357,38,166,-153,-0.06406792235833608,0.008652085822695239,0.05541583653564075,-1670,-523,-0.35676137577440714,-0.11948375889397683
12248,47101,Lewis,Tennessee,2016,890,3585,147,4622,0.19255733448723497,0.7756382518390307,0.031804413673734315,-557,30,468,-59,-0.11656464799514057,0.006809754412892614,0.10975489358224799,-2695,-1025,-0.5830809173517957,-0.22631954157738854
12249,47103,Lincoln,Tennessee,2000,5060,5435,164,10659,0.47471620227038186,0.5098977389999062,0.015386058729711981,0,0,0,0,0.0,0.0,0.0,-375,0,-0.03518153672952434,0.0
12250,47103,Lincoln,Tennessee,2004,4546,7829,82,12457,0.3649353776992855,0.6284819780043349,0.006582644296379545,-514,-82,2394,1798,-0.10978082457109634,-0.008803414433332435,0.11858423900442872,-3283,-2908,-0.2635466003050494,-0.22836506357552505
12251,47103,Lincoln,Tennessee,2008,3695,9231,204,13130,0.2814166031987814,0.7030464584920031,0.015536938309215537,-851,122,1402,673,-0.0835187745005041,0.00895429401283599,0.07456448048766817,-5536,-2253,-0.42162985529322167,-0.15808325498817227
12252,47103,Lincoln,Tennessee,2012,3290,9803,153,13246,0.24837686848860033,0.7400724747093462,0.01155065680205345,-405,-51,572,116,-0.033039734710181096,-0.003986281507162086,0.03702601621734314,-6513,-977,-0.49169560622074593,-0.07006575092752426
12253,47103,Lincoln,Tennessee,2016,2554,10398,396,13348,0.19133952652082709,0.7789931075816602,0.029667365897512735,-736,243,595,102,-0.05703734196777324,0.018116709095459285,0.038920632872313954,-7844,-1331,-0.5876535810608331,-0.09595797484008717
12254,47105,Loudon,Tennessee,2000,5905,10266,235,16406,0.35992929416067293,0.6257466780446178,0.014324027794709253,0,0,0,0,0.0,0.0,0.0,-4361,0,-0.2658173838839449,0.0
12255,47105,Loudon,Tennessee,2004,5708,14041,115,19864,0.2873540072492952,0.7068566250503423,0.005789367700362464,-197,-120,3775,3458,-0.07257528691137771,-0.008534660094346789,0.08110994700572449,-8333,-3972,-0.4195026178010471,-0.1536852339171022
12256,47105,Loudon,Tennessee,2008,6058,15815,311,22184,0.27307969707897584,0.7129011900468807,0.014019112874143527,350,196,1774,2320,-0.014274310170319382,0.008229745173781063,0.006044564996538382,-9757,-1424,-0.43982149296790485,-0.020318875166857764
12257,47105,Loudon,Tennessee,2012,5058,16707,280,22045,0.22943978226355183,0.7578589249262871,0.012701292810161035,-1000,-31,892,-139,-0.04363991481542401,-0.001317820063982492,0.044957734879406464,-11649,-1892,-0.5284191426627354,-0.08859764969483053
12258,47105,Loudon,Tennessee,2016,4919,17610,862,23391,0.21029455773588132,0.7528536616647429,0.03685178059937583,-139,582,903,1346,-0.019145224527670507,0.024150487789214792,-0.005005263261544268,-12691,-1042,-0.5425591039288615,-0.014139961266126155
12259,47107,McMinn,Tennessee,2000,6142,10155,303,16600,0.37,0.6117469879518073,0.01825301204819277,0,0,0,0,0.0,0.0,0.0,-4013,0,-0.24174698795180727,0.0
12260,47107,McMinn,Tennessee,2004,5891,11980,132,18003,0.3272232405710159,0.6654446481142032,0.0073321113147808694,-251,-171,1825,1403,-0.04277675942898407,-0.010920900733411901,0.053697660162395966,-6089,-2076,-0.3382214075431873,-0.09647441959138003
12261,47107,McMinn,Tennessee,2008,5541,12989,259,18789,0.2949065942838895,0.6913087444781522,0.01378466123795838,-350,127,1009,786,-0.03231664628712644,0.006452549923177511,0.02586409636394893,-7448,-1359,-0.39640215019426267,-0.05818074265107537
12262,47107,McMinn,Tennessee,2012,4609,12967,235,17811,0.25877266857559933,0.7280332378866993,0.01319409353770142,-932,-24,-22,-978,-0.03613392570829016,-0.0005905677002569602,0.03672449340854711,-8358,-910,-0.46926056931109994,-0.07285841911683727
12263,47107,McMinn,Tennessee,2016,3510,14691,554,18755,0.1871500933084511,0.7833111170354572,0.029538789656091708,-1099,319,1724,944,-0.07162257526714824,0.01634469611839029,0.055277879148757925,-11181,-2823,-0.5961610237270061,-0.12690045441590614
12264,47109,McNairy,Tennessee,2000,4003,4897,89,8989,0.44532206029591725,0.5447769496050728,0.009900990099009901,0,0,0,0,0.0,0.0,0.0,-894,0,-0.09945488930915558,0.0
12265,47109,McNairy,Tennessee,2004,4101,5787,36,9924,0.41324062877871826,0.5831318016928658,0.0036275695284159614,98,-53,890,935,-0.032081431517199,-0.00627342057059394,0.03835485208779299,-1686,-792,-0.16989117291414757,-0.07043628360499199
12266,47109,McNairy,Tennessee,2008,3131,7135,156,10422,0.30042218384187297,0.6846094799462675,0.014968336211859529,-970,120,1348,498,-0.11281844493684529,0.011340766683443568,0.1014776782534017,-4004,-2318,-0.38418729610439456,-0.214296123190247
12267,47109,McNairy,Tennessee,2012,2645,7015,127,9787,0.27025646265454173,0.7167671400837846,0.012976397261673649,-486,-29,-120,-635,-0.03016572118733124,-0.00199193895018588,0.032157660137517086,-4370,-366,-0.4465106774292429,-0.062323381324848326
12268,47109,McNairy,Tennessee,2016,1848,7841,349,10038,0.18410041841004185,0.7811316995417413,0.03476788204821678,-797,222,826,251,-0.08615604424449988,0.02179148478654313,0.06436455945795672,-5993,-1623,-0.5970312811316995,-0.15052060370245657
12269,47111,Macon,Tennessee,2000,3059,3366,66,6491,0.4712679094130334,0.5185641657679865,0.010167924818980127,0,0,0,0,0.0,0.0,0.0,-307,0,-0.04729625635495305,0.0
12270,47111,Macon,Tennessee,2004,2738,4670,25,7433,0.36835732544060273,0.6282792950356518,0.0033633795237454594,-321,-41,1304,942,-0.10291058397243069,-0.006804545295234667,0.10971512926766536,-1932,-1625,-0.2599219695950491,-0.21262571324009605
12271,47111,Macon,Tennessee,2008,2060,5145,155,7360,0.2798913043478261,0.6990489130434783,0.021059782608695652,-678,130,475,-73,-0.08846602109277663,0.017696403084950192,0.07076961800782644,-3085,-1153,-0.41915760869565216,-0.15923563910060307
12272,47111,Macon,Tennessee,2012,1552,5260,91,6903,0.22482978415181806,0.7619875416485586,0.013182674199623353,-508,-64,115,-457,-0.055061520196008046,-0.0078771084090723,0.06293862860508037,-3708,-623,-0.5371577574967406,-0.11800014880108839
12273,47111,Macon,Tennessee,2016,1072,6263,169,7504,0.14285714285714285,0.8346215351812367,0.022521321961620468,-480,78,1003,601,-0.08197264129467521,0.009338647761997115,0.07263399353267808,-5191,-1483,-0.6917643923240939,-0.15460663482735337
12274,47113,Madison,Tennessee,2000,15781,17862,287,33930,0.4651046271735927,0.5264367816091954,0.008458591217211906,0,0,0,0,0.0,0.0,0.0,-2081,0,-0.06133215443560269,0.0
12275,47113,Madison,Tennessee,2004,16840,21679,156,38675,0.4354234001292825,0.5605429864253394,0.004033613445378151,1059,-131,3817,4745,-0.0296812270443102,-0.004424977771833755,0.034106204816144015,-4839,-2758,-0.1251195862960569,-0.06378743186045421
12276,47113,Madison,Tennessee,2008,20209,23290,347,43846,0.46090863476713956,0.5311773023764995,0.0079140628563609,3369,191,1611,5171,0.025485234637857068,0.003880449410982749,-0.02936568404883988,-3081,1758,-0.07026866760935996,0.05485091868669695
12277,47113,Madison,Tennessee,2012,18367,21993,310,40670,0.45161052372756333,0.5407671502335875,0.007622326038849275,-1842,-37,-1297,-3176,-0.009298111039576229,-0.00029173681751162514,0.00958984785708794,-3626,-545,-0.08915662650602413,-0.01888795889666417
12278,47113,Madison,Tennessee,2016,15448,21335,1337,38120,0.40524658971668415,0.5596799580272823,0.03507345225603358,-2919,1027,-658,-2550,-0.04636393401087918,0.027451126217184305,0.018912807793694864,-5887,-2261,-0.15443336831059817,-0.06527674180457405
12279,47115,Marion,Tennessee,2000,5441,4651,158,10250,0.530829268292683,0.4537560975609756,0.015414634146341463,0,0,0,0,0.0,0.0,0.0,790,0,0.07707317073170733,0.0
12280,47115,Marion,Tennessee,2004,5548,5862,82,11492,0.48277062304211626,0.5100939784197702,0.00713539853811347,107,-76,1211,1242,-0.04805864525056669,-0.008279235608227993,0.0563378808587946,-314,-1104,-0.027323355377653957,-0.10439652610936129
12281,47115,Marion,Tennessee,2008,4506,6746,185,11437,0.3939844364780974,0.5898399930051587,0.0161755705167439,-1042,103,884,-55,-0.08878618656401888,0.009040171978630432,0.07974601458538844,-2240,-1926,-0.19585555652706127,-0.1685322011494073
12282,47115,Marion,Tennessee,2012,3953,6272,161,10386,0.38060851145773156,0.6038898517234739,0.015501636818794531,-553,-24,-474,-1051,-0.01337592502036583,-0.00067393369794937,0.014049858718315211,-2319,-79,-0.2232813402657423,-0.027425783738681042
12283,47115,Marion,Tennessee,2016,2832,7696,334,10862,0.26072546492358684,0.708525133492911,0.030749401583502117,-1121,173,1424,476,-0.11988304653414472,0.015247764764707586,0.10463528176943715,-4864,-2545,-0.4477996685693242,-0.22451832830358187
12284,47117,Marshall,Tennessee,2000,5107,4105,147,9359,0.545677957046693,0.43861523667058444,0.015706806282722512,0,0,0,0,0.0,0.0,0.0,1002,0,0.10706272037610853,0.0
12285,47117,Marshall,Tennessee,2004,4722,5825,68,10615,0.4448422044276967,0.5487517663683467,0.0064060292039566655,-385,-79,1720,1256,-0.1008357526189963,-0.009300777078765848,0.11013652969776222,-1103,-2105,-0.10390956194064999,-0.21097228231675852
12286,47117,Marshall,Tennessee,2008,4320,6755,214,11289,0.38267339888386925,0.5983700947825317,0.01895650633359908,-402,146,930,674,-0.06216880554382742,0.012550477129642416,0.04961832841418501,-2435,-1332,-0.21569669589866242,-0.11178713395801243
12287,47117,Marshall,Tennessee,2012,3725,6832,161,10718,0.3475461839895503,0.6374323567829819,0.015021459227467811,-595,-53,77,-571,-0.03512721489431897,-0.003935047106131269,0.039062262000450265,-3107,-672,-0.28988617279343165,-0.07418947689476924
12288,47117,Marshall,Tennessee,2016,2852,8184,419,11455,0.24897424705368834,0.7144478393714535,0.036577913574858144,-873,258,1352,737,-0.09857193693586194,0.021556454347390334,0.07701548258847157,-5332,-2225,-0.4654735923177652,-0.17558741952433354
12289,47119,Maury,Tennessee,2000,11127,11930,343,23400,0.4755128205128205,0.5098290598290598,0.014658119658119658,0,0,0,0,0.0,0.0,0.0,-803,0,-0.03431623931623928,0.0
12290,47119,Maury,Tennessee,2004,12379,17505,159,30043,0.4120427387411377,0.582664847052558,0.005292414206304297,1252,-184,5575,6643,-0.06347008177168278,-0.009365705451815361,0.07283578722349826,-5126,-4323,-0.17062210831142033,-0.13630586899518105
12291,47119,Maury,Tennessee,2008,13058,20288,421,33767,0.3867089169899606,0.6008232890099802,0.01246779400005923,679,262,2783,3724,-0.0253338217511771,0.007175379793754932,0.01815844195742211,-7230,-2104,-0.21411437202001954,-0.04349226370859921
12292,47119,Maury,Tennessee,2012,11825,20708,423,32956,0.35881174899866486,0.6283529554557592,0.01283529554557592,-1233,2,420,-811,-0.027897167991295768,0.0003675015455166901,0.027529666445779033,-8883,-1653,-0.26954120645709434,-0.0554268344370748
12293,47119,Maury,Tennessee,2016,10038,23799,1532,35369,0.2838078543357177,0.6728773784952925,0.04331476716898979,-1787,1109,3091,2413,-0.07500389466294716,0.03047947162341387,0.0445244230395333,-13761,-4878,-0.3890695241595748,-0.11952831770248046
12294,47121,Meigs,Tennessee,2000,1555,1797,38,3390,0.45870206489675514,0.5300884955752212,0.011209439528023599,0,0,0,0,0.0,0.0,0.0,-242,0,-0.07138643067846606,0.0
12295,47121,Meigs,Tennessee,2004,1595,2500,37,4132,0.3860116166505324,0.6050338818973863,0.008954501452081317,40,-1,703,742,-0.07269044824622273,-0.0022549380759422817,0.07494538632216508,-905,-663,-0.21902226524685386,-0.1476358345683878
12296,47121,Meigs,Tennessee,2008,1372,2797,68,4237,0.32381401935331605,0.660136889308473,0.016049091338211,-223,31,297,105,-0.062197597297216356,0.007094589886129682,0.05510300741108676,-1425,-520,-0.336322869955157,-0.11730060470830311
12297,47121,Meigs,Tennessee,2012,1163,2734,64,3961,0.2936127240595809,0.6902297399646554,0.016157535975763696,-209,-4,-63,-276,-0.030201295293735164,0.00010844463755269734,0.03009285065618239,-1571,-146,-0.39661701590507453,-0.060294145949917555
12298,47121,Meigs,Tennessee,2016,856,3342,122,4320,0.19814814814814816,0.7736111111111111,0.02824074074074074,-307,58,608,359,-0.09546457591143273,0.012083204764977044,0.08338137114645572,-2486,-915,-0.575462962962963,-0.17884594705788842
12299,47123,Monroe,Tennessee,2000,5327,7514,162,13003,0.4096746904560486,0.5778666461585787,0.012458663385372607,0,0,0,0,0.0,0.0,0.0,-2187,0,-0.16819195570253015,0.0
12300,47123,Monroe,Tennessee,2004,5354,10123,91,15568,0.34391058581706063,0.6502440904419322,0.005845323741007194,27,-71,2609,2565,-0.06576410463898796,-0.006613339644365413,0.07237744428335346,-4769,-2582,-0.3063335046248716,-0.13814154892234143
12301,47123,Monroe,Tennessee,2008,5053,11484,240,16777,0.30118614770221136,0.6845085533766466,0.01430529892114204,-301,149,1361,1209,-0.04272443811484927,0.008459975180134846,0.03426446293471441,-6431,-1662,-0.38332240567443526,-0.07698890104956368
12302,47123,Monroe,Tennessee,2012,4372,11731,211,16314,0.26799068284908667,0.7190756405541253,0.012933676596788036,-681,-29,247,-463,-0.03319546485312469,-0.0013716223243540049,0.034567087177478695,-7359,-928,-0.45108495770503865,-0.06776255203060338
12303,47123,Monroe,Tennessee,2016,3186,13374,533,17093,0.1863920903293746,0.7824255543204821,0.031182355350143333,-1186,322,1643,779,-0.08159859251971208,0.0182486787533553,0.06334991376635679,-10188,-2829,-0.5960334639911076,-0.14494850628606892
12304,47125,Montgomery,Tennessee,2000,18818,19644,582,39044,0.4819690605470751,0.5031246798483762,0.014906259604548715,0,0,0,0,0.0,0.0,0.0,-826,0,-0.021155619301301054,0.0
12305,47125,Montgomery,Tennessee,2004,20070,28627,301,48998,0.4096085554512429,0.5842483366668028,0.0061431078819543655,1252,-281,8983,9954,-0.0723605050958322,-0.00876315172259435,0.08112365681842659,-8557,-7731,-0.17463978121555984,-0.1534841619142588
12306,47125,Montgomery,Tennessee,2008,25716,30175,748,56639,0.45403343985592964,0.5327601122901181,0.013206447853952225,5646,447,1548,7641,0.044424884404686726,0.007063339971997859,-0.051488224376684655,-4459,4098,-0.07872667243418846,0.09591310878137138
12307,47125,Montgomery,Tennessee,2012,24499,30245,920,55664,0.4401228801379707,0.5433493820063237,0.016527737855705663,-1217,172,70,-975,-0.013910559717958959,0.0033212900017534387,0.010589269716205552,-5746,-1287,-0.10322650186835297,-0.02449982943416451
12308,47125,Montgomery,Tennessee,2016,21699,32341,3580,57620,0.37658799028115236,0.5612808052759458,0.06213120444290177,-2800,2660,2096,1956,-0.06353488985681832,0.045603466587196106,0.01793142326962216,-10642,-4896,-0.18469281499479345,-0.08146631312644048
12309,47127,Moore,Tennessee,2000,1107,1145,49,2301,0.4810951760104302,0.49760973489787047,0.021295089091699262,0,0,0,0,0.0,0.0,0.0,-38,0,-0.016514558887440245,0.0
12310,47127,Moore,Tennessee,2004,1084,1668,22,2774,0.39077144917087236,0.601297764960346,0.007930785868781542,-23,-27,523,473,-0.09032372683955786,-0.01336430322291772,0.10368803006247557,-584,-546,-0.21052631578947367,-0.19401175690203343
12311,47127,Moore,Tennessee,2008,881,2010,61,2952,0.2984417344173442,0.6808943089430894,0.020663956639566397,-203,39,342,178,-0.09232971475352819,0.012733170770784855,0.0795965439827434,-1129,-545,-0.38245257452574527,-0.1719262587362716
12312,47127,Moore,Tennessee,2012,705,2053,40,2798,0.25196568977841316,0.7337383845604003,0.014295925661186561,-176,-21,43,-154,-0.04647604463893101,-0.006368030978379836,0.05284407561731086,-1348,-219,-0.48177269478198714,-0.09932012025624187
12313,47127,Moore,Tennessee,2016,496,2325,105,2926,0.1695146958304853,0.7946001367053999,0.03588516746411483,-209,65,272,128,-0.08245099394792785,0.02158924180292827,0.06086175214499956,-1829,-481,-0.6250854408749146,-0.14331274609292743
12314,47129,Morgan,Tennessee,2000,2921,3144,97,6162,0.47403440441415123,0.5102239532619279,0.015741642323920804,0,0,0,0,0.0,0.0,0.0,-223,0,-0.0361895488477767,0.0
12315,47129,Morgan,Tennessee,2004,2924,4401,35,7360,0.3972826086956522,0.5979619565217391,0.004755434782608696,3,-62,1257,1198,-0.07675179571849905,-0.010986207541312108,0.08773800325981118,-1477,-1254,-0.20067934782608693,-0.16448979897831023
12316,47129,Morgan,Tennessee,2008,1969,4717,136,6822,0.2886250366461448,0.6914394605687482,0.019935502785107008,-955,101,316,-538,-0.10865757204950738,0.015180068002498312,0.09347750404700905,-2748,-1271,-0.40281442392260336,-0.20213507609651643
12317,47129,Morgan,Tennessee,2012,1725,4669,100,6494,0.2656298121342778,0.7189713581767786,0.015398829688943641,-244,-36,-48,-328,-0.02299522451186703,-0.004536673096163367,0.02753189760803043,-2944,-196,-0.4533415460425008,-0.05052712211989746
12318,47129,Morgan,Tennessee,2016,1054,5441,210,6705,0.15719612229679344,0.8114839671886652,0.03131991051454139,-671,110,772,211,-0.10843368983748433,0.015921080825597747,0.09251260901188663,-4387,-1443,-0.6542878448918718,-0.20094629884937093
12319,47131,Obion,Tennessee,2000,6056,6168,216,12440,0.4868167202572347,0.4958199356913183,0.017363344051446947,0,0,0,0,0.0,0.0,0.0,-112,0,-0.009003215434083611,0.0
12320,47131,Obion,Tennessee,2004,5549,7859,127,13535,0.40997414111562613,0.580642777983007,0.009383080901366827,-507,-89,1691,1095,-0.07684257914160858,-0.00798026315008012,0.08482284229168868,-2310,-2198,-0.17066863686738087,-0.16166542143329726
12321,47131,Obion,Tennessee,2008,4308,8873,211,13392,0.3216845878136201,0.6625597371565114,0.015755675029868577,-1241,84,1014,-143,-0.08828955330200605,0.00637259412850175,0.08191695917350439,-4565,-2255,-0.3408751493428913,-0.17020651247551044
12322,47131,Obion,Tennessee,2012,3321,8814,143,12278,0.2704837921485584,0.7178693598305913,0.011646848020850302,-987,-68,-59,-1114,-0.051200795665061694,-0.004108827009018275,0.055309622674079906,-5493,-928,-0.4473855676820329,-0.1065104183391416
12323,47131,Obion,Tennessee,2016,2426,9526,297,12249,0.19805698424361173,0.7776961384602825,0.024246877296105803,-895,154,712,-29,-0.07242680790494666,0.012600029275255501,0.05982677862969121,-7100,-1607,-0.5796391542166708,-0.13225358653463787
12324,47133,Overton,Tennessee,2000,4507,2875,114,7496,0.6012540021344717,0.38353788687299895,0.015208110992529349,0,0,0,0,0.0,0.0,0.0,1632,0,0.21771611526147272,0.0
12325,47133,Overton,Tennessee,2004,4518,3941,51,8510,0.5309048178613396,0.46310223266745004,0.005992949471210341,11,-63,1066,1014,-0.07034918427313208,-0.009215161521319008,0.0795643457944511,577,-1055,0.06780258519388954,-0.14991353006758318
12326,47133,Overton,Tennessee,2008,3419,4497,176,8092,0.42251606524962926,0.5557340583292141,0.021749876421156698,-1099,125,556,-418,-0.10838875261171033,0.015756926949946355,0.09263182566176403,-1078,-1655,-0.13321799307958482,-0.20102057827347436
12327,47133,Overton,Tennessee,2012,2805,4775,76,7656,0.36637931034482757,0.6236938349007315,0.009926854754440962,-614,-100,278,-436,-0.05613675490480169,-0.011823021666715736,0.06795977657151742,-1970,-892,-0.2573145245559039,-0.1240965314763191
12328,47133,Overton,Tennessee,2016,1945,6059,225,8229,0.23635921740187144,0.7362984566776036,0.027342325920524973,-860,149,1284,573,-0.13002009294295613,0.01741547116608401,0.11260462177687214,-4114,-2144,-0.4999392392757322,-0.24262471471982827
12329,47135,Perry,Tennessee,2000,1650,1165,51,2866,0.5757152826238661,0.40648988136775993,0.01779483600837404,0,0,0,0,0.0,0.0,0.0,485,0,0.16922540125610613,0.0
12330,47135,Perry,Tennessee,2004,1579,1522,49,3150,0.5012698412698413,0.4831746031746032,0.015555555555555555,-71,-2,357,284,-0.07444544135402476,-0.002239280452818484,0.07668472180684327,57,-428,0.01809523809523811,-0.15113016316086803
12331,47135,Perry,Tennessee,2008,1329,1596,75,3000,0.443,0.532,0.025,-250,26,74,-150,-0.058269841269841305,0.009444444444444446,0.04882539682539683,-267,-324,-0.08900000000000002,-0.10709523809523813
12332,47135,Perry,Tennessee,2012,992,1578,41,2611,0.3799310608962084,0.6043661432401379,0.015702795863653772,-337,-34,-18,-389,-0.06306893910379163,-0.00929720413634623,0.0723661432401379,-586,-319,-0.22443508234392956,-0.13543508234392954
12333,47135,Perry,Tennessee,2016,597,2167,91,2855,0.20910683012259193,0.7590192644483362,0.03187390542907181,-395,50,589,244,-0.17082423077361644,0.016171109565418035,0.1546531212081983,-1570,-984,-0.5499124343257443,-0.32547735198181477
12334,47137,Pickett,Tennessee,2000,939,1281,19,2239,0.41938365341670386,0.5721304153640018,0.008485931219294328,0,0,0,0,0.0,0.0,0.0,-342,0,-0.15274676194729792,0.0
12335,47137,Pickett,Tennessee,2004,1033,1600,12,2645,0.39054820415879016,0.6049149338374291,0.004536862003780718,94,-7,319,406,-0.028835449257913703,-0.00394906921551361,0.03278451847342734,-567,-225,-0.21436672967863896,-0.06161996773134104
12336,47137,Pickett,Tennessee,2008,854,1786,31,2671,0.31973043803818796,0.6686634219393486,0.011606140022463497,-179,19,186,26,-0.0708177661206022,0.007069278018682779,0.06374848810191946,-932,-365,-0.3489329839011606,-0.13456625422252166
12337,47137,Pickett,Tennessee,2012,712,1712,24,2448,0.2908496732026144,0.6993464052287581,0.00980392156862745,-142,-7,-74,-223,-0.028880764835573558,-0.0018022184538360464,0.03068298328940955,-1000,-68,-0.4084967320261437,-0.05956374812498311
12338,47137,Pickett,Tennessee,2016,536,2021,58,2615,0.20497131931166349,0.772848948374761,0.022179732313575527,-176,34,309,167,-0.08587835389095091,0.012375810744948076,0.07350254314600291,-1485,-485,-0.5678776290630976,-0.15938089703695385
12339,47139,Polk,Tennessee,2000,2574,2907,113,5594,0.4601358598498391,0.5196639256346085,0.020200214515552376,0,0,0,0,0.0,0.0,0.0,-333,0,-0.05952806578476938,0.0
12340,47139,Polk,Tennessee,2004,2724,3924,52,6700,0.4065671641791045,0.5856716417910448,0.007761194029850746,150,-61,1017,1106,-0.053568695670734634,-0.01243902048570163,0.0660077161564363,-1200,-867,-0.17910447761194032,-0.11957641182717094
12341,47139,Polk,Tennessee,2008,2124,4267,110,6501,0.32671896631287495,0.6563605599138594,0.01692047377326565,-600,58,343,-199,-0.07984819786622954,0.009159279743414905,0.07068891812281464,-2143,-943,-0.3296415936009845,-0.15053711598904418
12342,47139,Polk,Tennessee,2012,1856,4108,82,6046,0.30697982136950047,0.6794574925570626,0.013562686073436983,-268,-28,-159,-455,-0.019739144943374476,-0.003357787699828668,0.023096932643203116,-2252,-109,-0.3724776711875621,-0.04283607758657759
12343,47139,Polk,Tennessee,2016,1252,5097,171,6520,0.19202453987730062,0.7817484662576687,0.026226993865030676,-604,89,989,474,-0.11495528149219986,0.012664307791593693,0.10229097370060614,-3845,-1593,-0.5897239263803681,-0.217246255192806
12344,47141,Putnam,Tennessee,2000,10785,11248,405,22438,0.48065781263927265,0.501292450307514,0.018049737053213298,0,0,0,0,0.0,0.0,0.0,-463,0,-0.020634637668241362,0.0
12345,47141,Putnam,Tennessee,2004,10566,15637,239,26442,0.39959155888359427,0.5913697904848347,0.009038650631570985,-219,-166,4389,4004,-0.08106625375567839,-0.009011086421642313,0.09007734017732072,-5071,-4608,-0.19177823160124047,-0.1711435939329991
12346,47141,Putnam,Tennessee,2008,9739,17101,476,27316,0.3565309708595695,0.6260433445599649,0.017425684580465662,-827,237,1464,874,-0.04306058802402479,0.008387033948894677,0.034673554075130175,-7362,-2291,-0.26951237370039544,-0.07773414209915497
12347,47141,Putnam,Tennessee,2012,7802,17254,401,25457,0.306477589660997,0.6777703578583494,0.01575205248065365,-1937,-75,153,-1859,-0.0500533811985725,-0.0016736320998120106,0.05172701329838447,-9452,-2090,-0.3712927681973524,-0.10178039449695697
12348,47141,Putnam,Tennessee,2016,6851,19002,1359,27212,0.25176392767896516,0.6982948699103336,0.049941202410701165,-951,958,1748,1755,-0.054713661982031814,0.03418914993004751,0.020524512051984245,-12151,-2699,-0.44653094223136847,-0.07523817403401606
12349,47143,Rhea,Tennessee,2000,3722,5900,150,9772,0.3808841588211216,0.6037658616455178,0.015349979533360623,0,0,0,0,0.0,0.0,0.0,-2178,0,-0.22288170282439623,0.0
12350,47143,Rhea,Tennessee,2004,3665,7301,88,11054,0.3315541885290393,0.6604848923466619,0.007960919124298896,-57,-62,1401,1282,-0.049329970292082304,-0.007389060409061727,0.056719030701144035,-3636,-1458,-0.32893070381762257,-0.10604900099322634
12351,47143,Rhea,Tennessee,2008,2907,8042,157,11106,0.26175040518638576,0.7241130920223303,0.01413650279128399,-758,69,741,52,-0.06980378334265352,0.006175583666985094,0.06362819967566846,-5135,-1499,-0.46236268683594456,-0.133431983018322
12352,47143,Rhea,Tennessee,2012,2628,7802,147,10577,0.2484636475371088,0.7376382717216602,0.013898080741230973,-279,-10,-240,-529,-0.013286757649276948,-0.00023842205005301757,0.01352517969932987,-5174,-39,-0.4891746241845514,-0.026811937348606818
12353,47143,Rhea,Tennessee,2016,1942,8660,460,11062,0.1755559573314048,0.7828602422708371,0.04158380039775809,-686,313,858,485,-0.072907690205704,0.027685719656527115,0.04522197054917687,-6718,-1544,-0.6073042849394322,-0.11812966075488085
12354,47145,Roane,Tennessee,2000,9575,11345,406,21326,0.44898246272156056,0.5319797430366688,0.019037794241770607,0,0,0,0,0.0,0.0,0.0,-1770,0,-0.08299728031510828,0.0
12355,47145,Roane,Tennessee,2004,8706,14467,165,23338,0.37303967777873,0.6198903076527552,0.007070014568514868,-869,-241,3122,2012,-0.07594278494283058,-0.011967779673255739,0.08791056461608637,-5761,-3991,-0.24685062987402523,-0.16385334955891695
12356,47145,Roane,Tennessee,2008,7224,15658,394,23276,0.3103626052586355,0.672710087643925,0.016927307097439424,-1482,229,1191,-62,-0.06267707252009447,0.009857292528924555,0.052819779991169824,-8434,-2673,-0.3623474823852895,-0.11549685251126429
12357,47145,Roane,Tennessee,2012,6018,14724,318,21060,0.28575498575498576,0.6991452991452991,0.0150997150997151,-1206,-76,-934,-2216,-0.024607619503649758,-0.0018275919977243232,0.026435211501374067,-8706,-272,-0.41339031339031335,-0.051042831005023825
12358,47145,Roane,Tennessee,2016,4837,15880,952,21669,0.22322211454151092,0.7328441552448198,0.043933730213669295,-1181,634,1156,609,-0.06253287121347484,0.028834015113954194,0.033698856099520724,-11043,-2337,-0.509622040703309,-0.09623172731299562
12359,47147,Robertson,Tennessee,2000,10249,9675,240,20164,0.5082820868875223,0.47981551279508033,0.011902400317397342,0,0,0,0,0.0,0.0,0.0,574,0,0.028466574092441965,0.0
12360,47147,Robertson,Tennessee,2004,9865,15331,127,25323,0.3895667969829799,0.6054179994471429,0.0050152035698771864,-384,-113,5656,5159,-0.11871528990454239,-0.006887196747520155,0.12560248665206258,-5466,-6040,-0.215851202464163,-0.24431777655660497
12361,47147,Robertson,Tennessee,2008,9318,17903,393,27614,0.3374375316868255,0.6483305569638589,0.014231911349315564,-547,266,2572,2291,-0.052129265296154415,0.009216707779438378,0.042912557516715966,-8585,-3119,-0.3108930252770334,-0.09504182281287038
12362,47147,Robertson,Tennessee,2012,8290,17643,326,26259,0.3157012833695114,0.6718839255112533,0.01241479111923531,-1028,-67,-260,-1355,-0.021736248317314077,-0.0018171202300802537,0.023553368547394427,-9353,-768,-0.3561826421417419,-0.045289616864708504
12363,47147,Robertson,Tennessee,2016,6637,19410,1066,27113,0.24479032198576328,0.71589274517759,0.039316932836646626,-1653,740,1767,854,-0.07091096138374814,0.026902141717411315,0.04400881966633674,-12773,-3420,-0.47110242319182677,-0.11491978105008488
12364,47149,Rutherford,Tennessee,2000,27360,33445,1377,62182,0.4399987134540542,0.5378566144543437,0.02214467209160207,0,0,0,0,0.0,0.0,0.0,-6085,0,-0.09785790100028952,0.0
12365,47149,Rutherford,Tennessee,2004,31647,52200,562,84409,0.3749244748782713,0.6184174673316827,0.006658057790046085,4287,-815,18755,22227,-0.06507423857578293,-0.015486614301555984,0.08056085287733894,-20553,-14468,-0.24349299245341138,-0.14563509145312187
12366,47149,Rutherford,Tennessee,2008,40460,59892,1547,101899,0.3970598337569554,0.5877584667170433,0.015181699526001237,8813,985,7692,17490,0.02213535887868412,0.008523641735955153,-0.03065900061463933,-19432,1121,-0.19069863296008793,0.05279435949332345
12367,47149,Rutherford,Tennessee,2012,36414,60846,1505,98765,0.3686933630334633,0.6160684452994482,0.015238191667088544,-4046,-42,954,-3134,-0.028366470723492132,5.649214108730677e-05,0.028309978582404804,-24432,-5000,-0.24737508226598487,-0.056676449305896937
12368,47149,Rutherford,Tennessee,2016,36706,64515,6215,107436,0.3416545664395547,0.6004970400982911,0.057848393462154216,292,4710,3669,8671,-0.027038796593908565,0.04261020179506567,-0.015571405201157074,-27809,-3377,-0.25884247365873636,-0.011467391392751491
12369,47151,Scott,Tennessee,2000,2967,3579,69,6615,0.4485260770975057,0.5410430839002267,0.010430839002267574,0,0,0,0,0.0,0.0,0.0,-612,0,-0.09251700680272101,0.0
12370,47151,Scott,Tennessee,2004,3086,4509,33,7628,0.4045621394861038,0.5911116937598322,0.004326166754063975,119,-36,930,1013,-0.04396393761140188,-0.006104672248203599,0.050068609859605484,-1423,-811,-0.18654955427372838,-0.09403254747100737
12371,47151,Scott,Tennessee,2008,1720,4931,132,6783,0.2535751142562288,0.7269644699985257,0.019460415745245468,-1366,99,422,-845,-0.150987025229875,0.015134248991181494,0.13585277623869352,-3211,-1788,-0.4733893557422969,-0.2868398014685685
12372,47151,Scott,Tennessee,2012,1452,5117,90,6659,0.21805075837212795,0.7684336987535666,0.013515542874305451,-268,-42,186,-124,-0.035524355884100856,-0.005944872870940017,0.04146922875504089,-3665,-454,-0.5503829403814386,-0.07699358463914174
12373,47151,Scott,Tennessee,2016,934,6044,145,7123,0.13112452618278816,0.8485188824933315,0.020356591323880388,-518,55,927,464,-0.08692623218933979,0.006841048449574937,0.08008518373976492,-5110,-1445,-0.7173943563105434,-0.16701141592910473
12374,47153,Sequatchie,Tennessee,2000,1648,2169,70,3887,0.4239773604322099,0.558013892462053,0.018008747105737074,0,0,0,0,0.0,0.0,0.0,-521,0,-0.13403653202984311,0.0
12375,47153,Sequatchie,Tennessee,2004,1986,2951,46,4983,0.39855508729680916,0.5922135259883604,0.009231386714830423,338,-24,782,1096,-0.02542227313540074,-0.00877736039090665,0.034199633526307394,-965,-444,-0.19365843869155125,-0.059621906661708135
12376,47153,Sequatchie,Tennessee,2008,1717,3610,110,5437,0.31579915394519037,0.6639691006069524,0.020231745447857274,-269,64,659,454,-0.0827559333516188,0.011000358733026851,0.07175557461859194,-1893,-928,-0.348169946661762,-0.15451150797021074
12377,47153,Sequatchie,Tennessee,2012,1489,3541,116,5146,0.2893509521958803,0.6881072677808007,0.022541780023319084,-228,6,-69,-291,-0.026448201749310063,0.002310034575461809,0.024138167173848313,-2052,-159,-0.39875631558492036,-0.050586368923158376
12378,47153,Sequatchie,Tennessee,2016,1053,4441,200,5694,0.18493150684931506,0.7799438004917457,0.035124692658939236,-436,84,900,548,-0.10441944534656525,0.012582912635620152,0.09183653271094505,-3388,-1336,-0.5950122936424307,-0.19625597805751033
12379,47155,Sevier,Tennessee,2000,8208,16734,423,25365,0.3235955056179775,0.6597279716144293,0.01667652276759314,0,0,0,0,0.0,0.0,0.0,-8526,0,-0.3361324659964518,0.0
12380,47155,Sevier,Tennessee,2004,8621,22143,206,30970,0.2783661608007749,0.7149822408782693,0.006651598320955764,413,-217,5409,5605,-0.04522934481720259,-0.010024924446637377,0.05525426926384003,-13522,-4996,-0.4366160800774944,-0.10048361408104262
12381,47155,Sevier,Tennessee,2008,8604,24922,415,33941,0.2534987183642203,0.7342741816681889,0.01222709996759082,-17,209,2779,2971,-0.024867442436554643,0.005575501646635056,0.01929194078991958,-16318,-2796,-0.48077546330396864,-0.044159383226474225
12382,47155,Sevier,Tennessee,2012,7418,25984,423,33825,0.21930524759793052,0.7681892091648189,0.012505543237250555,-1186,8,1062,-116,-0.03419347076628976,0.00027844326965973526,0.03391502749663,-18566,-2248,-0.5488839615668883,-0.0681084982629197
12383,47155,Sevier,Tennessee,2016,6297,28629,1386,36312,0.1734137475214805,0.788417052214144,0.03816920026437541,-1121,963,2645,2487,-0.045891500076450015,0.025663657027124857,0.020227843049325123,-22332,-3766,-0.6150033046926635,-0.06611934312577517
12384,47157,Shelby,Tennessee,2000,190404,141756,4595,336755,0.5654080859972384,0.42094697925791746,0.013644934744844175,0,0,0,0,0.0,0.0,0.0,48648,0,0.1444611067393209,0.0
12385,47157,Shelby,Tennessee,2004,216945,158137,2200,377282,0.5750208067175216,0.4191480113018909,0.005831181980587465,26541,-2395,16381,40527,0.009612720720283296,-0.00781375276425671,-0.0017989679560265759,58808,10160,0.15587279541563076,0.011411688676309872
12386,47157,Shelby,Tennessee,2008,256297,145458,2800,404555,0.6335281976492689,0.359550617344984,0.0069211850057470554,39352,600,-12679,27273,0.05850739093174728,0.0010900030251595905,-0.059597393956906886,110839,52031,0.27397758030428493,0.11810478488865417
12387,47157,Shelby,Tennessee,2012,232443,135649,3272,371364,0.6259168901670598,0.3652723473465387,0.008810762486401481,-23854,472,-9809,-33191,-0.007611307482209173,0.001889577480654426,0.005721730001554681,96794,-14045,0.2606445428205211,-0.013333037483763854
12388,47157,Shelby,Tennessee,2016,208992,116344,12047,337383,0.6194502983256418,0.3448425083658631,0.035707193308495096,-23451,8775,-19305,-33981,-0.006466591841417957,0.026896430822093614,-0.020429838980675574,92648,-4146,0.2746077899597787,0.013963247139257617
12389,47159,Smith,Tennessee,2000,4884,2384,80,7348,0.6646706586826348,0.3244420250408274,0.010887316276537834,0,0,0,0,0.0,0.0,0.0,2500,0,0.34022863364180733,0.0
12390,47159,Smith,Tennessee,2004,4044,3739,45,7828,0.5166070516096065,0.4776443536024527,0.005748594787940726,-840,-35,1355,480,-0.14806360707302824,-0.005138721488597108,0.1532023285616253,305,-2195,0.038962698007153795,-0.30126593563465354
12391,47159,Smith,Tennessee,2008,2992,4563,186,7741,0.38651337036558586,0.5894587262627567,0.02402790337165741,-1052,141,824,-87,-0.13009368124402065,0.018279308583716684,0.11181437266030403,-1571,-1876,-0.2029453558971709,-0.24190805390432468
12392,47159,Smith,Tennessee,2012,2470,4495,110,7075,0.3491166077738516,0.6353356890459364,0.015547703180212015,-522,-76,-68,-666,-0.037396762591734245,-0.008480200191445394,0.04587696278317965,-2025,-454,-0.2862190812720848,-0.0832737253749139
12393,47159,Smith,Tennessee,2016,1689,5494,253,7436,0.2271382463690156,0.7388380849919312,0.034023668639053255,-781,143,999,361,-0.121978361404836,0.01847596545884124,0.10350239594599475,-3805,-1780,-0.5116998386229156,-0.22548075735083078
12394,47161,Stewart,Tennessee,2000,2870,1826,86,4782,0.6001672940192389,0.3818485989125889,0.017984107068172314,0,0,0,0,0.0,0.0,0.0,1044,0,0.21831869510664997,0.0
12395,47161,Stewart,Tennessee,2004,2860,2675,48,5583,0.5122693892172667,0.47913308257209386,0.008597528210639442,-10,-38,849,801,-0.08789790480197213,-0.009386578857532872,0.09728448365950498,185,-859,0.033136306645172864,-0.1851823884614771
12396,47161,Stewart,Tennessee,2008,2470,2956,81,5507,0.44852006537134553,0.5367713818776103,0.014708552751044126,-390,33,281,-76,-0.06374932384592119,0.006111024540404684,0.05763829930551645,-486,-671,-0.08825131650626478,-0.12138762315143764
12397,47161,Stewart,Tennessee,2012,2069,2963,77,5109,0.4049716187120767,0.5799569387355646,0.015071442552358583,-401,-4,7,-398,-0.043548446659268825,0.0003628898013144574,0.04318555685795433,-894,-408,-0.17498532002348793,-0.08673400351722316
12398,47161,Stewart,Tennessee,2016,1222,3864,213,5299,0.23060954897150407,0.7291941875825627,0.040196263445933196,-847,136,901,190,-0.17436206974057264,0.025124820893574613,0.14923724884699807,-2642,-1748,-0.4985846386110586,-0.3235993185875707
12399,47163,Sullivan,Tennessee,2000,21354,33482,891,55727,0.3831894772731351,0.6008218637285337,0.01598865899833115,0,0,0,0,0.0,0.0,0.0,-12128,0,-0.21763238645539862,0.0
12400,47163,Sullivan,Tennessee,2004,19637,42555,447,62639,0.3134947875923945,0.6793690831590543,0.007136129248551222,-1717,-444,9073,6912,-0.0696946896807406,-0.008852529749779927,0.07854721943052057,-22918,-10790,-0.3658742955666598,-0.14824190911126117
12401,47163,Sullivan,Tennessee,2008,18354,44808,835,63997,0.28679469350125786,0.7001578198978077,0.013047486600934419,-1283,388,2253,1358,-0.02670009409113666,0.005911357352383197,0.020788736738753366,-26454,-3536,-0.4133631263965498,-0.04748883082989003
12402,47163,Sullivan,Tennessee,2012,15321,43562,934,59817,0.2561312001604895,0.7282545095875754,0.01561429025193507,-3033,99,-1246,-4180,-0.030663493340768344,0.0025668036510006504,0.02809668968976775,-28241,-1787,-0.4721233094270859,-0.058760183030536095
12403,47163,Sullivan,Tennessee,2016,12578,46979,2721,62278,0.20196538103343076,0.7543434278557436,0.04369119111082565,-2743,1787,3417,2461,-0.054165819127058756,0.028076900858890582,0.02608891826816817,-34401,-6160,-0.5523780468223128,-0.08025473739522693
12404,47165,Sumner,Tennessee,2000,22118,27601,758,50477,0.4381797650415041,0.5468034946609347,0.015016740297561266,0,0,0,0,0.0,0.0,0.0,-5483,0,-0.10862372961943062,0.0
12405,47165,Sumner,Tennessee,2004,21458,40181,329,61968,0.3462754970307255,0.6484153111283243,0.005309191840950168,-660,-429,12580,11491,-0.09190426801077856,-0.0097075484566111,0.10161181646738959,-18723,-13240,-0.30213981409759877,-0.19351608447816815
12406,47165,Sumner,Tennessee,2008,21487,44949,926,67362,0.31897805884623376,0.6672753184287877,0.013746622724978475,29,597,4768,5394,-0.027297438184491762,0.008437430884028308,0.018860007300463444,-23462,-4739,-0.348297259582554,-0.046157445484955206
12407,47165,Sumner,Tennessee,2012,18579,46003,827,65409,0.2840434802550108,0.703312999740097,0.012643520004892293,-2908,-99,1054,-1953,-0.03493457859122295,-0.0011031027200861816,0.036037681311309244,-27424,-3962,-0.4192695194850862,-0.0709722599025322
12408,47165,Sumner,Tennessee,2016,18161,50129,3215,71505,0.2539822390042654,0.7010558702188658,0.04496189077686875,-418,2388,4126,6096,-0.030061241250745385,0.032318370771976454,-0.002257129521231138,-31968,-4544,-0.4470736312146004,-0.027804111729514247
12409,47167,Tipton,Tennessee,2000,6300,10070,182,16552,0.3806186563557274,0.6083856935717739,0.01099565007249879,0,0,0,0,0.0,0.0,0.0,-3770,0,-0.22776703721604646,0.0
12410,47167,Tipton,Tennessee,2004,7379,14178,120,21677,0.34040688287124604,0.654057295751257,0.005535821377496886,1079,-62,4108,5125,-0.04021177348448135,-0.005459828695001905,0.045671602179483184,-6799,-3029,-0.313650412880011,-0.08588337566396453
12411,47167,Tipton,Tennessee,2008,7931,17165,220,25316,0.3132801390425028,0.6780297045346816,0.00869015642281561,552,100,2987,3639,-0.02712674382874325,0.003154335045318724,0.023972408783424548,-9234,-2435,-0.3647495654921788,-0.0510991526121678
12412,47167,Tipton,Tennessee,2012,7133,16672,251,24056,0.2965164615896242,0.6930495510475557,0.010433987362820087,-798,31,-493,-1260,-0.0167636774528786,0.001743830940004477,0.015019846512874135,-9539,-305,-0.39653308945793153,-0.031783523965752736
12413,47167,Tipton,Tennessee,2016,5785,16910,786,23481,0.24636940505089222,0.7201567224564541,0.033473872492653635,-1348,535,238,-575,-0.05014705653873197,0.02303988512983355,0.0271071714088984,-11125,-1586,-0.4737873174055619,-0.07725422794763037
12414,47169,Trousdale,Tennessee,2000,1966,950,29,2945,0.667572156196944,0.3225806451612903,0.009847198641765705,0,0,0,0,0.0,0.0,0.0,1016,0,0.3449915110356537,0.0
12415,47169,Trousdale,Tennessee,2004,1851,1314,26,3191,0.5800689439047321,0.41178314008147915,0.00814791601378878,-115,-3,364,246,-0.08750321229221192,-0.0016992826279769238,0.08920249492018884,537,-479,0.16828580382325292,-0.17670570721240075
12416,47169,Trousdale,Tennessee,2008,1475,1688,76,3239,0.45538746526705776,0.5211485026242667,0.023464032108675516,-376,50,374,48,-0.12468147863767431,0.015316116094886735,0.10936536254278756,-213,-750,-0.06576103735720895,-0.23404684118046187
12417,47169,Trousdale,Tennessee,2012,1240,1612,51,2903,0.42714433344815705,0.5552876334826042,0.01756803306923872,-235,-25,-76,-336,-0.028243131818900702,-0.005895999039436797,0.03413913085833753,-372,-159,-0.12814330003444718,-0.06238226267723823
12418,47169,Trousdale,Tennessee,2016,946,2103,111,3160,0.2993670886075949,0.665506329113924,0.03512658227848101,-294,60,491,257,-0.12777724484056213,0.017558549209242293,0.11021869563131981,-1157,-785,-0.3661392405063291,-0.23799594047188194
12419,47171,Unicoi,Tennessee,2000,2566,3780,83,6429,0.3991289469590916,0.5879608026131591,0.012910250427749261,0,0,0,0,0.0,0.0,0.0,-1214,0,-0.18883185565406746,0.0
12420,47171,Unicoi,Tennessee,2004,2374,5030,59,7463,0.31810263968913305,0.6739916923489213,0.007905667961945598,-192,-24,1250,1034,-0.08102630726995858,-0.0050045824658036635,0.08603088973576223,-2656,-1442,-0.35588905265978826,-0.1670571970057208
12421,47171,Unicoi,Tennessee,2008,2107,5011,105,7223,0.29170704693340715,0.6937560570400111,0.014536896026581753,-267,46,-19,-240,-0.026395592755725894,0.006631228064636155,0.019764364691089775,-2904,-248,-0.40204901010660393,-0.04615995744681567
12422,47171,Unicoi,Tennessee,2012,1913,5032,131,7076,0.2703504804974562,0.711136235161108,0.01851328434143584,-194,26,21,-147,-0.021356566435950963,0.003976388314854086,0.017380178121096934,-3119,-215,-0.44078575466365183,-0.0387367445570479
12423,47171,Unicoi,Tennessee,2016,1262,5671,262,7195,0.1753995830437804,0.7881862404447533,0.0364141765114663,-651,131,639,119,-0.0949508974536758,0.01790089217003046,0.07705000528364525,-4409,-1290,-0.6127866574009728,-0.172000902737321
12424,47173,Union,Tennessee,2000,2564,3199,58,5821,0.44047414533585294,0.5495619309397011,0.009963923724445971,0,0,0,0,0.0,0.0,0.0,-635,0,-0.10908778560384813,0.0
12425,47173,Union,Tennessee,2004,2524,4145,41,6710,0.37615499254843515,0.6177347242921013,0.006110283159463488,-40,-17,946,889,-0.06431915278741779,-0.0038536405649824837,0.06817279335240023,-1621,-986,-0.24157973174366615,-0.13249194613981802
12426,47173,Union,Tennessee,2008,1829,4467,103,6399,0.28582591029848414,0.6980778246601032,0.016096265041412722,-695,62,322,-311,-0.09032908224995101,0.009985981881949234,0.08034310036800185,-2638,-1017,-0.412251914361619,-0.17067218261795286
12427,47173,Union,Tennessee,2012,1478,4282,66,5826,0.25369035358736697,0.7349811191211809,0.01132852729145211,-351,-37,-185,-573,-0.032135556711117175,-0.004767737749960612,0.03690329446107776,-2804,-166,-0.48129076553381395,-0.06903885117219494
12428,47173,Union,Tennessee,2016,1012,5053,182,6247,0.16199775892428367,0.8088682567632464,0.029133984312469986,-466,116,771,421,-0.0916925946630833,0.017805457021017875,0.07388713764206545,-4041,-1237,-0.6468704978389627,-0.16557973230514872
12429,47175,Van Buren,Tennessee,2000,1255,845,31,2131,0.5889253871421868,0.3965274519005162,0.014547160957297044,0,0,0,0,0.0,0.0,0.0,410,0,0.1923979352416706,0.0
12430,47175,Van Buren,Tennessee,2004,1209,1120,18,2347,0.5151256923732425,0.4772049424797614,0.007669365146996165,-46,-13,275,216,-0.07379969476894432,-0.006877795810300878,0.08067749057924523,89,-321,0.03792074989348104,-0.15447718534818955
12431,47175,Van Buren,Tennessee,2008,849,1294,63,2206,0.38485947416137806,0.586582048957389,0.028558476881233003,-360,45,174,-141,-0.1302662182118644,0.020889111734236836,0.10937710647762755,-445,-534,-0.2017225747960109,-0.23964332468949195
12432,47175,Van Buren,Tennessee,2012,875,1386,36,2297,0.3809316499782325,0.6033957335655202,0.01567261645624728,26,-27,92,91,-0.0039278241831455785,-0.012885860424985723,0.016813684608131263,-511,-66,-0.22246408358728775,-0.02074150879127684
12433,47175,Van Buren,Tennessee,2016,539,1820,60,2419,0.22281934683753618,0.7523770152955767,0.024803637866887142,-336,24,434,122,-0.1581123031406963,0.009131021410639862,0.14898128173005643,-1281,-770,-0.5295576684580405,-0.3070935848707528
12434,47177,Warren,Tennessee,2000,7378,5552,201,13131,0.5618764755159547,0.42281623638717536,0.015307288096870002,0,0,0,0,0.0,0.0,0.0,1826,0,0.1390602391287793,0.0
12435,47177,Warren,Tennessee,2004,6808,7503,89,14400,0.4727777777777778,0.5210416666666666,0.0061805555555555555,-570,-112,1951,1269,-0.08909869773817686,-0.009126732541314447,0.09822543027949127,-695,-2521,-0.04826388888888883,-0.18732412801766812
12436,47177,Warren,Tennessee,2008,5515,8562,323,14400,0.38298611111111114,0.5945833333333334,0.022430555555555554,-1293,234,1059,0,-0.08979166666666666,0.01625,0.07354166666666673,-3047,-2352,-0.21159722222222221,-0.16333333333333339
12437,47177,Warren,Tennessee,2012,4752,8010,230,12992,0.3657635467980296,0.6165332512315271,0.01770320197044335,-763,-93,-552,-1408,-0.017222564313081556,-0.004727353585112205,0.021949917898193783,-3258,-211,-0.25076970443349755,-0.03917248221127534
12438,47177,Warren,Tennessee,2016,3535,9540,537,13612,0.2596973258889215,0.700852189244784,0.03945048486629445,-1217,307,1530,620,-0.10606622090910806,0.021747282895851098,0.08431893801325685,-6005,-2747,-0.44115486335586246,-0.1903851589223649
12439,47179,Washington,Tennessee,2000,14769,22579,594,37942,0.38925201623530653,0.5950925096199462,0.015655474144747245,0,0,0,0,0.0,0.0,0.0,-7810,0,-0.20584049338463967,0.0
12440,47179,Washington,Tennessee,2004,14944,29735,327,45006,0.3320446162733858,0.6606896858196685,0.0072656979069457405,175,-267,7156,7064,-0.05720739996192076,-0.008389776237801504,0.06559717619972227,-14791,-6981,-0.3286450695462827,-0.12280457616164303
12441,47179,Washington,Tennessee,2008,15941,32341,700,48982,0.32544608223429017,0.6602629537381078,0.014290964027601976,997,373,2606,3976,-0.006598534039095605,0.0070252661206562355,-0.00042673208156063236,-16400,-1609,-0.33481687150381767,-0.0061718019575349725
12442,47179,Washington,Tennessee,2012,14325,32808,841,47974,0.29859924125568016,0.6838704298161504,0.017530328928169425,-1616,141,467,-1008,-0.02684684097861001,0.0032393649005674485,0.02360747607804259,-18483,-2083,-0.38527118856047027,-0.0504543170566526
12443,47179,Washington,Tennessee,2016,13024,34252,2474,49750,0.2617889447236181,0.6884824120603015,0.0497286432160804,-1301,1633,1444,1776,-0.03681029653206208,0.03219831428791098,0.004611982244151047,-21228,-2745,-0.4266934673366834,-0.04142227877621313
12444,47181,Wayne,Tennessee,2000,1859,3370,77,5306,0.35035808518658124,0.6351300414624953,0.014511873350923483,0,0,0,0,0.0,0.0,0.0,-1511,0,-0.28477195627591406,0.0
12445,47181,Wayne,Tennessee,2004,1951,3999,34,5984,0.3260360962566845,0.6682820855614974,0.005681818181818182,92,-43,629,678,-0.024321988929896732,-0.0088300551691053,0.033152044099002076,-2048,-537,-0.34224598930481287,-0.05747403302889881
12446,47181,Wayne,Tennessee,2008,1355,4076,96,5527,0.24516012303238646,0.7374705988782341,0.01736927808937941,-596,62,77,-457,-0.08087597322429804,0.011687459907561227,0.0691885133167367,-2721,-673,-0.49231047584584764,-0.15006448654103477
12447,47181,Wayne,Tennessee,2012,1163,4253,63,5479,0.21226501186347874,0.77623653951451,0.011498448622011315,-192,-33,177,-48,-0.032895111168907726,-0.005870829467368093,0.03876594063627592,-3090,-369,-0.5639715276510313,-0.07166105180518367
12448,47181,Wayne,Tennessee,2016,717,5036,104,5857,0.1224176199419498,0.8598258494109613,0.017756530647088955,-446,41,783,378,-0.08984739192152894,0.0062580820250776395,0.0835893098964513,-4319,-1229,-0.7374082294690115,-0.1734367018179802
12449,47183,Weakley,Tennessee,2000,5570,6106,168,11844,0.47028031070584264,0.5155352921310368,0.014184397163120567,0,0,0,0,0.0,0.0,0.0,-536,0,-0.04525498142519413,0.0
12450,47183,Weakley,Tennessee,2004,5588,7817,91,13496,0.41404860699466506,0.5792086544161233,0.006742738589211619,18,-77,1711,1652,-0.05623170371117758,-0.0074416585739089484,0.06367336228508658,-2229,-1693,-0.1651600474214583,-0.11990506599626416
12451,47183,Weakley,Tennessee,2008,4596,8855,239,13690,0.33571950328707084,0.6468224981738495,0.01745799853907962,-992,148,1038,194,-0.07832910370759422,0.010715259949868002,0.06761384375772617,-4259,-2030,-0.31110299488677867,-0.14594294746532038
12452,47183,Weakley,Tennessee,2012,3548,8605,158,12311,0.28819754690926813,0.6989684022418975,0.012834050848834376,-1048,-81,-250,-1379,-0.04752195637780271,-0.004623947690245244,0.05214590406804798,-5057,-798,-0.41077085533262936,-0.09966786044585069
12453,47183,Weakley,Tennessee,2016,2772,9008,404,12184,0.22751149047931712,0.7393302692055155,0.03315824031516743,-776,246,403,-127,-0.06068605642995101,0.020324189466333055,0.04036186696361799,-6236,-1179,-0.5118187787261983,-0.10104792339356894
12454,47185,White,Tennessee,2000,4135,3525,115,7775,0.5318327974276528,0.4533762057877814,0.014790996784565916,0,0,0,0,0.0,0.0,0.0,610,0,0.0784565916398714,0.0
12455,47185,White,Tennessee,2004,4147,5269,79,9495,0.43675618746708794,0.5549236440231701,0.00832016850974197,12,-36,1744,1720,-0.09507660996056483,-0.006470828274823946,0.1015474382353887,-1122,-1732,-0.11816745655608213,-0.19662404819595353
12456,47185,White,Tennessee,2008,3372,6103,172,9647,0.34953871669949205,0.6326319062921115,0.01782937700839639,-775,93,834,152,-0.0872174707675959,0.009509208498654421,0.07770826226894145,-2731,-1609,-0.2830931895926195,-0.16492573303653735
12457,47185,White,Tennessee,2012,2795,6197,137,9129,0.30616715960127067,0.678825720232227,0.015007120166502356,-577,-35,94,-518,-0.04337155709822138,-0.002822256841894036,0.04619381394011546,-3402,-671,-0.3726585606309563,-0.08956537103833684
12458,47185,White,Tennessee,2016,1845,7671,309,9825,0.18778625954198475,0.7807633587786259,0.031450381679389315,-950,172,1474,696,-0.11838090005928592,0.01644326151288696,0.10193763854639892,-5826,-2424,-0.5929770992366412,-0.2203185386056849
12459,47187,Williamson,Tennessee,2000,18745,38901,783,58429,0.32081671772578685,0.6657824025740643,0.013400879700148898,0,0,0,0,0.0,0.0,0.0,-20156,0,-0.34496568484827744,0.0
12460,47187,Williamson,Tennessee,2004,21732,57451,467,79650,0.2728436911487759,0.721293157564344,0.0058631512868801,2987,-316,18550,21221,-0.04797302657701097,-0.007537728413268798,0.05551075499027969,-35719,-15563,-0.4484494664155681,-0.10348378156729066
12461,47187,Williamson,Tennessee,2008,27886,64858,1092,93836,0.29717805533057673,0.691184619975276,0.011637324694147235,6154,625,7407,14186,0.02433436418180085,0.0057741734072671354,-0.030108537589067952,-36972,-1253,-0.3940065646446993,0.0544429017708688
12462,47187,Williamson,Tennessee,2012,25142,69850,1167,96159,0.2614627855946921,0.7264010649029212,0.012136149502386673,-2744,75,4992,2323,-0.035715269735884625,0.0004988248082394373,0.035216444927645196,-44708,-7736,-0.4649382793082291,-0.07093171466352982
12463,47187,Williamson,Tennessee,2016,31013,68212,7046,106271,0.2918293796049722,0.6418684307101655,0.06630218968486229,5871,5879,-1638,10112,0.03036659401028008,0.05416604018247562,-0.0845326341927557,-37199,7509,-0.35003905110519334,0.11489922820303577
12464,47189,Wilson,Tennessee,2000,16561,18844,511,35916,0.4611036863793295,0.5246686713442477,0.014227642276422764,0,0,0,0,0.0,0.0,0.0,-2283,0,-0.06356498496491814,0.0
12465,47189,Wilson,Tennessee,2004,15277,28924,251,44452,0.34367407540718076,0.6506793845046343,0.005646540088185008,-1284,-260,10080,8536,-0.11742961097214877,-0.008581102188237755,0.1260107131603866,-13647,-11364,-0.3070053090974535,-0.24344032413253536
12466,47189,Wilson,Tennessee,2008,15886,34595,678,51159,0.3105220977736078,0.6762251021325671,0.013252800093825134,609,427,5671,6707,-0.03315197763357297,0.007606260005640126,0.025545717627932896,-18709,-5062,-0.36570300435895936,-0.05869769526150587
12467,47189,Wilson,Tennessee,2012,14695,36109,750,51554,0.28504092795903324,0.7004112193040307,0.014547852736936028,-1191,72,1514,395,-0.025481169814574545,0.001295052643110894,0.024186117171463573,-21414,-2705,-0.4153702913449975,-0.04966728698603812
12468,47189,Wilson,Tennessee,2016,14385,39406,2943,56734,0.25355166214263053,0.6945746818486269,0.05187365600874255,-310,2193,3297,5180,-0.03148926581640271,0.037325803271806526,-0.005836537455403801,-25021,-3607,-0.4410230197059964,-0.02565272836099891
12469,48001,Anderson,Texas,2000,5041,9835,204,15080,0.3342838196286472,0.6521883289124668,0.013527851458885942,0,0,0,0,0.0,0.0,0.0,-4794,0,-0.3179045092838196,0.0
12470,48001,Anderson,Texas,2004,4678,11525,98,16301,0.286976259125207,0.7070118397644316,0.006011901110361328,-363,-106,1690,1221,-0.047307560503440205,-0.007515950348524614,0.054823510851964796,-6847,-2053,-0.4200355806392246,-0.102131071355405
12471,48001,Anderson,Texas,2008,4630,11884,141,16655,0.2779945962173521,0.713539477634344,0.008465926148303812,-48,43,359,354,-0.008981662907854904,0.0024540250379424845,0.006527637869912395,-7254,-407,-0.4355448814169919,-0.015509300777767299
12472,48001,Anderson,Texas,2012,3813,12262,137,16212,0.2351961509992598,0.7563533185294843,0.00845053047125586,-817,-4,378,-443,-0.04279844521809231,-1.539567704795207e-05,0.04281384089514029,-8449,-1195,-0.5211571675302245,-0.08561228611323257
12473,48001,Anderson,Texas,2016,3369,13201,407,16977,0.19844495493903516,0.7775814337044237,0.0239736113565412,-444,270,939,765,-0.036751196060224645,0.015523080885285341,0.021228115174939388,-9832,-1383,-0.5791364787653885,-0.05797931123516409
12474,48003,Andrews,Texas,2000,876,3091,57,4024,0.21769383697813122,0.768141153081511,0.014165009940357853,0,0,0,0,0.0,0.0,0.0,-2215,0,-0.5504473161033798,0.0
12475,48003,Andrews,Texas,2004,677,3837,22,4536,0.1492504409171076,0.8458994708994709,0.0048500881834215165,-199,-35,746,512,-0.06844339606102362,-0.009314921756936337,0.07775831781795994,-3160,-945,-0.6966490299823633,-0.1462017138789835
12476,48003,Andrews,Texas,2008,790,3816,23,4629,0.17066321019658673,0.8243681140635126,0.0049686757399006265,113,1,-21,93,0.021412769279479132,0.00011858755647911005,-0.021531356835958304,-3026,134,-0.6537049038669259,0.04294412611543741
12477,48003,Andrews,Texas,2012,795,3639,48,4482,0.17737617135207498,0.8119143239625167,0.0107095046854083,5,25,-177,-147,0.006712961155488251,0.005740828945507673,-0.012453790100995898,-2844,182,-0.6345381526104418,0.01916675125648415
12478,48003,Andrews,Texas,2016,836,3927,180,4943,0.16912805988266236,0.7944568076067166,0.03641513251062108,41,132,288,461,-0.008248111469412622,0.025705627825212782,-0.017457516355800173,-3091,-247,-0.6253287477240542,0.009209404886387551
12479,48005,Angelina,Texas,2000,9957,16648,369,26974,0.36913323941573367,0.6171869207384889,0.013679839845777416,0,0,0,0,0.0,0.0,0.0,-6691,0,-0.24805368132275524,0.0
12480,48005,Angelina,Texas,2004,9302,18932,130,28364,0.32795092370610635,0.6674658017204907,0.004583274573402905,-655,-239,2284,1390,-0.041182315709627326,-0.009096565272374511,0.05027888098200184,-9630,-2939,-0.3395148780143844,-0.09146119669162917
12481,48005,Angelina,Texas,2008,9379,19569,205,29153,0.3217164614276404,0.6712516722121222,0.007031866360237368,77,75,637,789,-0.006234462278465969,0.002448591786834463,0.0037858704916314823,-10190,-560,-0.34953521078448185,-0.010020332770097451
12482,48005,Angelina,Texas,2012,7834,20303,269,28406,0.2757868056044498,0.7147433640780116,0.009469830317538548,-1545,64,734,-747,-0.045929655823190585,0.0024379639573011798,0.043491691865889415,-12469,-2279,-0.43895655847356185,-0.08942134768908
12483,48005,Angelina,Texas,2016,7538,21668,705,29911,0.25201430911704725,0.7244157667747652,0.023569924108187625,-296,436,1365,1505,-0.02377249648740254,0.014100093790649077,0.009672402696753513,-14130,-1661,-0.4724014576577179,-0.03344489918415605
12484,48007,Aransas,Texas,2000,2637,5390,220,8247,0.3197526373226628,0.65357099551352,0.026676367163817147,0,0,0,0,0.0,0.0,0.0,-2753,0,-0.33381835819085726,0.0
12485,48007,Aransas,Texas,2004,2640,6569,59,9268,0.2848511005610703,0.7087829089339663,0.006365990504963314,3,-161,1179,1021,-0.03490153676159247,-0.02031037665885383,0.05521191342044629,-3929,-1176,-0.423931808372896,-0.09011345018203876
12486,48007,Aransas,Texas,2008,3006,6693,79,9778,0.30742483125383513,0.6844958069134792,0.00807936183268562,366,20,124,510,0.022573730692764804,0.0017133713277223059,-0.024287102020487117,-3687,242,-0.3770709756596441,0.04686083271325192
12487,48007,Aransas,Texas,2012,2704,6830,114,9648,0.2802653399668325,0.7079187396351575,0.01181592039800995,-302,35,137,-130,-0.027159491287002624,0.00373655856532433,0.02342293272167828,-4126,-439,-0.427653399668325,-0.050582424008680904
12488,48007,Aransas,Texas,2016,2465,7740,307,10512,0.2344939117199391,0.7363013698630136,0.029204718417047183,-239,193,910,864,-0.0457714282468934,0.017388798019037234,0.028382630227856143,-5275,-1149,-0.5018074581430745,-0.07415405847474948
12489,48009,Archer,Texas,2000,993,2951,53,3997,0.24843632724543407,0.7383037277958469,0.013259944958719039,0,0,0,0,0.0,0.0,0.0,-1958,0,-0.4898674005504128,0.0
12490,48009,Archer,Texas,2004,878,3556,17,4451,0.19725904291170523,0.7989215906537857,0.003819366434509099,-115,-36,605,454,-0.05117728433372884,-0.009440578524209941,0.0606178628579388,-2678,-720,-0.6016625477420804,-0.11179514719166761
12491,48009,Archer,Texas,2008,740,3595,30,4365,0.16953035509736541,0.8235967926689576,0.006872852233676976,-138,13,39,-86,-0.02772868781433982,0.0030534857991678767,0.024675202015171926,-2855,-177,-0.6540664375715921,-0.05240388982951172
12492,48009,Archer,Texas,2012,525,3600,39,4164,0.1260806916426513,0.8645533141210374,0.009365994236311239,-215,9,5,-201,-0.04344966345471413,0.002493142002634263,0.04095652145207984,-3075,-220,-0.7384726224783862,-0.08440618490679408
12493,48009,Archer,Texas,2016,394,3786,103,4283,0.09199159467662853,0.8839598412327807,0.024048564090590707,-131,64,186,119,-0.03408909696602276,0.014682569854279468,0.019406527111743288,-3392,-317,-0.7919682465561522,-0.05349562407776598
12494,48011,Armstrong,Texas,2000,150,772,16,938,0.15991471215351813,0.8230277185501066,0.017057569296375266,0,0,0,0,0.0,0.0,0.0,-622,0,-0.6631130063965884,0.0
12495,48011,Armstrong,Texas,2004,170,830,4,1004,0.1693227091633466,0.8266932270916335,0.00398406374501992,20,-12,58,66,0.009407997009828473,-0.013073505551355346,0.0036655085415269184,-660,-38,-0.6573705179282869,0.005742488468301499
12496,48011,Armstrong,Texas,2008,128,856,6,990,0.1292929292929293,0.8646464646464647,0.006060606060606061,-42,2,26,-14,-0.04002977987041731,0.0020765423155861404,0.037953237554831154,-728,-68,-0.7353535353535354,-0.07798301742524849
12497,48011,Armstrong,Texas,2012,98,828,9,935,0.10481283422459893,0.8855614973262033,0.009625668449197862,-30,3,-28,-55,-0.024480095068330363,0.003565062388591801,0.0209150326797386,-730,-2,-0.7807486631016043,-0.045395127748068864
12498,48011,Armstrong,Texas,2016,70,924,27,1021,0.06856023506366307,0.9049951028403526,0.02644466209598433,-28,18,96,86,-0.03625259916093586,0.01681899364678647,0.0194336055141493,-854,-124,-0.8364348677766895,-0.05568620467508523
12499,48013,Atascosa,Texas,2000,4322,6231,193,10746,0.4021961660152615,0.5798436627582356,0.017960171226502886,0,0,0,0,0.0,0.0,0.0,-1909,0,-0.17764749674297414,0.0
12500,48013,Atascosa,Texas,2004,4421,7635,60,12116,0.3648894024430505,0.6301584681413007,0.0049521294156487285,99,-133,1404,1370,-0.037306763572210966,-0.013008041810854158,0.0503148053830651,-3214,-1305,-0.2652690656982502,-0.08762156895527606
12501,48013,Atascosa,Texas,2008,4415,5462,61,9938,0.4442543771382572,0.5496075669148722,0.0061380559468705975,-6,1,-2173,-2178,0.0793649746952067,0.001185926531221869,-0.0805509012264285,-1047,2167,-0.10535318977661501,0.1599158759216352
12502,48013,Atascosa,Texas,2012,5133,7461,127,12721,0.40350601367816996,0.5865104944579829,0.009983491863847182,718,66,1999,2783,-0.040748363460087256,0.0038454359169765844,0.03690292754311064,-2328,-1281,-0.1830044807798129,-0.0776512910031979
12503,48013,Atascosa,Texas,2016,4651,8618,404,13673,0.3401594383090763,0.6302932787244935,0.02954728296643019,-482,277,1157,952,-0.06334657536909366,0.01956379110258301,0.04378278426651061,-3967,-1639,-0.2901338404154172,-0.10712935963560427
12504,48015,Austin,Texas,2000,2407,6661,159,9227,0.26086485314836894,0.7219031104367617,0.017232036414869405,0,0,0,0,0.0,0.0,0.0,-4254,0,-0.46103825728839276,0.0
12505,48015,Austin,Texas,2004,2582,8072,48,10702,0.24126331526817418,0.7542515417678939,0.004485142963931975,175,-111,1411,1475,-0.019601537880194753,-0.01274689345093743,0.03234843133113219,-5490,-1236,-0.5129882264997196,-0.051949969211326885
12506,48015,Austin,Texas,2008,2821,8786,114,11721,0.24067912294172852,0.7495947444757274,0.009726132582544152,239,66,714,1019,-0.0005841923264456594,0.005240989618612177,-0.0046567972921665035,-5965,-475,-0.5089156215339988,0.004072604965720816
12507,48015,Austin,Texas,2012,2252,9265,132,11649,0.1933213151343463,0.7953472401064469,0.0113314447592068,-569,18,479,-72,-0.04735780780738222,0.0016053121766626474,0.04575249563071948,-7013,-1048,-0.6020259249721005,-0.09311030343810167
12508,48015,Austin,Texas,2016,2320,9637,317,12274,0.1890174352289392,0.7851556134919342,0.025826951279126608,68,185,372,625,-0.004303879905407093,0.014495506519919809,-0.010191626614512672,-7317,-304,-0.596138178262995,0.0058877467091055236
12509,48017,Bailey,Texas,2000,488,1589,13,2090,0.23349282296650717,0.7602870813397129,0.006220095693779904,0,0,0,0,0.0,0.0,0.0,-1101,0,-0.5267942583732057,0.0
12510,48017,Bailey,Texas,2004,525,1882,5,2412,0.21766169154228857,0.7802653399668324,0.0020729684908789387,37,-8,293,322,-0.015831131424218603,-0.004147127202900966,0.01997825862711955,-1357,-256,-0.5626036484245439,-0.03580939005133821
12511,48017,Bailey,Texas,2008,682,1618,16,2316,0.29447322970639034,0.6986183074265976,0.0069084628670120895,157,11,-264,-96,0.07681153816410177,0.004835494376133151,-0.08164703254023487,-936,421,-0.40414507772020725,0.15845857070433667
12512,48017,Bailey,Texas,2012,466,1339,11,1816,0.2566079295154185,0.7373348017621145,0.006057268722466961,-216,-5,-279,-500,-0.03786530019097184,-0.0008511941445451289,0.03871649433551694,-873,63,-0.480726872246696,-0.07658179452648878
12513,48017,Bailey,Texas,2016,397,1344,52,1793,0.22141662018962632,0.7495817066369214,0.029001673173452314,-69,41,5,-23,-0.035191309325792175,0.022944404450985355,0.012246904874806841,-947,-74,-0.5281650864472951,-0.04743821420059907
12514,48019,Bandera,Texas,2000,1426,5613,234,7273,0.19606764746322014,0.7717585590540355,0.0321737934827444,0,0,0,0,0.0,0.0,0.0,-4187,0,-0.5756909115908153,0.0
12515,48019,Bandera,Texas,2004,1738,6933,70,8741,0.1988330854593296,0.7931586774968539,0.008008237043816497,312,-164,1320,1468,0.0027654379961094544,-0.024165556438927902,0.021400118442818417,-5195,-1008,-0.5943255920375243,-0.018634680446709018
12516,48019,Bandera,Texas,2008,2250,6935,112,9297,0.2420135527589545,0.7459395503925997,0.012046896848445735,512,42,2,556,0.04318046729962491,0.004038659804629238,-0.04721912710425413,-4685,510,-0.5039259976336452,0.09039959440387912
12517,48019,Bandera,Texas,2012,1864,7426,158,9448,0.19729043183742592,0.7859864521591872,0.01672311600338696,-386,46,491,151,-0.04472312092152858,0.004676219154941225,0.04004690176658743,-5562,-877,-0.5886960203217613,-0.08477002268811606
12518,48019,Bandera,Texas,2016,1726,8163,329,10218,0.16891759639851242,0.7988843217850852,0.03219808181640243,-138,171,737,770,-0.028372835438913502,0.015474965813015468,0.012897869625898006,-6437,-875,-0.6299667253865727,-0.04127070506481145
12519,48021,Bastrop,Texas,2000,6973,10310,1025,18308,0.38087175005462093,0.5631417959362027,0.05598645400917632,0,0,0,0,0.0,0.0,0.0,-3337,0,-0.1822700458815818,0.0
12520,48021,Bastrop,Texas,2004,9794,13290,357,23441,0.41781493963568106,0.5669553346700226,0.015229725694296318,2821,-668,2980,5133,0.03694318958106013,-0.04075672831488,0.0038135387338198434,-3496,-159,-0.1491403950343415,0.03312965084724029
12521,48021,Bastrop,Texas,2008,11687,13817,558,26062,0.4484306653365053,0.5301588519683831,0.021410482695111657,1893,201,527,2621,0.030615725700824215,0.006180757000815339,-0.03679648270163949,-2130,1366,-0.08172818663187781,0.0674122084024637
12522,48021,Bastrop,Texas,2012,9864,14033,584,24481,0.40292471712756833,0.5732200482006454,0.023855234671786282,-1823,26,216,-1581,-0.04550594820893694,0.002444751976674625,0.043061196232262344,-4169,-2039,-0.1702953310730771,-0.08856714444119929
12523,48021,Bastrop,Texas,2016,10569,16328,1557,28454,0.371441625079075,0.5738384761369227,0.05471989878400225,705,973,2295,3973,-0.03148309204849331,0.030864664112215966,0.0006184279362773104,-5759,-1590,-0.20239685105784772,-0.03210151998477062
12524,48023,Baylor,Texas,2000,663,1285,36,1984,0.3341733870967742,0.6476814516129032,0.018145161290322582,0,0,0,0,0.0,0.0,0.0,-622,0,-0.31350806451612906,0.0
12525,48023,Baylor,Texas,2004,467,1169,4,1640,0.2847560975609756,0.7128048780487805,0.0024390243902439024,-196,-32,-116,-344,-0.0494172895357986,-0.01570613690007868,0.06512342643587721,-702,-80,-0.42804878048780487,-0.11454071597167581
12526,48023,Baylor,Texas,2008,366,1262,15,1643,0.22276323797930614,0.7681071211199026,0.009129640900791236,-101,11,93,3,-0.061992859581669446,0.0066906165105473335,0.05530224307112219,-896,-194,-0.5453438831405966,-0.1172951026527917
12527,48023,Baylor,Texas,2012,267,1297,28,1592,0.16771356783919597,0.8146984924623115,0.017587939698492462,-99,13,35,-51,-0.05504967014011017,0.008458298797701226,0.04659137134240887,-1030,-134,-0.6469849246231155,-0.10164104148251896
12528,48023,Baylor,Texas,2016,191,1267,41,1499,0.12741827885256837,0.8452301534356238,0.027351567711807873,-76,13,-30,-93,-0.0402952889866276,0.009763628013315411,0.03053166097331228,-1076,-46,-0.7178118745830554,-0.07082694995993988
12529,48025,Bee,Texas,2000,3795,4429,106,8330,0.45558223289315725,0.5316926770708283,0.012725090036014406,0,0,0,0,0.0,0.0,0.0,-634,0,-0.0761104441776711,0.0
12530,48025,Bee,Texas,2004,4045,5428,45,9518,0.42498424038663585,0.5702878756041185,0.00472788400924564,250,-61,999,1188,-0.0305979925065214,-0.007997206026768768,0.03859519853329019,-1383,-749,-0.14530363521748269,-0.06919319103981159
12531,48025,Bee,Texas,2008,3645,4471,41,8157,0.4468554615667525,0.5481181807036901,0.005026357729557436,-400,-4,-957,-1361,0.02187122118011664,0.00029847372031179594,-0.022169694900428416,-826,557,-0.10126271913693763,0.044040916080545056
12532,48025,Bee,Texas,2012,3452,4356,71,7879,0.4381266658205356,0.5528620383297372,0.009011295849727123,-193,30,-115,-278,-0.008728795746216877,0.003984938120169687,0.004743857626047121,-904,-78,-0.11473537250920163,-0.013472653372263999
12533,48025,Bee,Texas,2016,3444,4744,297,8485,0.40589275191514435,0.559104301708898,0.03500294637595757,-8,226,388,606,-0.032233913905391265,0.025991650526230446,0.006242263379160784,-1300,-396,-0.15321154979375368,-0.03847617728455205
12534,48027,Bell,Texas,2000,21011,41208,1072,63291,0.33197453034396673,0.6510878323932313,0.016937637262801977,0,0,0,0,0.0,0.0,0.0,-20197,0,-0.3191133020492646,0.0
12535,48027,Bell,Texas,2004,27165,52135,424,79724,0.3407380462595956,0.6539436054387637,0.00531834830164066,6154,-648,10927,16433,0.00876351591562885,-0.011619288961161316,0.002855773045532417,-24970,-4773,-0.31320555917916815,0.005907742870096433
12536,48027,Bell,Texas,2008,40413,49242,935,90590,0.44610884203554474,0.5435699304559002,0.010321227508555028,13248,511,-2893,10866,0.10537079577594916,0.0050028792069143685,-0.11037367498286355,-8829,16141,-0.09746108842035545,0.2157444707588127
12537,48027,Bell,Texas,2012,35512,49574,1339,86425,0.41089962395140295,0.5736071738501591,0.015493202198437951,-4901,404,332,-4165,-0.03520921808414179,0.005171974689882923,0.03003724339425895,-14062,-5233,-0.1627075498987562,-0.06524646147840074
12538,48027,Bell,Texas,2016,37801,51998,5195,94994,0.3979303956039329,0.5473819399119945,0.05468766448407268,2289,3856,2424,8569,-0.012969228347470052,0.03919446228563473,-0.02622523393816467,-14197,-135,-0.14945154430806157,0.01325600559069462
12539,48029,Bexar,Texas,2000,185158,215613,11955,412726,0.44862208826194616,0.5224119633849091,0.028965948353144703,0,0,0,0,0.0,0.0,0.0,-30455,0,-0.07378987512296298,0.0
12540,48029,Bexar,Texas,2004,210976,260698,3640,475314,0.44386658082867325,0.5484753236807668,0.0076580954905599245,25818,-8315,45085,62588,-0.00475550743327291,-0.021307852862584777,0.02606336029585765,-49722,-19267,-0.10460874285209354,-0.03081886772913056
12541,48029,Bexar,Texas,2008,275527,246275,5690,527492,0.5223339880036095,0.46687911854587366,0.010786893450516786,64551,2050,-14423,52178,0.07846740717493628,0.0031287979599568614,-0.08159620513489313,29252,78974,0.05545486945773587,0.1600636123098294
12542,48029,Bexar,Texas,2012,264856,241617,8237,514710,0.5145732548425327,0.46942355889724313,0.016003186260224202,-10671,2547,-4658,-12782,-0.007760733161076838,0.0052162928097074165,0.0025444403513694702,23239,-6013,0.04514969594528956,-0.010305173512446308
12543,48029,Bexar,Texas,2016,319550,240333,29762,589645,0.5419362497774084,0.4075893122132809,0.05047443800931069,54694,21525,-1284,74935,0.027362994934875706,0.03447125174908648,-0.06183424668396226,79217,55978,0.13434693756412752,0.08919724161883796
12544,48031,Blanco,Texas,2000,811,2777,179,3767,0.21529068224050968,0.7371913989912398,0.047517918768250594,0,0,0,0,0.0,0.0,0.0,-1966,0,-0.5219007167507301,0.0
12545,48031,Blanco,Texas,2004,1267,3277,40,4584,0.2763961605584642,0.7148778359511344,0.008726003490401396,456,-139,500,817,0.06110547831795454,-0.0387919152778492,-0.022313563040105344,-2010,-44,-0.4384816753926702,0.08341904135805994
12546,48031,Blanco,Texas,2008,1467,3418,54,4939,0.2970236890058716,0.6920429236687589,0.010933387325369508,200,14,141,355,0.020627528447407395,0.0022073838349681123,-0.022834912282375552,-1951,59,-0.39501923466288724,0.04346244072978295
12547,48031,Blanco,Texas,2012,1220,3638,115,4973,0.24532475366981701,0.7315503720088478,0.02312487432133521,-247,61,220,34,-0.0516989353360546,0.0121914869959657,0.0395074483400889,-2418,-467,-0.4862256183390308,-0.09120638367614353
12548,48031,Blanco,Texas,2016,1244,4212,229,5685,0.21882145998240984,0.7408970976253298,0.040281442392260336,24,114,574,712,-0.02650329368740717,0.017156568070925127,0.009346725616482088,-2968,-550,-0.52207563764292,-0.0358500193038892
12549,48033,Borden,Texas,2000,62,283,8,353,0.17563739376770537,0.8016997167138811,0.0226628895184136,0,0,0,0,0.0,0.0,0.0,-221,0,-0.6260623229461757,0.0
12550,48033,Borden,Texas,2004,55,303,1,359,0.1532033426183844,0.8440111420612814,0.002785515320334262,-7,-7,20,6,-0.022434051149320983,-0.019877374198079337,0.04231142534740029,-248,-27,-0.6908077994428969,-0.06474547649672124
12551,48033,Borden,Texas,2008,40,316,5,361,0.11080332409972299,0.8753462603878116,0.013850415512465374,-15,4,13,2,-0.0424000185186614,0.011064900192131112,0.03133511832653024,-276,-28,-0.7645429362880887,-0.07373513684519173
12552,48033,Borden,Texas,2012,32,324,7,363,0.0881542699724518,0.8925619834710744,0.01928374655647383,-8,2,8,2,-0.022649054127271195,0.005433331044008456,0.0172157230832628,-292,-16,-0.8044077134986226,-0.03986477721053394
12553,48033,Borden,Texas,2016,31,330,4,365,0.08493150684931507,0.9041095890410958,0.010958904109589041,-1,-3,6,2,-0.0032227631231367265,-0.008324842446884789,0.011547605570021435,-299,-7,-0.8191780821917808,-0.014770368693158176
12554,48035,Bosque,Texas,2000,1930,4745,95,6770,0.28508124076809455,0.7008862629246676,0.014032496307237814,0,0,0,0,0.0,0.0,0.0,-2815,0,-0.41580502215657306,0.0
12555,48035,Bosque,Texas,2004,1815,5737,34,7586,0.2392565251779594,0.7562615344054838,0.004481940416556815,-115,-61,992,816,-0.04582471559013515,-0.009550555890680998,0.055375271480816224,-3922,-1107,-0.5170050092275245,-0.1011999870709514
12556,48035,Bosque,Texas,2008,1797,5762,87,7646,0.23502484959455924,0.7535966518441015,0.011378498561339262,-18,53,25,60,-0.004231675583400152,0.006896558144782447,-0.002664882561382309,-3965,-43,-0.5185718022495422,-0.0015667930220177873
12557,48035,Bosque,Texas,2012,1367,5885,104,7356,0.1858346927678086,0.8000271886895052,0.014138118542686243,-430,17,123,-290,-0.04919015682675065,0.0027596199813469807,0.04643053684540366,-4518,-553,-0.6141924959216966,-0.09562069367215431
12558,48035,Bosque,Texas,2016,1278,6339,221,7838,0.16305179892829805,0.8087522327124267,0.028195968359275327,-89,117,454,482,-0.022782893839510543,0.014057849816589084,0.008725044022921513,-5061,-543,-0.6457004337841287,-0.03150793786243211
12559,48037,Bowie,Texas,2000,11662,18325,333,30320,0.3846306068601583,0.60438654353562,0.010982849604221636,0,0,0,0,0.0,0.0,0.0,-6663,0,-0.21975593667546173,0.0
12560,48037,Bowie,Texas,2004,11880,21791,89,33760,0.3518957345971564,0.645468009478673,0.002636255924170616,218,-244,3466,3440,-0.032734872263001924,-0.00834659368005102,0.04108146594305295,-9911,-3248,-0.2935722748815166,-0.07381633820605488
12561,48037,Bowie,Texas,2008,10815,24162,209,35186,0.3073665662479395,0.6866935713067698,0.005939862445290741,-1065,120,2371,1426,-0.044529168349216885,0.0033036065211201246,0.04122556182809678,-13347,-3436,-0.37932700505883027,-0.08575473017731366
12562,48037,Bowie,Texas,2012,10196,24869,339,35404,0.28799005762060786,0.702434753135239,0.009575189244153202,-619,130,707,218,-0.019376508627331646,0.0036353267988624618,0.015741181828469175,-14673,-1326,-0.4144446955146311,-0.03511769045580082
12563,48037,Bowie,Texas,2016,8838,24924,840,34602,0.2554187619212762,0.7203051846714063,0.024276053407317495,-1358,501,55,-802,-0.03257129569933165,0.014700864163164292,0.017870431536167297,-16086,-1413,-0.46488642275013004,-0.050441727235498945
12564,48039,Brazoria,Texas,2000,24883,53445,1691,80019,0.31096364613404315,0.6679038728302028,0.02113248103575401,0,0,0,0,0.0,0.0,0.0,-28562,0,-0.35694022669615966,0.0
12565,48039,Brazoria,Texas,2004,28904,63662,682,93248,0.3099691146190803,0.6827170555936857,0.007313829787234043,4021,-1009,10217,13229,-0.0009945315149628708,-0.013818651248519966,0.014813182763482868,-34758,-6196,-0.3727479409746054,-0.01580771427844574
12566,48039,Brazoria,Texas,2008,36480,67515,945,104940,0.34762721555174386,0.6433676386506575,0.009005145797598629,7576,263,3853,11692,0.037658100932663585,0.001691316010364586,-0.03934941694302818,-31035,3723,-0.29574042309891363,0.07700751787569177
12567,48039,Brazoria,Texas,2012,34421,70862,1456,106739,0.3224781944743721,0.6638810556591311,0.013640749866496781,-2059,511,3347,1799,-0.02514902107737177,0.004635604068898153,0.020513417008473644,-36441,-5406,-0.34140286118475904,-0.045662438085845414
12568,48039,Brazoria,Texas,2016,43200,72791,5190,121181,0.3564915292001221,0.6006799745834743,0.04282849621640356,8779,3734,1929,14442,0.03401333472575002,0.02918774634990678,-0.0632010810756568,-29591,6850,-0.24418844538335222,0.09721441580140683
12569,48041,Brazos,Texas,2000,12359,32864,1718,46941,0.26328795722289683,0.7001129076926355,0.036599135084467736,0,0,0,0,0.0,0.0,0.0,-20505,0,-0.4368249504697386,0.0
12570,48041,Brazos,Texas,2004,16128,37594,587,54309,0.2969673534773242,0.6922241249148392,0.010808521607836638,3769,-1131,4730,7368,0.033679396254427396,-0.0257906134766311,-0.007888782777796255,-21466,-961,-0.395256771437515,0.04156817903222365
12571,48041,Brazos,Texas,2008,20502,37465,706,58673,0.34942818672984166,0.6385390213556491,0.01203279191450923,4374,119,-129,4364,0.052460833252517436,0.0012242703066725914,-0.053685103559190095,-16963,4503,-0.28911083462580744,0.10614593681170753
12572,48041,Brazos,Texas,2012,17477,37209,1276,55962,0.3123012043886923,0.6648976090918838,0.022801186519423894,-3025,570,-256,-2711,-0.03712698234114936,0.010768394604914664,0.026358587736234673,-19732,-2769,-0.3525964047031915,-0.06348557007738403
12573,48041,Brazos,Texas,2016,23121,38738,5352,67211,0.34400618946303435,0.5763639880376724,0.07962982249929328,5644,4076,1529,11249,0.03170498507434205,0.05682863597986938,-0.08853362105421136,-15617,4115,-0.23235779857463806,0.12023860612855342
12574,48043,Brewster,Texas,2000,1349,1867,364,3580,0.37681564245810056,0.5215083798882681,0.10167597765363129,0,0,0,0,0.0,0.0,0.0,-518,0,-0.14469273743016758,0.0
12575,48043,Brewster,Texas,2004,1729,1980,51,3760,0.4598404255319149,0.526595744680851,0.013563829787234043,380,-313,113,180,0.08302478307381433,-0.08811214786639725,0.005087364792582871,-251,267,-0.06675531914893612,0.07793741828123146
12576,48043,Brewster,Texas,2008,1970,1855,75,3900,0.5051282051282051,0.4756410256410256,0.019230769230769232,241,24,-125,140,0.04528777959629021,0.005666939443535189,-0.0509547190398254,115,366,0.029487179487179493,0.09624249863611561
12577,48043,Brewster,Texas,2012,1765,1976,126,3867,0.456426170157745,0.5109904318593225,0.032583397982932506,-205,51,121,-33,-0.048702034970460106,0.013352628752163274,0.03534940621829685,-211,-326,-0.054564261701577466,-0.08405144118875696
12578,48043,Brewster,Texas,2016,1873,2077,302,4252,0.44049858889934146,0.48847601128880525,0.07102539981185324,108,176,101,385,-0.015927581258403545,0.038442001828920734,-0.022514420570517224,-204,7,-0.047977422389463786,0.006586839312113679
12579,48045,Briscoe,Texas,2000,224,544,4,772,0.29015544041450775,0.7046632124352331,0.0051813471502590676,0,0,0,0,0.0,0.0,0.0,-320,0,-0.41450777202072536,0.0
12580,48045,Briscoe,Texas,2004,191,620,0,811,0.23551171393341552,0.7644882860665845,0.0,-33,-4,76,39,-0.054643726481092225,-0.0051813471502590676,0.059825073631351366,-429,-109,-0.528976572133169,-0.11446880011244359
12581,48045,Briscoe,Texas,2008,205,617,8,830,0.2469879518072289,0.7433734939759036,0.00963855421686747,14,8,-3,19,0.011476237873813383,0.00963855421686747,-0.0211147920906809,-412,17,-0.4963855421686747,0.032591029964494256
12582,48045,Briscoe,Texas,2012,117,578,7,702,0.16666666666666666,0.8233618233618234,0.009971509971509971,-88,-1,-39,-128,-0.08032128514056225,0.00033295575464250063,0.07998832938591982,-461,-49,-0.6566951566951568,-0.16030961452648207
12583,48045,Briscoe,Texas,2016,91,625,20,736,0.12364130434782608,0.8491847826086957,0.02717391304347826,-26,13,47,34,-0.043025362318840576,0.01720240307196829,0.02582295924687228,-534,-73,-0.7255434782608696,-0.06884832156571286
12584,48047,Brooks,Texas,2000,1854,556,21,2431,0.762649115590292,0.22871246400658166,0.008638420403126285,0,0,0,0,0.0,0.0,0.0,1298,0,0.5339366515837104,0.0
12585,48047,Brooks,Texas,2004,1823,845,6,2674,0.681750186985789,0.31600598354525056,0.002243829468960359,-31,-15,289,243,-0.08089892860450298,-0.0063945909341659255,0.0872935195386689,978,-320,0.3657442034405385,-0.1681924481431719
12586,48047,Brooks,Texas,2008,1747,556,6,2309,0.7566045907319185,0.2407968817669987,0.00259852750108272,-76,0,-289,-365,0.0748544037461295,0.00035469803212236084,-0.07520910177825185,1191,213,0.5158077089649198,0.1500635055243813
12587,48047,Brooks,Texas,2012,1886,507,10,2403,0.7848522679983354,0.21098626716604243,0.004161464835622139,139,4,-49,94,0.02824767726641686,0.0015629373345394195,-0.02981061460095627,1379,188,0.573866000832293,0.05805829186737321
12588,48047,Brooks,Texas,2016,1937,613,46,2596,0.7461479198767335,0.23613251155624038,0.017719568567026195,51,36,106,193,-0.03870434812160195,0.013558103731404056,0.02514624439019794,1324,-55,0.5100154083204931,-0.06385059251179992
12589,48049,Brown,Texas,2000,3138,9609,173,12920,0.24287925696594428,0.7437306501547988,0.013390092879256965,0,0,0,0,0.0,0.0,0.0,-6471,0,-0.5008513931888545,0.0
12590,48049,Brown,Texas,2004,2523,11640,90,14253,0.17701536518627659,0.8166701747000631,0.006314460113660282,-615,-83,2031,1333,-0.0658638917796677,-0.007075632765596683,0.07293952454526431,-9117,-2646,-0.6396548095137865,-0.13880341632493198
12591,48049,Brown,Texas,2008,2822,12052,200,15074,0.18720976515855114,0.7995223563752156,0.013267878466233248,299,110,412,821,0.01019439997227456,0.006953418352572967,-0.017147818324847464,-9230,-113,-0.6123125912166645,0.027342218297122023
12592,48049,Brown,Texas,2012,1904,11895,148,13947,0.13651681365168136,0.8528715852871586,0.010611601061160107,-918,-52,-157,-1127,-0.05069295150686978,-0.002656277405073142,0.053349228911942936,-9991,-761,-0.7163547716354772,-0.10404218041881275
12593,48049,Brown,Texas,2016,1621,12017,388,14026,0.11557108227577356,0.8567660059888778,0.027662911735348638,-283,240,122,79,-0.0209457313759078,0.01705131067418853,0.0038944207017191923,-10396,-405,-0.7411949237131041,-0.02484015207762691
12594,48051,Burleson,Texas,2000,2235,3542,89,5866,0.3810092055915445,0.60381861575179,0.01517217865666553,0,0,0,0,0.0,0.0,0.0,-1307,0,-0.22280941016024547,0.0
12595,48051,Burleson,Texas,2004,2276,4405,40,6721,0.33864008332093437,0.6554084213658682,0.00595149531319744,41,-49,863,855,-0.04236912227061013,-0.009220683343468091,0.05158980561407822,-2129,-822,-0.3167683380449338,-0.09395892788468835
12596,48051,Burleson,Texas,2008,2053,4547,65,6665,0.3080270067516879,0.6822205551387847,0.009752438109527382,-223,25,142,-56,-0.030613076569246445,0.003800942796329942,0.02681213377291647,-2494,-365,-0.37419354838709673,-0.05742521034216291
12597,48051,Burleson,Texas,2012,1705,4671,80,6456,0.26409541511771994,0.7235130111524164,0.012391573729863693,-348,15,124,-209,-0.04393159163396798,0.002639135620336311,0.04129245601363174,-2966,-472,-0.45941759603469645,-0.08522404764759972
12598,48051,Burleson,Texas,2016,1491,5316,153,6960,0.21422413793103448,0.7637931034482759,0.021982758620689654,-214,73,645,504,-0.049871277186685464,0.00959118489082596,0.04028009229585949,-3825,-859,-0.5495689655172414,-0.09015136948254499
12599,48053,Burnet,Texas,2000,3557,9286,389,13232,0.2688180169286578,0.7017835550181378,0.02939842805320435,0,0,0,0,0.0,0.0,0.0,-5729,0,-0.43296553808948,0.0
12600,48053,Burnet,Texas,2004,4147,11456,139,15742,0.26343539575657476,0.7277347223986786,0.008829881844746538,590,-250,2170,2510,-0.005382621172083046,-0.020568546208457814,0.02595116738054082,-7309,-1580,-0.4642993266421039,-0.031333788552623865
12601,48053,Burnet,Texas,2008,4608,12059,226,16893,0.27277570591369205,0.7138459717042562,0.013378322382051737,461,87,603,1151,0.009340310157117282,0.004548440537305199,-0.013888750694422414,-7451,-142,-0.4410702657905642,0.023229060851539696
12602,48053,Burnet,Texas,2012,3674,12843,279,16796,0.21874255775184567,0.7646463443677066,0.016611097880447727,-934,53,784,-97,-0.05403314816184637,0.0032327754983959896,0.05080037266345039,-9169,-1718,-0.5459037866158609,-0.10483352082529673
12603,48053,Burnet,Texas,2016,3797,14638,769,19204,0.1977192251614247,0.7622370339512602,0.04004374088731514,123,490,1795,2408,-0.021023332590420968,0.023432643006867412,-0.0024093104164464307,-10841,-1672,-0.5645178087898355,-0.018614022173974565
12604,48055,Caldwell,Texas,2000,3872,5216,337,9425,0.4108222811671087,0.5534217506631299,0.035755968169761274,0,0,0,0,0.0,0.0,0.0,-1344,0,-0.1425994694960212,0.0
12605,48055,Caldwell,Texas,2004,5052,6436,99,11587,0.43600586864589624,0.5554500733580737,0.008544057996030033,1180,-238,1220,2162,0.025183587478787517,-0.02721191017373124,0.002028322694943796,-1384,-40,-0.11944420471217748,0.02315526478384372
12606,48055,Caldwell,Texas,2008,5403,6107,138,11648,0.46385645604395603,0.5242960164835165,0.011847527472527472,351,39,-329,61,0.02785058739805979,0.0033034694764974386,-0.03115405687455719,-704,680,-0.0604395604395605,0.05900464427261698
12607,48055,Caldwell,Texas,2012,4791,6021,256,11068,0.4328695337911095,0.5440007228044814,0.023129743404409108,-612,118,-86,-580,-0.03098692225284655,0.011282215931881636,0.019704706320964882,-1230,-526,-0.11113118901337193,-0.05069162857381143
12608,48055,Caldwell,Texas,2016,4795,6691,606,12092,0.39654316903738007,0.5533410519351637,0.05011577902745617,4,350,670,1024,-0.03632636475372941,0.02698603562304706,0.009340329130682279,-1896,-666,-0.15679788289778362,-0.04566669388441169
12609,48057,Calhoun,Texas,2000,2766,3724,73,6563,0.42145360353496875,0.5674234344049978,0.011122962060033522,0,0,0,0,0.0,0.0,0.0,-958,0,-0.14596983087002902,0.0
12610,48057,Calhoun,Texas,2004,2561,4348,20,6929,0.3696060037523452,0.6275075768509164,0.002886419396738346,-205,-53,624,366,-0.051847599782623544,-0.008236542663295175,0.06008414244591864,-1787,-829,-0.2579015730985712,-0.11193174222854219
12611,48057,Calhoun,Texas,2008,2729,4106,44,6879,0.39671463875563306,0.596889082715511,0.006396278528855938,168,24,-242,-50,0.027108635003287862,0.003509859132117592,-0.030618494135405405,-1377,410,-0.20017444395987793,0.05772712913869327
12612,48057,Calhoun,Texas,2012,2410,4144,94,6648,0.36251504211793023,0.6233453670276775,0.014139590854392299,-319,50,38,-231,-0.034199596637702834,0.0077433123255363605,0.02645628431216651,-1734,-357,-0.2608303249097473,-0.060655880949869345
12613,48057,Calhoun,Texas,2016,2118,4638,209,6965,0.304091888011486,0.6659009332376167,0.030007178750897343,-292,115,494,317,-0.05842315410644422,0.015867587896505046,0.042555566209939166,-2520,-786,-0.36180904522613067,-0.10097872031638339
12614,48059,Callahan,Texas,2000,1174,3656,66,4896,0.2397875816993464,0.7467320261437909,0.013480392156862746,0,0,0,0,0.0,0.0,0.0,-2482,0,-0.5069444444444444,0.0
12615,48059,Callahan,Texas,2004,1073,4542,39,5654,0.1897771489211178,0.803325079589671,0.006897771489211178,-101,-27,886,758,-0.050010432778228614,-0.006582620667651568,0.05659305344588017,-3469,-987,-0.6135479306685532,-0.10660348622410876
12616,48059,Callahan,Texas,2008,1063,4589,64,5716,0.18596920923722884,0.8028341497550735,0.01119664100769769,-10,25,47,62,-0.0038079396838889557,0.004298869518486512,-0.000490929834597531,-3526,-57,-0.6168649405178447,-0.003317009849291508
12617,48059,Callahan,Texas,2012,751,4378,68,5197,0.14450644602655377,0.8424090821627862,0.013084471810659996,-312,4,-211,-519,-0.041462763210675074,0.001887830802962306,0.039574932407712704,-3627,-101,-0.6979026361362324,-0.0810376956183877
12618,48059,Callahan,Texas,2016,569,4865,145,5579,0.10198960387166159,0.8720200752823086,0.025990320846029754,-182,77,487,382,-0.04251684215489218,0.012905849035369758,0.029610993119522422,-4296,-669,-0.7700304714106471,-0.07212783527441469
12619,48061,Cameron,Texas,2000,33214,27800,1043,62057,0.5352176225083392,0.4479752485618061,0.016807128929854812,0,0,0,0,0.0,0.0,0.0,5414,0,0.08724237394653306,0.0
12620,48061,Cameron,Texas,2004,33998,34801,357,69156,0.49161316443981723,0.5032245936722771,0.005162241887905605,784,-686,7001,7099,-0.04360445806852192,-0.011644887041949208,0.055249345110471026,-803,-6217,-0.011611429232459891,-0.09885380317899295
12621,48061,Cameron,Texas,2008,48480,26671,926,76077,0.6372491028826058,0.3505790186258659,0.01217187849152832,14482,569,-8130,6921,0.1456359384427886,0.007009636603622716,-0.15264557504641124,21809,22612,0.28667008425673995,0.29828151348919985
12622,48061,Cameron,Texas,2012,49975,26099,821,76895,0.6499122179595552,0.33941088497301514,0.010676897067429612,1495,-105,-572,818,0.012663115076949394,-0.0014949814240987087,-0.011168133652850742,23876,2067,0.3105013329865401,0.023831248729800136
12623,48061,Cameron,Texas,2016,59402,29472,3205,92079,0.6451199513461267,0.32007298080995666,0.034807067843916635,9427,2384,3373,15184,-0.004792266613428575,0.024130170776487023,-0.019337904163058472,29930,6054,0.32504697053617,0.014545637549629897
12624,48063,Camp,Texas,2000,1625,2121,38,3784,0.4294397463002114,0.5605179704016914,0.01004228329809725,0,0,0,0,0.0,0.0,0.0,-496,0,-0.13107822410147996,0.0
12625,48063,Camp,Texas,2004,1778,2638,23,4439,0.4005406623113314,0.5942779905384096,0.0051813471502590676,153,-15,517,655,-0.028899083988880025,-0.004860936147838183,0.033760020136718194,-860,-364,-0.19373732822707818,-0.06265910412559822
12626,48063,Camp,Texas,2008,1734,2798,35,4567,0.37968031530545215,0.6126560105101817,0.0076636741843661045,-44,12,160,128,-0.020860347005879243,0.002482327034107037,0.01837801997177213,-1064,-204,-0.23297569520472955,-0.03923836697765137
12627,48063,Camp,Texas,2012,1428,2881,26,4335,0.32941176470588235,0.6645905420991927,0.0059976931949250285,-306,-9,83,-232,-0.050268550599569806,-0.001665980989441076,0.05193453158901096,-1453,-389,-0.3351787773933103,-0.10220308218858076
12628,48063,Camp,Texas,2016,1260,3201,81,4542,0.2774108322324967,0.7047556142668429,0.0178335535006605,-168,55,320,207,-0.052000932473385664,0.011835860305735472,0.040165072167650195,-1941,-488,-0.42734478203434617,-0.09216600464103586
12629,48065,Carson,Texas,2000,480,2216,46,2742,0.175054704595186,0.8081692195477753,0.016776075857038657,0,0,0,0,0.0,0.0,0.0,-1736,0,-0.6331145149525893,0.0
12630,48065,Carson,Texas,2004,485,2450,9,2944,0.16474184782608695,0.8322010869565217,0.0030570652173913045,5,-37,234,202,-0.010312856769099044,-0.013719010639647353,0.02403186740874641,-1965,-229,-0.6674592391304348,-0.03434472417784551
12631,48065,Carson,Texas,2008,406,2548,26,2980,0.13624161073825503,0.8550335570469799,0.0087248322147651,-79,17,98,36,-0.02850023708783192,0.005667766997373796,0.02283247009045819,-2142,-177,-0.7187919463087249,-0.05133270717829008
12632,48065,Carson,Texas,2012,292,2451,35,2778,0.10511159107271419,0.8822894168466523,0.01259899208063355,-114,9,-97,-202,-0.03113001966554084,0.00387415986586845,0.027255859799672377,-2159,-17,-0.7771778257739381,-0.05838587946521323
12633,48065,Carson,Texas,2016,249,2620,95,2964,0.0840080971659919,0.8839406207827261,0.03205128205128205,-43,60,169,186,-0.02110349390672228,0.019452289970648497,0.001651203936073764,-2371,-212,-0.7999325236167342,-0.022754697842796046
12634,48067,Cass,Texas,2000,4618,6295,106,11019,0.4190942916780107,0.5712859606134858,0.009619747708503493,0,0,0,0,0.0,0.0,0.0,-1677,0,-0.1521916689354751,0.0
12635,48067,Cass,Texas,2004,4630,7383,36,12049,0.38426425429496225,0.6127479458876255,0.0029877998174122336,12,-70,1088,1030,-0.03483003738304846,-0.00663194789109126,0.04146198527413969,-2753,-1076,-0.22848369159266324,-0.07629202265718815
12636,48067,Cass,Texas,2008,3490,8279,77,11846,0.29461421576903596,0.6988856998142833,0.0065000844166807365,-1140,41,896,-203,-0.08965003852592629,0.003512284599268503,0.08613775392665779,-4789,-2036,-0.4042714840452473,-0.17578779245258408
12637,48067,Cass,Texas,2012,2924,8763,101,11788,0.2480488632507635,0.7433831014591109,0.008568035290125552,-566,24,484,-58,-0.04656535251827246,0.0020679508734448154,0.04449740164482763,-5839,-1050,-0.49533423820834743,-0.09106275416310011
12638,48067,Cass,Texas,2016,2391,9726,227,12344,0.19369734283862605,0.7879131561892417,0.01838950097213221,-533,126,963,556,-0.05435152041213745,0.00982146568200666,0.04453005473013083,-7335,-1496,-0.5942158133506157,-0.09888157514226825
12639,48069,Castro,Texas,2000,727,1607,20,2354,0.3088360237892948,0.6826677994902294,0.008496176720475786,0,0,0,0,0.0,0.0,0.0,-880,0,-0.37383177570093457,0.0
12640,48069,Castro,Texas,2004,631,1794,5,2430,0.25967078189300413,0.7382716049382716,0.00205761316872428,-96,-15,187,76,-0.04916524189629068,-0.006438563551751506,0.05560380544804222,-1163,-283,-0.47860082304526746,-0.1047690473443329
12641,48069,Castro,Texas,2008,719,1562,10,2291,0.313836752509821,0.6817983413356613,0.004364906154517678,88,5,-232,-139,0.05416597061681688,0.002307292985793398,-0.05647326360261029,-843,320,-0.3679615888258403,0.11063923421942717
12642,48069,Castro,Texas,2012,630,1470,19,2119,0.2973100519112789,0.6937234544596508,0.008966493629070316,-89,9,-92,-172,-0.01652670059854211,0.0046015874745526375,0.011925113123989473,-840,3,-0.3964134025483719,-0.028451813722531583
12643,48069,Castro,Texas,2016,526,1414,57,1997,0.26339509263895844,0.7080620931397096,0.028542814221331998,-104,38,-56,-122,-0.033914959272320466,0.019576320592261682,0.014338638680058802,-888,-48,-0.44466700050075114,-0.04825359795237927
12644,48071,Chambers,Texas,2000,2888,6769,149,9806,0.2945135631246176,0.6902916581684683,0.015194778706914134,0,0,0,0,0.0,0.0,0.0,-3881,0,-0.3957780950438507,0.0
12645,48071,Chambers,Texas,2004,2953,8618,78,11649,0.2534981543480127,0.7398059919306378,0.006695853721349472,65,-71,1849,1843,-0.04101540877660487,-0.008498924985564663,0.049514333762169516,-5665,-1784,-0.4863078375826251,-0.09052974253877438
12646,48071,Chambers,Texas,2008,3188,9988,116,13292,0.23984351489617814,0.7514294312368341,0.008727053866987662,235,38,1370,1643,-0.013654639451834566,0.0020312001456381902,0.01162343930619636,-6800,-1135,-0.511585916340656,-0.025278078758030897
12647,48071,Chambers,Texas,2012,2790,11787,158,14735,0.18934509670851712,0.7999321343739396,0.010722768917543264,-398,42,1799,1443,-0.050498418187661015,0.0019957150505556017,0.048502703137105474,-8997,-2197,-0.6105870376654225,-0.09900112132476657
12648,48071,Chambers,Texas,2016,2948,13339,499,16786,0.17562254259501967,0.7946503038246158,0.02972715358036459,158,341,1552,2051,-0.01372255411349746,0.019004384662821325,-0.0052818305493238515,-10391,-1394,-0.6190277612295961,-0.00844072356417358
12649,48073,Cherokee,Texas,2000,4755,9599,183,14537,0.3270963747678338,0.6603150581275367,0.012588567104629566,0,0,0,0,0.0,0.0,0.0,-4844,0,-0.33321868335970284,0.0
12650,48073,Cherokee,Texas,2004,4439,11329,71,15839,0.2802575920196982,0.7152598017551614,0.004482606225140476,-316,-112,1730,1302,-0.04683878274813563,-0.00810596087948909,0.05494474362762469,-6890,-2046,-0.43500220973546316,-0.10178352637576032
12651,48073,Cherokee,Texas,2008,4610,11695,112,16417,0.28080648108667844,0.7123713224096972,0.0068221965036242916,171,41,366,578,0.0005488890669802515,0.0023395902784838158,-0.002888479345464101,-7085,-195,-0.4315648413230188,0.0034373684124443526
12652,48073,Cherokee,Texas,2012,3875,12094,157,16126,0.24029517549299267,0.7499689941709041,0.009735830336103188,-735,45,399,-291,-0.040511305593685765,0.0029136338324788963,0.037597671761206874,-8219,-1134,-0.5096738186779115,-0.0781089773548927
12653,48073,Cherokee,Texas,2016,3469,12919,402,16790,0.2066110780226325,0.769446098868374,0.023942823108993448,-406,245,825,664,-0.033684097470360164,0.01420699277289026,0.019477104697469882,-9450,-1231,-0.5628350208457416,-0.053161202167830046
12654,48075,Childress,Texas,2000,602,1506,18,2126,0.2831608654750706,0.7083725305738476,0.008466603951081843,0,0,0,0,0.0,0.0,0.0,-904,0,-0.42521166509877706,0.0
12655,48075,Childress,Texas,2004,511,1629,4,2144,0.23833955223880596,0.7597947761194029,0.0018656716417910447,-91,-14,123,18,-0.04482131323626462,-0.006600932309290798,0.0514222455455553,-1118,-214,-0.521455223880597,-0.0962435587818199
12656,48075,Childress,Texas,2008,497,1782,17,2296,0.21646341463414634,0.7761324041811847,0.007404181184668989,-14,13,153,152,-0.021876137604659618,0.0055385095428779445,0.01633762806178174,-1285,-167,-0.5596689895470384,-0.03821376566644141
12657,48075,Childress,Texas,2012,320,1665,11,1996,0.16032064128256512,0.8341683366733467,0.005511022044088177,-177,-6,-117,-300,-0.056142773351581216,-0.0018931591405808128,0.05803593249216199,-1345,-60,-0.6738476953907815,-0.11417870584374312
12658,48075,Childress,Texas,2016,253,1802,29,2084,0.12140115163147792,0.8646833013435701,0.013915547024952015,-67,18,137,88,-0.0389194896510872,0.008404524980863838,0.03051496467022341,-1549,-204,-0.7432821497120922,-0.06943445432131068
12659,48077,Clay,Texas,2000,1460,3112,65,4637,0.31485874487815396,0.6711235712745309,0.014017683847315074,0,0,0,0,0.0,0.0,0.0,-1652,0,-0.35626482639637697,0.0
12660,48077,Clay,Texas,2004,1299,3971,18,5288,0.24565052950075644,0.750945537065053,0.00340393343419062,-161,-47,859,651,-0.06920821537739752,-0.010613750413124453,0.07982196579052203,-2672,-1020,-0.5052950075642966,-0.1490301811679196
12661,48077,Clay,Texas,2008,1085,4213,41,5339,0.2032215770743585,0.7890990822251358,0.007679340700505713,-214,23,242,51,-0.04242895242639794,0.004275407266315093,0.03815354516008285,-3128,-456,-0.5858775051507773,-0.08058249758648073
12662,48077,Clay,Texas,2012,740,4266,51,5057,0.1463318172829741,0.8435831520664425,0.01008503065058335,-345,10,53,-282,-0.056889759791384414,0.0024056899500776363,0.054484069841306715,-3526,-398,-0.6972513347834685,-0.11137382963269116
12663,48077,Clay,Texas,2016,536,4377,105,5018,0.1068154643284177,0.8722598644878438,0.02092467118373854,-204,54,111,-39,-0.0395163529545564,0.010839640533155191,0.02867671242140124,-3841,-315,-0.765444400159426,-0.0681930653759576
12664,48079,Cochran,Texas,2000,344,807,20,1171,0.2937660119555935,0.6891545687446626,0.017079419299743808,0,0,0,0,0.0,0.0,0.0,-463,0,-0.39538855678906915,0.0
12665,48079,Cochran,Texas,2004,249,856,5,1110,0.22432432432432434,0.7711711711711712,0.0045045045045045045,-95,-15,49,-61,-0.06944168763126915,-0.012574914795239304,0.08201660242650854,-607,-144,-0.5468468468468468,-0.15145829005777767
12666,48079,Cochran,Texas,2008,284,758,15,1057,0.2686849574266793,0.7171239356669821,0.014191106906338695,35,10,-98,-53,0.04436063310235497,0.00968660240183419,-0.054047235504189106,-474,133,-0.44843897824030277,0.09840786860654405
12667,48079,Cochran,Texas,2012,256,649,12,917,0.2791712104689204,0.707742639040349,0.013086150490730643,-28,-3,-109,-140,0.0104862530422411,-0.0011049564156080521,-0.009381296626633118,-393,81,-0.42857142857142855,0.019867549668874218
12668,48079,Cochran,Texas,2016,190,679,32,901,0.21087680355160932,0.753607103218646,0.03551609322974473,-66,20,30,-16,-0.06829440691731109,0.022429942739014087,0.04586446417829704,-489,-96,-0.5427302996670367,-0.11415887109560813
12669,48081,Coke,Texas,2000,355,1137,23,1515,0.23432343234323433,0.7504950495049505,0.015181518151815182,0,0,0,0,0.0,0.0,0.0,-782,0,-0.5161716171617161,0.0
12670,48081,Coke,Texas,2004,266,1338,6,1610,0.16521739130434782,0.831055900621118,0.0037267080745341614,-89,-17,201,95,-0.06910604103888651,-0.011454810077281021,0.08056085111616751,-1072,-290,-0.6658385093167702,-0.14966689215505413
12671,48081,Coke,Texas,2008,299,1252,18,1569,0.1905672402804334,0.7979604843849586,0.011472275334608031,33,12,-86,-41,0.02534984897608558,0.00774556726007387,-0.033095416236159414,-953,119,-0.6073932441045252,0.05844526521224502
12672,48081,Coke,Texas,2012,179,1218,11,1408,0.12713068181818182,0.8650568181818182,0.0078125,-120,-7,-34,-161,-0.06343655846225157,-0.003659775334608031,0.06709633379685964,-1039,-86,-0.7379261363636365,-0.13053289225911124
12673,48081,Coke,Texas,2016,140,1265,18,1423,0.09838369641602249,0.8889669711876318,0.012649332396345749,-39,7,47,15,-0.028746985402159336,0.004836832396345749,0.02391015300581356,-1125,-86,-0.7905832747716093,-0.052657138407972814
12674,48083,Coleman,Texas,2000,853,2687,38,3578,0.23840134153158188,0.7509782001117943,0.010620458356623811,0,0,0,0,0.0,0.0,0.0,-1834,0,-0.5125768585802124,0.0
12675,48083,Coleman,Texas,2004,778,3035,13,3826,0.20334553058024046,0.7932566649242028,0.003397804495556717,-75,-25,348,248,-0.035055810951341415,-0.007222653861067094,0.04227846481240849,-2257,-423,-0.5899111343439623,-0.07733427576374985
12676,48083,Coleman,Texas,2008,643,3011,48,3702,0.17368989735278229,0.8133441383036196,0.012965964343598054,-135,35,-24,-124,-0.029655633227458178,0.009568159848041338,0.020087473379416854,-2368,-111,-0.6396542409508373,-0.04974310660687509
12677,48083,Coleman,Texas,2012,442,3012,38,3492,0.1265750286368843,0.8625429553264605,0.010882016036655211,-201,-10,1,-210,-0.047114868715897984,-0.002083948306942843,0.0491988170228409,-2570,-202,-0.7359679266895762,-0.09631368573873889
12678,48083,Coleman,Texas,2016,388,3177,78,3643,0.1065056272303047,0.872083447707933,0.021410925061762284,-54,40,165,151,-0.020069401406579604,0.010528909025107072,0.009540492381472476,-2789,-219,-0.7655778204776283,-0.029609893788052122
12679,48085,Collin,Texas,2000,42884,128179,4357,175420,0.24446471325960553,0.7306977539619199,0.02483753277847452,0,0,0,0,0.0,0.0,0.0,-85295,0,-0.48623304070231443,0.0
12680,48085,Collin,Texas,2004,68935,174435,1784,245154,0.2811905985625362,0.711532342935461,0.0072770585020028224,26051,-2573,46256,69734,0.036725885302930666,-0.0175604742764717,-0.019165411026458967,-105500,-20205,-0.4303417443729248,0.05589129632938966
12681,48085,Collin,Texas,2008,109047,184897,3513,297457,0.36659752502042314,0.6215923646106832,0.011810110368893656,40112,1729,10462,52303,0.08540692645788694,0.004533051866890833,-0.08993997832477774,-75850,29650,-0.2549948395902601,0.17534690478266468
12682,48085,Collin,Texas,2012,101415,196888,5264,303567,0.3340778147822392,0.6485816969565203,0.017340488261240516,-7632,1751,11991,6110,-0.03251971023818395,0.005530377892346861,0.026989332345837114,-95473,-19623,-0.31450388217428116,-0.059509042584021066
12683,48085,Collin,Texas,2016,140624,201014,19781,361419,0.3890885647959847,0.5561799462673518,0.05473148893666354,39209,14517,4126,57852,0.0550107500137455,0.037391000675423024,-0.09240175068916856,-60390,35083,-0.1670913814713671,0.14741250070291406
12684,48087,Collingsworth,Texas,2000,429,974,12,1415,0.30318021201413425,0.688339222614841,0.008480565371024734,0,0,0,0,0.0,0.0,0.0,-545,0,-0.3851590106007068,0.0
12685,48087,Collingsworth,Texas,2004,346,1051,1,1398,0.2474964234620887,0.751788268955651,0.000715307582260372,-83,-11,77,-17,-0.05568378855204556,-0.007765257788764362,0.06344904634080994,-705,-160,-0.5042918454935623,-0.11913283489285553
12686,48087,Collingsworth,Texas,2008,234,943,18,1195,0.19581589958158996,0.7891213389121339,0.01506276150627615,-112,17,-108,-203,-0.051680523880498735,0.014347453924015778,0.03733306995648289,-709,-4,-0.5933054393305439,-0.0890135938369816
12687,48087,Collingsworth,Texas,2012,177,962,11,1150,0.15391304347826087,0.8365217391304348,0.009565217391304347,-57,-7,19,-45,-0.041902856103329084,-0.005497544114971803,0.04740040021830094,-785,-76,-0.682608695652174,-0.08930325632163005
12688,48087,Collingsworth,Texas,2016,145,983,28,1156,0.1254325259515571,0.8503460207612457,0.02422145328719723,-32,17,21,6,-0.028480517526703775,0.014656235895892884,0.013824281630810842,-838,-53,-0.7249134948096886,-0.042304799157514617
12689,48089,Colorado,Texas,2000,2229,4913,107,7249,0.3074906883708098,0.6777486549868947,0.01476065664229549,0,0,0,0,0.0,0.0,0.0,-2684,0,-0.37025796661608495,0.0
12690,48089,Colorado,Texas,2004,2161,5488,41,7690,0.2810143042912874,0.7136540962288687,0.005331599479843953,-68,-66,575,441,-0.026476384079522408,-0.009429057162451536,0.03590544124197392,-3327,-643,-0.4326397919375813,-0.06238182532149633
12691,48089,Colorado,Texas,2008,2508,5795,50,8353,0.30025140668023464,0.6937627199808452,0.005985873338920148,347,9,307,663,0.01923710238894727,0.0006542738590761951,-0.019891376248023507,-3287,40,-0.3935113133006105,0.039128478636970776
12692,48089,Colorado,Texas,2012,2029,6026,62,8117,0.24996920044351362,0.7423925095478625,0.007638290008623876,-479,12,231,-236,-0.05028220623672103,0.0016524166697037277,0.048629789567017356,-3997,-710,-0.4924233091043489,-0.09891199580373838
12693,48089,Colorado,Texas,2016,1987,6325,201,8513,0.23340772935510395,0.7429813226829555,0.023610947961940562,-42,139,299,396,-0.016561471088409663,0.015972657953316687,0.0005888131350929582,-4338,-341,-0.5095735933278516,-0.017150284223502676
12694,48091,Comal,Texas,2000,7131,24599,1018,32748,0.21775375595456212,0.7511603762061805,0.031085867839257358,0,0,0,0,0.0,0.0,0.0,-17468,0,-0.5334066202516183,0.0
12695,48091,Comal,Texas,2004,9153,31574,316,41043,0.2230100138878737,0.7692907438540068,0.007699242258119533,2022,-702,6975,8295,0.005256257933311581,-0.023386625581137827,0.018130367647826273,-22421,-4953,-0.5462807299661331,-0.012874109714514748
12696,48091,Comal,Texas,2008,12384,35233,644,48261,0.25660471187915707,0.7300511800418558,0.013344108078987173,3231,328,3659,7218,0.03359469799128337,0.00564486582086764,-0.03923956381215099,-22849,-428,-0.4734464681626987,0.07283426180343439
12697,48091,Comal,Texas,2012,11450,39318,761,51529,0.22220497195753847,0.7630266451900871,0.014768382852374392,-934,117,4085,3268,-0.0343997399216186,0.0014242747733872185,0.03297546514823135,-27868,-5019,-0.5408216732325486,-0.0673752050698499
12698,48091,Comal,Texas,2016,14238,45136,2804,62178,0.2289877448615266,0.7259159188137283,0.045096336324745086,2788,2043,5818,10649,0.006782772903988127,0.030327953472370696,-0.037110726376358816,-30898,-3030,-0.4969281739522017,0.043893499280346915
12699,48093,Comanche,Texas,2000,1636,3334,52,5022,0.32576662684189567,0.663878932696137,0.010354440461967344,0,0,0,0,0.0,0.0,0.0,-1698,0,-0.3381123058542413,0.0
12700,48093,Comanche,Texas,2004,1431,3813,24,5268,0.2716400911161731,0.7238041002277904,0.004555808656036446,-205,-28,479,246,-0.05412653572572257,-0.005798631805930898,0.059925167531653445,-2382,-684,-0.4521640091116173,-0.11405170325737601
12701,48093,Comanche,Texas,2008,1334,3813,70,5217,0.25570251102166,0.730879815986199,0.013417672992141078,-97,46,0,-51,-0.015937580094513126,0.00886186433610463,0.007075715758408596,-2479,-97,-0.475177304964539,-0.023013295852921722
12702,48093,Comanche,Texas,2012,890,3944,72,4906,0.18141051773338768,0.8039135752140236,0.014675907052588666,-444,2,131,-311,-0.0742919932882723,0.0012582340604475883,0.07303375922782462,-3054,-575,-0.622503057480636,-0.14732575251609692
12703,48093,Comanche,Texas,2016,789,4333,115,5237,0.15065877410731335,0.8273820889822417,0.02195913691044491,-101,43,389,331,-0.03075174362607433,0.007283229857856245,0.023468513768218124,-3544,-490,-0.6767233148749284,-0.05422025739429248
12704,48095,Concho,Texas,2000,268,818,17,1103,0.242973708068903,0.7416137805983681,0.015412511332728921,0,0,0,0,0.0,0.0,0.0,-550,0,-0.49864007252946513,0.0
12705,48095,Concho,Texas,2004,270,911,12,1193,0.22632020117351215,0.7636211232187762,0.010058675607711651,2,-5,93,90,-0.016653506895390857,-0.00535383572501727,0.022007342620408044,-641,-91,-0.537300922045264,-0.0386608495157989
12706,48095,Concho,Texas,2008,257,807,13,1077,0.23862581244196843,0.7493036211699164,0.012070566388115135,-13,1,-104,-116,0.012305611268456279,0.0020118907804034837,-0.014317502048859732,-550,91,-0.510677808727948,0.02662311331731604
12707,48095,Concho,Texas,2012,194,793,14,1001,0.1938061938061938,0.7922077922077922,0.013986013986013986,-63,1,-14,-76,-0.04481961863577463,0.001915447597898851,0.042904171037875805,-599,-49,-0.5984015984015985,-0.08772378967365047
12708,48095,Concho,Texas,2016,148,885,35,1068,0.13857677902621723,0.8286516853932584,0.03277153558052434,-46,21,92,67,-0.05522941477997656,0.018785521594510357,0.03644389318546615,-737,-138,-0.6900749063670412,-0.09167330796544271
12709,48097,Cooke,Texas,2000,3153,10128,188,13469,0.23409310268022868,0.7519489197416289,0.013957977578142402,0,0,0,0,0.0,0.0,0.0,-6975,0,-0.5178558170614003,0.0
12710,48097,Cooke,Texas,2004,3142,11908,57,15107,0.20798305421327862,0.7882438604620374,0.0037730853246839215,-11,-131,1780,1638,-0.02611004846695006,-0.01018489225345848,0.03629494072040851,-8766,-1791,-0.5802608062487589,-0.062404989187358595
12711,48097,Cooke,Texas,2008,3051,11871,132,15054,0.20267038660821043,0.7885611797528896,0.00876843363889996,-91,75,-37,-53,-0.005312667605068183,0.004995348314216039,0.0003173192908522138,-8820,-54,-0.5858907931446792,-0.005629986895920314
12712,48097,Cooke,Texas,2012,2246,11951,154,14351,0.15650477318653752,0.8327642672984461,0.010730959515016375,-805,22,80,-703,-0.04616561342167291,0.001962525876116415,0.04420308754555646,-9705,-885,-0.6762594941119086,-0.09036870096722938
12713,48097,Cooke,Texas,2016,2352,13181,422,15955,0.1474146035725478,0.8261360075211532,0.026449388906298967,106,268,1230,1604,-0.00909016961398973,0.015718429391282592,-0.006628259777292866,-10829,-1124,-0.6787214039486055,-0.0024619098366969183
12714,48099,Coryell,Texas,2000,4493,10321,273,15087,0.2978060581957977,0.6840988930867634,0.018095048717438854,0,0,0,0,0.0,0.0,0.0,-5828,0,-0.3862928348909657,0.0
12715,48099,Coryell,Texas,2004,5122,12421,82,17625,0.2906099290780142,0.7047375886524823,0.004652482269503546,629,-191,2100,2538,-0.007196129117783501,-0.013442566447935308,0.020638695565718845,-7299,-1471,-0.41412765957446807,-0.027834824683502346
12716,48099,Coryell,Texas,2008,6619,11550,163,18332,0.361062622736199,0.630045821514292,0.008891555749509054,1497,81,-871,707,0.0704526936581848,0.004239073480005509,-0.07469176713819026,-4931,2368,-0.268983198778093,0.14514446079637505
12717,48099,Coryell,Texas,2012,5158,11220,226,16604,0.3106480366176825,0.675740785352927,0.013611178029390509,-1461,63,-330,-1728,-0.05041458611851651,0.0047196222798814545,0.04569496383863503,-6062,-1131,-0.36509274873524455,-0.09610954995715154
12718,48099,Coryell,Texas,2016,5064,12225,964,18253,0.2774338464909878,0.6697529173286583,0.05281323618035391,-94,738,1005,1649,-0.03321419012669469,0.039202058150963406,-0.005987868024268761,-7161,-1099,-0.3923190708376705,-0.027226322102425926
12719,48101,Cottle,Texas,2000,241,502,14,757,0.31836195508586523,0.6631439894319683,0.018494055482166448,0,0,0,0,0.0,0.0,0.0,-261,0,-0.34478203434610305,0.0
12720,48101,Cottle,Texas,2004,214,549,5,768,0.2786458333333333,0.71484375,0.006510416666666667,-27,-9,47,11,-0.03971612175253192,-0.01198363881549978,0.051699760568031716,-335,-74,-0.4361979166666667,-0.09141588232056364
12721,48101,Cottle,Texas,2008,187,509,9,705,0.2652482269503546,0.7219858156028369,0.01276595744680851,-27,4,-40,-63,-0.01339760638297871,0.006255540780141843,0.007142065602836922,-322,13,-0.4567375886524823,-0.020539671985815633
12722,48101,Cottle,Texas,2012,180,555,6,741,0.242914979757085,0.7489878542510121,0.008097165991902834,-7,-3,46,36,-0.022333247193269595,-0.004668791454905676,0.027002038648175186,-375,-53,-0.5060728744939271,-0.04933528584144481
12723,48101,Cottle,Texas,2016,92,506,14,612,0.1503267973856209,0.826797385620915,0.02287581699346405,-88,8,-49,-129,-0.0925881823714641,0.014778651001561217,0.07780953136990287,-414,-39,-0.676470588235294,-0.17039771374136692
12724,48103,Crane,Texas,2000,387,1246,21,1654,0.23397823458282951,0.7533252720677146,0.012696493349455865,0,0,0,0,0.0,0.0,0.0,-859,0,-0.5193470374848851,0.0
12725,48103,Crane,Texas,2004,254,1314,6,1574,0.1613722998729352,0.8348157560355781,0.0038119440914866584,-133,-15,68,-80,-0.07260593470989432,-0.008884549257969207,0.08149048396786351,-1060,-201,-0.6734434561626429,-0.1540964186777578
12726,48103,Crane,Texas,2008,319,1119,16,1454,0.21939477303988997,0.7696011004126547,0.011004126547455296,65,10,-195,-120,0.058022473166954774,0.007192182455968638,-0.06521465562292339,-800,260,-0.5502063273727648,0.12323712878987814
12727,48103,Crane,Texas,2012,275,985,23,1283,0.21434138737334374,0.7677318784099766,0.017926734216679657,-44,7,-134,-171,-0.0050533856665462284,0.006922607669224361,-0.0018692220026781392,-710,90,-0.5533904910366328,-0.0031841636638680892
12728,48103,Crane,Texas,2016,299,1049,36,1384,0.21604046242774566,0.7579479768786127,0.02601156069364162,24,13,64,101,0.0016990750544019217,0.008084826476961963,-0.009783901531363881,-750,-40,-0.541907514450867,0.011482976585765803
12729,48105,Crockett,Texas,2000,467,924,7,1398,0.3340486409155937,0.6609442060085837,0.005007153075822604,0,0,0,0,0.0,0.0,0.0,-457,0,-0.32689556509299,0.0
12730,48105,Crockett,Texas,2004,473,1248,7,1728,0.27372685185185186,0.7222222222222222,0.004050925925925926,6,0,324,330,-0.06032178906374186,-0.000956227149896678,0.061278016213638486,-775,-318,-0.44849537037037035,-0.12159980527738035
12731,48105,Crockett,Texas,2008,512,1026,7,1545,0.3313915857605178,0.6640776699029126,0.004530744336569579,39,0,-222,-183,0.057664733908665944,0.00047981841064365354,-0.058144552319309595,-514,261,-0.3326860841423948,0.11580928622797554
12732,48105,Crockett,Texas,2012,480,957,20,1457,0.32944406314344543,0.6568291008922443,0.013726835964310227,-32,13,-69,-88,-0.0019475226170723725,0.009196091627740648,-0.007248569010668282,-477,37,-0.3273850377487989,0.00530104639359591
12733,48105,Crockett,Texas,2016,372,980,43,1395,0.26666666666666666,0.7025089605734767,0.03082437275985663,-108,23,23,-62,-0.06277739647677877,0.017097536795546403,0.04567985968123234,-608,-131,-0.43584229390681,-0.1084572561580111
12734,48107,Crosby,Texas,2000,705,1270,27,2002,0.35214785214785216,0.6343656343656343,0.013486513486513486,0,0,0,0,0.0,0.0,0.0,-565,0,-0.28221778221778215,0.0
12735,48107,Crosby,Texas,2004,622,1647,6,2275,0.2734065934065934,0.723956043956044,0.0026373626373626374,-83,-21,377,273,-0.07874125874125876,-0.010849150849150849,0.08959040959040965,-1025,-460,-0.45054945054945056,-0.1683316683316684
12736,48107,Crosby,Texas,2008,684,1221,9,1914,0.3573667711598746,0.6379310344827587,0.004702194357366771,62,3,-426,-361,0.08396017775328118,0.002064831720004134,-0.08602500947328529,-537,488,-0.2805642633228841,0.16998518722656647
12737,48107,Crosby,Texas,2012,639,1132,16,1787,0.35758254057078903,0.6334639059876889,0.008953553441522105,-45,7,-89,-127,0.0002157694109144459,0.0042513590841553334,-0.004467128495069805,-493,44,-0.27588136541689984,0.004682897905984251
12738,48107,Crosby,Texas,2016,468,1181,79,1728,0.2708333333333333,0.6834490740740741,0.045717592592592594,-171,63,49,-59,-0.08674920723745572,0.03676403915107049,0.0499851680863852,-713,-220,-0.41261574074074076,-0.13673437532384092
12739,48109,Culberson,Texas,2000,577,413,22,1012,0.5701581027667985,0.40810276679841895,0.021739130434782608,0,0,0,0,0.0,0.0,0.0,164,0,0.1620553359683795,0.0
12740,48109,Culberson,Texas,2004,375,407,6,788,0.47588832487309646,0.516497461928934,0.007614213197969543,-202,-16,-6,-224,-0.094269777893702,-0.014124917236813065,0.10839469513051503,-32,-196,-0.04060913705583752,-0.20266447302421703
12741,48109,Culberson,Texas,2008,492,257,10,759,0.6482213438735178,0.3386034255599473,0.013175230566534914,117,4,-150,-29,0.17233301900042136,0.005561017368565371,-0.17789403636898665,235,267,0.3096179183135705,0.350227055369408
12742,48109,Culberson,Texas,2012,568,295,16,879,0.646188850967008,0.33560864618885095,0.01820250284414107,76,6,38,120,-0.002032492906509864,0.005027272277606154,-0.002994779371096379,273,38,0.310580204778157,0.0009622864645865148
12743,48109,Culberson,Texas,2016,454,280,33,767,0.5919165580182529,0.3650586701434159,0.04302477183833116,-114,17,-15,-112,-0.05427229294875502,0.02482226899419009,0.029450023954564974,174,-99,0.22685788787483702,-0.08372231690332
12744,48111,Dallam,Texas,2000,341,1385,18,1744,0.19552752293577982,0.794151376146789,0.010321100917431193,0,0,0,0,0.0,0.0,0.0,-1044,0,-0.5986238532110092,0.0
12745,48111,Dallam,Texas,2004,305,1473,4,1782,0.17115600448933782,0.8265993265993266,0.002244668911335578,-36,-14,88,38,-0.024371518446442003,-0.008076432006095615,0.032447950452537566,-1168,-124,-0.6554433221099887,-0.056819468898979486
12746,48111,Dallam,Texas,2008,302,1269,18,1589,0.19005663939584644,0.7986154814348647,0.011327879169288861,-3,14,-204,-193,0.018900634906508618,0.009083210257953283,-0.02798384516446184,-967,201,-0.6085588420390182,0.04688448007097046
12747,48111,Dallam,Texas,2012,253,1248,33,1534,0.16492829204693613,0.8135593220338984,0.02151238591916558,-49,15,-21,-55,-0.025128347348910313,0.010184506749876717,0.014943840599033642,-995,-28,-0.6486310299869622,-0.04007218794794398
12748,48111,Dallam,Texas,2016,222,1261,61,1544,0.14378238341968913,0.8167098445595855,0.03950777202072539,-31,28,13,10,-0.021145908627246995,0.01799538610155981,0.0031505225256871494,-1039,-44,-0.6729274611398963,-0.024296431152934117
12749,48113,Dallas,Texas,2000,275308,322345,15386,613039,0.4490872521976579,0.5258148339665176,0.025097913835824475,0,0,0,0,0.0,0.0,0.0,-47037,0,-0.07672758176885974,0.0
12750,48113,Dallas,Texas,2004,336641,346246,4822,687709,0.48951082507281424,0.5034774882981028,0.007011686629082941,61333,-10564,23901,74670,0.040423572875156355,-0.018086227206741533,-0.022337345668414832,-9605,37432,-0.013966663225288556,0.06276091854357119
12751,48113,Dallas,Texas,2008,422989,310000,7085,740074,0.5715496017965771,0.41887703121579734,0.009573366987625561,86348,2263,-36246,52365,0.08203877672376286,0.0025616803585426203,-0.08460045708230546,112989,122594,0.15267257058077977,0.16663923380606832
12752,48113,Dallas,Texas,2012,405571,295813,10228,711612,0.5699327723534735,0.4156942266291181,0.014373001017408363,-17418,3143,-14187,-28462,-0.0016168294431035957,0.004799634029782802,-0.0031828045866792443,109758,-3231,0.1542385457243554,0.0015659751435756486
12753,48113,Dallas,Texas,2016,461080,262945,34948,758973,0.6075051418166391,0.34644842438400314,0.046046433799357814,55509,24720,-32868,47361,0.037572369463165556,0.03167343278194945,-0.06924580224511495,198135,88377,0.2610567174326359,0.10681817170828051
12754,48115,Dawson,Texas,2000,1463,3337,39,4839,0.30233519322174,0.6896052903492457,0.008059516429014259,0,0,0,0,0.0,0.0,0.0,-1874,0,-0.38727009712750565,0.0
12755,48115,Dawson,Texas,2004,1114,3419,12,4545,0.24510451045104512,0.7522552255225523,0.0026402640264026403,-349,-27,82,-294,-0.0572306827706949,-0.005419252402611619,0.06264993517330664,-2305,-431,-0.5071507150715072,-0.11988061794400157
12756,48115,Dawson,Texas,2008,1152,2906,38,4096,0.28125,0.70947265625,0.00927734375,38,26,-513,-449,0.036145489548954884,0.00663707972359736,-0.04278256927255231,-1754,551,-0.42822265625,0.07892805882150722
12757,48115,Dawson,Texas,2012,1019,2591,32,3642,0.2797913234486546,0.7114222954420648,0.008786381109280615,-133,-6,-315,-454,-0.0014586765513454059,-0.0004909626407193848,0.0019496391920648115,-1572,182,-0.4316309719934102,-0.0034083157434102174
12758,48115,Dawson,Texas,2016,835,2636,92,3563,0.2343530732528768,0.7398259893348302,0.02582093741229301,-184,60,45,-79,-0.045438250195777796,0.017034556303012396,0.028403693892765425,-1801,-229,-0.5054729160819534,-0.07384194408854322
12759,48117,Deaf Smith,Texas,2000,1240,3687,57,4984,0.24879614767255218,0.7397672552166934,0.011436597110754414,0,0,0,0,0.0,0.0,0.0,-2447,0,-0.4909711075441412,0.0
12760,48117,Deaf Smith,Texas,2004,1133,4139,19,5291,0.21413721413721415,0.7822717822717823,0.003591003591003591,-107,-38,452,307,-0.03465893353533803,-0.007845593519750824,0.04250452705508889,-3006,-559,-0.5681345681345682,-0.077163460590427
12761,48117,Deaf Smith,Texas,2008,1247,3466,31,4744,0.26285834738617203,0.7306070826306914,0.0065345699831365935,114,12,-673,-547,0.04872113324895788,0.0029435663921330026,-0.05166469964109088,-2219,787,-0.4677487352445194,0.10038583289004882
12762,48117,Deaf Smith,Texas,2012,1239,3042,28,4309,0.287537711766071,0.705964260849385,0.006498027384543977,-8,-3,-424,-435,0.024679364379898983,-3.65425985926161e-05,-0.02464282178130639,-1803,416,-0.418426549083314,0.04932218616120537
12763,48117,Deaf Smith,Texas,2016,1185,2911,120,4216,0.2810721062618596,0.6904648956356736,0.028462998102466792,-54,92,-131,-93,-0.006465605504211436,0.021964970717922815,-0.015499365213711425,-1726,77,-0.409392789373814,0.009033759709499989
12764,48119,Delta,Texas,2000,726,1143,31,1900,0.3821052631578947,0.6015789473684211,0.01631578947368421,0,0,0,0,0.0,0.0,0.0,-417,0,-0.21947368421052638,0.0
12765,48119,Delta,Texas,2004,627,1447,8,2082,0.3011527377521614,0.6950048030739674,0.0038424591738712775,-99,-23,304,182,-0.08095252540573333,-0.012473330299812933,0.09342585570554629,-820,-403,-0.393852065321806,-0.17437838111127962
12766,48119,Delta,Texas,2008,589,1580,18,2187,0.26931870141746683,0.7224508459076361,0.00823045267489712,-38,10,133,105,-0.03183403633469456,0.004387993501025842,0.027446042833668693,-991,-171,-0.45313214449016925,-0.05928007916836325
12767,48119,Delta,Texas,2012,454,1524,40,2018,0.22497522299306244,0.755203171456888,0.019821605550049554,-135,22,-56,-169,-0.04434347842440439,0.011591152875152434,0.03275232554925189,-1070,-79,-0.5302279484638255,-0.07709580397365623
12768,48119,Delta,Texas,2016,400,1836,45,2281,0.17536168347216133,0.8049101271372205,0.01972818939061815,-54,5,312,263,-0.04961353952090111,-9.341615943140452e-05,0.049706955680332565,-1436,-366,-0.6295484436650592,-0.09932049520123376
12769,48121,Denton,Texas,2000,40144,102171,4475,146790,0.27347911983105117,0.6960351522583282,0.030485727910620614,0,0,0,0,0.0,0.0,0.0,-62027,0,-0.4225560324272771,0.0
12770,48121,Denton,Texas,2004,59346,140891,1173,201410,0.294652698475746,0.6995233603098158,0.00582394121443821,19202,-3302,38720,54620,0.021173578644694824,-0.024661786696182405,0.003488208051487529,-81545,-19518,-0.4048706618340698,0.017685370593207295
12771,48121,Denton,Texas,2008,91160,149935,2168,243263,0.37473845179908166,0.6163493831778775,0.008912165023040906,31814,995,9044,41853,0.08008575332333567,0.0030882238086026954,-0.0831739771319383,-58775,22770,-0.2416109313787958,0.16325973045527398
12772,48121,Denton,Texas,2012,80978,157579,4224,242781,0.3335433991951594,0.6490582047194797,0.01739839608536088,-10182,2056,7644,-482,-0.041195052603922255,0.008486231062319976,0.03270882154160226,-76601,-17826,-0.3155148055243203,-0.07390387414552452
12773,48121,Denton,Texas,2016,110890,170603,17152,298645,0.37131041872457266,0.5712568434093991,0.057432737866028226,29912,12928,13024,55864,0.03776701952941325,0.040034341780667344,-0.07780136131008064,-59713,16888,-0.19994642468482643,0.11556838083949389
12774,48123,DeWitt,Texas,2000,1570,4541,72,6183,0.25392204431505744,0.7344331230794113,0.011644832605531296,0,0,0,0,0.0,0.0,0.0,-2971,0,-0.4805110787643539,0.0
12775,48123,DeWitt,Texas,2004,1610,5100,22,6732,0.23915626856803326,0.7575757575757576,0.0032679738562091504,40,-50,559,549,-0.014765775747024174,-0.008376858749322145,0.023142634496346237,-3490,-519,-0.5184194890077243,-0.03790841024337038
12776,48123,DeWitt,Texas,2008,1716,4888,22,6626,0.25897977663748867,0.7376999698158768,0.0033202535466344703,106,0,-212,-106,0.019823508069455403,5.227969042531991e-05,-0.019875787759880748,-3172,318,-0.47872019317838815,0.03969929582933612
12777,48123,DeWitt,Texas,2012,1467,5122,49,6638,0.22100030129557097,0.7716179572160289,0.0073817414884001205,-249,27,234,12,-0.0379794753419177,0.004061487941765651,0.03391798740015206,-3655,-483,-0.5506176559204579,-0.0718974627420697
12778,48123,DeWitt,Texas,2016,1163,5519,162,6844,0.16992986557568673,0.8063997662185857,0.023670368205727644,-304,113,397,206,-0.05107043571988423,0.016288626717327524,0.034781809002556785,-4356,-701,-0.6364699006428989,-0.08585224472244102
12779,48125,Dickens,Texas,2000,284,589,8,881,0.322360953461975,0.6685584562996595,0.009080590238365494,0,0,0,0,0.0,0.0,0.0,-305,0,-0.34619750283768447,0.0
12780,48125,Dickens,Texas,2004,245,815,3,1063,0.23047977422389465,0.7666980244590781,0.0028222013170272815,-39,-5,226,182,-0.09188117923808037,-0.0062583889213382125,0.0981395681594186,-570,-265,-0.5362182502351834,-0.19002074739749897
12781,48125,Dickens,Texas,2008,234,730,8,972,0.24074074074074073,0.7510288065843621,0.00823045267489712,-11,5,-85,-91,0.010260966516846076,0.005408251357869839,-0.01566921787471598,-496,74,-0.5102880658436214,0.025930184391562028
12782,48125,Dickens,Texas,2012,216,793,10,1019,0.21197252208047104,0.7782139352306182,0.009813542688910697,-18,2,63,47,-0.028768218660269684,0.0015830900140135773,0.027185128646256107,-577,-81,-0.5662414131501472,-0.05595334730652579
12783,48125,Dickens,Texas,2016,128,755,26,909,0.1408140814081408,0.8305830583058306,0.028602860286028604,-88,16,-38,-110,-0.07115844067233024,0.018789317597117907,0.052369123075212354,-627,-50,-0.6897689768976898,-0.12352756374754259
12784,48127,Dimmit,Texas,2000,2678,1032,43,3753,0.7135624833466561,0.2749800159872102,0.01145750066613376,0,0,0,0,0.0,0.0,0.0,1646,0,0.43858246735944584,0.0
12785,48127,Dimmit,Texas,2004,2365,1188,13,3566,0.6632080762759395,0.3331463825014021,0.0036455412226584407,-313,-30,156,-187,-0.05035440707071659,-0.007811959443475319,0.05816636651419188,1177,-469,0.33006169377453737,-0.10852077358490847
12786,48127,Dimmit,Texas,2008,2692,874,21,3587,0.7504878728742682,0.24365765263451353,0.005854474491218288,327,8,-314,21,0.08727979659832874,0.0022089332685598477,-0.08948872986688858,1818,641,0.5068302202397547,0.1767685264652173
12787,48127,Dimmit,Texas,2012,2141,762,14,2917,0.7339732601988345,0.26122728830990743,0.0047994514912581415,-551,-7,-112,-670,-0.01651461267543375,-0.0010550229999601469,0.017569635675393908,1379,-439,0.47274597188892703,-0.03408424835082763
12788,48127,Dimmit,Texas,2016,2173,974,78,3225,0.6737984496124031,0.302015503875969,0.024186046511627906,32,64,212,308,-0.06017481058643137,0.019386595020369764,0.04078821556606155,1199,-180,0.3717829457364341,-0.10096302615249292
12789,48129,Donley,Texas,2000,360,1333,26,1719,0.2094240837696335,0.7754508435136708,0.015125072716695753,0,0,0,0,0.0,0.0,0.0,-973,0,-0.5660267597440373,0.0
12790,48129,Donley,Texas,2004,349,1429,6,1784,0.19562780269058297,0.8010089686098655,0.0033632286995515697,-11,-20,96,65,-0.013796281079050537,-0.011761844017144182,0.025558125096194706,-1080,-107,-0.6053811659192825,-0.039354406175245216
12791,48129,Donley,Texas,2008,291,1374,25,1690,0.17218934911242603,0.8130177514792899,0.014792899408284023,-58,19,-55,-94,-0.023438453578156937,0.011429670708732454,0.012008782869424417,-1083,-3,-0.6408284023668639,-0.03544723644758141
12792,48129,Donley,Texas,2012,226,1287,22,1535,0.1472312703583062,0.8384364820846906,0.014332247557003257,-65,-3,-87,-155,-0.024958078754119845,-0.0004606518512807658,0.025418730605400675,-1061,22,-0.6912052117263844,-0.05037680935952049
12793,48129,Donley,Texas,2016,191,1225,49,1465,0.13037542662116042,0.8361774744027304,0.033447098976109216,-35,27,-62,-70,-0.01685584373714577,0.01911485141910596,-0.00225900768196019,-1034,27,-0.70580204778157,-0.01459683605518558
12794,48131,Duval,Texas,2000,3990,1010,30,5030,0.7932405566600398,0.20079522862823063,0.005964214711729622,0,0,0,0,0.0,0.0,0.0,2980,0,0.5924453280318092,0.0
12795,48131,Duval,Texas,2004,2916,1160,15,4091,0.7127841603519922,0.283549254461012,0.0036665851869958446,-1074,-15,150,-939,-0.08045639630804757,-0.0022976295247337775,0.08275402583278135,1756,-1224,0.42923490589098023,-0.16321042214082893
12796,48131,Duval,Texas,2008,3298,1076,35,4409,0.7480154229984124,0.24404626899523701,0.007938308006350647,382,20,-84,318,0.03523126264642018,0.004271722819354803,-0.039502985465774965,2222,466,0.5039691540031754,0.0747342481121952
12797,48131,Duval,Texas,2012,3331,980,33,4344,0.766804788213628,0.22559852670349909,0.007596685082872928,33,-2,-96,-65,0.01878936521521557,-0.0003416229234777194,-0.01844774229173793,2351,129,0.5412062615101288,0.037237107506953415
12798,48131,Duval,Texas,2016,2783,1316,69,4168,0.6677063339731286,0.31573896353166986,0.016554702495201537,-548,36,336,-176,-0.09909845424049935,0.00895801741232861,0.09014043682817077,1467,-884,0.35196737044145876,-0.1892388910686701
12799,48133,Eastland,Texas,2000,1774,4531,109,6414,0.2765824758341129,0.7064234487059557,0.0169940754599314,0,0,0,0,0.0,0.0,0.0,-2757,0,-0.42984097287184286,0.0
12800,48133,Eastland,Texas,2004,1582,5249,26,6857,0.23071313985708036,0.7654951144815517,0.0037917456613679452,-192,-83,718,443,-0.04586933597703252,-0.013202329798563454,0.05907166577559597,-3667,-910,-0.5347819746244713,-0.10494100175262844
12801,48133,Eastland,Texas,2008,1271,5165,73,6509,0.1952680903364572,0.7935166692272239,0.011215240436318942,-311,47,-84,-348,-0.03544504952062316,0.007423494774950997,0.02802155474567214,-3894,-227,-0.5982485788907667,-0.06346660426629536
12802,48133,Eastland,Texas,2012,970,5444,81,6495,0.14934565050038492,0.8381832178598922,0.012471131639722863,-301,8,279,-14,-0.045922439836072276,0.0012558912034039207,0.04466654863266839,-4474,-580,-0.6888375673595073,-0.09058898846874064
12803,48133,Eastland,Texas,2016,776,6011,176,6963,0.11144621571161856,0.8632773229929628,0.02527646129541864,-194,95,567,468,-0.03789943478876637,0.012805329655695778,0.025094105133070532,-5235,-761,-0.7518311072813442,-0.06299353992183687
12804,48135,Ector,Texas,2000,9425,22893,583,32901,0.2864654569769916,0.6958147168779064,0.017719826145101973,0,0,0,0,0.0,0.0,0.0,-13468,0,-0.4093492599009148,0.0
12805,48135,Ector,Texas,2004,8579,27502,229,36310,0.23627099972459378,0.757422197741669,0.006306802533737262,-846,-354,4609,3409,-0.05019445725239782,-0.01141302361136471,0.061607480863762554,-18923,-5455,-0.5211511980170752,-0.1118019381161604
12806,48135,Ector,Texas,2008,9123,26199,329,35651,0.25589745028189953,0.7348741970772208,0.009228352640879638,544,100,-1303,-659,0.019626450557305747,0.002921550107142376,-0.022548000664448176,-17076,1847,-0.47897674679532126,0.04217445122175395
12807,48135,Ector,Texas,2012,8118,24010,385,32513,0.24968474148802017,0.7384738412327376,0.01184141727924215,-1005,56,-2189,-3138,-0.006212708793879362,0.002613064638362512,0.0035996441555168346,-15892,1184,-0.48878909974471746,-0.009812352949396197
12808,48135,Ector,Texas,2016,10249,25020,1261,36530,0.2805639200656994,0.6849165069805639,0.03451957295373666,2131,876,1010,4017,0.030879178577679245,0.022678155674494507,-0.05355733425217368,-14771,1121,-0.40435258691486453,0.08443651282985293
12809,48137,Edwards,Texas,2000,261,663,13,937,0.27854855923159016,0.7075773745997865,0.013874066168623266,0,0,0,0,0.0,0.0,0.0,-402,0,-0.42902881536819637,0.0
12810,48137,Edwards,Texas,2004,217,745,1,963,0.22533748701973,0.7736240913811008,0.0010384215991692627,-44,-12,82,26,-0.053211072211860166,-0.012835644569454003,0.06604671678131424,-528,-126,-0.5482866043613708,-0.11925778899317441
12811,48137,Edwards,Texas,2008,346,673,16,1035,0.3342995169082126,0.6502415458937199,0.015458937198067632,129,15,-72,72,0.10896202988848258,0.01442051559889837,-0.12338254548738092,-327,201,-0.3159420289855073,0.2323445753758635
12812,48137,Edwards,Texas,2012,232,642,10,884,0.26244343891402716,0.7262443438914027,0.011312217194570135,-114,-6,-31,-151,-0.07185607799418542,-0.004146720003497497,0.07600279799768284,-410,-83,-0.4638009049773755,-0.14785887599186825
12813,48137,Edwards,Texas,2016,303,746,24,1073,0.28238583410997203,0.6952469711090401,0.022367194780987885,71,14,104,189,0.019942395195944873,0.01105497758641775,-0.030997372782362587,-443,-33,-0.41286113699906807,0.05093976797830746
12814,48139,Ellis,Texas,2000,10629,26091,587,37307,0.2849063178491972,0.6993593695553113,0.015734312595491462,0,0,0,0,0.0,0.0,0.0,-15462,0,-0.41445305170611413,0.0
12815,48139,Ellis,Texas,2004,11640,34602,202,46444,0.2506244078890707,0.745026268193954,0.004349323916975282,1011,-385,8511,9137,-0.03428190996012648,-0.01138498867851618,0.045666898638642706,-22962,-7500,-0.4944018603048833,-0.07994880859876918
12816,48139,Ellis,Texas,2008,15333,38078,442,53853,0.28471951423319036,0.7070729578667855,0.00820752790002414,3693,240,3476,7409,0.03409510634411966,0.0038582039830488577,-0.03795331032716853,-22745,217,-0.4223534436335951,0.0720484166712882
12817,48139,Ellis,Texas,2012,13881,39574,799,54254,0.25585210307074135,0.7294208721937553,0.014727024735503374,-1452,357,1496,401,-0.028867411162449008,0.006519496835479234,0.02234791432696981,-25693,-2948,-0.47356876912301393,-0.05121532548941882
12818,48139,Ellis,Texas,2016,16253,44941,2479,63673,0.2552573304226281,0.705809369748559,0.03893329982881284,2372,1680,5367,9419,-0.0005947726481132509,0.02420627509330947,-0.023611502445196275,-28688,-2995,-0.4505520393259309,0.023016729797083024
12819,48141,El Paso,Texas,2000,83848,57574,3620,145042,0.5780946208684381,0.3969470911873802,0.024958287944181687,0,0,0,0,0.0,0.0,0.0,26274,0,0.1811475296810579,0.0
12820,48141,El Paso,Texas,2004,95142,73261,1170,169573,0.5610680945669416,0.4320322221108313,0.006899683322227006,11294,-2450,15687,24531,-0.01702652630149648,-0.01805860462195468,0.03508513092345111,21881,-4393,0.1290358724561103,-0.052111657224947594
12821,48141,El Paso,Texas,2008,122021,61783,1826,185630,0.65733448257286,0.3328287453536605,0.009836772073479503,26879,656,-11478,16057,0.09626638800591836,0.002937088751252497,-0.09920347675717078,60238,38357,0.32450573721919945,0.19546986476308914
12822,48141,El Paso,Texas,2012,112952,57150,2601,172703,0.6540245392378824,0.33091492330764377,0.015060537454473865,-9069,775,-4633,-12927,-0.003309943334977583,0.005223765380994363,-0.0019138220460167554,55802,-4436,0.3231096159302386,-0.0013961212889608277
12823,48141,El Paso,Texas,2016,147843,55512,10653,214008,0.6908293147919704,0.2593921722552428,0.04977851295278681,34891,8052,-1638,41305,0.03680477555408801,0.034717975498312945,-0.07152275105240097,92331,36529,0.4314371425367276,0.10832752660648898
12824,48143,Erath,Texas,2000,2804,8126,185,11115,0.2522717049032839,0.7310841205578048,0.016644174538911382,0,0,0,0,0.0,0.0,0.0,-5322,0,-0.47881241565452093,0.0
12825,48143,Erath,Texas,2004,2710,9506,65,12281,0.22066606953831122,0.7740412018565264,0.005292728605162446,-94,-120,1380,1166,-0.031605635364972656,-0.011351445933748936,0.042957081298721556,-6796,-1474,-0.5533751323182151,-0.07456271666369418
12826,48143,Erath,Texas,2008,3128,10768,123,14019,0.22312575789999287,0.7681004351237606,0.008773806976246523,418,58,1262,1738,0.0024596883616816445,0.003481078371084077,-0.005940766732765779,-7640,-844,-0.5449746772237677,0.008400455094447423
12827,48143,Erath,Texas,2012,1965,10329,179,12473,0.15754028701996312,0.8281087148240199,0.014350998156016996,-1163,56,-439,-1546,-0.06558547088002975,0.005577191179770473,0.06000827970025935,-8364,-724,-0.6705684278040568,-0.1255937505802891
12828,48143,Erath,Texas,2016,2160,11210,523,13893,0.1554739797020082,0.8068811631757,0.0376448571222918,195,344,881,1420,-0.002066307317954902,0.023293858966274804,-0.02122755164831991,-9050,-686,-0.6514071834736919,0.019161244330364924
12829,48145,Falls,Texas,2000,2417,3239,59,5715,0.4229221347331584,0.5667541557305337,0.010323709536307962,0,0,0,0,0.0,0.0,0.0,-822,0,-0.1438320209973753,0.0
12830,48145,Falls,Texas,2004,2427,3454,21,5902,0.41121653676719755,0.5852253473398847,0.003558115892917655,10,-38,215,187,-0.011705597965960823,-0.006765593643390307,0.018471191609351068,-1027,-205,-0.1740088105726872,-0.03017678957531189
12831,48145,Falls,Texas,2008,2225,3328,46,5599,0.3973923914984819,0.5943918556885158,0.008215752813002321,-202,25,-126,-303,-0.01382414526871567,0.004657636920084666,0.009166508348631086,-1103,-76,-0.19699946419003395,-0.022990653617346757
12832,48145,Falls,Texas,2012,2033,3356,45,5434,0.3741258741258741,0.6175929333824071,0.008281192491718808,-192,-1,28,-165,-0.023266517372607765,6.543967871648626e-05,0.023201077693891237,-1323,-220,-0.24346705925653295,-0.046467595066499
12833,48145,Falls,Texas,2016,1684,3441,123,5248,0.3208841463414634,0.6556783536585366,0.0234375,-349,78,85,-186,-0.05324172778441072,0.015156307508281192,0.03808542027612949,-1757,-434,-0.33479420731707316,-0.09132714806054021
12834,48147,Fannin,Texas,2000,4102,6074,164,10340,0.3967117988394584,0.5874274661508704,0.01586073500967118,0,0,0,0,0.0,0.0,0.0,-1972,0,-0.19071566731141198,0.0
12835,48147,Fannin,Texas,2004,4001,7893,66,11960,0.33453177257525085,0.6599498327759198,0.005518394648829431,-101,-98,1819,1620,-0.062180026264207544,-0.01034234036084175,0.0725223666250494,-3892,-1920,-0.32541806020066893,-0.13470239288925695
12836,48147,Fannin,Texas,2008,3464,8092,138,11694,0.29622028390627675,0.6919787925431845,0.011800923550538737,-537,72,199,-266,-0.0383114886689741,0.006282528901709306,0.03202895976726472,-4628,-736,-0.39575850863690776,-0.07034044843623882
12837,48147,Fannin,Texas,2012,2486,8161,157,10804,0.23009996297667532,0.7553683820807109,0.014531654942613846,-978,19,69,-890,-0.06612032092960143,0.0027307313920751086,0.06338958953752638,-5675,-1047,-0.5252684191040355,-0.1295099104671278
12838,48147,Fannin,Texas,2016,2132,9548,364,12044,0.17701760212553969,0.7927598804383925,0.030222517436067752,-354,207,1387,1240,-0.05308236085113563,0.015690862493453906,0.03739149835768163,-7416,-1741,-0.6157422783128528,-0.09047385920881723
12839,48149,Fayette,Texas,2000,2542,6658,187,9387,0.27080004261212315,0.7092787898157026,0.019921167572174284,0,0,0,0,0.0,0.0,0.0,-4116,0,-0.43847874720357943,0.0
12840,48149,Fayette,Texas,2004,2803,7527,67,10397,0.2695969991343657,0.723958834279119,0.006444166586515341,261,-120,869,1010,-0.0012030434777574595,-0.013477000985658943,0.01468004446341642,-4724,-608,-0.4543618351447533,-0.01588308794117388
12841,48149,Fayette,Texas,2008,3014,7582,169,10765,0.2799814212726428,0.7043195541105435,0.01569902461681375,211,102,55,368,0.010384422138277116,0.009254858030298407,-0.019639280168575524,-4568,156,-0.4243381328379007,0.03002370230685264
12842,48149,Fayette,Texas,2012,2315,8106,160,10581,0.21878839429165486,0.7660901616104338,0.01512144409791135,-699,-9,524,-184,-0.06119302698098794,-0.0005775805189023979,0.06177060749989027,-5791,-1223,-0.5473017673187789,-0.12296363448087821
12843,48149,Fayette,Texas,2016,2144,8743,287,11174,0.19187399319849652,0.7824413817791301,0.025684625022373366,-171,127,637,593,-0.026914401093158347,0.010563180924462016,0.01635122016869639,-6599,-808,-0.5905673885806336,-0.043265621261854736
12844,48151,Fisher,Texas,2000,884,968,20,1872,0.4722222222222222,0.5170940170940171,0.010683760683760684,0,0,0,0,0.0,0.0,0.0,-84,0,-0.044871794871794934,0.0
12845,48151,Fisher,Texas,2004,758,1161,4,1923,0.39417576703068125,0.6037441497659907,0.0020800832033281333,-126,-16,193,51,-0.07804645519154096,-0.00860367748043255,0.08665013267197352,-403,-319,-0.20956838273530942,-0.1646965878635145
12846,48151,Fisher,Texas,2008,687,1083,14,1784,0.3850896860986547,0.6070627802690582,0.007847533632286996,-71,10,-78,-139,-0.009086080932026563,0.005767450428958862,0.0033186305030675767,-396,7,-0.22197309417040356,-0.01240471143509414
12847,48151,Fisher,Texas,2012,512,1094,23,1629,0.31430325352977284,0.6715776550030693,0.014119091467157766,-175,9,11,-155,-0.07078643256888184,0.00627155783487077,0.06451487473401107,-582,-186,-0.3572744014732965,-0.13530130730289291
12848,48151,Fisher,Texas,2016,403,1265,61,1729,0.23308270676691728,0.7316367842683632,0.035280508964719494,-109,38,171,100,-0.08122054676285556,0.02116141749756173,0.06005912926529389,-862,-280,-0.4985540775014459,-0.14127967602814945
12849,48153,Floyd,Texas,2000,580,1830,10,2420,0.2396694214876033,0.756198347107438,0.004132231404958678,0,0,0,0,0.0,0.0,0.0,-1250,0,-0.5165289256198348,0.0
12850,48153,Floyd,Texas,2004,545,2032,7,2584,0.21091331269349844,0.7863777089783281,0.0027089783281733747,-35,-3,202,164,-0.028756108794104868,-0.0014232530767853031,0.030179361870890098,-1487,-237,-0.5754643962848297,-0.05893547066499494
12851,48153,Floyd,Texas,2008,730,1784,7,2521,0.2895676318921063,0.7076556921856406,0.002776675922253074,185,0,-248,-63,0.07865431919860788,6.76975940796993e-05,-0.07872201679268753,-1054,433,-0.4180880602935343,0.1573763359912954
12852,48153,Floyd,Texas,2012,551,1523,11,2085,0.2642685851318945,0.7304556354916067,0.005275779376498801,-179,4,-261,-436,-0.02529904676021183,0.0024991034542457273,0.02279994330596613,-972,82,-0.46618705035971225,-0.04809899006617796
12853,48153,Floyd,Texas,2016,435,1474,50,1959,0.222052067381317,0.7524247064828994,0.025523226135783564,-116,39,-49,-126,-0.0422165177505775,0.020247446759284762,0.02196907099129264,-1039,-67,-0.5303726391015824,-0.06418558874187014
12854,48155,Foard,Texas,2000,263,286,7,556,0.47302158273381295,0.5143884892086331,0.012589928057553957,0,0,0,0,0.0,0.0,0.0,-23,0,-0.041366906474820164,0.0
12855,48155,Foard,Texas,2004,235,347,5,587,0.40034071550255534,0.5911413969335605,0.008517887563884156,-28,-2,61,31,-0.0726808672312576,-0.0040720404936698,0.07675290772492738,-112,-89,-0.19080068143100515,-0.14943377495618498
12856,48155,Foard,Texas,2008,198,327,13,538,0.3680297397769517,0.6078066914498141,0.024163568773234202,-37,8,-20,-49,-0.03231097572560365,0.015645681209350046,0.016665294516253648,-129,-17,-0.23977695167286245,-0.0489762702418573
12857,48155,Foard,Texas,2012,140,348,7,495,0.2828282828282828,0.703030303030303,0.014141414141414142,-58,-6,21,-43,-0.08520145694866887,-0.01002215463182006,0.09522361158048886,-208,-79,-0.4202020202020202,-0.18042506852915774
12858,48155,Foard,Texas,2016,113,383,17,513,0.2202729044834308,0.746588693957115,0.03313840155945419,-27,10,35,18,-0.06255537834485203,0.018996987418040047,0.04355839092681202,-270,-62,-0.5263157894736843,-0.1061137692716641
12859,48157,Fort Bend,Texas,2000,47569,73567,2373,123509,0.38514602174740303,0.5956408035041981,0.0192131747483989,0,0,0,0,0.0,0.0,0.0,-25998,0,-0.2104947817567951,0.0
12860,48157,Fort Bend,Texas,2004,68722,93625,822,163169,0.42117068805961916,0.5737915903143367,0.005037721626044163,21153,-1551,20058,39660,0.036024666312216125,-0.014175453122354739,-0.02184921318986144,-24903,1095,-0.15262090225471753,0.05787387950207756
12861,48157,Fort Bend,Texas,2008,98368,103206,1248,202822,0.4849966966108213,0.5088501247399198,0.006153178649258956,29646,426,9581,39653,0.06382600855120213,0.0011154570232147932,-0.06494146557441693,-4838,20065,-0.023853428129098464,0.12876747412561906
12862,48157,Fort Bend,Texas,2012,101144,116126,2219,219489,0.4608158039810651,0.5290743499674243,0.010109846051510553,2776,971,12920,16667,-0.0241808926297562,0.003956667402251597,0.020224225227504555,-14982,-10144,-0.06825854598635922,-0.044405117857260756
12863,48157,Fort Bend,Texas,2016,134686,117291,10089,262066,0.5139392366808361,0.44756282768462907,0.03849793563453481,33542,7870,1165,42577,0.05312343269977099,0.02838808958302426,-0.08151152228279523,17395,32377,0.066376408996207,0.13463495498256622
12864,48159,Franklin,Texas,2000,1018,2420,34,3472,0.2932027649769585,0.6970046082949308,0.009792626728110598,0,0,0,0,0.0,0.0,0.0,-1402,0,-0.4038018433179723,0.0
12865,48159,Franklin,Texas,2004,1011,3185,21,4217,0.23974389376333888,0.755276262746028,0.004979843490633152,-7,-13,765,745,-0.05345887121361964,-0.004812783237477447,0.058271654451097166,-2174,-772,-0.5155323689826892,-0.11173052566471686
12866,48159,Franklin,Texas,2008,1036,3392,63,4491,0.23068358940102426,0.7552883544867512,0.014028056112224449,25,42,207,274,-0.009060304362314614,0.009048212621591297,1.2091740723252364e-05,-2356,-182,-0.524604765085727,-0.009072396103037783
12867,48159,Franklin,Texas,2012,751,3446,60,4257,0.17641531595019966,0.8094902513507165,0.014094432699083862,-285,-3,54,-234,-0.054268273450824606,6.637658685941343e-05,0.05420189686396526,-2695,-339,-0.6330749354005168,-0.1084701703147899
12868,48159,Franklin,Texas,2016,665,3585,130,4380,0.15182648401826485,0.8184931506849316,0.02968036529680365,-86,70,139,123,-0.024588831931934813,0.015585932597719789,0.009002899334215053,-2920,-225,-0.6666666666666667,-0.03359173126614989
12869,48161,Freestone,Texas,2000,2316,4247,78,6641,0.3487426592380666,0.6395121216684234,0.011745219093510013,0,0,0,0,0.0,0.0,0.0,-1931,0,-0.29076946243035684,0.0
12870,48161,Freestone,Texas,2004,2070,5057,34,7161,0.2890657729367407,0.7061862868314481,0.0047479402318111995,-246,-44,810,520,-0.05967688630132589,-0.006997278861698814,0.06667416516302471,-2987,-1056,-0.41712051389470745,-0.1263510514643506
12871,48161,Freestone,Texas,2008,2034,5205,49,7288,0.27908891328210755,0.7141877058177827,0.00672338090010977,-36,15,148,127,-0.00997685965463313,0.0019754406682985703,0.008001418986334552,-3171,-184,-0.4350987925356751,-0.017978278640967682
12872,48161,Freestone,Texas,2012,1850,5646,74,7570,0.24438573315719947,0.7458388375165126,0.00977542932628798,-184,25,441,282,-0.034703180124908084,0.00305204842617821,0.031651131698729906,-3796,-625,-0.5014531043593131,-0.06635431182363799
12873,48161,Freestone,Texas,2016,1471,6026,187,7684,0.19143675169182717,0.7842269651223321,0.024336283185840708,-379,113,380,114,-0.0529489814653723,0.014560853859552728,0.038388127605819555,-4555,-759,-0.592790213430505,-0.09133710907119186
12874,48163,Frio,Texas,2000,2317,1774,37,4128,0.5612887596899225,0.42974806201550386,0.008963178294573644,0,0,0,0,0.0,0.0,0.0,543,0,0.13154069767441867,0.0
12875,48163,Frio,Texas,2004,1931,1991,8,3930,0.49134860050890583,0.5066157760814249,0.002035623409669211,-386,-29,217,-198,-0.0699401591810167,-0.0069275548849044325,0.07686771406592108,-60,-603,-0.01526717557251911,-0.14680787324693778
12876,48163,Frio,Texas,2008,2405,1644,13,4062,0.5920728705071393,0.40472673559822747,0.003200393894633186,474,5,-347,132,0.10072426999823347,0.0011647704849639747,-0.10188904048319747,761,821,0.18734613490891183,0.20261331048143094
12877,48163,Frio,Texas,2012,2376,1559,33,3968,0.5987903225806451,0.3928931451612903,0.008316532258064516,-29,20,-85,-94,0.006717452073505825,0.005116138363431329,-0.011833590436937158,817,56,0.20589717741935482,0.018551042510442983
12878,48163,Frio,Texas,2016,2444,1856,100,4400,0.5554545454545454,0.4218181818181818,0.022727272727272728,68,67,297,432,-0.043335777126099706,0.014410740469208212,0.0289250366568915,588,-229,0.1336363636363636,-0.0722608137829912
12879,48165,Gaines,Texas,2000,723,2691,45,3459,0.20901994796183868,0.7779705117085863,0.013009540329575022,0,0,0,0,0.0,0.0,0.0,-1968,0,-0.5689505637467477,0.0
12880,48165,Gaines,Texas,2004,608,3540,16,4164,0.14601344860710855,0.8501440922190202,0.0038424591738712775,-115,-29,849,705,-0.06300649935473013,-0.009167081155703744,0.07217358051043388,-2932,-964,-0.7041306436119117,-0.135180079865164
12881,48165,Gaines,Texas,2008,650,3385,32,4067,0.1598229653307106,0.832308827145316,0.007868207523973445,42,16,-155,-97,0.013809516723602061,0.004025748350102167,-0.017835265073704254,-2735,197,-0.6724858618146053,0.03164478179730634
12882,48165,Gaines,Texas,2012,535,3484,47,4066,0.13157894736842105,0.8568617806197737,0.011559272011805214,-115,15,99,-1,-0.028244017962289564,0.003691064487831769,0.02455295347445774,-2949,-214,-0.7252828332513527,-0.05279697143674733
12883,48165,Gaines,Texas,2016,597,3907,116,4620,0.1292207792207792,0.8456709956709957,0.025108225108225107,62,69,423,554,-0.002358168147641837,0.013548953096419894,-0.01119078494877801,-3310,-361,-0.7164502164502164,0.008832616801136228
12884,48167,Galveston,Texas,2000,40020,50397,2566,92983,0.43040125614359614,0.5420023014959724,0.027596442360431475,0,0,0,0,0.0,0.0,0.0,-10377,0,-0.11160104535237625,0.0
12885,48167,Galveston,Texas,2004,43919,61290,772,105981,0.4144044687255263,0.5783112067257339,0.007284324548739869,3899,-1794,10893,12998,-0.01599678741806987,-0.020312117811691607,0.03630890522976149,-17371,-6994,-0.1639067380002076,-0.05230569264783136
12886,48167,Galveston,Texas,2008,41805,62258,941,105004,0.39812769037370005,0.5929107462572855,0.008961563369014514,-2114,169,968,-977,-0.016276778351826227,0.0016772388202746452,0.014599539531551575,-20453,-3082,-0.1947830558835854,-0.030876317883377802
12887,48167,Galveston,Texas,2012,39511,69059,1508,110078,0.3589363905594215,0.6273642326350406,0.01369937680553789,-2294,567,6801,5074,-0.039191299814278546,0.004737813436523377,0.03445348637775514,-29548,-9095,-0.2684278420756191,-0.07364478619203368
12888,48167,Galveston,Texas,2016,43658,73757,5488,122903,0.35522322481957314,0.6001236747679064,0.04465310041252044,4147,3980,4698,12825,-0.0037131657398483675,0.03095372360698255,-0.027240557867134196,-30099,-551,-0.24490044994833327,0.02352739212728583
12889,48169,Garza,Texas,2000,454,1302,14,1770,0.25649717514124293,0.735593220338983,0.007909604519774011,0,0,0,0,0.0,0.0,0.0,-848,0,-0.4790960451977401,0.0
12890,48169,Garza,Texas,2004,326,1480,6,1812,0.17991169977924945,0.8167770419426048,0.0033112582781456954,-128,-8,178,42,-0.07658547536199348,-0.004598346241628316,0.08118382160362181,-1154,-306,-0.6368653421633553,-0.15776929696561526
12891,48169,Garza,Texas,2008,375,1356,19,1750,0.21428571428571427,0.7748571428571429,0.010857142857142857,49,13,-124,-62,0.03437401450646482,0.007545884578997162,-0.0419198990854619,-981,173,-0.5605714285714286,0.07629391359192672
12892,48169,Garza,Texas,2012,279,1263,18,1560,0.17884615384615385,0.8096153846153846,0.011538461538461539,-96,-1,-93,-190,-0.035439560439560425,0.0006813186813186822,0.034758241758241715,-984,-3,-0.6307692307692307,-0.07019780219780214
12893,48169,Garza,Texas,2016,230,1225,29,1484,0.15498652291105122,0.8254716981132075,0.01954177897574124,-49,11,-38,-76,-0.023859630935102627,0.008003317437279701,0.015856313497822905,-995,-11,-0.6704851752021563,-0.03971594443292559
12894,48171,Gillespie,Texas,2000,1511,8096,313,9920,0.15231854838709677,0.8161290322580645,0.03155241935483871,0,0,0,0,0.0,0.0,0.0,-6585,0,-0.6638104838709677,0.0
12895,48171,Gillespie,Texas,2004,2104,9297,152,11553,0.1821171989959318,0.8047260451830693,0.013156755820998874,593,-161,1201,1633,0.02979865060883502,-0.01839566353383984,-0.011402987074995208,-7193,-608,-0.6226088461871375,0.04120163768383023
12896,48171,Gillespie,Texas,2008,2576,9563,199,12338,0.20878586480791053,0.775085102934025,0.016129032258064516,472,47,266,785,0.026668665811978742,0.0029722764370656417,-0.029640942249044344,-6987,206,-0.5662992381261145,0.05630960806102303
12897,48171,Gillespie,Texas,2012,2055,10306,189,12550,0.16374501992031873,0.821195219123506,0.015059760956175299,-521,-10,743,212,-0.0450408448875918,-0.0010692713018892169,0.04611011618948102,-8251,-1264,-0.6574501992031873,-0.09115096107707277
12898,48171,Gillespie,Texas,2016,2288,10446,480,13214,0.17314968972302103,0.7905252005448766,0.03632510973210232,233,291,140,664,0.009404669802702298,0.02126534877592702,-0.030670018578629388,-8158,93,-0.6173755108218556,0.04007468838133166
12899,48173,Glasscock,Texas,2000,39,528,4,571,0.06830122591943957,0.9246935201401051,0.0070052539404553416,0,0,0,0,0.0,0.0,0.0,-489,0,-0.8563922942206655,0.0
12900,48173,Glasscock,Texas,2004,44,488,1,533,0.0825515947467167,0.9155722326454033,0.001876172607879925,5,-3,-40,-38,0.014250368827277121,-0.005129081332575417,-0.009121287494701757,-444,45,-0.8330206378986866,0.023371656321978906
12901,48173,Glasscock,Texas,2008,52,502,3,557,0.0933572710951526,0.9012567324955116,0.005385996409335727,8,2,14,24,0.010805676348435905,0.0035098238014558024,-0.014315500149891691,-450,-6,-0.8078994614003591,0.02512117649832757
12902,48173,Glasscock,Texas,2012,44,526,8,578,0.07612456747404844,0.9100346020761245,0.01384083044982699,-8,5,24,21,-0.017232703621104156,0.008454834040491263,0.008777869580612885,-482,-32,-0.833910034602076,-0.026010573201716958
12903,48173,Glasscock,Texas,2016,34,553,17,604,0.056291390728476824,0.9155629139072847,0.028145695364238412,-10,9,27,26,-0.01983317674557162,0.014304864914411422,0.005528311831160204,-519,-37,-0.859271523178808,-0.025361488576731928
12904,48175,Goliad,Texas,2000,1233,2108,51,3392,0.36350235849056606,0.6214622641509434,0.015035377358490566,0,0,0,0,0.0,0.0,0.0,-875,0,-0.25795990566037735,0.0
12905,48175,Goliad,Texas,2004,1219,2267,15,3501,0.3481862325049986,0.6475292773493287,0.004284490145672665,-14,-36,159,109,-0.015316125985567475,-0.010750887212817901,0.026067013198385336,-1048,-173,-0.29934304484433016,-0.04138313918395281
12906,48175,Goliad,Texas,2008,1329,2298,28,3655,0.3636114911080711,0.6287277701778385,0.007660738714090287,110,13,31,154,0.015425258603072534,0.003376248568417622,-0.018801507171490206,-969,79,-0.2651162790697674,0.03422676577456274
12907,48175,Goliad,Texas,2012,1127,2294,37,3458,0.3259109311740891,0.6633892423366108,0.010699826489300174,-202,9,-4,-197,-0.037700559933982025,0.003039087775209887,0.034661472158772244,-1167,-198,-0.3374783111625217,-0.07236203209275427
12908,48175,Goliad,Texas,2016,973,2620,115,3708,0.26240560949298813,0.7065803667745415,0.031014023732470336,-154,78,326,250,-0.06350532168110096,0.020314197243170164,0.04319112443793072,-1647,-480,-0.44417475728155337,-0.10669644611903167
12909,48177,Gonzales,Texas,2000,1877,4092,100,6069,0.3092766518372055,0.6742461690558577,0.01647717910693689,0,0,0,0,0.0,0.0,0.0,-2215,0,-0.3649695172186522,0.0
12910,48177,Gonzales,Texas,2004,1709,4291,22,6022,0.2837927598804384,0.7125539687811359,0.0036532713384257723,-168,-78,199,-47,-0.02548389195676709,-0.012823907768511118,0.0383077997252782,-2582,-367,-0.42876120890069747,-0.06379169168204529
12911,48177,Gonzales,Texas,2008,2167,4076,44,6287,0.3446794973755368,0.648321934149833,0.0069985684746301895,458,22,-215,265,0.06088673749509843,0.003345297136204417,-0.06423203463130289,-1909,673,-0.30364243677429614,0.12511877212640132
12912,48177,Gonzales,Texas,2012,1777,4216,64,6057,0.29337956083869904,0.6960541522205712,0.010566286940729735,-390,20,140,-230,-0.05129993653683779,0.0035677184660995453,0.04773221807073824,-2439,-530,-0.40267459138187217,-0.09903215460757603
12913,48177,Gonzales,Texas,2016,1571,4587,176,6334,0.2480265235238396,0.7241869276918219,0.02778654878433849,-206,112,371,277,-0.04535303731485943,0.017220261843608756,0.028132775471250704,-3016,-577,-0.47616040416798233,-0.07348581278611016
12914,48179,Gray,Texas,2000,1376,6732,77,8185,0.16811240073304826,0.8224801466096519,0.009407452657299939,0,0,0,0,0.0,0.0,0.0,-5356,0,-0.6543677458766036,0.0
12915,48179,Gray,Texas,2004,1289,7260,23,8572,0.15037330844610358,0.8469435370975268,0.0026831544563695755,-87,-54,528,387,-0.017739092286944674,-0.006724298200930363,0.024463390487874936,-5971,-615,-0.6965702286514233,-0.04220248277481964
12916,48179,Gray,Texas,2008,1153,6924,56,8133,0.14176810525021516,0.8513463666543711,0.0068855280954137465,-136,33,-336,-439,-0.008605203195888422,0.004202373639044171,0.004402829556844345,-5771,200,-0.7095782614041559,-0.013008032752732657
12917,48179,Gray,Texas,2012,886,6443,60,7389,0.11990797130870212,0.8719718500473677,0.008120178643930167,-267,4,-481,-744,-0.021860133941513038,0.0012346505485164201,0.020625483392996524,-5557,214,-0.7520638787386655,-0.04248561733450962
12918,48179,Gray,Texas,2016,701,6500,204,7405,0.09466576637407158,0.8777852802160703,0.027548953409858204,-185,144,57,16,-0.025242204934630544,0.01942877476592804,0.005813430168702616,-5799,-242,-0.7831195138419987,-0.0310556351033332
12919,48181,Grayson,Texas,2000,13647,25596,697,39940,0.3416875312969454,0.6408612919379069,0.017451176765147722,0,0,0,0,0.0,0.0,0.0,-11949,0,-0.29917376064096146,0.0
12920,48181,Grayson,Texas,2004,13452,30777,194,44423,0.3028161087724827,0.6928167840983275,0.0043671071291898345,-195,-503,5181,4483,-0.038871422524462684,-0.013084069635957887,0.05195549216042061,-17325,-5376,-0.39000067532584476,-0.0908269146848833
12921,48181,Grayson,Texas,2008,13900,31136,528,45564,0.3050654025107541,0.6833465016240892,0.011588095865156703,448,334,359,1141,0.002249293738271374,0.007220988735966868,-0.009470282474238312,-17236,89,-0.3782810991133351,0.011719576212509686
12922,48181,Grayson,Texas,2012,10670,30936,658,42264,0.25246072307401096,0.7319704713231119,0.015568805602877153,-3230,130,-200,-3300,-0.05260467943674313,0.00398070973772045,0.04862396969902272,-20266,-3030,-0.4795097482491009,-0.10122864913576585
12923,48181,Grayson,Texas,2016,10301,35325,1790,47416,0.21724734266914122,0.745001687194196,0.03775097013666273,-369,1132,4389,5152,-0.03521338040486974,0.02218216453378558,0.013031215871084134,-25024,-4758,-0.5277543445250548,-0.048244596275953844
12924,48183,Gregg,Texas,2000,11244,26739,450,38433,0.2925610803215986,0.6957302318320193,0.011708687846382015,0,0,0,0,0.0,0.0,0.0,-15495,0,-0.4031691515104207,0.0
12925,48183,Gregg,Texas,2004,12306,29939,153,42398,0.2902495400726449,0.7061417991414689,0.0036086607858861267,1062,-297,3200,3965,-0.002311540248953692,-0.008100027060495889,0.010411567309449588,-17633,-2138,-0.415892259068824,-0.01272310755840328
12926,48183,Gregg,Texas,2008,13166,29203,241,42610,0.30898850035203,0.6853555503402957,0.0056559493076742545,860,88,-736,212,0.018738960279385097,0.002047288521788128,-0.02078624880117319,-16037,1596,-0.3763670499882657,0.03952520908055829
12927,48183,Gregg,Texas,2012,12398,28742,367,41507,0.2986966053918616,0.6924615125159611,0.008841882092177223,-768,126,-461,-1103,-0.010291894960168413,0.0031859327845029685,0.007105962175665392,-16344,-307,-0.3937649071240995,-0.017397857135833805
12928,48183,Gregg,Texas,2016,11677,28764,1308,41749,0.2796953220436418,0.688974586217634,0.03133009173872428,-721,941,22,242,-0.019001283348219822,0.022488209646547058,-0.003486926298327142,-17087,-743,-0.4092792641739922,-0.01551435704989268
12929,48185,Grimes,Texas,2000,2450,4197,155,6802,0.3601881799470744,0.6170244045868862,0.0227874154660394,0,0,0,0,0.0,0.0,0.0,-1747,0,-0.2568362246398118,0.0
12930,48185,Grimes,Texas,2004,2713,5263,54,8030,0.3378580323785803,0.6554171855541718,0.0067247820672478205,263,-101,1066,1228,-0.022330147568494108,-0.01606263339879158,0.0383927809672856,-2550,-803,-0.3175591531755915,-0.06072292853577971
12931,48185,Grimes,Texas,2008,2704,5562,56,8322,0.3249218937755347,0.6683489545782264,0.0067291516462388845,-9,2,299,292,-0.0129361386030456,4.3695789910640215e-06,0.012931769024054574,-2858,-308,-0.3434270608026917,-0.025867907627100173
12932,48185,Grimes,Texas,2012,2339,6141,121,8601,0.2719451226601558,0.713986745727241,0.014068131612603186,-365,65,579,279,-0.05297677111537891,0.007338979966364302,0.04563779114901456,-3802,-944,-0.44204162306708517,-0.09861456226439347
12933,48185,Grimes,Texas,2016,2194,7065,274,9533,0.23014790726948495,0.7411098290150006,0.02874226371551453,-145,153,924,932,-0.041797215390670855,0.014674132102911344,0.027123083287759586,-4871,-1069,-0.5109619217455156,-0.06892029867843041
12934,48187,Guadalupe,Texas,2000,8311,21499,757,30567,0.2718945267772434,0.7033402034874211,0.024765269735335493,0,0,0,0,0.0,0.0,0.0,-13188,0,-0.4314456767101777,0.0
12935,48187,Guadalupe,Texas,2004,10290,28208,254,38752,0.26553468208092484,0.7279108175061932,0.006554500412881916,1979,-503,6709,8185,-0.006359844696318562,-0.01821076932245358,0.02457061401877214,-17918,-4730,-0.4623761354252684,-0.030930458715090703
12936,48187,Guadalupe,Texas,2008,16156,30869,535,47560,0.33969722455845247,0.649053826745164,0.011248948696383515,5866,281,2661,8808,0.07416254247752763,0.004694448283501599,-0.07885699076102926,-14713,3205,-0.3093566021867115,0.15301953323855688
12937,48187,Guadalupe,Texas,2012,15744,33117,765,49626,0.3172530528352073,0.6673316406722283,0.015415306492564382,-412,230,2248,2066,-0.022444171723245143,0.004166357796180867,0.01827781392706429,-17373,-2660,-0.35007858783702095,-0.040721985650309434
12938,48187,Guadalupe,Texas,2016,18391,36632,2799,57822,0.31806232921725297,0.633530490124866,0.048407180657881084,2647,2034,3515,8196,0.0008092763820456428,0.0329918741653167,-0.033801150547362324,-18241,-868,-0.315468160907613,0.03461042692940797
12939,48189,Hale,Texas,2000,2158,6868,84,9110,0.23688254665203073,0.7538968166849616,0.009220636663007684,0,0,0,0,0.0,0.0,0.0,-4710,0,-0.5170142700329308,0.0
12940,48189,Hale,Texas,2004,2078,8025,51,10154,0.20464841441796336,0.7903289344100847,0.00502265117195194,-80,-33,1157,1044,-0.032234132234067375,-0.004197985491055744,0.036432117725123114,-5947,-1237,-0.5856805199921213,-0.06866624995919057
12941,48189,Hale,Texas,2008,2708,7171,64,9943,0.27235240872975963,0.7212109021422106,0.00643668912802977,630,13,-854,-211,0.06770399431179627,0.0014140379560778297,-0.06911803226787405,-4463,1484,-0.448858493412451,0.13682202657967035
12942,48189,Hale,Texas,2012,2243,6490,121,8854,0.2533318274226338,0.7330020329794443,0.013666139597921843,-465,57,-681,-1089,-0.019020581307125806,0.007229450469892073,0.01179113083723371,-4247,216,-0.4796702055568105,-0.030811712144359515
12943,48189,Hale,Texas,2016,2101,6366,391,8858,0.23718672386543238,0.7186723865432377,0.04414088959132987,-142,270,-124,4,-0.016145103557201446,0.030474749993408025,-0.0143296464362066,-4265,-18,-0.48148566267780535,-0.0018154571209948456
12944,48191,Hall,Texas,2000,472,966,8,1446,0.326417704011065,0.6680497925311203,0.005532503457814661,0,0,0,0,0.0,0.0,0.0,-494,0,-0.3416320885200553,0.0
12945,48191,Hall,Texas,2004,413,860,4,1277,0.32341425215348474,0.6734534064212999,0.0031323414252153485,-59,-4,-106,-169,-0.003003451857580275,-0.002400162032599313,0.005403613890179626,-447,47,-0.3500391542678152,-0.008407065747759901
12946,48191,Hall,Texas,2008,324,930,10,1264,0.2563291139240506,0.7357594936708861,0.007911392405063292,-89,6,70,-13,-0.06708513822943413,0.004779050979847943,0.062306087249586195,-606,-159,-0.4794303797468355,-0.12939122547902032
12947,48191,Hall,Texas,2012,265,832,12,1109,0.23895401262398558,0.7502254283137962,0.010820559062218215,-59,2,-98,-155,-0.017375101300065032,0.0029091666571549237,0.014465934642910128,-567,39,-0.5112714156898106,-0.031841035942975104
12948,48191,Hall,Texas,2016,164,893,34,1091,0.15032080659945005,0.8185151237396884,0.031164069660861594,-101,22,61,-18,-0.08863320602453553,0.02034351059864338,0.06828969542589214,-729,-162,-0.6681943171402384,-0.15692290145042775
12949,48193,Hamilton,Texas,2000,878,2447,51,3376,0.26007109004739337,0.7248222748815166,0.015106635071090047,0,0,0,0,0.0,0.0,0.0,-1569,0,-0.46475118483412325,0.0
12950,48193,Hamilton,Texas,2004,845,2856,29,3730,0.22654155495978553,0.7656836461126005,0.007774798927613941,-33,-22,409,354,-0.03352953508760784,-0.007331836143476106,0.04086137123108391,-2011,-442,-0.539142091152815,-0.07439090631869172
12951,48193,Hamilton,Texas,2008,863,2876,39,3778,0.22842773954473267,0.7612493382742191,0.010322922181048173,18,10,20,48,0.0018861845849471315,0.002548123253434232,-0.0044343078383813905,-2013,-2,-0.5328215987294864,0.00632049242332855
12952,48193,Hamilton,Texas,2012,591,2918,43,3552,0.16638513513513514,0.821509009009009,0.012105855855855855,-272,4,42,-226,-0.062042604409597524,0.0017829336748076824,0.06025967073478988,-2327,-314,-0.6551238738738738,-0.1223022751443874
12953,48193,Hamilton,Texas,2016,479,3060,81,3620,0.13232044198895027,0.8453038674033149,0.022375690607734807,-112,38,142,68,-0.03406469314618488,0.010269834751878952,0.02379485839430584,-2581,-254,-0.7129834254143645,-0.05785955154049072
12954,48195,Hansford,Texas,2000,198,1874,16,2088,0.09482758620689655,0.8975095785440613,0.007662835249042145,0,0,0,0,0.0,0.0,0.0,-1676,0,-0.8026819923371648,0.0
12955,48195,Hansford,Texas,2004,240,1903,4,2147,0.11178388448998602,0.8863530507685142,0.0018630647414997672,42,-12,29,59,0.016956298283089477,-0.005799770507542378,-0.011156527775547098,-1663,13,-0.7745691662785282,0.02811282605863652
12956,48195,Hansford,Texas,2008,240,1847,15,2102,0.11417697431018078,0.878686964795433,0.007136060894386299,0,11,-56,-45,0.0023930898201947604,0.005272996152886532,-0.007666085973081271,-1607,56,-0.7645099904852521,0.010059175793276087
12957,48195,Hansford,Texas,2012,159,1788,15,1962,0.08103975535168195,0.9113149847094801,0.00764525993883792,-81,0,-59,-140,-0.03313721895849883,0.0005091990444516213,0.03262801991404718,-1629,-22,-0.8302752293577982,-0.06576523887254604
12958,48195,Hansford,Texas,2016,171,1730,46,1947,0.08782742681047766,0.8885464817668207,0.02362609142270159,12,31,-58,-15,0.006787671458795705,0.015980831483863672,-0.02276850294265942,-1559,70,-0.8007190549563431,0.029556174401455082
12959,48197,Hardeman,Texas,2000,566,976,15,1557,0.363519588953115,0.6268464996788696,0.009633911368015413,0,0,0,0,0.0,0.0,0.0,-410,0,-0.26332691072575465,0.0
12960,48197,Hardeman,Texas,2004,480,1214,8,1702,0.282021151586369,0.7132784958871915,0.004700352526439483,-86,-7,238,145,-0.081498437366746,-0.004933558841575931,0.08643199620832187,-734,-324,-0.4312573443008225,-0.16793043357506787
12961,48197,Hardeman,Texas,2008,373,1199,23,1595,0.23385579937304074,0.7517241379310344,0.014420062695924765,-107,15,-15,-107,-0.04816535221332824,0.009719710169485283,0.03844564204384293,-826,-92,-0.5178683385579936,-0.08661099425717111
12962,48197,Hardeman,Texas,2012,302,1176,17,1495,0.2020066889632107,0.7866220735785954,0.01137123745819398,-71,-6,-23,-100,-0.031849110409830045,-0.0030488252377307845,0.03489793564756094,-874,-48,-0.5846153846153846,-0.06674704605739101
12963,48197,Hardeman,Texas,2016,249,1207,57,1513,0.16457369464639787,0.797752808988764,0.03767349636483807,-53,40,31,18,-0.03743299431681282,0.026302258906644088,0.011130735410168624,-958,-84,-0.6331791143423662,-0.04856372972698153
12964,48199,Hardin,Texas,2000,5595,11962,279,17836,0.31369141063018613,0.6706660686252524,0.015642520744561562,0,0,0,0,0.0,0.0,0.0,-6367,0,-0.3569746579950662,0.0
12965,48199,Hardin,Texas,2004,5608,15030,72,20710,0.27078705939159825,0.7257363592467407,0.0034765813616610334,13,-207,3068,2874,-0.04290435123858788,-0.012165939382900528,0.05507029062148838,-9422,-3055,-0.4549492998551425,-0.09797464186007626
12966,48199,Hardin,Texas,2008,3939,16603,160,20702,0.1902714713554246,0.8019998067819535,0.007728721862621969,-1669,88,1573,-8,-0.08051558803617365,0.004252140500960936,0.07626344753521275,-12664,-3242,-0.6117283354265288,-0.15677903557138634
12967,48199,Hardin,Texas,2012,3359,17746,192,21297,0.15772174484669202,0.833262900878058,0.009015354275250036,-580,32,1143,595,-0.032549726508732585,0.0012866324126280674,0.031263094096104505,-14387,-1723,-0.675541156031366,-0.06381282060483717
12968,48199,Hardin,Texas,2016,2780,19606,394,22780,0.12203687445127305,0.860667251975417,0.01729587357330992,-579,202,1860,1483,-0.03568487039541897,0.008280519298059884,0.02740435109735906,-16826,-2439,-0.738630377524144,-0.06308922149277796
12969,48201,Harris,Texas,2000,418267,529159,27396,974822,0.42907012767459085,0.5428262800798505,0.028103592245558678,0,0,0,0,0.0,0.0,0.0,-110892,0,-0.1137561524052596,0.0
12970,48201,Harris,Texas,2004,475865,584723,7380,1067968,0.44557983010726915,0.5475098504824114,0.00691031941031941,57598,-20016,55564,93146,0.016509702432678297,-0.021193272835239266,0.004683570402560955,-108858,2034,-0.10193002037514226,0.011826132030117342
12971,48201,Harris,Texas,2008,590982,571883,8607,1171472,0.5044781266645725,0.48817470669380064,0.007347166641626945,115117,1227,-12840,103504,0.05889829655730333,0.0004368472313075345,-0.05933514378861077,19099,127957,0.016303419970771837,0.1182334403459141
12972,48201,Harris,Texas,2012,587044,586073,15468,1188585,0.49390157203733853,0.4930846342499695,0.013013793712691983,-3938,6861,14190,17113,-0.010576554627233947,0.005666627071065038,0.004909927556168869,971,-18128,0.0008169377873690209,-0.015486482183402817
12973,48201,Harris,Texas,2016,707914,545955,58243,1312112,0.5395225407587158,0.4160887180362652,0.04438874120501908,120870,42775,-40118,123527,0.04562096872137722,0.031374947492327096,-0.07699591621370433,161959,160988,0.12343382272245057,0.12261688493508155
12974,48203,Harrison,Texas,2000,8878,13834,258,22970,0.3865041358293426,0.6022638223770135,0.011232041793643883,0,0,0,0,0.0,0.0,0.0,-4956,0,-0.21575968654767086,0.0
12975,48203,Harrison,Texas,2004,9642,16473,108,26223,0.36769248369751745,0.628188994394234,0.004118521908248484,764,-150,2639,3253,-0.018811652131825174,-0.007113519885395399,0.025925172017220555,-6831,-1875,-0.2604965106967166,-0.04473682414904573
12976,48203,Harrison,Texas,2008,8887,17103,168,26158,0.3397430996253536,0.6538343910084868,0.006422509366159492,-755,60,630,-65,-0.027949384072163852,0.002303987457911008,0.025645396614252802,-8216,-1385,-0.31409129138313324,-0.053594780686416654
12977,48203,Harrison,Texas,2012,8456,17512,202,26170,0.323118074130684,0.669163163928162,0.0077187619411539935,-431,34,409,12,-0.0166250254946696,0.0012962525749945011,0.01532877291967516,-9056,-840,-0.346045089797478,-0.03195379841434476
12978,48203,Harrison,Texas,2016,7151,18749,648,26548,0.26936115714931447,0.7062302244990206,0.02440861835166491,-1305,446,1237,378,-0.05375691698136953,0.016689856410510916,0.03706706057085862,-11598,-2542,-0.43686906734970615,-0.09082397755222815
12979,48205,Hartley,Texas,2000,359,1645,27,2031,0.17676021664204825,0.809945839487937,0.013293943870014771,0,0,0,0,0.0,0.0,0.0,-1286,0,-0.6331856228458888,0.0
12980,48205,Hartley,Texas,2004,315,1736,8,2059,0.152986886838271,0.8431277319086935,0.003885381253035454,-44,-19,91,28,-0.02377332980377725,-0.009408562616979317,0.03318189242075653,-1421,-135,-0.6901408450704225,-0.05695522222453375
12981,48205,Hartley,Texas,2008,250,1711,24,1985,0.12594458438287154,0.8619647355163728,0.012090680100755667,-65,16,-25,-74,-0.02704230245539946,0.008205298847720213,0.01883700360767926,-1461,-40,-0.7360201511335012,-0.04587930606307866
12982,48205,Hartley,Texas,2012,184,1708,21,1913,0.09618400418191322,0.8928384736016728,0.01097752221641401,-66,-3,-3,-72,-0.029760580200958314,-0.0011131578843416572,0.03087373808530003,-1524,-63,-0.7966544694197596,-0.060634318286258426
12983,48205,Hartley,Texas,2016,173,1730,49,1952,0.08862704918032786,0.8862704918032787,0.025102459016393443,-11,28,22,39,-0.007556955001585361,0.014124936799979433,-0.006567981798394129,-1557,-33,-0.7976434426229508,-0.0009889732031912457
12984,48207,Haskell,Texas,2000,1401,1488,38,2927,0.4786470789203963,0.5083703450632047,0.012982576016399043,0,0,0,0,0.0,0.0,0.0,-87,0,-0.029723266142808347,0.0
12985,48207,Haskell,Texas,2004,867,1539,10,2416,0.35885761589403975,0.6370033112582781,0.0041390728476821195,-534,-28,51,-511,-0.11978946302635657,-0.008843503168716923,0.12863296619507347,-672,-585,-0.2781456953642384,-0.24842242922143004
12986,48207,Haskell,Texas,2008,699,1388,29,2116,0.33034026465028354,0.6559546313799622,0.013705103969754254,-168,19,-151,-300,-0.028517351243756206,0.009566031122072135,0.0189513201216841,-689,-17,-0.3256143667296787,-0.04746867136544031
12987,48207,Haskell,Texas,2012,553,1424,36,2013,0.2747143566815698,0.7074018877297565,0.01788375558867362,-146,7,36,-103,-0.05562590796871375,0.004178651618919367,0.0514472563497943,-871,-182,-0.43268753104818675,-0.10707316431850805
12988,48207,Haskell,Texas,2016,314,1403,53,1770,0.17740112994350282,0.7926553672316384,0.029943502824858758,-239,17,-21,-243,-0.09731322673806697,0.012059747236185137,0.08525347950188189,-1089,-218,-0.6152542372881356,-0.1825667062399488
12989,48209,Hays,Texas,2000,11387,20170,2760,34317,0.33181804936328935,0.5877553399189905,0.08042661071772009,0,0,0,0,0.0,0.0,0.0,-8783,0,-0.2559372905557012,0.0
12990,48209,Hays,Texas,2004,20110,27021,692,47823,0.4205089601237898,0.5650210149927859,0.014470024883424294,8723,-2068,6851,13506,0.08869091076050045,-0.0659565858342958,-0.02273432492620464,-6911,1872,-0.1445120548689961,0.11142523568670509
12991,48209,Hays,Texas,2008,28431,29638,983,59052,0.48145702093070514,0.5018966334755809,0.016646345593714015,8321,291,2617,11229,0.06094806080691534,0.002176320710289722,-0.06312438151720501,-1207,5704,-0.02043961254487575,0.12407244232412035
12992,48209,Hays,Texas,2012,25537,31661,1813,59011,0.4327498263035705,0.5365270881700022,0.030723085526427277,-2894,830,2023,-41,-0.04870719462713463,0.014076739932713262,0.034630454694421275,-6124,-4917,-0.10377726186643166,-0.0833376493215559
12993,48209,Hays,Texas,2016,33224,33826,5114,72164,0.4603957652014855,0.4687378748406408,0.07086635995787373,7687,3301,2165,13153,0.027645938897915,0.040143274431446455,-0.06778921332936139,-602,5522,-0.00834210963915527,0.09543515222727639
12994,48211,Hemphill,Texas,2000,251,1203,20,1474,0.17028493894165536,0.816146540027137,0.013568521031207599,0,0,0,0,0.0,0.0,0.0,-952,0,-0.6458616010854816,0.0
12995,48211,Hemphill,Texas,2004,257,1380,6,1643,0.15642118076688982,0.8399269628727937,0.0036518563603164943,6,-14,177,169,-0.01386375817476554,-0.009916664670891105,0.023780422845656624,-1123,-171,-0.6835057821059038,-0.03764418102042222
12996,48211,Hemphill,Texas,2008,216,1345,9,1570,0.1375796178343949,0.856687898089172,0.005732484076433121,-41,3,-35,-73,-0.01884156293249492,0.0020806277161166263,0.016760935216378336,-1129,-6,-0.7191082802547771,-0.035602498148873285
12997,48211,Hemphill,Texas,2012,192,1298,19,1509,0.1272365805168986,0.8601722995361166,0.012591119946984758,-24,10,-47,-61,-0.010343037317496306,0.006858635870551637,0.0034844014469446183,-1106,23,-0.7329357190192181,-0.013827438764440925
12998,48211,Hemphill,Texas,2016,181,1462,52,1695,0.10678466076696165,0.8625368731563422,0.030678466076696165,-11,33,164,186,-0.020451919749936945,0.018087346129711405,0.002364573620225574,-1281,-175,-0.7557522123893805,-0.02281649337016245
12999,48213,Henderson,Texas,2000,8704,16607,316,25627,0.3396417840558786,0.6480274710266516,0.012330744917469856,0,0,0,0,0.0,0.0,0.0,-7903,0,-0.308385686970773,0.0
13000,48213,Henderson,Texas,2004,8505,20210,134,28849,0.29481091199001697,0.7005442129709869,0.004644875038996152,-199,-182,3603,3222,-0.044830872065861616,-0.007685869878473704,0.05251674194433531,-11705,-3802,-0.40573330098096994,-0.09734761401019693
13001,48213,Henderson,Texas,2008,7913,20857,223,28993,0.2729279481254096,0.7193805401303763,0.007691511744214121,-592,89,647,144,-0.021882963864607363,0.0030466367052179684,0.018836327159389432,-12944,-1239,-0.44645259200496673,-0.040719291023996795
13002,48213,Henderson,Texas,2012,6106,21231,290,27627,0.22101567307344264,0.768487349332175,0.010496977594382307,-1807,67,374,-1366,-0.051912275051966966,0.002805465850168186,0.04910680920179866,-15125,-2181,-0.5474716762587324,-0.10101908425376566
13003,48213,Henderson,Texas,2016,5669,23650,726,30045,0.18868364120485936,0.7871526044266933,0.024163754368447327,-437,436,2419,2418,-0.03233203186858327,0.01366677677406502,0.01866525509451833,-17981,-2856,-0.598468963221834,-0.050997286963101573
13004,48215,Hidalgo,Texas,2000,61390,38301,1359,101050,0.6075210291934686,0.3790301830776843,0.013448787728847106,0,0,0,0,0.0,0.0,0.0,23089,0,0.2284908461157843,0.0
13005,48215,Hidalgo,Texas,2004,62369,50931,383,113683,0.5486220455125217,0.44800893713220097,0.003369017355277394,979,-976,12630,12633,-0.058898983680946926,-0.010079770373569712,0.06897875405451664,11438,-11651,0.10061310838032073,-0.12787773773546357
13006,48215,Hidalgo,Texas,2008,90261,39668,1043,130972,0.6891625690987386,0.3028738967107473,0.007963534190514003,27892,660,-11263,17289,0.14054052358621694,0.004594516835236609,-0.14513504042145364,50593,39155,0.3862886723879913,0.2856755640076706
13007,48215,Hidalgo,Texas,2012,97969,39865,1488,139322,0.7031839910423335,0.2861357143882517,0.010680294569414737,7708,445,197,8350,0.014021421943594903,0.002716760378900734,-0.01673818232249563,58104,7511,0.41704827665408184,0.030759604266090534
13008,48215,Hidalgo,Texas,2016,118809,48642,5986,173437,0.6850268397170154,0.28045918690936766,0.03451397337361693,20840,4498,8777,34115,-0.018157151325318144,0.023833678804202195,-0.00567652747888403,70167,12063,0.4045676528076477,-0.012480623846434113
13009,48217,Hill,Texas,2000,3524,7054,157,10735,0.328272007452259,0.6571029343269679,0.014625058220773172,0,0,0,0,0.0,0.0,0.0,-3530,0,-0.3288309268747089,0.0
13010,48217,Hill,Texas,2004,3751,9225,77,13053,0.2873668888378151,0.7067340841185934,0.005899027043591512,227,-80,2171,2318,-0.0409051186144439,-0.00872603117718166,0.04963114979162553,-5474,-1944,-0.4193671952807783,-0.09053626840606943
13011,48217,Hill,Texas,2008,3811,9264,113,13188,0.28897482559902943,0.7024567788898999,0.00856839551107067,60,36,39,135,0.0016079367612143458,0.002669368467479158,-0.004277305228693518,-5453,21,-0.41348195329087045,0.005885241989907863
13012,48217,Hill,Texas,2012,2752,9132,161,12045,0.22847654628476546,0.7581569115815692,0.013366542133665421,-1059,48,-132,-1143,-0.060498279314263964,0.0047981466225947515,0.05570013269166929,-6380,-927,-0.5296803652968037,-0.11619841200593328
13013,48217,Hill,Texas,2016,2547,10108,315,12970,0.1963762528912876,0.779336931380108,0.02428681572860447,-205,154,976,925,-0.03210029339347786,0.01092027359493905,0.021180019798538785,-7561,-1181,-0.5829606784888204,-0.05328031319201665
13014,48219,Hockley,Texas,2000,1419,5250,76,6745,0.21037805782060787,0.7783543365455893,0.011267605633802818,0,0,0,0,0.0,0.0,0.0,-3831,0,-0.5679762787249814,0.0
13015,48219,Hockley,Texas,2004,1385,6160,32,7577,0.18279002243632045,0.8129866701860895,0.0042233073775900755,-34,-44,910,832,-0.027588035384287418,-0.007044298256212742,0.034632333640500224,-4775,-944,-0.630196647749769,-0.06222036902478767
13016,48219,Hockley,Texas,2008,1797,5795,53,7645,0.23505559189012426,0.7580117724002616,0.0069326357096141265,412,21,-365,68,0.05226556945380381,0.002709328332024051,-0.05497489778582787,-3998,777,-0.5229561805101374,0.10724046723963165
13017,48219,Hockley,Texas,2012,1486,5546,102,7134,0.2082982898794505,0.7774039809363611,0.014297729184188394,-311,49,-249,-511,-0.02675730201067375,0.0073650934745742675,0.019392208536099464,-4060,-62,-0.5691056910569106,-0.04614951054677319
13018,48219,Hockley,Texas,2016,1260,5809,242,7311,0.1723430447271235,0.7945561482697305,0.033100807003145945,-226,140,263,177,-0.03595524515232701,0.01880307781895755,0.01715216733336944,-4549,-489,-0.6222131035426071,-0.053107412485696504
13019,48221,Hood,Texas,2000,4704,12429,372,17505,0.26872322193658954,0.7100257069408741,0.02125107112253642,0,0,0,0,0.0,0.0,0.0,-7725,0,-0.44130248500428454,0.0
13020,48221,Hood,Texas,2004,4865,16280,148,21293,0.2284788428121918,0.7645705161320622,0.00695064105574602,161,-224,3851,3788,-0.04024437912439774,-0.014300430066790399,0.05454480919118809,-11415,-3690,-0.5360916733198704,-0.09478918831558586
13021,48221,Hood,Texas,2008,5087,17299,238,22624,0.2248497171145686,0.7646304809052333,0.01051980198019802,222,90,1019,1331,-0.0036291256976231923,0.0035691609244520002,5.996477317116167e-05,-12212,-797,-0.5397807637906648,-0.003689090470794354
13022,48221,Hood,Texas,2012,3843,18409,327,22579,0.17020240046060497,0.8153151158155808,0.014482483723814164,-1244,89,1110,-45,-0.054647316653963635,0.0039626817436161435,0.05068463491034747,-14566,-2354,-0.6451127153549758,-0.10533195156431108
13023,48221,Hood,Texas,2016,4008,21382,872,26262,0.15261594699565914,0.8141801842967025,0.03320386870763841,165,545,2973,3683,-0.017586453464945834,0.018721384983824245,-0.0011349315188783349,-17374,-2808,-0.6615642373010433,-0.01645152194606747
13024,48223,Hopkins,Texas,2000,3692,7076,142,10910,0.3384051329055912,0.6485792850595784,0.013015582034830431,0,0,0,0,0.0,0.0,0.0,-3384,0,-0.3101741521539872,0.0
13025,48223,Hopkins,Texas,2004,3443,8582,37,12062,0.2854418836013928,0.7114906317360306,0.003067484662576687,-249,-105,1506,1152,-0.052963249304198434,-0.009948097372253745,0.06291134667645215,-5139,-1755,-0.4260487481346378,-0.11587459598065059
13026,48223,Hopkins,Texas,2008,3530,9299,90,12919,0.27324096292282685,0.71979255360322,0.006966483473953092,87,53,717,857,-0.01220092067856593,0.0038989988113764047,0.008301921867189477,-5769,-630,-0.4465515906803932,-0.020502842545755406
13027,48223,Hopkins,Texas,2012,2777,9836,140,12753,0.2177526856425939,0.7712695052144594,0.010977809142946758,-753,50,537,-166,-0.05548827728023295,0.0040113256689936665,0.05147695161123933,-7059,-1290,-0.5535168195718655,-0.10696522889147231
13028,48223,Hopkins,Texas,2016,2510,10707,321,13538,0.18540404786526812,0.7908849165312454,0.02371103560348648,-267,181,871,785,-0.03234863777732577,0.012733226460539723,0.019615411316786013,-8197,-1138,-0.6054808686659773,-0.051964049094111786
13029,48225,Houston,Texas,2000,2833,5308,95,8236,0.34397765905779504,0.644487615347256,0.011534725594949004,0,0,0,0,0.0,0.0,0.0,-2475,0,-0.3005099562894609,0.0
13030,48225,Houston,Texas,2004,2921,5848,37,8806,0.331705655235067,0.6640926640926641,0.004201680672268907,88,-58,540,570,-0.012272003822728028,-0.007333044922680097,0.019605048745408138,-2927,-452,-0.3323870088575971,-0.031877052568136166
13031,48225,Houston,Texas,2008,2656,5872,96,8624,0.3079777365491651,0.6808905380333952,0.011131725417439703,-265,59,24,-182,-0.023727918685901905,0.0069300447451707955,0.016797873940731067,-3216,-289,-0.37291280148423006,-0.04052579262663297
13032,48225,Houston,Texas,2012,2265,5880,69,8214,0.27574872169466763,0.7158509861212564,0.008400292184075968,-391,-27,8,-410,-0.03222901485449747,-0.0027314332333637347,0.03496044808786125,-3615,-399,-0.4401022644265888,-0.06718946294235872
13033,48225,Houston,Texas,2016,1978,6205,170,8353,0.23680114928768106,0.7428468813599904,0.020351969352328504,-287,101,325,139,-0.03894757240698657,0.011951677168252536,0.026995895238734025,-4227,-612,-0.5060457320723094,-0.06594346764572062
13034,48227,Howard,Texas,2000,2744,6668,136,9548,0.2873900293255132,0.6983661499790532,0.014243820695433599,0,0,0,0,0.0,0.0,0.0,-3924,0,-0.41097612065354,0.0
13035,48227,Howard,Texas,2004,2663,7480,58,10201,0.261052837957063,0.7332614449563768,0.005685717086560141,-81,-78,812,653,-0.026337191368450197,-0.008558103608873458,0.03489529497732358,-4817,-893,-0.4722086069993138,-0.06123248634577377
13036,48227,Howard,Texas,2008,2545,7029,115,9689,0.2626690060893797,0.7254618639694499,0.0118691299411704,-118,57,-451,-512,0.0016161681323166865,0.0061834128546102585,-0.007799580986926902,-4484,333,-0.4627928578800702,0.009415749119243588
13037,48227,Howard,Texas,2012,2110,6453,132,8695,0.24266820011500861,0.7421506612995975,0.015181138585393904,-435,17,-576,-994,-0.020000805974371094,0.0033120086442235044,0.01668879733014761,-4343,141,-0.4994824611845889,-0.0366896033045187
13038,48227,Howard,Texas,2016,1770,6637,316,8723,0.20291184225610456,0.7608620887309412,0.03622606901295426,-340,184,184,28,-0.03975635785890405,0.02104493042756036,0.018711427431343686,-4867,-524,-0.5579502464748366,-0.05846778529024771
13039,48229,Hudspeth,Texas,2000,380,514,28,922,0.4121475054229935,0.5574837310195228,0.03036876355748373,0,0,0,0,0.0,0.0,0.0,-134,0,-0.14533622559652926,0.0
13040,48229,Hudspeth,Texas,2004,302,577,7,886,0.34085778781038373,0.6512415349887133,0.007900677200902935,-78,-21,63,-36,-0.07128971761260977,-0.022468086356580794,0.09375780396919053,-275,-141,-0.31038374717832956,-0.1650475215818003
13041,48229,Hudspeth,Texas,2008,430,458,10,898,0.47884187082405344,0.5100222717149221,0.011135857461024499,128,3,-119,12,0.1379840830136697,0.003235180260121564,-0.1412192632737912,-28,247,-0.031180400890868654,0.2792033462874609
13042,48229,Hudspeth,Texas,2012,379,471,13,863,0.4391657010428737,0.5457705677867902,0.015063731170336037,-51,3,13,-35,-0.039676169781179715,0.0039278737093115385,0.035748296071868135,-92,-64,-0.1066048667439165,-0.07542446585304785
13043,48229,Hudspeth,Texas,2016,324,503,44,871,0.3719862227324914,0.5774971297359357,0.0505166475315729,-55,31,32,8,-0.06717947831038235,0.03545291636123686,0.03172656194914547,-179,-87,-0.20551090700344432,-0.09890604025952782
13044,48231,Hunt,Texas,2000,7857,16177,432,24466,0.321139540586937,0.6612033025423036,0.01765715687075942,0,0,0,0,0.0,0.0,0.0,-8320,0,-0.34006376195536664,0.0
13045,48231,Hunt,Texas,2004,7971,20065,158,28194,0.28271972760161734,0.7116762431723062,0.00560402922607647,114,-274,3888,3728,-0.03841981298531966,-0.01205312764468295,0.050472940630002516,-12094,-3774,-0.4289565155706888,-0.08889275361532217
13046,48231,Hunt,Texas,2008,8594,20573,357,29524,0.29108521880503996,0.6968229237230728,0.012091857471887279,623,199,508,1330,0.008365491203422615,0.0064878282458108085,-0.014853319449233404,-11979,115,-0.4057377049180328,0.02321881065265602
13047,48231,Hunt,Texas,2012,6671,21011,367,28049,0.23783379086598452,0.749081963706371,0.01308424542764448,-1923,10,438,-1475,-0.053251427939055435,0.0009923879557572016,0.05225903998329828,-14340,-2361,-0.5112481728403865,-0.10551046792235369
13048,48231,Hunt,Texas,2016,6396,23910,1248,31554,0.20270013310515306,0.7577486214109146,0.03955124548393231,-275,881,2899,3505,-0.035133657760831466,0.02646700005628783,0.008666657704543557,-17514,-3174,-0.5550484883057616,-0.043800315465375106
13049,48233,Hutchinson,Texas,2000,1796,7443,112,9351,0.19206501978398033,0.7959576515880654,0.01197732862795423,0,0,0,0,0.0,0.0,0.0,-5647,0,-0.6038926318040851,0.0
13050,48233,Hutchinson,Texas,2004,1503,7839,27,9369,0.16042267050912584,0.8366954851104706,0.002881844380403458,-293,-85,396,18,-0.03164234927485449,-0.00909548424755077,0.04073783352240523,-6336,-689,-0.6762728146013448,-0.07238018279725966
13051,48233,Hutchinson,Texas,2008,1322,7361,78,8761,0.15089601643647985,0.8402008903093254,0.008903093254194727,-181,51,-478,-608,-0.009526654072645996,0.006021248873791268,0.003505405198854783,-6039,297,-0.6893048738728456,-0.013032059271500751
13052,48233,Hutchinson,Texas,2012,1045,6804,79,7928,0.13181130171543895,0.8582240161453077,0.00996468213925328,-277,1,-557,-833,-0.019084714721040896,0.001061588885058553,0.018023125835982312,-5759,280,-0.7264127144298688,-0.03710784055702321
13053,48233,Hutchinson,Texas,2016,854,7042,259,8155,0.10472103004291845,0.863519313304721,0.03175965665236052,-191,180,238,227,-0.027090271672520497,0.02179497451310724,0.005295297159413237,-6188,-429,-0.7587982832618025,-0.032385568831933775
13054,48235,Irion,Texas,2000,162,624,7,793,0.2042875157629256,0.7868852459016393,0.008827238335435058,0,0,0,0,0.0,0.0,0.0,-462,0,-0.5825977301387137,0.0
13055,48235,Irion,Texas,2004,141,684,3,828,0.17028985507246377,0.8260869565217391,0.0036231884057971015,-21,-4,60,35,-0.03399766069046181,-0.005204049929637956,0.039201710620099806,-543,-81,-0.6557971014492754,-0.07319937131056165
13056,48235,Irion,Texas,2008,164,644,9,817,0.200734394124847,0.7882496940024479,0.011015911872705019,23,6,-40,-11,0.03044453905238323,0.007392723466907917,-0.037837262519291204,-480,63,-0.587515299877601,0.0682818015716744
13057,48235,Irion,Texas,2012,112,668,8,788,0.14213197969543148,0.8477157360406091,0.01015228426395939,-52,-1,24,-29,-0.05860241442941552,-0.000863627608745629,0.05946604203816119,-556,-76,-0.7055837563451777,-0.11806845646757669
13058,48235,Irion,Texas,2016,90,660,16,766,0.1174934725848564,0.8616187989556136,0.020887728459530026,-22,8,-8,-22,-0.02463850711057508,0.010735444195570636,0.013903062915004427,-570,-14,-0.7441253263707571,-0.03854157002557945
13059,48237,Jack,Texas,2000,822,2107,45,2974,0.27639542703429726,0.7084734364492267,0.015131136516476126,0,0,0,0,0.0,0.0,0.0,-1285,0,-0.4320780094149294,0.0
13060,48237,Jack,Texas,2004,643,2470,13,3126,0.2056941778630838,0.7901471529110684,0.004158669225847729,-179,-32,363,152,-0.07070124917121345,-0.010972467290628396,0.08167371646184174,-1827,-542,-0.5844529750479845,-0.15237496563305514
13061,48237,Jack,Texas,2008,470,2528,25,3023,0.1554746940125703,0.8362553754548462,0.008269930532583526,-173,12,58,-103,-0.0502194838505135,0.004111261306735797,0.04610822254377778,-2058,-231,-0.6807806814422759,-0.09632770639429133
13062,48237,Jack,Texas,2012,303,2580,25,2908,0.10419532324621733,0.8872077028885832,0.00859697386519945,-167,0,52,-115,-0.05127937076635297,0.00032704333261592347,0.05095232743373701,-2277,-219,-0.7830123796423658,-0.10223169820008993
13063,48237,Jack,Texas,2016,314,2973,63,3350,0.09373134328358208,0.8874626865671642,0.018805970149253733,11,38,393,442,-0.010463979962635248,0.010208996284054283,0.0002549836785810111,-2659,-382,-0.7937313432835821,-0.010718963641216273
13064,48239,Jackson,Texas,2000,1446,3365,45,4856,0.29777594728171336,0.6929571663920923,0.009266886326194398,0,0,0,0,0.0,0.0,0.0,-1919,0,-0.3951812191103789,0.0
13065,48239,Jackson,Texas,2004,1296,3766,15,5077,0.2552688595627339,0.7417766397478827,0.0029545006893834944,-150,-30,401,221,-0.042507087718979486,-0.006312385636810904,0.0488194733557904,-2470,-551,-0.4865077801851488,-0.09132656107476989
13066,48239,Jackson,Texas,2008,1301,3723,44,5068,0.25670876085240724,0.7346093133385951,0.008681925808997633,5,29,-43,-9,0.001439901289673362,0.0057274251196141384,-0.007167326409287522,-2422,48,-0.4779005524861879,0.008607227698960884
13067,48239,Jackson,Texas,2012,1070,3906,49,5025,0.21293532338308457,0.7773134328358209,0.009751243781094527,-231,5,183,-43,-0.04377343746932266,0.0010693179720968945,0.042704119497225745,-2836,-414,-0.5643781094527363,-0.08647755696654835
13068,48239,Jackson,Texas,2016,904,4266,132,5302,0.17050169747265184,0.8046020369671822,0.024896265560165973,-166,83,360,277,-0.04243362591043273,0.015145021779071446,0.02728860413136136,-3362,-526,-0.6341003394945304,-0.06972223004179412
13069,48241,Jasper,Texas,2000,4533,7071,138,11742,0.3860500766479305,0.6021972406745018,0.011752682677567705,0,0,0,0,0.0,0.0,0.0,-2538,0,-0.21614716402657125,0.0
13070,48241,Jasper,Texas,2004,4471,8347,55,12873,0.34731608793599006,0.6484114037131982,0.004272508350811777,-62,-83,1276,1131,-0.03873398871194045,-0.007480174326755929,0.04621416303869641,-3876,-1338,-0.3010953157772081,-0.08494815175063686
13071,48241,Jasper,Texas,2008,3658,9022,96,12776,0.28631809643080774,0.7061678146524734,0.007514088916718848,-813,41,675,-97,-0.060997991505182314,0.003241580565907071,0.05775641093927519,-5364,-1488,-0.4198497182216656,-0.11875440244445751
13072,48241,Jasper,Texas,2012,3423,9957,137,13517,0.2532366649404454,0.7366279499889029,0.010135385070651771,-235,41,935,741,-0.033081431490362356,0.0026212961539329232,0.03046013533642955,-6534,-1170,-0.4833912850484575,-0.0635415668267919
13073,48241,Jasper,Texas,2016,2590,10609,220,13419,0.19300991131977047,0.7905954243982413,0.016394664281988224,-833,83,652,-98,-0.06022675362067492,0.006259279211336453,0.053967474409338356,-8019,-1485,-0.5975855130784709,-0.11419422803001333
13074,48243,Jeff Davis,Texas,2000,283,708,69,1060,0.2669811320754717,0.6679245283018868,0.06509433962264151,0,0,0,0,0.0,0.0,0.0,-425,0,-0.40094339622641506,0.0
13075,48243,Jeff Davis,Texas,2004,378,764,25,1167,0.32390745501285345,0.6546700942587832,0.021422450728363324,95,-44,56,107,0.05692632293738176,-0.043671888894278185,-0.013254434043103558,-386,39,-0.33076263924592975,0.07018075698048531
13076,48243,Jeff Davis,Texas,2008,468,749,19,1236,0.3786407766990291,0.6059870550161812,0.015372168284789644,90,-6,-15,69,0.05473332168617567,-0.00605028244357368,-0.04868303924260198,-281,105,-0.2273462783171521,0.10341636092877765
13077,48243,Jeff Davis,Texas,2012,440,719,33,1192,0.3691275167785235,0.6031879194630873,0.027684563758389263,-28,14,-30,-44,-0.009513259920505612,0.01231239547359962,-0.0027991355530939677,-279,2,-0.23406040268456374,-0.006714124367411645
13078,48243,Jeff Davis,Texas,2016,422,695,74,1191,0.35432409739714527,0.5835432409739715,0.06213266162888329,-18,41,-24,-1,-0.014803419381378247,0.03444809787049403,-0.019644678489115774,-273,6,-0.2292191435768262,0.004841259107737528
13079,48245,Jefferson,Texas,2000,45409,40320,1180,86909,0.5224890402605024,0.4639335396794348,0.013577420060062824,0,0,0,0,0.0,0.0,0.0,5089,0,0.058555500581067566,0.0
13080,48245,Jefferson,Texas,2004,47066,44423,377,91866,0.5123331809374524,0.48356301569677573,0.0041038033657718855,1657,-803,4103,4957,-0.010155859323049965,-0.009473616694290938,0.01962947601734094,2643,-2446,0.02877016524067666,-0.029785335340390906
13081,48245,Jefferson,Texas,2008,44888,42905,637,88430,0.5076105394097026,0.4851860228429266,0.0072034377473708016,-2178,260,-1518,-3436,-0.004722641527749816,0.003099634381598916,0.0016230071461508788,1983,-660,0.022424516566775965,-0.0063456486739006945
13082,48245,Jefferson,Texas,2012,44668,43242,825,88735,0.5033864878571026,0.4873161661125824,0.009297346030314983,-220,188,337,305,-0.004224051552599972,0.0020939082829441813,0.002130143269655771,1426,-557,0.016070321744520222,-0.006354194822255743
13083,48245,Jefferson,Texas,2016,42443,42862,2313,87618,0.4844095962016937,0.4891917185966354,0.02639868520167089,-2225,1488,-380,-1117,-0.01897689165540889,0.01710133917135591,0.0018755524840530224,-419,-1845,-0.00478212239494169,-0.020852444139461912
13084,48247,Jim Hogg,Texas,2000,1512,623,22,2157,0.7009735744089013,0.2888270746407047,0.010199350950394067,0,0,0,0,0.0,0.0,0.0,889,0,0.4121464997681966,0.0
13085,48247,Jim Hogg,Texas,2004,1344,712,9,2065,0.6508474576271186,0.3447941888619855,0.0043583535108958835,-168,-13,89,-92,-0.05012611678178269,-0.005840997439498183,0.05596711422128081,632,-257,0.3060532687651331,-0.1060932310030635
13086,48247,Jim Hogg,Texas,2008,1336,472,7,1815,0.7360881542699724,0.26005509641873276,0.003856749311294766,-8,-2,-240,-250,0.08524069664285383,-0.0005016041996011174,-0.08473909244325273,864,232,0.47603305785123967,0.16997978908610656
13087,48247,Jim Hogg,Texas,2012,1301,356,10,1667,0.7804439112177565,0.21355728854229153,0.00599880023995201,-35,3,-116,-148,0.04435575694778404,0.002142050928657244,-0.04649780787644123,945,81,0.566886622675465,0.0908535648242253
13088,48247,Jim Hogg,Texas,2016,1635,430,54,2119,0.7715903728173666,0.20292590844738084,0.025483718735252476,334,44,74,452,-0.008853538400389827,0.019484918495300464,-0.010631380094910686,1205,260,0.5686644643699859,0.0017778416945208875
13089,48249,Jim Wells,Texas,2000,7418,4498,107,12023,0.616984113781918,0.3741162771354903,0.008899609082591698,0,0,0,0,0.0,0.0,0.0,2920,0,0.2428678366464277,0.0
13090,48249,Jim Wells,Texas,2004,6824,5817,50,12691,0.5377038846426602,0.45835631549917266,0.003939799858167205,-594,-57,1319,668,-0.07928022913925781,-0.004959809224424494,0.08424003836368238,1007,-1913,0.0793475691434875,-0.1635202675029402
13091,48249,Jim Wells,Texas,2008,6706,4841,65,11612,0.5775060282466414,0.41689631415776784,0.005597657595590768,-118,15,-976,-1079,0.039802143603981266,0.0016578577374235636,-0.04146000134140482,1865,858,0.1606097140888736,0.08126214494538608
13092,48249,Jim Wells,Texas,2012,6492,4598,76,11166,0.5814078452444922,0.41178577825541823,0.006806376500089558,-214,11,-243,-446,0.003901816997850749,0.0012087189044987894,-0.005110535902349611,1894,29,0.16962206698907395,0.00901235290020036
13093,48249,Jim Wells,Texas,2016,6694,5420,265,12379,0.5407545035947976,0.43783827449713225,0.02140722190807012,202,189,822,1213,-0.040653341649694585,0.014600845407980562,0.026052496241714018,1274,-620,0.10291622909766535,-0.0667058378914086
13094,48251,Johnson,Texas,2000,11778,26202,746,38726,0.30413675566802667,0.6765997004596395,0.01926354387233383,0,0,0,0,0.0,0.0,0.0,-14424,0,-0.3724629447916128,0.0
13095,48251,Johnson,Texas,2004,12325,34818,279,47422,0.2599004681371515,0.7342161865800684,0.005883345282780144,547,-467,8616,8696,-0.04423628753087516,-0.013380198589553687,0.05761648612042891,-22493,-8069,-0.47431571844291687,-0.10185277365130407
13096,48251,Johnson,Texas,2008,12912,36685,453,50050,0.257982017982018,0.7329670329670329,0.009050949050949051,587,174,1867,2628,-0.0019184501551335331,0.0031676037681689076,-0.0012491536130354586,-23773,-1280,-0.47498501498501494,-0.0006692965420980745
13097,48251,Johnson,Texas,2012,10496,37661,681,48838,0.21491461566812728,0.7711413243785576,0.013944059953315041,-2416,228,976,-1212,-0.043067402313890696,0.00489311090236599,0.03817429141152473,-27165,-3392,-0.5562267087104303,-0.0812416937254154
13098,48251,Johnson,Texas,2016,10988,44382,2236,57606,0.19074401972016805,0.7704405791063431,0.038815401173488875,492,1555,6721,8768,-0.024170595947959228,0.024871341220173836,-0.0007007452722145313,-33394,-6229,-0.579696559386175,-0.023469850675744697
13099,48253,Jones,Texas,2000,1899,4080,69,6048,0.31398809523809523,0.6746031746031746,0.011408730158730158,0,0,0,0,0.0,0.0,0.0,-2181,0,-0.3606150793650794,0.0
13100,48253,Jones,Texas,2004,1658,4254,19,5931,0.2795481369077727,0.7172483560950936,0.0032035069971337042,-241,-50,174,-117,-0.03443995833032254,-0.008205223161596454,0.04264518149191898,-2596,-415,-0.43770021918732094,-0.07708513982224152
13101,48253,Jones,Texas,2008,1528,4203,77,5808,0.2630853994490358,0.7236570247933884,0.013257575757575758,-130,58,-51,-123,-0.016462737458736887,0.010054068760442054,0.006408668698294817,-2675,-79,-0.46057162534435264,-0.022871406157031704
13102,48253,Jones,Texas,2012,1226,4262,79,5567,0.22022633375246992,0.7655828992275912,0.014190767019938925,-302,2,59,-241,-0.04285906569656589,0.0009331912623631675,0.0419258744342027,-3036,-361,-0.5453565654751212,-0.0847849401307686
13103,48253,Jones,Texas,2016,936,4819,205,5960,0.15704697986577182,0.8085570469798657,0.034395973154362415,-290,126,557,393,-0.0631793538866981,0.02020520613442349,0.042974147752274594,-3883,-847,-0.6515100671140939,-0.10615350163897264
13104,48255,Karnes,Texas,2000,1617,2638,53,4308,0.3753481894150418,0.6123491179201486,0.012302692664809656,0,0,0,0,0.0,0.0,0.0,-1021,0,-0.2370009285051068,0.0
13105,48255,Karnes,Texas,2004,1543,3114,16,4673,0.33019473571581426,0.6663813396105286,0.0034239246736571796,-74,-37,476,365,-0.04515345369922752,-0.008878767991152475,0.05403222169038002,-1571,-550,-0.33618660389471433,-0.09918567538960754
13106,48255,Karnes,Texas,2008,1760,2736,31,4527,0.3887784404683013,0.6043737574552683,0.0068478020764303075,217,15,-378,-146,0.05858370475248703,0.003423877402773128,-0.062007582155260255,-976,595,-0.21559531698696704,0.12059128690774729
13107,48255,Karnes,Texas,2012,1325,2825,35,4185,0.31660692951015534,0.6750298685782556,0.008363201911589008,-435,4,89,-342,-0.07217151095814595,0.0015153998351587006,0.07065611112298731,-1500,-524,-0.3584229390681003,-0.14282762208113325
13108,48255,Karnes,Texas,2016,1145,2965,88,4198,0.27274892806098144,0.7062887089090043,0.02096236303001429,-180,53,140,13,-0.0438580014491739,0.012599161118425283,0.03125884033074866,-1820,-320,-0.43353978084802286,-0.07511684177992256
13109,48257,Kaufman,Texas,2000,7455,15290,318,23063,0.3232450244981139,0.6629666565494515,0.013788318952434635,0,0,0,0,0.0,0.0,0.0,-7835,0,-0.33972163205133765,0.0
13110,48257,Kaufman,Texas,2004,8947,21304,115,30366,0.294638740696832,0.701574128960021,0.0037871303431469406,1492,-203,6014,7303,-0.028606283801281884,-0.010001188609287694,0.0386074724105695,-12357,-4522,-0.40693538826318904,-0.06721375621185138
13111,48257,Kaufman,Texas,2008,11161,23735,249,35145,0.3175700668658415,0.6753449992886612,0.007084933845497226,2214,134,2431,4779,0.022931326169009503,0.0032978035023502853,-0.02622912967135982,-12574,-217,-0.3577749324228197,0.04916045584036932
13112,48257,Kaufman,Texas,2012,9472,24846,352,34670,0.27320449956734927,0.7166426305162965,0.010152869916354198,-1689,103,1111,-475,-0.044365567298492226,0.0030679360708569716,0.0412976312276353,-15374,-2800,-0.44343813094894724,-0.08566319852612753
13113,48257,Kaufman,Texas,2016,10278,29587,1400,41265,0.2490730643402399,0.7169998788319399,0.033927056827820185,806,1048,4741,6595,-0.024131435227109366,0.02377418691146599,0.0003572483156434325,-19309,-3935,-0.46792681449170004,-0.024488683542752798
13114,48259,Kendall,Texas,2000,1901,8788,384,11073,0.17167885848460218,0.7936421927210331,0.03467894879436467,0,0,0,0,0.0,0.0,0.0,-6887,0,-0.6219633342364309,0.0
13115,48259,Kendall,Texas,2004,2532,11434,106,14072,0.17993177942012506,0.8125355315520182,0.007532689027856736,631,-278,2646,2999,0.008252920935522878,-0.027146259766507936,0.018893338830985096,-8902,-2015,-0.6326037521318931,-0.010640417895462218
13116,48259,Kendall,Texas,2008,3599,12971,176,16746,0.21491699510330825,0.7745730323659381,0.010509972530753612,1067,70,1537,2674,0.03498521568318319,0.002977283502896876,-0.03796249918608008,-9372,-470,-0.5596560372626298,0.07294771486926332
13117,48259,Kendall,Texas,2012,3043,14508,232,17783,0.17111848394534104,0.8158353483664174,0.01304616768824158,-556,56,1537,1037,-0.04379851115796721,0.002536195157487967,0.04126231600047925,-11465,-2093,-0.6447168644210763,-0.08506082715844654
13118,48259,Kendall,Texas,2016,3643,15700,777,20120,0.18106361829025844,0.7803180914512923,0.0386182902584493,600,545,1192,2337,0.009945134344917395,0.025572122570207724,-0.035517256915125084,-12057,-592,-0.5992544731610339,0.04546239126004248
13119,48261,Kenedy,Texas,2000,119,106,3,228,0.5219298245614035,0.4649122807017544,0.013157894736842105,0,0,0,0,0.0,0.0,0.0,13,0,0.05701754385964908,0.0
13120,48261,Kenedy,Texas,2004,85,82,2,169,0.5029585798816568,0.48520710059171596,0.011834319526627219,-34,-1,-24,-59,-0.018971244679746646,-0.0013235752102148859,0.02029481988996157,3,-10,0.017751479289940864,-0.039266064569708214
13121,48261,Kenedy,Texas,2008,108,94,0,202,0.5346534653465347,0.46534653465346537,0.0,23,-2,12,33,0.031694885464877864,-0.011834319526627219,-0.019860565938250585,14,11,0.06930693069306931,0.05155545140312845
13122,48261,Kenedy,Texas,2012,82,84,1,167,0.49101796407185627,0.5029940119760479,0.005988023952095809,-26,1,-10,-35,-0.04363550127467841,0.005988023952095809,0.0376474773225825,-2,-16,-0.0119760479041916,-0.08128297859726091
13123,48261,Kenedy,Texas,2016,99,84,3,186,0.532258064516129,0.45161290322580644,0.016129032258064516,17,2,0,19,0.04124010044427273,0.010141008305968707,-0.05138110875024143,15,17,0.08064516129032256,0.09262120919451416
13124,48263,Kent,Texas,2000,185,346,5,536,0.3451492537313433,0.6455223880597015,0.009328358208955223,0,0,0,0,0.0,0.0,0.0,-161,0,-0.3003731343283582,0.0
13125,48263,Kent,Texas,2004,138,382,2,522,0.26436781609195403,0.7318007662835249,0.0038314176245210726,-47,-3,36,-14,-0.08078143763938928,-0.005496940584434151,0.08627837822382334,-244,-83,-0.46743295019157083,-0.1670598158632126
13126,48263,Kent,Texas,2008,99,342,7,448,0.22098214285714285,0.7633928571428571,0.015625,-39,5,-40,-74,-0.043385673234811184,0.011793582375478928,0.031592090859332234,-243,1,-0.5424107142857142,-0.07497776409414336
13127,48263,Kent,Texas,2012,66,335,4,405,0.16296296296296298,0.8271604938271605,0.009876543209876543,-33,-3,-7,-43,-0.05801917989417987,-0.005748456790123457,0.06376763668430341,-269,-26,-0.6641975308641975,-0.12178681657848334
13128,48263,Kent,Texas,2016,59,360,15,434,0.1359447004608295,0.8294930875576036,0.03456221198156682,-7,11,25,29,-0.02701826250213349,0.024685668771690282,0.0023325937304431443,-301,-32,-0.6935483870967741,-0.029350856232576605
13129,48265,Kerr,Texas,2000,4002,14637,589,19228,0.20813397129186603,0.7612336176409403,0.030632411067193676,0,0,0,0,0.0,0.0,0.0,-10635,0,-0.5530996463490743,0.0
13130,48265,Kerr,Texas,2004,4557,16538,151,21246,0.21448743292855127,0.7784053468888261,0.0071072201826226115,555,-438,1901,2018,0.006353461636685237,-0.023525190884571064,0.017171729247885792,-11981,-1346,-0.5639179139602748,-0.010818267611200527
13131,48265,Kerr,Texas,2008,5570,16752,234,22556,0.24694094697641425,0.7426848732044689,0.010374179819116865,1013,83,214,1310,0.03245351404786298,0.003266959636494254,-0.03572047368435727,-11182,799,-0.49574392622805463,0.06817398773222016
13132,48265,Kerr,Texas,2012,4338,17274,267,21879,0.19827231591937475,0.7895242012889072,0.012203482791718085,-1232,33,522,-677,-0.0486686310570395,0.0018293029726012197,0.04683932808443836,-12936,-1754,-0.5912518853695324,-0.0955079591414778
13133,48265,Kerr,Texas,2016,4681,17727,889,23297,0.20092715800317637,0.7609134223290552,0.03815941966776838,343,622,453,1418,0.002654842083801623,0.025955936876050297,-0.02861077895985198,-13046,-110,-0.5599862643258788,0.0312656210436536
13134,48267,Kimble,Texas,2000,328,1313,25,1666,0.19687875150060025,0.7881152460984394,0.015006002400960384,0,0,0,0,0.0,0.0,0.0,-985,0,-0.5912364945978392,0.0
13135,48267,Kimble,Texas,2004,324,1482,10,1816,0.17841409691629956,0.816079295154185,0.005506607929515419,-4,-15,169,150,-0.018464654584300688,-0.009499394471444964,0.027964049055745566,-1158,-173,-0.6376651982378854,-0.04642870364004614
13136,48267,Kimble,Texas,2008,342,1487,14,1843,0.18556701030927836,0.806836679327184,0.007596310363537711,18,4,5,27,0.007152913392978799,0.0020897024340222918,-0.009242615827001033,-1145,13,-0.6212696690179056,0.016395529219979776
13137,48267,Kimble,Texas,2012,217,1667,8,1892,0.11469344608879492,0.88107822410148,0.004228329809725159,-125,-6,180,49,-0.07087356422048344,-0.003367980553812552,0.07424154477429601,-1450,-305,-0.766384778012685,-0.14511510899477942
13138,48267,Kimble,Texas,2016,206,1697,49,1952,0.10553278688524591,0.8693647540983607,0.025102459016393443,-11,41,30,60,-0.009160659203549013,0.020874129206668285,-0.011713470003119286,-1491,-41,-0.7638319672131147,0.00255281079957026
13139,48269,King,Texas,2000,14,120,3,137,0.10218978102189781,0.8759124087591241,0.021897810218978103,0,0,0,0,0.0,0.0,0.0,-106,0,-0.7737226277372263,0.0
13140,48269,King,Texas,2004,18,137,1,156,0.11538461538461539,0.8782051282051282,0.00641025641025641,4,-2,17,19,0.01319483436271758,-0.015487553808721693,0.0022927194460040656,-119,-13,-0.7628205128205128,0.010902114916713557
13141,48269,King,Texas,2008,8,151,4,163,0.049079754601226995,0.9263803680981595,0.024539877300613498,-10,3,14,7,-0.0663048607833884,0.018129620890357086,0.048175239893031296,-143,-24,-0.8773006134969324,-0.11448010067641967
13142,48269,King,Texas,2012,5,139,1,145,0.034482758620689655,0.9586206896551724,0.006896551724137931,-3,-3,-12,-18,-0.01459699598053734,-0.017643325576475567,0.03224032155701295,-134,9,-0.9241379310344828,-0.04683731753755038
13143,48269,King,Texas,2016,5,149,5,159,0.031446540880503145,0.9371069182389937,0.031446540880503145,0,4,10,14,-0.00303621774018651,0.024549989156365214,-0.021513771416178717,-144,-10,-0.9056603773584906,0.018477553675992242
13144,48271,Kinney,Texas,2000,486,932,26,1444,0.3365650969529086,0.6454293628808865,0.018005540166204988,0,0,0,0,0.0,0.0,0.0,-446,0,-0.3088642659279779,0.0
13145,48271,Kinney,Texas,2004,542,1051,7,1600,0.33875,0.656875,0.004375,56,-19,119,156,0.002184903047091402,-0.013630540166204987,0.011445637119113505,-509,-63,-0.318125,-0.009260734072022103
13146,48271,Kinney,Texas,2008,633,907,11,1551,0.4081237911025145,0.5847840103159252,0.0070921985815602835,91,4,-144,-49,0.06937379110251451,0.002717198581560283,-0.07209098968407479,-274,235,-0.17666021921341069,0.1414647807865893
13147,48271,Kinney,Texas,2012,522,880,23,1425,0.3663157894736842,0.6175438596491228,0.016140350877192983,-111,12,-27,-126,-0.041808001628830305,0.0090481522956327,0.032759849333197644,-358,-84,-0.25122807017543863,-0.07456785096202795
13148,48271,Kinney,Texas,2016,458,936,36,1430,0.3202797202797203,0.6545454545454545,0.025174825174825177,-64,13,56,5,-0.04603606919396391,0.009034474297632194,0.0370015948963317,-478,-120,-0.33426573426573425,-0.08303766409029562
13149,48273,Kleberg,Texas,2000,4481,4526,187,9194,0.48738307591907765,0.4922775723297803,0.02033935175114205,0,0,0,0,0.0,0.0,0.0,-45,0,-0.0048944964107026645,0.0
13150,48273,Kleberg,Texas,2004,4550,5366,57,9973,0.45623182593001105,0.5380527424044921,0.005715431665496842,69,-130,840,779,-0.0311512499890666,-0.014623920085645208,0.04577517007471177,-816,-771,-0.08182091647448103,-0.07692642006377837
13151,48273,Kleberg,Texas,2008,5256,4540,80,9876,0.5321992709599028,0.45970028351559333,0.008100445524503848,706,23,-826,-97,0.07596744502989178,0.002385013859007006,-0.07835245888889875,716,1532,0.07249898744430949,0.15431990391879052
13152,48273,Kleberg,Texas,2012,4754,4058,95,8907,0.5337375098237341,0.4555967216795779,0.010665768496687999,-502,15,-482,-969,0.0015382388638313094,0.002565322972184151,-0.004103561836015457,696,-20,0.07814078814415626,0.005641800699846766
13153,48273,Kleberg,Texas,2016,4716,4367,429,9512,0.49579478553406225,0.45910428931875524,0.04510092514718251,-38,334,309,605,-0.03794272428967188,0.034435156650494514,0.003507567639177367,349,-347,0.03669049621530701,-0.04145029192884925
13154,48275,Knox,Texas,2000,617,947,12,1576,0.39149746192893403,0.6008883248730964,0.007614213197969543,0,0,0,0,0.0,0.0,0.0,-330,0,-0.20939086294416237,0.0
13155,48275,Knox,Texas,2004,464,1081,7,1552,0.29896907216494845,0.696520618556701,0.004510309278350515,-153,-5,134,-24,-0.09252838976398559,-0.0031039039196190284,0.0956322936836046,-617,-287,-0.39755154639175255,-0.18816068344759018
13156,48275,Knox,Texas,2008,367,986,15,1368,0.2682748538011696,0.7207602339181286,0.010964912280701754,-97,8,-95,-184,-0.030694218363778836,0.006454603002351239,0.024239615361427602,-619,-2,-0.452485380116959,-0.05493383372520644
13157,48275,Knox,Texas,2012,332,1160,18,1510,0.21986754966887417,0.7682119205298014,0.011920529801324504,-35,3,174,142,-0.04840730413229544,0.0009556175206227504,0.04745168661167276,-828,-209,-0.5483443708609272,-0.09585899074396825
13158,48275,Knox,Texas,2016,247,1078,42,1367,0.18068763716166789,0.7885881492318947,0.030724213606437453,-85,24,-82,-143,-0.03917991250720629,0.01880368380511295,0.020376228702093324,-831,-3,-0.6079005120702268,-0.05955614120929953
13159,48277,Lamar,Texas,2000,5553,9775,102,15430,0.35988334413480233,0.6335061568373299,0.00661049902786779,0,0,0,0,0.0,0.0,0.0,-4222,0,-0.2736228127025276,0.0
13160,48277,Lamar,Texas,2004,5338,12054,78,17470,0.3055523755008586,0.6899828277046365,0.004464796794504866,-215,-24,2279,2040,-0.05433096863394371,-0.0021457022333629247,0.056476670867306566,-6716,-2494,-0.38443045220377786,-0.11080763950125028
13161,48277,Lamar,Texas,2008,5243,12952,167,18362,0.28553534473368913,0.7053697854264241,0.009094869839886723,-95,89,898,892,-0.020017030767169486,0.004630073045381857,0.015386957721787664,-7709,-993,-0.419834440692735,-0.03540398848895715
13162,48277,Lamar,Texas,2012,4181,12826,190,17197,0.24312380066290631,0.7458277606559284,0.01104843868116532,-1062,23,-126,-1165,-0.04241154407078282,0.0019535688412785964,0.04045797522950423,-8645,-936,-0.5027039599930221,-0.08286951930028708
13163,48277,Lamar,Texas,2016,3583,14561,467,18611,0.19252055236150664,0.7823867605179733,0.025092687120520124,-598,277,1735,1414,-0.05060324830139967,0.014044248439354805,0.036558999862044916,-10978,-2333,-0.5898662081564666,-0.08716224816344453
13164,48279,Lamb,Texas,2000,1114,3451,33,4598,0.24227925184862983,0.7505437146585472,0.007177033492822967,0,0,0,0,0.0,0.0,0.0,-2337,0,-0.5082644628099173,0.0
13165,48279,Lamb,Texas,2004,857,3410,4,4271,0.20065558417232499,0.7984078670100679,0.0009365488176071178,-257,-29,-41,-327,-0.04162366767630485,-0.006240484675215849,0.04786415235152075,-2553,-216,-0.597752282837743,-0.08948782002782563
13166,48279,Lamb,Texas,2008,1156,3344,25,4525,0.2554696132596685,0.7390055248618784,0.0055248618784530384,299,21,-66,254,0.05481402908734351,0.00458831306084592,-0.05940234214818951,-2188,365,-0.48353591160220993,0.11421637123553302
13167,48279,Lamb,Texas,2012,998,3058,35,4091,0.24395013444145686,0.7474945001222195,0.008555365436323637,-158,10,-286,-434,-0.011519478818211637,0.003030503557870599,0.008488975260341092,-2060,128,-0.5035443656807627,-0.02000845407855273
13168,48279,Lamb,Texas,2016,771,3111,113,3995,0.19299123904881102,0.7787234042553192,0.02828535669586984,-227,78,53,-96,-0.05095889539264584,0.0197299912595462,0.031228904133099644,-2340,-280,-0.5857321652065082,-0.08218779952574551
13169,48281,Lampasas,Texas,2000,1569,4526,119,6214,0.25249436755712906,0.7283553266816866,0.019150305761184424,0,0,0,0,0.0,0.0,0.0,-2957,0,-0.4758609591245575,0.0
13170,48281,Lampasas,Texas,2004,1593,5422,10,7025,0.22676156583629895,0.7718149466192171,0.0014234875444839859,24,-109,896,811,-0.025732801720830117,-0.017726818216700437,0.04345961993753056,-3829,-872,-0.5450533807829182,-0.0691924216583607
13171,48281,Lampasas,Texas,2008,1903,5651,80,7634,0.24927953890489912,0.7402410269845429,0.010479434110558029,310,70,229,609,0.022517973068600178,0.009055946566074044,-0.03157391963467426,-3748,81,-0.49096148807964374,0.05409189270327447
13172,48281,Lampasas,Texas,2012,1479,5621,104,7204,0.2053026096612993,0.7802609661299278,0.014436424208772903,-424,24,-30,-430,-0.04397692924359983,0.003956990098214874,0.04001993914538493,-4142,-394,-0.5749583564686285,-0.08399686838898474
13173,48281,Lampasas,Texas,2016,1483,6385,337,8205,0.18074344911639245,0.7781840341255332,0.04107251675807434,4,233,764,1001,-0.02455916054490684,0.026636092549301438,-0.002076932004394627,-4902,-760,-0.5974405850091407,-0.022482228540512184
13174,48283,La Salle,Texas,2000,1266,731,17,2014,0.6285998013902682,0.36295928500496527,0.008440913604766634,0,0,0,0,0.0,0.0,0.0,535,0,0.2656405163853029,0.0
13175,48283,La Salle,Texas,2004,1229,989,12,2230,0.5511210762331838,0.44349775784753365,0.0053811659192825115,-37,-5,258,216,-0.07747872515708432,-0.0030597476854841224,0.08053847284256838,240,-295,0.1076233183856502,-0.1580171979996527
13176,48283,La Salle,Texas,2008,1052,714,10,1776,0.5923423423423423,0.40202702702702703,0.00563063063063063,-177,-2,-275,-454,0.04122126610915844,0.0002494647113481189,-0.04147073082050662,338,98,0.19031531531531526,0.08269199692966506
13177,48283,La Salle,Texas,2012,965,669,12,1646,0.586269744835966,0.40643985419198053,0.007290400972053463,-87,2,-45,-130,-0.006072597506376343,0.0016597703414228324,0.004412827164953503,296,-42,0.1798298906439854,-0.010485424671329846
13178,48283,La Salle,Texas,2016,1129,872,58,2059,0.5483244293346284,0.4235065565808645,0.028169014084507043,164,46,203,413,-0.037945315501337507,0.02087861311245358,0.01706670238888397,257,-39,0.12481787275376394,-0.055012017890221476
13179,48285,LaVaca,Texas,2000,2171,5288,87,7546,0.2877020938245428,0.7007686191359661,0.011529287039491121,0,0,0,0,0.0,0.0,0.0,-3117,0,-0.4130665253114233,0.0
13180,48285,LaVaca,Texas,2004,2152,5974,51,8177,0.2631772043536749,0.7305857894093188,0.006237006237006237,-19,-36,686,631,-0.024524889470867894,-0.005292280802484884,0.029817170273352733,-3822,-705,-0.4674085850556439,-0.05434205974422063
13181,48285,LaVaca,Texas,2008,1869,6293,86,8248,0.2266003879728419,0.762972841901067,0.010426770126091174,-283,35,319,71,-0.036576816380833016,0.004189763889084937,0.032387052491748114,-4424,-602,-0.5363724539282251,-0.06896386887258116
13182,48285,LaVaca,Texas,2012,1428,6796,90,8314,0.171758479672841,0.817416406062064,0.01082511426509502,-441,4,503,66,-0.05484190830000091,0.00039834413900384676,0.05444356416099705,-5368,-944,-0.645657926389223,-0.10928547246099796
13183,48285,LaVaca,Texas,2016,1170,7347,144,8661,0.13508832698302736,0.8482854173882923,0.01662625562868029,-258,54,551,347,-0.036670152689813634,0.0058011413635852705,0.030869011326228324,-6177,-809,-0.7131970904052649,-0.06753916401604187
13184,48287,Lee,Texas,2000,1733,3699,104,5536,0.3130419075144509,0.6681719653179191,0.01878612716763006,0,0,0,0,0.0,0.0,0.0,-1966,0,-0.35513005780346824,0.0
13185,48287,Lee,Texas,2004,1899,4160,29,6088,0.3119250985545335,0.683311432325887,0.004763469119579501,166,-75,461,552,-0.0011168089599173925,-0.014022658048050557,0.015139467007967866,-2261,-295,-0.3713863337713535,-0.01625627596788526
13186,48287,Lee,Texas,2008,2000,4312,65,6377,0.31362709738121375,0.6761800219538968,0.010192880664889447,101,36,152,289,0.0017019988266802621,0.005429411545309946,-0.007131410371990166,-2312,-51,-0.36255292457268307,0.008833409198670428
13187,48287,Lee,Texas,2012,1632,4507,97,6236,0.2617062219371392,0.7227389352148813,0.015554842847979474,-368,32,195,-141,-0.05192087544407453,0.005361962183090027,0.04655891326098449,-2875,-563,-0.4610327132777421,-0.09847978870505902
13188,48287,Lee,Texas,2016,1372,4997,166,6535,0.20994644223412395,0.7646518745218056,0.02540168324407039,-260,69,490,299,-0.05175977970301526,0.009846840396090916,0.0419129393069243,-3625,-750,-0.5547054322876817,-0.09367271900993956
13189,48289,Leon,Texas,2000,1893,4362,71,6326,0.2992412266835283,0.6895352513436611,0.011223521972810622,0,0,0,0,0.0,0.0,0.0,-2469,0,-0.3902940246601328,0.0
13190,48289,Leon,Texas,2004,1754,5023,22,6799,0.2579791145756729,0.7387851154581556,0.003235769966171496,-139,-49,661,473,-0.04126211210785541,-0.007987752006639126,0.0492498641144945,-3269,-800,-0.4808060008824827,-0.09051197622234991
13191,48289,Leon,Texas,2008,1418,5566,57,7041,0.20139184774889932,0.7905127112626047,0.008095440988495952,-336,35,543,242,-0.05658726682677359,0.004859671022324456,0.05172759580444908,-4148,-879,-0.5891208635137054,-0.1083148626312227
13192,48289,Leon,Texas,2012,1062,5814,84,6960,0.15258620689655172,0.8353448275862069,0.01206896551724138,-356,27,248,-81,-0.04880564085234759,0.003973524528745427,0.04483211632360218,-4752,-604,-0.6827586206896552,-0.0936377571759498
13193,48289,Leon,Texas,2016,909,6391,139,7439,0.1221938432585025,0.859120849576556,0.018685307164941524,-153,55,577,479,-0.03039236363804923,0.006616341647700145,0.023776021990349117,-5482,-730,-0.7369270063180535,-0.05416838562839832
13194,48291,Liberty,Texas,2000,7311,12458,308,20077,0.3641480300841759,0.6205110325247796,0.015340937391044479,0,0,0,0,0.0,0.0,0.0,-5147,0,-0.25636300244060367,0.0
13195,48291,Liberty,Texas,2004,6780,14821,90,21691,0.31257203448434834,0.6832787792171868,0.004149186298464801,-531,-218,2363,1614,-0.05157599559982756,-0.011191751092579678,0.06276774669240726,-8041,-2894,-0.3707067447328385,-0.11434374229223482
13196,48291,Liberty,Texas,2008,5991,15448,248,21687,0.27624844376815605,0.7123161340895467,0.011435422142297228,-789,158,627,-4,-0.03632359071619229,0.007286235843832428,0.029037354872359922,-9457,-1416,-0.4360676903213907,-0.06536094558855221
13197,48291,Liberty,Texas,2012,5202,17323,221,22746,0.22869955156950672,0.7615844544095666,0.009715994020926755,-789,-27,1875,1059,-0.04754889219864933,-0.001719428121370473,0.04926832032001982,-12121,-2664,-0.5328849028400598,-0.09681721251866915
13198,48291,Liberty,Texas,2016,4862,18892,513,24267,0.200354390736391,0.7785057897556352,0.021139819507973792,-340,292,1569,1521,-0.028345160833115723,0.011423825487047037,0.016921335346068656,-14030,-1909,-0.5781513990192442,-0.04526649617918432
13199,48293,Limestone,Texas,2000,2768,4212,95,7075,0.3912367491166078,0.5953356890459364,0.01342756183745583,0,0,0,0,0.0,0.0,0.0,-1444,0,-0.2040989399293286,0.0
13200,48293,Limestone,Texas,2004,2752,5028,38,7818,0.35200818623688923,0.6431312356101304,0.004860578152980302,-16,-57,816,743,-0.03922856287971854,-0.008566983684475529,0.04779554656419405,-2276,-832,-0.2911230493732412,-0.08702410944391259
13201,48293,Limestone,Texas,2008,2516,5079,77,7672,0.32794577685088633,0.6620177267987487,0.010036496350364963,-236,39,51,-146,-0.024062409386002903,0.005175918197384661,0.018886491188618293,-2563,-287,-0.3340719499478624,-0.042948900574621196
13202,48293,Limestone,Texas,2012,2208,5288,67,7563,0.29194763982546607,0.6991934417559169,0.00885891841861695,-308,-10,209,-109,-0.03599813702542026,-0.001177577931748013,0.037175714957168204,-3080,-517,-0.40724580193045085,-0.07317385198258847
13203,48293,Limestone,Texas,2016,1778,5796,165,7739,0.22974544514795192,0.7489339707972607,0.02132058405478744,-430,98,508,176,-0.062202194677514144,0.012461665636170488,0.04974052904134374,-4018,-938,-0.5191885256493087,-0.11194272371885788
13204,48295,Lipscomb,Texas,2000,206,1072,16,1294,0.15919629057187018,0.8284389489953632,0.012364760432766615,0,0,0,0,0.0,0.0,0.0,-866,0,-0.669242658423493,0.0
13205,48295,Lipscomb,Texas,2004,184,1147,6,1337,0.137621540762902,0.8578908002991773,0.004487658937920718,-22,-10,75,43,-0.021574749808968174,-0.007877101494845898,0.029451851303814114,-963,-97,-0.7202692595362753,-0.051026601112782344
13206,48295,Lipscomb,Texas,2008,155,1093,8,1256,0.12340764331210191,0.8702229299363057,0.006369426751592357,-29,2,-54,-81,-0.014213897450800095,0.001881767813671639,0.012332129637128375,-938,25,-0.7468152866242037,-0.026546027087928414
13207,48295,Lipscomb,Texas,2012,119,1044,5,1168,0.10188356164383562,0.8938356164383562,0.004280821917808219,-36,-3,-49,-88,-0.02152408166826629,-0.002088604833784138,0.023612686502050506,-925,13,-0.7919520547945206,-0.045136768170316866
13208,48295,Lipscomb,Texas,2016,135,1159,38,1332,0.10135135135135136,0.8701201201201201,0.028528528528528527,16,33,115,164,-0.0005322102924842642,0.02424770661072031,-0.023715496318236107,-1024,-99,-0.7687687687687688,0.023183286025751815
13209,48297,Live Oak,Texas,2000,1114,2828,62,4004,0.27822177822177824,0.7062937062937062,0.015484515484515484,0,0,0,0,0.0,0.0,0.0,-1714,0,-0.428071928071928,0.0
13210,48297,Live Oak,Texas,2004,1036,3147,18,4201,0.24660795048797907,0.7491073553915735,0.0042846941204475126,-78,-44,319,197,-0.03161382773379917,-0.011199821364067972,0.042813649097867224,-2111,-397,-0.5024994049035945,-0.07442747683166645
13211,48297,Live Oak,Texas,2008,1048,3095,33,4176,0.2509578544061303,0.741139846743295,0.007902298850574713,12,15,-52,-25,0.00434990391815121,0.003617604730127201,-0.007967508648278443,-2047,64,-0.49018199233716475,0.012317412566429708
13212,48297,Live Oak,Texas,2012,919,3154,40,4113,0.22343787989302213,0.7668368587405786,0.009725261366399222,-129,7,59,-63,-0.027519974513108142,0.001822962515824509,0.02569701199728358,-2235,-188,-0.5433989788475565,-0.05321698651039175
13213,48297,Live Oak,Texas,2016,742,3464,96,4302,0.1724779172477917,0.805206880520688,0.022315202231520222,-177,56,310,189,-0.05095996264523042,0.012589940865121,0.0383700217801094,-2722,-487,-0.6327289632728963,-0.08932998442533979
13214,48299,Llano,Texas,2000,2143,6295,189,8627,0.24840616668598586,0.7296858699432016,0.021907963370812564,0,0,0,0,0.0,0.0,0.0,-4152,0,-0.48127970325721575,0.0
13215,48299,Llano,Texas,2004,2257,7241,65,9563,0.2360138031998327,0.7571891665795253,0.006797030220642058,114,-124,946,936,-0.012392363486153163,-0.015110933150170505,0.02750329663632367,-4984,-832,-0.5211753633796926,-0.03989566012247686
13216,48299,Llano,Texas,2008,2250,7281,98,9629,0.23366912451968014,0.756153286945685,0.010177588534634957,-7,33,40,66,-0.002344678680152562,0.003380558313992899,-0.0010358796338403309,-5031,-47,-0.5224841624260048,-0.0013087990463122035
13217,48299,Llano,Texas,2012,1822,7610,126,9558,0.19062565390249006,0.7961916718978865,0.013182674199623353,-428,28,329,-71,-0.04304347061719008,0.0030050856649883953,0.04003838495220158,-5788,-757,-0.6055660179953964,-0.08308185556939163
13218,48299,Llano,Texas,2016,1825,8299,323,10447,0.17469129893749402,0.7943907341820619,0.030917966880444146,3,197,689,889,-0.01593435496499604,0.017735292680820795,-0.0018009377158246798,-6474,-686,-0.6196994352445678,-0.014133417249171387
13219,48301,Loving,Texas,2000,29,124,3,156,0.1858974358974359,0.7948717948717948,0.019230769230769232,0,0,0,0,0.0,0.0,0.0,-95,0,-0.6089743589743589,0.0
13220,48301,Loving,Texas,2004,12,65,3,80,0.15,0.8125,0.0375,-17,0,-59,-76,-0.03589743589743591,0.018269230769230767,0.017628205128205177,-53,42,-0.6625,-0.05352564102564106
13221,48301,Loving,Texas,2008,12,67,0,79,0.1518987341772152,0.8481012658227848,0.0,0,-3,2,-1,0.0018987341772152,-0.0375,0.03560126582278478,-55,-2,-0.6962025316455696,-0.03370253164556958
13222,48301,Loving,Texas,2012,9,54,1,64,0.140625,0.84375,0.015625,-3,1,-13,-15,-0.011273734177215194,0.015625,-0.004351265822784778,-45,10,-0.703125,-0.006922468354430444
13223,48301,Loving,Texas,2016,4,58,3,65,0.06153846153846154,0.8923076923076924,0.046153846153846156,-5,2,4,1,-0.07908653846153846,0.030528846153846156,0.04855769230769236,-54,-9,-0.8307692307692308,-0.12764423076923082
13224,48303,Lubbock,Texas,2000,18469,56054,1485,76008,0.24298758025471004,0.737475002631302,0.019537417113988,0,0,0,0,0.0,0.0,0.0,-37585,0,-0.49448742237659193,0.0
13225,48303,Lubbock,Texas,2004,22472,70135,544,93151,0.24124271344376336,0.752917306309111,0.005839980247125635,4003,-941,14081,17143,-0.0017448668109466825,-0.013697436866862367,0.015442303677809077,-47663,-10078,-0.5116745928653477,-0.017187170488755732
13226,48303,Lubbock,Texas,2008,30486,66304,744,97534,0.3125679250312711,0.6798039657965428,0.007628109172186109,8014,200,-3831,4383,0.07132521158750776,0.0017881289250604743,-0.07311334051256824,-35818,11845,-0.36723604076527167,0.144438552100076
13227,48303,Lubbock,Texas,2012,26271,63469,1444,91184,0.28810975609756095,0.696054132303913,0.01583611159852606,-4215,700,-2835,-6350,-0.024458168933710167,0.008208002426339948,0.01625016650737021,-37198,-1380,-0.40794437620635204,-0.04070833544108038
13228,48303,Lubbock,Texas,2016,28023,65651,5339,99013,0.2830234413662852,0.6630543463989577,0.05392221223475705,1752,3895,2182,7829,-0.005086314731275743,0.038086100636230996,-0.03299978590495534,-37628,-430,-0.38003090503267245,0.027913471173679594
13229,48305,Lynn,Texas,2000,562,1507,15,2084,0.2696737044145873,0.7231285988483686,0.007197696737044146,0,0,0,0,0.0,0.0,0.0,-945,0,-0.45345489443378123,0.0
13230,48305,Lynn,Texas,2004,490,1776,5,2271,0.21576398062527521,0.7820343461030383,0.002201673271686482,-72,-10,269,187,-0.05390972378931211,-0.004996023465357664,0.058905747254669794,-1286,-341,-0.5662703654777631,-0.11281547104398187
13231,48305,Lynn,Texas,2008,627,1473,16,2116,0.29631379962192816,0.696124763705104,0.007561436672967864,137,11,-303,-155,0.08054981899665295,0.005359763401281382,-0.08590958239793434,-846,440,-0.39981096408317585,0.16645940139458726
13232,48305,Lynn,Texas,2012,506,1439,14,1959,0.25829504849412965,0.734558448187851,0.0071465033180193975,-121,-2,-34,-157,-0.03801875112779851,-0.0004149333549484666,0.03843368448274698,-933,-87,-0.47626339969372133,-0.07645243561054549
13233,48305,Lynn,Texas,2016,403,1546,60,2009,0.20059731209556994,0.7695370831259333,0.029865604778496764,-103,46,107,50,-0.05769773639855971,0.022719101460477367,0.03497863493808229,-1143,-210,-0.5689397710303633,-0.09267637133664197
13234,48307,McCulloch,Texas,2000,794,2084,42,2920,0.2719178082191781,0.7136986301369863,0.014383561643835616,0,0,0,0,0.0,0.0,0.0,-1290,0,-0.4417808219178082,0.0
13235,48307,McCulloch,Texas,2004,745,2465,10,3220,0.23136645962732919,0.765527950310559,0.003105590062111801,-49,-32,381,300,-0.04055134859184892,-0.011277971581723816,0.05182932017357267,-1720,-430,-0.5341614906832298,-0.09238066876542161
13236,48307,McCulloch,Texas,2008,728,2263,19,3010,0.24186046511627907,0.751827242524917,0.006312292358803987,-17,9,-202,-210,0.010494005488949881,0.003206702296692186,-0.01370070778564203,-1535,185,-0.5099667774086378,0.024194713274591995
13237,48307,McCulloch,Texas,2012,537,2419,37,2993,0.17941864350150352,0.8082191780821918,0.012362178416304711,-191,18,156,-17,-0.062441821614775544,0.006049886057500724,0.05639193555727484,-1882,-347,-0.6288005345806883,-0.11883375717205047
13238,48307,McCulloch,Texas,2016,482,2552,69,3103,0.15533354817918144,0.822429906542056,0.02223654527876249,-55,32,133,110,-0.024085095322322086,0.009874366862457778,0.014210728459864264,-2070,-188,-0.6670963583628746,-0.03829582378218632
13239,48309,McLennan,Texas,2000,23462,43955,1372,68789,0.341071973716728,0.6389829769294509,0.019945049353821104,0,0,0,0,0.0,0.0,0.0,-20493,0,-0.29791100321272296,0.0
13240,48309,McLennan,Texas,2004,26760,52090,404,79254,0.3376485729426906,0.6572538925480101,0.005097534509299216,3298,-968,8135,10465,-0.0034234007740374106,-0.014847514844521889,0.018270915618559203,-25330,-4837,-0.31960531960531957,-0.021694316392596613
13241,48309,McLennan,Texas,2008,29998,49044,632,79674,0.3765092752968346,0.615558400481964,0.007932324221201395,3238,228,-3046,420,0.03886070235414402,0.0028347897119021795,-0.04169549206604617,-19046,6284,-0.23904912518512939,0.08055619442019019
13242,48309,McLennan,Texas,2012,25694,47903,944,74541,0.3446962074562992,0.642639621148093,0.012664171395607786,-4304,312,-1141,-5133,-0.03181306784053539,0.004731847174406391,0.027081220666129058,-22209,-3163,-0.29794341369179383,-0.05889428850666445
13243,48309,McLennan,Texas,2016,27063,48260,3752,79075,0.3422447043945621,0.610306670882074,0.0474486247233639,1369,2808,357,4534,-0.0024515030617370814,0.034784453327756114,-0.03233295026601901,-21197,1012,-0.2680619664875119,0.02988144720428193
13244,48311,McMullen,Texas,2000,77,358,4,439,0.17539863325740318,0.8154897494305239,0.009111617312072893,0,0,0,0,0.0,0.0,0.0,-281,0,-0.6400911161731206,0.0
13245,48311,McMullen,Texas,2004,95,467,2,564,0.16843971631205673,0.8280141843971631,0.0035460992907801418,18,-2,109,125,-0.0069589169453464494,-0.005565518021292751,0.012524434966639242,-372,-91,-0.6595744680851063,-0.01948335191198569
13246,48311,McMullen,Texas,2008,132,400,5,537,0.24581005586592178,0.74487895716946,0.00931098696461825,37,3,-67,-27,0.07737033955386505,0.005764887673838108,-0.08313522722770317,-268,104,-0.4990689013035382,0.16050556678156813
13247,48311,McMullen,Texas,2012,67,431,5,503,0.13320079522862824,0.856858846918489,0.009940357852882704,-65,0,31,-34,-0.11260926063729354,0.0006293708882644539,0.11197988974902906,-364,-96,-0.7236580516898607,-0.22458915038632254
13248,48311,McMullen,Texas,2016,40,454,5,499,0.08016032064128256,0.9098196392785571,0.01002004008016032,-27,0,23,-4,-0.053040474587345676,7.968222727761619e-05,0.05296079236006812,-414,-50,-0.8296593186372746,-0.10600126694741385
13249,48313,Madison,Texas,2000,1241,2333,49,3623,0.3425338117582114,0.6439414849572178,0.013524703284570798,0,0,0,0,0.0,0.0,0.0,-1092,0,-0.3014076731990064,0.0
13250,48313,Madison,Texas,2004,1235,2837,29,4101,0.30114606193611315,0.6917824920751037,0.007071445988783224,-6,-20,504,478,-0.04138774982209825,-0.0064532572957875746,0.04784100711788586,-1602,-510,-0.3906364301389905,-0.08922875693998411
13251,48313,Madison,Texas,2008,1146,2891,37,4074,0.2812960235640648,0.7096219931271478,0.009081983308787433,-89,8,54,-27,-0.01985003837204835,0.0020105373200042095,0.017839501052044127,-1745,-143,-0.428325969563083,-0.03768953942409248
13252,48313,Madison,Texas,2012,967,3028,33,4028,0.2400695134061569,0.7517378351539226,0.008192651439920555,-179,-4,137,-46,-0.0412265101579079,-0.0008893318688668779,0.042115842026774764,-2061,-316,-0.5116683217477657,-0.08334235218468267
13253,48313,Madison,Texas,2016,881,3351,57,4289,0.2054091862905106,0.7813010025647004,0.013289811144788995,-86,24,323,261,-0.03466032711564629,0.00509715970486844,0.029563167410777802,-2470,-409,-0.5758918162741897,-0.06422349452642406
13254,48315,Marion,Texas,2000,1852,2039,39,3930,0.4712468193384224,0.5188295165394402,0.009923664122137405,0,0,0,0,0.0,0.0,0.0,-187,0,-0.04758269720101782,0.0
13255,48315,Marion,Texas,2004,1884,2441,23,4348,0.43330266789328425,0.5614075436982521,0.0052897884084636615,32,-16,402,418,-0.03794415144513813,-0.004633875713673743,0.04257802715881187,-557,-370,-0.12810487580496782,-0.08052217860395
13256,48315,Marion,Texas,2008,1644,2567,41,4252,0.38664158043273755,0.6037158984007526,0.009642521166509878,-240,18,126,-96,-0.0466610874605467,0.004352732758046217,0.042308354702500495,-923,-366,-0.21707431796801502,-0.0889694421630472
13257,48315,Marion,Texas,2012,1495,2733,54,4282,0.3491359177954227,0.638253152732368,0.012610929472209247,-149,13,166,30,-0.03750566263731486,0.002968408305699369,0.034537254331615475,-1238,-315,-0.28911723493694536,-0.07204291696893034
13258,48315,Marion,Texas,2016,1165,2983,90,4238,0.2748938178386031,0.7038697498820198,0.021236432279377066,-330,36,250,-44,-0.07424209995681957,0.008625502807167819,0.06561659714965173,-1818,-580,-0.42897593204341666,-0.1398586971064713
13259,48317,Martin,Texas,2000,415,1520,14,1949,0.2129297075423294,0.779887121600821,0.007183170856849667,0,0,0,0,0.0,0.0,0.0,-1105,0,-0.5669574140584915,0.0
13260,48317,Martin,Texas,2004,288,1514,5,1807,0.15938018815716656,0.8378527946873271,0.002767017155506364,-127,-9,-6,-142,-0.053549519385162836,-0.004416153701343303,0.05796567308650613,-1226,-121,-0.6784726065301605,-0.11151519247166897
13261,48317,Martin,Texas,2008,314,1389,12,1715,0.18309037900874636,0.8099125364431486,0.006997084548104956,26,7,-125,-92,0.0237101908515798,0.004230067392598592,-0.02794025824417845,-1075,151,-0.6268221574344023,0.05165044909575822
13262,48317,Martin,Texas,2012,248,1368,8,1624,0.15270935960591134,0.8423645320197044,0.0049261083743842365,-66,-4,-21,-91,-0.030381019402835024,-0.0020709761737207196,0.03245199557655576,-1120,-45,-0.689655172413793,-0.06283301497939076
13263,48317,Martin,Texas,2016,266,1455,41,1762,0.15096481271282633,0.825766174801362,0.023269012485811577,18,33,87,138,-0.0017445468930850083,0.01834290411142734,-0.016598357218342352,-1189,-69,-0.6748013620885357,0.014853810325257344
13264,48319,Mason,Texas,2000,417,1352,32,1801,0.23153803442531926,0.750694058856191,0.01776790671848973,0,0,0,0,0.0,0.0,0.0,-935,0,-0.5191560244308717,0.0
13265,48319,Mason,Texas,2004,459,1600,18,2077,0.2209918151179586,0.7703418391911411,0.008666345690900338,42,-14,248,276,-0.01054621930736066,-0.009101561027589392,0.01964778033495007,-1141,-206,-0.5493500240731825,-0.03019399964231073
13266,48319,Mason,Texas,2008,546,1544,31,2121,0.25742574257425743,0.727958510136728,0.014615747289014616,87,13,-56,44,0.03643392745629884,0.005949401598114279,-0.04238332905441311,-998,143,-0.47053276756247053,0.07881725651071192
13267,48319,Mason,Texas,2012,380,1565,23,1968,0.19308943089430894,0.7952235772357723,0.011686991869918699,-166,-8,21,-153,-0.0643363116799485,-0.0029287554190959176,0.06726506709904434,-1185,-187,-0.6021341463414633,-0.1316013787789928
13268,48319,Mason,Texas,2016,354,1656,47,2057,0.17209528439474964,0.8050559066601848,0.022848808945065628,-26,24,91,89,-0.020994146499559302,0.01116181707514693,0.009832329424412478,-1302,-117,-0.6329606222654351,-0.030826475923971808
13269,48321,Matagorda,Texas,2000,4696,7584,179,12459,0.376916285416165,0.6087165904165663,0.014367124167268642,0,0,0,0,0.0,0.0,0.0,-2888,0,-0.23180030500040133,0.0
13270,48321,Matagorda,Texas,2004,4355,8119,47,12521,0.3478156696749461,0.6484306365306285,0.0037536937944253656,-341,-132,535,62,-0.029100615741218916,-0.010613430372843277,0.03971404611406215,-3764,-876,-0.3006149668556824,-0.06881466185528107
13271,48321,Matagorda,Texas,2008,4440,7835,98,12373,0.3588458740806595,0.6332336539238664,0.007920471995474016,85,51,-284,-148,0.011030204405713395,0.00416677820104865,-0.015196982606762055,-3395,369,-0.27438777984320695,0.02622718701247545
13272,48321,Matagorda,Texas,2012,3980,8040,113,12133,0.32803098986235885,0.6626555674606445,0.00931344267699662,-460,15,205,-240,-0.030814884218300642,0.0013929706815226043,0.029421913536778033,-4060,-665,-0.3346245775982856,-0.060236797755078675
13273,48321,Matagorda,Texas,2016,3500,8366,330,12196,0.2869793374877009,0.6859626106920301,0.02705805182026894,-480,217,326,63,-0.041051652374657965,0.01774460914327232,0.02330704323138566,-4866,-806,-0.39898327320432925,-0.06435869560604363
13274,48323,Maverick,Texas,2000,5995,3143,91,9229,0.6495828367103695,0.34055694008018206,0.009860223209448477,0,0,0,0,0.0,0.0,0.0,2852,0,0.3090258966301875,0.0
13275,48323,Maverick,Texas,2004,5948,4025,61,10034,0.5927845325891967,0.40113613713374524,0.006079330277058002,-47,-30,882,805,-0.056798304121172816,-0.003780892932390475,0.06057919705356318,1923,-929,0.19164839545545148,-0.117377501174736
13276,48323,Maverick,Texas,2008,8554,2316,69,10939,0.781972758021757,0.21171953560654538,0.006307706371697596,2606,8,-1709,905,0.1891882254325603,0.00022837609463959366,-0.18941660152719986,6238,4315,0.5702532224152117,0.3786048269597602
13277,48323,Maverick,Texas,2012,8303,2171,89,10563,0.7860456309760485,0.20552873236769856,0.008425636656252958,-251,20,-145,-376,0.004072872954291484,0.0021179302845553624,-0.006190803238846826,6132,-106,0.58051689860835,0.010263676193138282
13278,48323,Maverick,Texas,2016,10397,2816,375,13588,0.7651604356785399,0.2072416838386812,0.027597880482778923,2094,286,645,3025,-0.020885195297508652,0.019172243826525964,0.0017129514709826321,7581,1449,0.5579187518398587,-0.022598146768491256
13279,48325,Medina,Texas,2000,4025,8590,258,12873,0.3126699293094073,0.6672881224267847,0.02004194826380797,0,0,0,0,0.0,0.0,0.0,-4565,0,-0.3546181931173774,0.0
13280,48325,Medina,Texas,2004,4322,10389,115,14826,0.2915149062457844,0.7007284500202348,0.0077566437339808446,297,-143,1799,1953,-0.02115502306362288,-0.012285304529827124,0.03344032759345006,-6067,-1502,-0.40921354377445035,-0.05459535065707294
13281,48325,Medina,Texas,2008,5147,10480,110,15737,0.3270636080574442,0.6659464955201119,0.006989896422443922,825,-5,91,911,0.03554870181165981,-0.0007667473115369229,-0.03478195450012289,-5333,734,-0.33888288746266765,0.0703306563117827
13282,48325,Medina,Texas,2012,4784,11079,186,16049,0.29808710823104245,0.6903233846345567,0.011589507134400897,-363,76,599,312,-0.02897649982640177,0.004599610711956976,0.0243768891144448,-6295,-962,-0.3922362764035142,-0.05335338894084657
13283,48325,Medina,Texas,2016,4634,12085,527,17246,0.268699988403108,0.7007422010901079,0.030557810506784182,-150,341,1006,1197,-0.02938711982793446,0.018968303372383283,0.010418816455551205,-7451,-1156,-0.4320422126869999,-0.039805936283485666
13284,48327,Menard,Texas,2000,334,642,14,990,0.3373737373737374,0.6484848484848484,0.014141414141414142,0,0,0,0,0.0,0.0,0.0,-308,0,-0.31111111111111106,0.0
13285,48327,Menard,Texas,2004,331,761,11,1103,0.300090661831369,0.6899365367180417,0.009972801450589302,-3,-3,119,113,-0.03728307554236837,-0.00416861269082484,0.04145168823319323,-430,-122,-0.38984587488667266,-0.0787347637755616
13286,48327,Menard,Texas,2008,295,712,11,1018,0.28978388998035365,0.6994106090373281,0.010805500982318271,-36,0,-49,-85,-0.010306771851015362,0.0008326995317289691,0.00947407231928643,-417,13,-0.40962671905697445,-0.019780844170301792
13287,48327,Menard,Texas,2012,171,665,13,849,0.20141342756183744,0.7832744405182568,0.015312131919905771,-124,2,-47,-169,-0.0883704624185162,0.0045066309375875,0.08386383148092869,-494,-77,-0.5818610129564193,-0.1722342938994449
13288,48327,Menard,Texas,2016,154,682,28,864,0.17824074074074073,0.7893518518518519,0.032407407407407406,-17,15,17,15,-0.023172686821096716,0.017095275487501636,0.006077411333595073,-528,-34,-0.6111111111111112,-0.029250098154691817
13289,48329,Midland,Texas,2000,7534,31514,692,39740,0.18958228485153497,0.7930045294413689,0.017413185707096126,0,0,0,0,0.0,0.0,0.0,-23980,0,-0.603422244589834,0.0
13290,48329,Midland,Texas,2004,8005,36585,244,44834,0.17854753089173395,0.8160101708524781,0.005442298255788018,471,-448,5071,5094,-0.011034753959801025,-0.011970887451308108,0.023005641411109168,-28580,-4600,-0.6374626399607441,-0.03404039537091019
13291,48329,Midland,Texas,2008,9691,36155,428,46274,0.2094264597830315,0.7813242857760297,0.009249254440938756,1686,184,-430,1440,0.030878928891297563,0.003806956185150738,-0.03468588507644832,-26464,2116,-0.5718978259929982,0.06556481396774594
13292,48329,Midland,Texas,2012,8286,35689,722,44697,0.18538156923283441,0.7984652213795109,0.016153209387654653,-1405,294,-466,-1577,-0.024044890550197096,0.006903954946715897,0.017140935603481178,-27403,-939,-0.6130836521466765,-0.04118582615367827
13293,48329,Midland,Texas,2016,10025,36973,2214,49212,0.20371047711940177,0.7513004958140291,0.044989027066569126,1739,1492,1284,4515,0.018328907886567353,0.028835817678914473,-0.04716472556548179,-26948,455,-0.5475900186946274,0.06549363345204906
13294,48331,Milam,Texas,2000,3429,4706,134,8269,0.41468133994437056,0.569113556657395,0.01620510339823437,0,0,0,0,0.0,0.0,0.0,-1277,0,-0.15443221671302448,0.0
13295,48331,Milam,Texas,2004,3445,5291,47,8783,0.39223499943071843,0.6024137538426506,0.005351246726630992,16,-87,585,514,-0.02244634051365213,-0.010853856671603379,0.033300197185255564,-1846,-569,-0.21017875441193218,-0.055746537698907694
13296,48331,Milam,Texas,2008,3044,5217,96,8357,0.36424554265884884,0.6242670814885725,0.011487375852578677,-401,49,-74,-426,-0.027989456771869592,0.006136129125947685,0.02185332764592185,-2173,-327,-0.2600215388297236,-0.04984278441779144
13297,48331,Milam,Texas,2012,2636,5481,113,8230,0.3202916160388821,0.6659781287970838,0.013730255164034023,-408,17,264,-127,-0.04395392661996672,0.0022428793114553456,0.041711047308511384,-2845,-672,-0.3456865127582017,-0.0856649739284781
13298,48331,Milam,Texas,2016,2051,6364,249,8664,0.23672668513388734,0.734533702677747,0.02873961218836565,-585,136,883,434,-0.08356493090499478,0.015009357024331628,0.06855557388066313,-4313,-1468,-0.49780701754385964,-0.15212050478565792
13299,48333,Mills,Texas,2000,548,1738,28,2314,0.23681936041486604,0.7510803802938635,0.012100259291270527,0,0,0,0,0.0,0.0,0.0,-1190,0,-0.5142610198789974,0.0
13300,48333,Mills,Texas,2004,416,1794,21,2231,0.1864634692962797,0.8041237113402062,0.00941281936351412,-132,-7,56,-83,-0.05035589111858635,-0.002687439927756408,0.053043331046342734,-1378,-188,-0.6176602420439266,-0.10339922216492914
13301,48333,Mills,Texas,2008,398,1753,26,2177,0.18282039503904457,0.8052365640790078,0.011943040881947635,-18,5,-41,-54,-0.0036430742572351182,0.0025302215184335158,0.001112852738801573,-1355,23,-0.6224161690399632,-0.0047559269960366635
13302,48333,Mills,Texas,2012,279,1882,40,2201,0.1267605633802817,0.8550658791458428,0.01817355747387551,-119,14,129,24,-0.05605983165876288,0.006230516591927877,0.04982931506683497,-1603,-248,-0.728305315765561,-0.1058891467255978
13303,48333,Mills,Texas,2016,243,1951,51,2245,0.10824053452115813,0.8690423162583519,0.02271714922048998,-36,11,69,44,-0.018520028859123558,0.004543591746614468,0.013976437112509177,-1708,-105,-0.7608017817371938,-0.032496465971632804
13304,48335,Mitchell,Texas,2000,837,1708,29,2574,0.32517482517482516,0.6635586635586636,0.011266511266511266,0,0,0,0,0.0,0.0,0.0,-871,0,-0.3383838383838384,0.0
13305,48335,Mitchell,Texas,2004,639,1912,7,2558,0.24980453479280687,0.7474589523064894,0.002736512900703675,-198,-22,204,-16,-0.07537029038201828,-0.008529998365807591,0.08390028874782585,-1273,-402,-0.49765441751368256,-0.15927057912984416
13306,48335,Mitchell,Texas,2008,586,1815,30,2431,0.24105306458247636,0.746606334841629,0.012340600575894693,-53,23,-97,-127,-0.008751470210330514,0.009604087675191018,-0.0008526174648604279,-1229,44,-0.5055532702591526,-0.007898852745470086
13307,48335,Mitchell,Texas,2012,538,1756,22,2316,0.23229706390328153,0.7582037996545768,0.009499136442141624,-48,-8,-59,-115,-0.008756000679194825,-0.0028414641337530695,0.011597464812947877,-1218,11,-0.5259067357512953,-0.020353465492142675
13308,48335,Mitchell,Texas,2016,354,1780,62,2196,0.16120218579234974,0.8105646630236795,0.028233151183970857,-184,40,24,-120,-0.07109487811093179,0.018734014741829234,0.05236086336910262,-1426,-208,-0.6493624772313298,-0.12345574148003446
13309,48337,Montague,Texas,2000,2256,4951,123,7330,0.3077762619372442,0.6754433833560709,0.016780354706684857,0,0,0,0,0.0,0.0,0.0,-2695,0,-0.3676671214188267,0.0
13310,48337,Montague,Texas,2004,1946,5910,41,7897,0.24642269216158036,0.7483854628339875,0.005191845004432063,-310,-82,959,567,-0.06135356977566386,-0.011588509702252794,0.07294207947791664,-3964,-1269,-0.5019627706724072,-0.13429564925358056
13311,48337,Montague,Texas,2008,1597,6245,108,7950,0.20088050314465408,0.7855345911949686,0.013584905660377358,-349,67,335,53,-0.04554218901692628,0.008393060655945295,0.037149128360981054,-4648,-684,-0.5846540880503145,-0.08269131737790725
13312,48337,Montague,Texas,2012,1116,6549,86,7751,0.143981421752032,0.8449232357115211,0.01109534253644691,-481,-22,304,-199,-0.05689908139262209,-0.0024895631239304477,0.05938864451655246,-5433,-785,-0.7009418139594891,-0.11628772590917458
13313,48337,Montague,Texas,2016,885,7526,193,8604,0.10285913528591353,0.8747094374709438,0.022431427243142725,-231,107,977,853,-0.04112228646611846,0.011336084706695814,0.029786201759422704,-6641,-1208,-0.7718503021850303,-0.07090848822554119
13314,48339,Montgomery,Texas,2000,23286,80600,2327,106213,0.21923869959421163,0.7588524945157372,0.021908805890051123,0,0,0,0,0.0,0.0,0.0,-57314,0,-0.5396137949215256,0.0
13315,48339,Montgomery,Texas,2004,28628,104654,706,133988,0.21366092485894259,0.7810699465623787,0.005269128578678688,5342,-1621,24054,27775,-0.005577774735269048,-0.016639677311372433,0.022217452046641495,-76026,-18712,-0.5674090217034361,-0.027795226781910487
13316,48339,Montgomery,Texas,2008,36703,119884,1664,158251,0.23192902414518707,0.7575560344010465,0.010514941453766484,8075,958,15230,24263,0.018268099286244482,0.005245812875087796,-0.02351391216133225,-83181,-7155,-0.5256270102558593,0.04178201144757676
13317,48339,Montgomery,Texas,2012,32920,137969,2634,173523,0.18971548440264402,0.7951049716752246,0.01517954392213136,-3783,970,18085,15272,-0.04221353974254305,0.004664602468364875,0.037548937274178185,-105049,-21868,-0.6053894872725807,-0.07976247701672134
13318,48339,Montgomery,Texas,2016,45835,150314,8483,204632,0.22398745064310568,0.7345576449431174,0.04145490441377692,12915,5849,12345,31109,0.034271966240461665,0.026275360491645562,-0.060547326732107276,-104479,570,-0.5105701943000117,0.09481929297256897
13319,48341,Moore,Texas,2000,1040,4201,49,5290,0.19659735349716445,0.7941398865784499,0.009262759924385633,0,0,0,0,0.0,0.0,0.0,-3161,0,-0.5975425330812855,0.0
13320,48341,Moore,Texas,2004,1009,4601,18,5628,0.17928216062544422,0.8175195451314854,0.0031982942430703624,-31,-31,400,338,-0.01731519287172023,-0.0060644656813152705,0.023379658553035476,-3592,-431,-0.6382373845060412,-0.04069485142475571
13321,48341,Moore,Texas,2008,1123,4282,32,5437,0.2065477285267611,0.7875666727974986,0.005885598675740298,114,14,-319,-191,0.027265567901316873,0.002687304432669935,-0.029952872333986802,-3159,433,-0.5810189442707375,0.05721844023530365
13322,48341,Moore,Texas,2012,964,3968,53,4985,0.19338014042126378,0.795987963891675,0.010631895687061183,-159,21,-314,-452,-0.013167588105497313,0.004746297011320885,0.008421291094176442,-3004,155,-0.6026078234704113,-0.021588879199673783
13323,48341,Moore,Texas,2016,1098,3977,209,5284,0.2077971233913702,0.7526495079485238,0.03955336866010598,134,156,9,299,0.014416982970106407,0.0289214729730448,-0.04333845594315122,-2879,125,-0.5448523845571536,0.05775543891325774
13324,48343,Morris,Texas,2000,2455,2381,53,4889,0.5021476784618532,0.4870116588259358,0.010840662712211086,0,0,0,0,0.0,0.0,0.0,74,0,0.015136019635917375,0.0
13325,48343,Morris,Texas,2004,2437,2818,23,5278,0.46172792724516865,0.5339143615005684,0.004357711254262978,-18,-30,437,389,-0.04041975121668451,-0.006482951457948108,0.04690270267463259,-381,-455,-0.07218643425539972,-0.0873224538913171
13326,48343,Morris,Texas,2008,2055,3158,35,5248,0.39157774390243905,0.6017530487804879,0.006669207317073171,-382,12,340,-30,-0.0701501833427296,0.0023114960628101925,0.06783868727991949,-1103,-722,-0.2101753048780488,-0.13798887062264908
13327,48343,Morris,Texas,2012,1858,3232,49,5139,0.3615489394823896,0.6289161315431018,0.00953492897450866,-197,14,74,-109,-0.03002880442004946,0.0028657216574354888,0.02716308276261392,-1374,-271,-0.2673671920607122,-0.05719188718266338
13328,48343,Morris,Texas,2016,1425,3446,102,4973,0.2865473557208928,0.6929418861854012,0.020510758093706012,-433,53,214,-166,-0.07500158376149679,0.010975829119197353,0.06402575464229943,-2021,-647,-0.4063945304645084,-0.13902733840379622
13329,48345,Motley,Texas,2000,118,514,10,642,0.1838006230529595,0.8006230529595015,0.01557632398753894,0,0,0,0,0.0,0.0,0.0,-396,0,-0.616822429906542,0.0
13330,48345,Motley,Texas,2004,113,564,7,684,0.1652046783625731,0.8245614035087719,0.01023391812865497,-5,-3,50,42,-0.01859594469038639,-0.005342405858883971,0.023938350549270404,-451,-55,-0.6593567251461988,-0.042534295239656794
13331,48345,Motley,Texas,2008,67,522,5,594,0.1127946127946128,0.8787878787878788,0.008417508417508417,-46,-2,-42,-90,-0.05241006556796031,-0.0018164097111465528,0.054226475279106845,-455,-4,-0.765993265993266,-0.1066365408470672
13332,48345,Motley,Texas,2012,55,538,7,600,0.09166666666666666,0.8966666666666666,0.011666666666666667,-12,2,16,6,-0.021127946127946134,0.00324915824915825,0.017878787878787827,-483,-28,-0.8049999999999999,-0.039006734006733934
13333,48345,Motley,Texas,2016,40,566,9,615,0.06504065040650407,0.9203252032520325,0.014634146341463415,-15,2,28,15,-0.02662601626016259,0.0029674796747967483,0.023658536585365875,-526,-43,-0.8552845528455284,-0.05028455284552846
13334,48347,Nacogdoches,Texas,2000,6204,13145,450,19799,0.3133491590484368,0.6639224203242589,0.02272842062730441,0,0,0,0,0.0,0.0,0.0,-6941,0,-0.35057326127582206,0.0
13335,48347,Nacogdoches,Texas,2004,7152,14160,154,21466,0.3331780490077332,0.6596478151495389,0.007174135842728035,948,-296,1015,1667,0.01982888995929638,-0.015554284784576374,-0.004274605174720003,-7008,-67,-0.3264697661418057,0.024103495134016384
13336,48347,Nacogdoches,Texas,2008,8393,14828,170,23391,0.3588132187593519,0.6339190286862468,0.007267752554401265,1241,16,668,1925,0.025635169751618725,9.361671167323025e-05,-0.02572878646329202,-6435,573,-0.27510580992689493,0.051363956214910744
13337,48347,Nacogdoches,Texas,2012,6465,13925,263,20653,0.3130295840797947,0.6742361884471989,0.012734227473006343,-1928,93,-903,-2738,-0.045783634679557206,0.005466474918605078,0.04031715976095207,-7460,-1025,-0.3612066043674042,-0.08610079444050928
13338,48347,Nacogdoches,Texas,2016,6846,14771,1005,22622,0.3026257625320484,0.6529484572540005,0.04442578021395102,381,742,846,1969,-0.010403821547746273,0.03169155274094468,-0.021287731193198378,-7925,-465,-0.3503226947219521,0.010883909645452106
13339,48349,Navarro,Texas,2000,5366,8358,166,13890,0.386321094312455,0.6017278617710583,0.011951043916486681,0,0,0,0,0.0,0.0,0.0,-2992,0,-0.21540676745860332,0.0
13340,48349,Navarro,Texas,2004,5259,10715,60,16034,0.32799052014469254,0.6682674317076213,0.003742048147686167,-107,-106,2357,2144,-0.05833057416776244,-0.008208995768800515,0.06653956993656296,-5456,-2464,-0.3402769115629287,-0.1248701441043254
13341,48349,Navarro,Texas,2008,5400,10810,111,16321,0.3308620795294406,0.6623368666135654,0.006801053856994057,141,51,95,287,0.0028715593847480347,0.00305900570930789,-0.005930565094055873,-5410,46,-0.3314747870841248,0.008802124478803908
13342,48349,Navarro,Texas,2012,4350,10847,167,15364,0.2831293933871388,0.7060010413954699,0.010869565217391304,-1050,56,37,-957,-0.047732686142301806,0.004068511360397247,0.04366417478190454,-6497,-1087,-0.42287164800833116,-0.09139686092420635
13343,48349,Navarro,Texas,2016,4002,11994,437,16433,0.24353435160956613,0.7298728168928376,0.026592831497596302,-348,270,1147,1069,-0.03959504177757264,0.015723266280204998,0.02387177549736763,-7992,-1495,-0.4863384652832714,-0.06346681727494025
13344,48351,Newton,Texas,2000,2503,2423,64,4990,0.5016032064128256,0.48557114228456916,0.01282565130260521,0,0,0,0,0.0,0.0,0.0,80,0,0.016032064128256474,0.0
13345,48351,Newton,Texas,2004,2513,3159,28,5700,0.44087719298245615,0.5542105263157895,0.004912280701754386,10,-36,736,710,-0.060726013430369485,-0.007913370600850823,0.06863938403122033,-646,-726,-0.11333333333333334,-0.12936539746158982
13346,48351,Newton,Texas,2008,1751,3446,63,5260,0.3328897338403042,0.6551330798479087,0.011977186311787073,-762,35,287,-440,-0.10798745914215196,0.0070649056100326865,0.10092255353211921,-1695,-1049,-0.3222433460076045,-0.20891001267427117
13347,48351,Newton,Texas,2012,1677,4112,80,5869,0.28573862668256944,0.7006304310785483,0.013630942238882263,-74,17,666,609,-0.04715110715773474,0.0016537559270951904,0.04549735123063958,-2435,-740,-0.41489180439597884,-0.09264845838837432
13348,48351,Newton,Texas,2016,1156,4288,90,5534,0.20889049512106975,0.7748464040477051,0.016263100831225154,-521,10,176,-335,-0.0768481315614997,0.0026321585923428908,0.07421597296915683,-3132,-697,-0.5659559089266354,-0.15106410453065655
13349,48353,Nolan,Texas,2000,1874,3337,101,5312,0.35278614457831325,0.6282003012048193,0.01901355421686747,0,0,0,0,0.0,0.0,0.0,-1463,0,-0.27541415662650603,0.0
13350,48353,Nolan,Texas,2004,1541,3722,26,5289,0.2913594252221592,0.7037247116657213,0.004915863112119493,-333,-75,385,-23,-0.06142671935615407,-0.014097691104747977,0.07552441046090197,-2181,-718,-0.4123652864435621,-0.13695112981705604
13351,48353,Nolan,Texas,2008,1521,3485,57,5063,0.30041477384949633,0.6883270788070314,0.01125814734347225,-20,31,-237,-226,0.009055348627337145,0.006342284231352757,-0.015397632858689891,-1964,217,-0.38791230495753504,0.024452981486027037
13352,48353,Nolan,Texas,2012,1216,3282,77,4575,0.26579234972677596,0.7173770491803279,0.016830601092896174,-305,20,-203,-488,-0.034622424122720374,0.005572453749423924,0.029049970373296485,-2066,-102,-0.4515846994535519,-0.06367239449601686
13353,48353,Nolan,Texas,2016,1029,3552,276,4857,0.2118591723285979,0.7313156269302038,0.05682520074119827,-187,199,270,282,-0.053933177398178045,0.0399945996483021,0.013938577749875947,-2523,-457,-0.5194564546016058,-0.06787175514805394
13354,48355,Nueces,Texas,2000,45349,49906,2071,97326,0.4659494893450876,0.512771510182274,0.021279000472638348,0,0,0,0,0.0,0.0,0.0,-4557,0,-0.04682202083718634,0.0
13355,48355,Nueces,Texas,2004,44439,59359,762,104560,0.4250095638867636,0.5677027543993879,0.007287681713848508,-910,-1309,9453,7234,-0.040939925458324034,-0.013991318758789839,0.05493124421711393,-14920,-10363,-0.1426931905126243,-0.09587116967543796
13356,48355,Nueces,Texas,2008,47912,52391,927,101230,0.4732984293193717,0.5175442062629655,0.009157364417662748,3473,165,-6968,-3330,0.04828886543260813,0.0018696827038142396,-0.0501585481364224,-4479,10441,-0.04424577694359377,0.09844741356903053
13357,48355,Nueces,Texas,2012,45772,48966,1366,96104,0.4762757013235661,0.5095105302588862,0.014213768417547656,-2140,439,-3425,-5126,0.002977272004194398,0.0050564039998849085,-0.008033676004079338,-3194,1285,-0.03323482893532004,0.011010948008273735
13358,48355,Nueces,Texas,2016,49198,50766,4441,104405,0.4712226425937455,0.48624108040802644,0.042536276998228054,3426,3075,1800,8301,-0.005053058729820592,0.028322508580680396,-0.023269449850859714,-1568,1626,-0.015018437814280916,0.01821639112103912
13359,48357,Ochiltree,Texas,2000,251,2687,24,2962,0.08474004051316678,0.9071573261309925,0.008102633355840648,0,0,0,0,0.0,0.0,0.0,-2436,0,-0.8224172856178258,0.0
13360,48357,Ochiltree,Texas,2004,251,2922,4,3177,0.07900535096002519,0.9197355996222851,0.0012590494176896443,0,-20,235,215,-0.005734689553141589,-0.006843583938151004,0.012578273491292591,-2671,-235,-0.84073024866226,-0.018312963044434194
13361,48357,Ochiltree,Texas,2008,243,2851,15,3109,0.0781601801222258,0.9170151174010936,0.004824702476680605,-8,11,-71,-68,-0.0008451708377993916,0.0035656530589909608,-0.002720482221191478,-2608,63,-0.8388549372788678,0.001875311383392142
13362,48357,Ochiltree,Texas,2012,253,2719,21,2993,0.0845305713331106,0.908453057133311,0.0070163715335783495,10,6,-132,-116,0.006370391210884799,0.0021916690568977446,-0.008562060267782612,-2466,142,-0.8239224858002004,0.014932451478667397
13363,48357,Ochiltree,Texas,2016,274,2628,100,3002,0.09127248500999334,0.8754163890739507,0.033311125916055964,21,79,-91,9,0.0067419136768827465,0.026294754382477616,-0.03303666805936034,-2354,112,-0.7841439040639574,0.039778581736243046
13364,48359,Oldham,Texas,2000,108,659,7,774,0.13953488372093023,0.851421188630491,0.00904392764857881,0,0,0,0,0.0,0.0,0.0,-551,0,-0.7118863049095607,0.0
13365,48359,Oldham,Texas,2004,108,733,2,843,0.12811387900355872,0.8695136417556346,0.002372479240806643,0,-5,74,69,-0.011421004717371508,-0.0066714484077721676,0.018092453125143626,-625,-74,-0.7413997627520759,-0.029513457842515134
13366,48359,Oldham,Texas,2008,102,813,5,920,0.1108695652173913,0.883695652173913,0.005434782608695652,-6,3,80,77,-0.01724431378616742,0.003062303367889009,0.014182010418278379,-711,-86,-0.7728260869565217,-0.0314263242044458
13367,48359,Oldham,Texas,2012,71,790,8,869,0.08170310701956271,0.9090909090909091,0.009205983889528193,-31,3,-23,-51,-0.029166458197828593,0.0037712012808325413,0.025395256916996067,-719,-8,-0.8273878020713463,-0.05456171511482466
13368,48359,Oldham,Texas,2016,78,850,20,948,0.08227848101265822,0.8966244725738397,0.02109704641350211,7,12,60,79,0.0005753739930955126,0.011891062523973915,-0.012466436517069357,-772,-53,-0.8143459915611815,0.013041810510164842
13369,48361,Orange,Texas,2000,11887,17325,442,29654,0.40085654549133337,0.5842382140689283,0.014905240439738315,0,0,0,0,0.0,0.0,0.0,-5438,0,-0.18338166857759491,0.0
13370,48361,Orange,Texas,2004,11476,20292,140,31908,0.35965901968158454,0.6359533659270402,0.004387614391375204,-411,-302,2967,2254,-0.041197525809748836,-0.01051762604836311,0.05171515185811193,-8816,-3378,-0.2762943462454557,-0.09291267766786077
13371,48361,Orange,Texas,2008,7646,21509,251,29406,0.2600149629327348,0.7314493640753588,0.008535672991906414,-3830,111,1217,-2502,-0.09964405674884974,0.00414805860053121,0.09549599814831855,-13863,-5047,-0.47143440114262397,-0.1951400548971683
13372,48361,Orange,Texas,2012,6800,23366,529,30695,0.2215344518651246,0.7612314709236032,0.017234077211272195,-846,278,1857,1289,-0.03848051106761019,0.00869840421936578,0.02978210684824445,-16566,-2703,-0.5396970190584787,-0.0682626179158547
13373,48361,Orange,Texas,2016,5735,25513,752,32000,0.17921875,0.79728125,0.0235,-1065,223,2147,1305,-0.042315701865124594,0.0062659227887278054,0.03604977907639684,-19778,-3212,-0.6180625000000001,-0.0783654809415214
13374,48363,Palo Pinto,Texas,2000,3263,5690,165,9118,0.3578635665716166,0.6240403597280105,0.01809607370037289,0,0,0,0,0.0,0.0,0.0,-2427,0,-0.2661767931563939,0.0
13375,48363,Palo Pinto,Texas,2004,2816,7137,61,10014,0.2812063111643699,0.7127022168963452,0.006091471939285001,-447,-104,1447,896,-0.07665725540724672,-0.012004601761087887,0.08866185716833463,-4321,-1894,-0.43149590573197527,-0.16531911257558135
13376,48363,Palo Pinto,Texas,2008,2499,7264,127,9890,0.2526794742163802,0.734479271991911,0.012841253791708796,-317,66,127,-124,-0.028526836947989687,0.0067497818524237954,0.021777055095565823,-4765,-444,-0.4817997977755308,-0.05030389204355551
13377,48363,Palo Pinto,Texas,2012,1811,7393,147,9351,0.19366912629665275,0.7906106298791573,0.015720243824189926,-688,20,129,-539,-0.05901034791972745,0.0028789900324811303,0.056131357887246325,-5582,-817,-0.5969415035825045,-0.11514170580697375
13378,48363,Palo Pinto,Texas,2016,1708,8284,278,10270,0.16630963972736124,0.8066212268743914,0.027069133398247323,-103,131,891,919,-0.02735948656929152,0.011348889574057396,0.016010596995234105,-6576,-994,-0.6403115871470302,-0.04337008356452565
13379,48365,Panola,Texas,2000,3011,5975,88,9074,0.33182719858937626,0.6584747630592903,0.00969803835133348,0,0,0,0,0.0,0.0,0.0,-2964,0,-0.32664756446991405,0.0
13380,48365,Panola,Texas,2004,2958,7021,28,10007,0.2955930848406116,0.7016088737883481,0.0027980413710402717,-53,-60,1046,933,-0.036234113748764674,-0.006899996980293209,0.04313411072905782,-4063,-1099,-0.40601578894773654,-0.07936822447782249
13381,48365,Panola,Texas,2008,2586,7582,48,10216,0.25313234142521535,0.7421691464369616,0.004698512137823023,-372,20,561,209,-0.04246074341539624,0.0019004707667827515,0.040560272648613505,-4996,-933,-0.4890368050117463,-0.08302101606400974
13382,48365,Panola,Texas,2012,2211,7950,69,10230,0.2161290322580645,0.7771260997067448,0.006744868035190616,-375,21,368,14,-0.03700330916715083,0.002046355897367593,0.03495695326978321,-5739,-743,-0.5609970674486804,-0.0719602624369341
13383,48365,Panola,Texas,2016,1835,8445,136,10416,0.17617127496159754,0.8107718894009217,0.013056835637480798,-376,67,495,186,-0.03995775729646697,0.006311967602290182,0.033645789694176864,-6610,-871,-0.6346006144393241,-0.07360354699064375
13384,48367,Parker,Texas,2000,8878,23651,696,33225,0.2672084273890143,0.7118434913468773,0.020948081264108354,0,0,0,0,0.0,0.0,0.0,-14773,0,-0.444635063957863,0.0
13385,48367,Parker,Texas,2004,8966,31795,196,40957,0.21891251800668995,0.7763019752423274,0.004785506750982738,88,-500,8144,7732,-0.04829590938232434,-0.016162574513125617,0.06445848389545006,-22829,-8056,-0.5573894572356374,-0.11275439327777437
13386,48367,Parker,Texas,2008,10502,36974,475,47951,0.21901524472899417,0.7710788096181519,0.009905945652853954,1536,279,5179,6994,0.00010272672230421387,0.005120438901871216,-0.005223165624175463,-26472,-3643,-0.5520635648891578,0.0053258923464796215
13387,48367,Parker,Texas,2012,7853,39243,598,47694,0.16465383486392418,0.8228079003648258,0.012538264771250052,-2649,123,2269,-257,-0.05436140986506999,0.0026323191183960978,0.05172909074667387,-31390,-4918,-0.6581540655009016,-0.10609050061174385
13388,48367,Parker,Texas,2016,8344,46473,2000,56817,0.14685745463505642,0.8179418131897144,0.035200732175229246,491,1402,7230,9123,-0.01779638022886776,0.022662467403979196,-0.004866087175111389,-38129,-6739,-0.671084358554658,-0.01293029305375637
13389,48369,Parmer,Texas,2000,447,2274,23,2744,0.16290087463556852,0.8287172011661808,0.008381924198250729,0,0,0,0,0.0,0.0,0.0,-1827,0,-0.6658163265306123,0.0
13390,48369,Parmer,Texas,2004,389,2375,9,2773,0.14028128380815003,0.856473133790119,0.0032455824017309774,-58,-14,101,29,-0.02261959082741849,-0.005136341796519752,0.027755932623938273,-1986,-159,-0.716191849981969,-0.05037552345135676
13391,48369,Parmer,Texas,2008,719,2969,25,3713,0.19364395367627255,0.7996229464045247,0.006733099919202801,330,16,594,940,0.05336266986812252,0.0034875175174718235,-0.05685018738559433,-2250,-264,-0.6059789927282522,0.11021285725371688
13392,48369,Parmer,Texas,2012,529,2011,14,2554,0.2071260767423649,0.7873923257635083,0.00548159749412686,-190,-11,-958,-1159,0.013482123066092366,-0.0012515024250759413,-0.012230620641016432,-1482,768,-0.5802662490211433,0.025712743707108854
13393,48369,Parmer,Texas,2016,485,1915,66,2466,0.19667477696674776,0.7765612327656123,0.0267639902676399,-44,52,-96,-88,-0.010451299775617151,0.021282392773513042,-0.010831092997895975,-1430,52,-0.5798864557988646,0.0003797932222787681
13394,48371,Pecos,Texas,2000,1539,2700,64,4303,0.3576574482918894,0.6274692075296305,0.01487334417848013,0,0,0,0,0.0,0.0,0.0,-1161,0,-0.26981175923774114,0.0
13395,48371,Pecos,Texas,2004,1242,3167,19,4428,0.2804878048780488,0.7152213188798555,0.004290876242095754,-297,-45,467,125,-0.07716964341384058,-0.010582467936384376,0.08775211135022498,-1925,-764,-0.4347335140018067,-0.16492175476406556
13396,48371,Pecos,Texas,2008,1476,2480,54,4010,0.3680798004987531,0.6184538653366584,0.013466334164588529,234,35,-687,-418,0.0875919956207043,0.009175457922492775,-0.09676745354319716,-1004,921,-0.25037406483790525,0.18435944916390146
13397,48371,Pecos,Texas,2012,1591,2512,47,4150,0.3833734939759036,0.6053012048192771,0.011325301204819277,115,-7,32,140,0.015293693477150483,-0.0021410329597692512,-0.013152660517381287,-921,83,-0.22192771084337348,0.02844635399453177
13398,48371,Pecos,Texas,2016,1554,2468,163,4185,0.37132616487455194,0.5897252090800478,0.03894862604540024,-37,116,-44,35,-0.012047329101351645,0.027623324840580964,-0.015575995739229298,-914,7,-0.21839904420549583,0.0035286666378776532
13399,48373,Polk,Texas,2000,6877,11746,371,18994,0.36206170369590396,0.6184058123617985,0.019532483942297566,0,0,0,0,0.0,0.0,0.0,-4869,0,-0.2563441086658945,0.0
13400,48373,Polk,Texas,2004,6964,13778,104,20846,0.3340688861172407,0.6609421471745179,0.004988966708241389,87,-267,2032,1852,-0.02799281757866323,-0.014543517234056176,0.042536334812719456,-6814,-1945,-0.3268732610572772,-0.07052915239138269
13401,48373,Polk,Texas,2008,6230,13731,188,20149,0.3091964861779741,0.6814730259566232,0.00933048786540275,-734,84,-47,-697,-0.024872399939266654,0.00434152115716136,0.020530878782105244,-7501,-687,-0.3722765397786491,-0.0454032787213719
13402,48373,Polk,Texas,2012,4859,14071,204,19134,0.25394585554510296,0.7353924950350162,0.01066164941988084,-1371,16,340,-1015,-0.05525063063287111,0.001331161554478091,0.05391946907839307,-9212,-1711,-0.4814466394899133,-0.10917009971126418
13403,48373,Polk,Texas,2016,4187,15176,489,19852,0.2109107394720935,0.764456981664316,0.02463227886359057,-672,285,1105,718,-0.04303511607300947,0.01397062944370973,0.029064486629299724,-10989,-1777,-0.5535462421922225,-0.0720996027023092
13404,48375,Potter,Texas,2000,7242,17629,505,25376,0.2853877679697352,0.6947115384615384,0.019900693568726355,0,0,0,0,0.0,0.0,0.0,-10387,0,-0.40932377049180324,0.0
13405,48375,Potter,Texas,2004,7489,21401,166,29056,0.25774366740088106,0.7365432268722467,0.005713105726872247,247,-339,3772,3680,-0.027644100568854135,-0.014187587841854109,0.04183168841070828,-13912,-3525,-0.47879955947136565,-0.06947578897956241
13406,48375,Potter,Texas,2008,8939,20761,313,30013,0.2978376037050611,0.691733582114417,0.010428814180521774,1450,147,-640,957,0.04009393630418007,0.0047157084536495275,-0.04480964475782967,-11822,2090,-0.3938959784093559,0.08490358106200974
13407,48375,Potter,Texas,2012,7126,18918,406,26450,0.269413988657845,0.7152362948960302,0.015349716446124763,-1813,93,-1843,-3563,-0.028423615047216133,0.004920902265602989,0.0235027127816132,-11792,30,-0.44582230623818525,-0.05192632782882933
13408,48375,Potter,Texas,2016,7657,19630,1364,28651,0.2672507067816132,0.6851418798645772,0.04760741335380964,531,958,712,2201,-0.0021632818762317707,0.03225769690768488,-0.030094415031453048,-11973,-181,-0.417891173082964,0.027931133155221277
13409,48377,Presidio,Texas,2000,1064,618,75,1757,0.6055776892430279,0.35173591348890154,0.042686397268070574,0,0,0,0,0.0,0.0,0.0,446,0,0.25384177575412636,0.0
13410,48377,Presidio,Texas,2004,1159,715,16,1890,0.6132275132275132,0.3783068783068783,0.008465608465608466,95,-59,97,133,0.007649823984485327,-0.034220788802462106,0.026570964817976772,444,-2,0.23492063492063492,-0.018921140833491445
13411,48377,Presidio,Texas,2008,1252,489,16,1757,0.7125782583949914,0.27831531018782013,0.00910643141718839,93,0,-226,-133,0.09935074516747822,0.0006408229515799235,-0.09999156811905818,763,319,0.4342629482071713,0.1993423132865364
13412,48377,Presidio,Texas,2012,1282,504,31,1817,0.7055586130985141,0.2773802971931756,0.0170610897083104,30,15,15,60,-0.0070196452964773615,0.007954658291122012,-0.0009350129946445462,778,15,0.4281783159053385,-0.006084632301832815
13413,48377,Presidio,Texas,2016,1458,652,98,2208,0.6603260869565217,0.29528985507246375,0.044384057971014496,176,67,148,391,-0.04523252614199236,0.027322968262704094,0.017909557879288163,806,28,0.365036231884058,-0.06314208402128052
13414,48379,Rains,Texas,2000,1225,2049,59,3333,0.36753675367536753,0.6147614761476148,0.0177017701770177,0,0,0,0,0.0,0.0,0.0,-824,0,-0.24722472247224725,0.0
13415,48379,Rains,Texas,2004,1213,2998,18,4229,0.2868290375975408,0.7089146370300308,0.00425632537242847,-12,-41,949,896,-0.08070771607782673,-0.013445444804589231,0.09415316088241599,-1785,-961,-0.42208559943248997,-0.17486087696024272
13416,48379,Rains,Texas,2008,1048,3146,42,4236,0.2474032105760151,0.7426817752596789,0.009915014164305949,-165,24,148,7,-0.039425827021525695,0.005658688791877479,0.033767138229648164,-2098,-313,-0.4952785646836638,-0.07319296525117386
13417,48379,Rains,Texas,2012,761,3279,47,4087,0.18620014680694885,0.8022999755321751,0.011499877660875948,-287,5,133,-149,-0.06120306376906626,0.0015848634965699993,0.0596182002724962,-2518,-420,-0.6160998287252263,-0.12082126404156246
13418,48379,Rains,Texas,2016,628,3968,105,4701,0.133588598170602,0.8440757285683897,0.022335673261008295,-133,58,689,614,-0.052611548636346844,0.010835795600132347,0.04177575303621461,-3340,-822,-0.7104871303977878,-0.09438730167256149
13419,48381,Randall,Texas,2000,7209,33921,660,41790,0.172505384063173,0.8117013639626705,0.015793251974156496,0,0,0,0,0.0,0.0,0.0,-26712,0,-0.6391959798994975,0.0
13420,48381,Randall,Texas,2004,7849,40520,218,48587,0.16154526931072097,0.8339679338094552,0.004486796879823821,640,-442,6599,6797,-0.010960114752452038,-0.011306455094332675,0.022266569846784767,-32671,-5959,-0.6724226644987342,-0.03322668459923672
13421,48381,Randall,Texas,2008,9468,41948,416,51832,0.1826670782528168,0.8093069918197253,0.008025929927457941,1619,198,1428,3245,0.021121808942095838,0.0035391330476341205,-0.0246609419897299,-32480,191,-0.6266399135669085,0.04578275093182571
13422,48381,Randall,Texas,2012,7574,41447,675,49696,0.15240663232453316,0.8340107855763039,0.01358258209916291,-1894,259,-501,-2136,-0.03026044592828364,0.005556652171704968,0.024703793756578607,-33873,-1393,-0.6816041532517707,-0.05496423968486219
13423,48381,Randall,Texas,2016,8367,43462,2476,54305,0.15407421047785655,0.8003314611914188,0.04559432833072461,793,1801,2015,4609,0.0016675781533233847,0.0320117462315617,-0.03367932438488508,-35095,-1222,-0.6462572507135623,0.03534690253820838
13424,48383,Reagan,Texas,2000,282,959,14,1255,0.22470119521912352,0.7641434262948207,0.011155378486055778,0,0,0,0,0.0,0.0,0.0,-677,0,-0.5394422310756972,0.0
13425,48383,Reagan,Texas,2004,184,956,3,1143,0.1609798775153106,0.8363954505686789,0.0026246719160104987,-98,-11,-3,-112,-0.06372131770381292,-0.008530706570045279,0.07225202427385824,-772,-95,-0.6754155730533683,-0.13597334197767108
13426,48383,Reagan,Texas,2008,197,795,2,994,0.1981891348088531,0.7997987927565392,0.002012072434607646,13,-1,-161,-149,0.03720925729354252,-0.0006125994814028526,-0.03659665781213972,-598,174,-0.6016096579476861,0.07380591510568224
13427,48383,Reagan,Texas,2012,158,676,9,843,0.1874258600237248,0.8018979833926453,0.010676156583629894,-39,7,-119,-151,-0.010763274785128313,0.008664084149022248,0.0020991906361060853,-518,80,-0.6144721233689205,-0.012862465421234481
13428,48383,Reagan,Texas,2016,167,709,28,904,0.1847345132743363,0.7842920353982301,0.030973451327433628,9,19,33,61,-0.002691346749388507,0.020297294743803734,-0.017605947994415172,-542,-24,-0.5995575221238938,0.014914601245026748
13429,48385,Real,Texas,2000,316,1146,28,1490,0.21208053691275167,0.7691275167785235,0.01879194630872483,0,0,0,0,0.0,0.0,0.0,-830,0,-0.5570469798657719,0.0
13430,48385,Real,Texas,2004,325,1314,6,1645,0.19756838905775076,0.7987841945288754,0.00364741641337386,9,-22,168,155,-0.014512147855000906,-0.01514452989535097,0.029656677750351856,-989,-159,-0.6012158054711246,-0.044168825605352735
13431,48385,Real,Texas,2008,375,1238,15,1628,0.23034398034398035,0.7604422604422605,0.009213759213759214,50,9,-76,-17,0.03277559128622959,0.005566342800385354,-0.038341934086614904,-863,126,-0.5300982800982801,0.07111752537284455
13432,48385,Real,Texas,2012,277,1236,22,1535,0.18045602605863192,0.8052117263843648,0.014332247557003257,-98,7,-2,-93,-0.049887954285348424,0.0051184883432440435,0.04476946594210429,-959,-96,-0.6247557003257329,-0.09465742022745283
13433,48385,Real,Texas,2016,262,1382,37,1681,0.15585960737656157,0.8221296847114813,0.022010707911957167,-15,15,146,146,-0.024596418682070353,0.00767846035495391,0.01691795832711651,-1120,-161,-0.6662700773349197,-0.04151437700918681
13434,48387,Red River,Texas,2000,2219,2941,42,5202,0.42656670511341793,0.565359477124183,0.008073817762399077,0,0,0,0,0.0,0.0,0.0,-722,0,-0.13879277201076506,0.0
13435,48387,Red River,Texas,2004,2097,3379,14,5490,0.3819672131147541,0.6154826958105647,0.0025500910746812386,-122,-28,438,288,-0.04459949199866381,-0.005523726687717838,0.0501232186863817,-1282,-560,-0.23351548269581057,-0.09472271068504551
13436,48387,Red River,Texas,2008,1539,3461,52,5052,0.30463182897862234,0.6850752177355502,0.010292953285827395,-558,38,82,-438,-0.07733538413613178,0.007742862211146157,0.06959252192498555,-1922,-640,-0.3804433887569279,-0.14692790606111733
13437,48387,Red River,Texas,2012,1482,3549,43,5074,0.2920772566022862,0.6994481671265274,0.00847457627118644,-57,-9,88,22,-0.01255457237633617,-0.0018183770146409546,0.014372949390977108,-2067,-145,-0.4073709105242412,-0.02692752176731328
13438,48387,Red River,Texas,2016,1149,3926,86,5161,0.22263127300910676,0.760705289672544,0.016663437318349156,-333,43,377,87,-0.06944598359317941,0.008188861047162715,0.061257122546016674,-2777,-710,-0.5380740166634372,-0.13070310613919606
13439,48389,Reeves,Texas,2000,1872,1273,31,3176,0.5894206549118388,0.40081863979848864,0.009760705289672544,0,0,0,0,0.0,0.0,0.0,599,0,0.18860201511335017,0.0
13440,48389,Reeves,Texas,2004,1600,1777,18,3395,0.47128129602356406,0.5234167893961709,0.005301914580265096,-272,-13,504,219,-0.11813935888827476,-0.004458790709407448,0.12259814959768223,-177,-776,-0.05213549337260681,-0.24073750848595699
13441,48389,Reeves,Texas,2008,1606,1445,26,3077,0.5219369515762106,0.4696132596685083,0.008449788755281119,6,8,-332,-318,0.050655655552646506,0.0031478741750160227,-0.05380352972766256,161,338,0.05232369190770225,0.10445918528030906
13442,48389,Reeves,Texas,2012,1655,1188,34,2877,0.5752519986096628,0.4129301355578728,0.011817865832464372,49,8,-257,-200,0.053315047033452245,0.0033680770771832534,-0.05668312411063553,467,306,0.16232186305179003,0.10999817114408778
13443,48389,Reeves,Texas,2016,1659,1417,108,3184,0.5210427135678392,0.44503768844221103,0.03391959798994975,4,74,229,307,-0.05420928504182365,0.022101732157485378,0.03210755288433825,242,-225,0.07600502512562812,-0.0863168379261619
13444,48391,Refugio,Texas,2000,1172,1721,28,2921,0.40123245463882234,0.5891817870592263,0.009585758301951387,0,0,0,0,0.0,0.0,0.0,-549,0,-0.18794933242040396,0.0
13445,48391,Refugio,Texas,2004,1232,2212,11,3455,0.35658465991316934,0.640231548480463,0.0031837916063675834,60,-17,491,534,-0.044647794725653,-0.006401966695583804,0.05104976142123674,-980,-431,-0.2836468885672937,-0.09569755614688974
13446,48391,Refugio,Texas,2008,1382,1855,24,3261,0.4237963814780742,0.5688439129101502,0.007359705611775529,150,13,-357,-194,0.06721172156490485,0.004175914005407946,-0.0713876355703128,-473,507,-0.14504753143207605,0.13859935713521765
13447,48391,Refugio,Texas,2012,998,1663,16,2677,0.3728053791557714,0.6212177810982443,0.005976839745984311,-384,-8,-192,-584,-0.0509910023223028,-0.0013828658657912178,0.052373868188094086,-665,-192,-0.24841240194247294,-0.10336487051039689
13448,48391,Refugio,Texas,2016,1034,1830,84,2948,0.35074626865671643,0.6207598371777476,0.028493894165535955,36,68,167,271,-0.022059110499054957,0.022517054419551645,-0.0004579439204966951,-796,-131,-0.2700135685210312,-0.021601166578558262
13449,48393,Roberts,Texas,2000,72,472,5,549,0.13114754098360656,0.8597449908925319,0.009107468123861567,0,0,0,0,0.0,0.0,0.0,-400,0,-0.7285974499089253,0.0
13450,48393,Roberts,Texas,2004,46,461,0,507,0.09072978303747535,0.9092702169625246,0.0,-26,-5,-11,-42,-0.040417757946131214,-0.009107468123861567,0.04952522606999277,-415,-15,-0.8185404339250493,-0.089942984016124
13451,48393,Roberts,Texas,2008,41,477,0,518,0.07915057915057915,0.9208494208494209,0.0,-5,0,16,11,-0.011579203886896205,0.0,0.011579203886896261,-436,-21,-0.8416988416988418,-0.023158407773792522
13452,48393,Roberts,Texas,2012,33,468,7,508,0.06496062992125984,0.9212598425196851,0.013779527559055118,-8,7,-9,-10,-0.014189949229319307,0.013779527559055118,0.00041042167026417165,-435,1,-0.8562992125984252,-0.014600370899583437
13453,48393,Roberts,Texas,2016,20,524,10,554,0.036101083032490974,0.9458483754512635,0.018050541516245487,-13,3,56,46,-0.028859546888768864,0.004271013957190369,0.024588532931578477,-504,-69,-0.9097472924187726,-0.05344807982034738
13454,48395,Robertson,Texas,2000,3283,3007,79,6369,0.5154655361909248,0.4721306327523944,0.012403831056680798,0,0,0,0,0.0,0.0,0.0,276,0,0.043334903438530414,0.0
13455,48395,Robertson,Texas,2004,2979,3792,24,6795,0.4384105960264901,0.5580573951434878,0.003532008830022075,-304,-55,785,426,-0.07705494016443476,-0.008871822226658723,0.08592676239109343,-813,-1089,-0.11964679911699777,-0.16298170255552819
13456,48395,Robertson,Texas,2008,2675,3980,55,6710,0.3986587183308495,0.5931445603576752,0.00819672131147541,-304,31,188,-85,-0.03975187769564059,0.004664712481453335,0.03508716521418731,-1305,-492,-0.19448584202682567,-0.0748390429098279
13457,48395,Robertson,Texas,2012,2798,4419,70,7287,0.38397145601756555,0.6064223960477563,0.009606147934678195,123,15,439,577,-0.014687262313283933,0.0014094266232027846,0.013277835690081119,-1621,-316,-0.22245094003019072,-0.027965098003365052
13458,48395,Robertson,Texas,2016,2203,4668,164,7035,0.3131485429992893,0.6635394456289979,0.023312011371712866,-595,94,249,-252,-0.07082291301827626,0.013705863437034671,0.05711704958124164,-2465,-844,-0.3503909026297086,-0.1279399625995179
13459,48397,Rockwall,Texas,2000,3642,13666,344,17652,0.2063222297756628,0.7741898934964877,0.019487876727849535,0,0,0,0,0.0,0.0,0.0,-10024,0,-0.5678676637208249,0.0
13460,48397,Rockwall,Texas,2004,5320,20120,141,25581,0.20796685039677887,0.7865212462374419,0.005511903365779289,1678,-203,6454,7929,0.0016446206211160608,-0.013975973362070246,0.012331352740954205,-14800,-4776,-0.578554395840663,-0.010686732119838172
13461,48397,Rockwall,Texas,2008,8492,23300,370,32162,0.26403830607549283,0.7244574342391642,0.011504259685342952,3172,229,3180,6581,0.056071455678713966,0.005992356319563663,-0.06206381199827771,-14808,-8,-0.46041912816367137,0.11813526767699167
13462,48397,Rockwall,Texas,2012,8120,27113,531,35764,0.22704395481489767,0.7581087126719607,0.014847332513141707,-372,161,3813,3602,-0.036994351260595165,0.0033430728277987556,0.03365127843279647,-18993,-4185,-0.531064757857063,-0.07064562969339161
13463,48397,Rockwall,Texas,2016,9655,28451,1842,39948,0.24168919595474117,0.7122008611194552,0.046109942925803546,1535,1311,1338,4184,0.014645241139843501,0.03126261041266184,-0.04590785155250543,-18796,197,-0.4705116651647141,0.060553092692348875
13464,48399,Runnels,Texas,2000,969,3020,57,4046,0.23949579831932774,0.7464162135442413,0.014087988136431043,0,0,0,0,0.0,0.0,0.0,-2051,0,-0.5069204152249135,0.0
13465,48399,Runnels,Texas,2004,792,3239,18,4049,0.19560385280316128,0.799950605087676,0.004445542109162756,-177,-39,219,3,-0.04389194551616646,-0.009642446027268287,0.053534391543434756,-2447,-396,-0.6043467522845147,-0.09742633705960124
13466,48399,Runnels,Texas,2008,720,3118,29,3867,0.18619084561675717,0.8063098008792345,0.0074993535040082755,-72,11,-121,-182,-0.009413007186404115,0.003053811394845519,0.006359195791558525,-2398,49,-0.6201189552624774,-0.015772202977962668
13467,48399,Runnels,Texas,2012,519,3104,45,3668,0.1414940021810251,0.8462377317339149,0.012268266085059978,-201,16,-14,-199,-0.044696843435732075,0.0047689125810517026,0.03992793085468038,-2585,-187,-0.7047437295528898,-0.08462477429041237
13468,48399,Runnels,Texas,2016,453,3250,79,3782,0.1197778952934955,0.8593336858804865,0.02088841882601798,-66,34,146,114,-0.02171610688752959,0.008620152740958,0.013095954146571609,-2797,-212,-0.7395557905869911,-0.03481206103410128
13469,48401,Rusk,Texas,2000,4841,11611,181,16633,0.29104791679191966,0.6980701016052426,0.010881981602837732,0,0,0,0,0.0,0.0,0.0,-6770,0,-0.407022184813323,0.0
13470,48401,Rusk,Texas,2004,4899,13390,55,18344,0.26706279982555603,0.7299389446140427,0.002998255560401221,58,-126,1779,1711,-0.02398511696636363,-0.00788372604243651,0.03186884300880011,-8491,-1721,-0.4628761447884867,-0.055853959975163736
13471,48401,Rusk,Texas,2008,4983,13646,93,18722,0.26615746180963573,0.728875120179468,0.004967418010896272,84,38,256,378,-0.0009053380159202984,0.001969162450495051,-0.001063824434574756,-8663,-172,-0.46271765836983225,0.00015848641865445767
13472,48401,Rusk,Texas,2012,4451,13924,171,18546,0.23999784320069018,0.7507818397498113,0.009220317049498545,-532,78,278,-176,-0.026159618608945556,0.0042528990386022725,0.02190671957034329,-9473,-810,-0.5107839965491211,-0.04806633817928885
13473,48401,Rusk,Texas,2016,3935,14675,384,18994,0.20717068547962514,0.7726124039170265,0.020216910603348424,-516,213,751,448,-0.03282715772106504,0.01099659355384988,0.021830564167215183,-10740,-1267,-0.5654417184374013,-0.05465772188828022
13474,48403,Sabine,Texas,2000,1753,2764,74,4591,0.3818340230886517,0.6020474842082335,0.01611849270311479,0,0,0,0,0.0,0.0,0.0,-1011,0,-0.2202134611195818,0.0
13475,48403,Sabine,Texas,2004,1476,3138,25,4639,0.31817201983186033,0.6764388876913128,0.0053890924768269025,-277,-49,374,48,-0.06366200325679139,-0.010729400226287888,0.07439140348307927,-1662,-651,-0.35826686785945244,-0.13805340673987065
13476,48403,Sabine,Texas,2008,1077,3749,48,4874,0.22096840377513335,0.7691834222404595,0.009848173984407058,-399,23,611,235,-0.09720361605672698,0.004459081507580155,0.09274453454914677,-2672,-1010,-0.5482150184653262,-0.18994815060587372
13477,48403,Sabine,Texas,2012,807,3727,44,4578,0.17627785058977719,0.8141109654871123,0.009611183923110528,-270,-4,-22,-296,-0.04469055318535617,-0.00023699006129652977,0.04492754324665271,-2920,-248,-0.6378331148973351,-0.08961809643200891
13478,48403,Sabine,Texas,2016,614,3998,39,4651,0.13201462051171792,0.8596000860030101,0.008385293485271984,-193,-5,271,73,-0.04426323007805927,-0.0012258904378385435,0.04548912051589782,-3384,-464,-0.7275854654912921,-0.08975235059395703
13479,48405,San Augustine,Texas,2000,1636,2116,53,3805,0.4299605781865966,0.5561103810775295,0.01392904073587385,0,0,0,0,0.0,0.0,0.0,-480,0,-0.12614980289093292,0.0
13480,48405,San Augustine,Texas,2004,1506,2235,16,3757,0.40085174341229707,0.5948895395262177,0.004258717061485228,-130,-37,119,-48,-0.02910883477429954,-0.009670323674388623,0.03877915844868818,-729,-249,-0.19403779611392064,-0.06788799322298772
13481,48405,San Augustine,Texas,2008,1328,2342,45,3715,0.35746971736204575,0.6304172274562584,0.012113055181695828,-178,29,107,-42,-0.04338202605025132,0.0078543381202106,0.035527687930040686,-1014,-285,-0.27294751009421264,-0.078909713980292
13482,48405,San Augustine,Texas,2012,1193,2469,28,3690,0.32330623306233064,0.6691056910569105,0.007588075880758808,-135,-17,127,-25,-0.03416348429971511,-0.00452497930093702,0.038688463600652145,-1276,-262,-0.3457994579945799,-0.07285194790036725
13483,48405,San Augustine,Texas,2016,910,2622,37,3569,0.25497338189969176,0.7346595685065844,0.010367049593723731,-283,9,153,-121,-0.06833285116263887,0.0027789737129649238,0.06555387744967389,-1712,-436,-0.47968618660689266,-0.13388672861231277
13484,48407,San Jacinto,Texas,2000,2946,4623,145,7714,0.38190303344568316,0.5992999740731139,0.018796992481203006,0,0,0,0,0.0,0.0,0.0,-1677,0,-0.2173969406274307,0.0
13485,48407,San Jacinto,Texas,2004,2688,5394,43,8125,0.3308307692307692,0.663876923076923,0.0052923076923076925,-258,-102,771,411,-0.051072264214913954,-0.013504684788895313,0.06457694900380917,-2706,-1029,-0.3330461538461538,-0.11564921321872312
13486,48407,San Jacinto,Texas,2008,2721,6151,86,8958,0.3037508372404555,0.6866488055369502,0.009600357222594329,33,43,757,833,-0.02707993199031372,0.004308049530286636,0.02277188246002715,-3430,-724,-0.3828979682964947,-0.04985181445034087
13487,48407,San Jacinto,Texas,2012,2410,7107,99,9616,0.25062396006655574,0.7390806988352745,0.010295341098169717,-311,13,956,658,-0.053126877173899745,0.000694983875575388,0.05243189329832432,-4697,-1267,-0.48845673876871876,-0.10555877047222406
13488,48407,San Jacinto,Texas,2016,2038,8059,246,10343,0.19704147732766122,0.779174320796674,0.023784201875664702,-372,147,952,727,-0.053582482738894516,0.013488860777494985,0.04009362196139954,-6021,-1324,-0.5821328434690128,-0.09367610470029408
13489,48409,San Patricio,Texas,2000,7840,10599,260,18699,0.41927375795497085,0.5668217551740735,0.013904486870955666,0,0,0,0,0.0,0.0,0.0,-2759,0,-0.14754799721910267,0.0
13490,48409,San Patricio,Texas,2004,7764,13474,82,21320,0.3641651031894934,0.6319887429643527,0.0038461538461538464,-76,-178,2875,2621,-0.05510865476547744,-0.01005833302480182,0.06516698779027918,-5710,-2951,-0.2678236397748593,-0.12027564255575662
13491,48409,San Patricio,Texas,2008,8854,12404,138,21396,0.41381566647971585,0.5797345298186577,0.006449803701626472,1090,56,-1070,76,0.04965056329022244,0.0026036498554726254,-0.052254213145695005,-3550,2160,-0.16591886333894185,0.10190477643591744
13492,48409,San Patricio,Texas,2012,7856,12005,217,20078,0.39127403127801574,0.597918119334595,0.010807849387389183,-998,79,-399,-1318,-0.022541635201700105,0.004358045685762711,0.01818358951593735,-4149,-599,-0.2066440880565793,-0.040725224717637454
13493,48409,San Patricio,Texas,2016,7871,13030,755,21656,0.3634558551902475,0.6016808274843,0.03486331732545253,15,538,1025,1578,-0.027818176087768265,0.024055467938063346,0.0037627081497049186,-5159,-1010,-0.23822497229405248,-0.031580884237473184
13494,48411,San Saba,Texas,2000,618,1691,24,2333,0.26489498499785685,0.7248178311187312,0.010287183883411917,0,0,0,0,0.0,0.0,0.0,-1073,0,-0.45992284612087436,0.0
13495,48411,San Saba,Texas,2004,529,1894,8,2431,0.21760592348827643,0.779103249691485,0.003290826820238585,-89,-16,203,98,-0.04728906150958043,-0.006996357063173331,0.05428541857275382,-1365,-292,-0.5614973262032086,-0.10157448008233422
13496,48411,San Saba,Texas,2008,487,1941,29,2457,0.19820919820919822,0.78998778998779,0.011803011803011803,-42,21,47,26,-0.01939672527907821,0.008512184982773218,0.010884540296304923,-1454,-89,-0.5917785917785917,-0.03028126557538313
13497,48411,San Saba,Texas,2012,323,1905,31,2259,0.14298362107127047,0.8432934926958832,0.013722886232846392,-164,2,-36,-198,-0.05522557713792775,0.0019198744298345883,0.053305702708093206,-1582,-128,-0.7003098716246127,-0.10853127984602096
13498,48411,San Saba,Texas,2016,293,2025,39,2357,0.12431056427662282,0.859142978362325,0.016546457361052185,-30,8,120,98,-0.018673056794647647,0.0028235711282057936,0.015849485666441843,-1732,-150,-0.7348324140857022,-0.034522542461089545
13499,48413,Schleicher,Texas,2000,338,826,9,1173,0.28815004262574595,0.7041773231031543,0.0076726342710997444,0,0,0,0,0.0,0.0,0.0,-488,0,-0.41602728047740833,0.0
13500,48413,Schleicher,Texas,2004,312,1012,5,1329,0.23476297968397292,0.7614747930775019,0.003762227238525207,-26,-4,186,156,-0.053387062941773034,-0.003910407032574538,0.05729746997434759,-700,-212,-0.5267118133935289,-0.11068453291612057
13501,48413,Schleicher,Texas,2008,324,970,10,1304,0.24846625766871167,0.7438650306748467,0.007668711656441718,12,5,-42,-25,0.013703277984738749,0.00390648441791651,-0.017609762402655216,-646,54,-0.495398773006135,0.03131304038739391
13502,48413,Schleicher,Texas,2012,221,787,9,1017,0.21730580137659783,0.7738446411012783,0.008849557522123894,-103,-1,-183,-287,-0.031160456292113836,0.001180845865682176,0.029979610426431602,-566,80,-0.5565388397246804,-0.06114006671854544
13503,48413,Schleicher,Texas,2016,208,821,30,1059,0.1964117091595845,0.7752596789423984,0.028328611898016998,-13,21,34,42,-0.020894092217013327,0.019479054375893104,0.0014150378411201814,-613,-47,-0.5788479697828139,-0.02230913005813351
13504,48415,Scurry,Texas,2000,1193,4060,73,5326,0.22399549380398048,0.7622981599699586,0.013706346226060834,0,0,0,0,0.0,0.0,0.0,-2867,0,-0.5383026661659782,0.0
13505,48415,Scurry,Texas,2004,981,4576,15,5572,0.1760588657573582,0.8212491026561378,0.0026920315865039484,-212,-58,516,246,-0.04793662804662227,-0.011014314639556886,0.058950942686179175,-3595,-728,-0.6451902368987796,-0.10688757073280142
13506,48415,Scurry,Texas,2008,1088,4414,67,5569,0.19536721134853655,0.792601903393787,0.012030885257676423,107,52,-162,-3,0.019308345591178333,0.009338853671172475,-0.02864719926235082,-3326,269,-0.5972346920452505,0.04795554485352915
13507,48415,Scurry,Texas,2012,838,4124,65,5027,0.1666998209667794,0.820370001989258,0.012930177043962602,-250,-2,-290,-542,-0.02866739038175714,0.0008992917862861785,0.027768098595471025,-3286,40,-0.6536701810224786,-0.056435488977228165
13508,48415,Scurry,Texas,2016,733,4410,146,5289,0.13858952543013803,0.8338060124787294,0.02760446209113254,-105,81,286,262,-0.028110295536641378,0.014674285047169937,0.013436010489471406,-3677,-391,-0.6952164870485914,-0.041546306026112756
13509,48417,Shackelford,Texas,2000,264,1066,17,1347,0.19599109131403117,0.791388270230141,0.012620638455827766,0,0,0,0,0.0,0.0,0.0,-802,0,-0.5953971789161099,0.0
13510,48417,Shackelford,Texas,2004,229,1292,6,1527,0.14996725605762934,0.8461034708578913,0.003929273084479371,-35,-11,226,180,-0.04602383525640183,-0.008691365371348396,0.05471520062775026,-1063,-261,-0.6961362148002619,-0.100739035884152
13511,48417,Shackelford,Texas,2008,208,1284,13,1505,0.1382059800664452,0.8531561461794019,0.008637873754152824,-21,7,-8,-22,-0.01176127599118415,0.004708600669673453,0.00705267532151066,-1076,-13,-0.7149501661129567,-0.01881395131269481
13512,48417,Shackelford,Texas,2012,131,1218,14,1363,0.09611151870873075,0.8936170212765957,0.010271460014673514,-77,1,-66,-142,-0.04209446135771444,0.0016335862605206895,0.04046087509719376,-1087,-11,-0.797505502567865,-0.08255533645490831
13513,48417,Shackelford,Texas,2016,103,1378,23,1504,0.06848404255319149,0.9162234042553191,0.015292553191489361,-28,9,160,141,-0.02762747615553926,0.0050210931768158475,0.022606382978723416,-1275,-188,-0.8477393617021276,-0.05023385913426259
13514,48419,Shelby,Texas,2000,3227,5692,86,9005,0.3583564686285397,0.6320932815102721,0.009550249861188229,0,0,0,0,0.0,0.0,0.0,-2465,0,-0.2737368128817324,0.0
13515,48419,Shelby,Texas,2004,2951,6295,33,9279,0.31802996012501344,0.6784136221575601,0.003556417717426447,-276,-53,603,274,-0.04032650850352626,-0.005993832143761781,0.04632034064728796,-3344,-879,-0.3603836620325466,-0.08664684915081422
13516,48419,Shelby,Texas,2008,2548,6630,42,9220,0.27635574837310195,0.7190889370932755,0.00455531453362256,-403,9,335,-59,-0.041674211751911494,0.0009988968161961129,0.04067531493571541,-4082,-738,-0.44273318872017353,-0.0823495266876269
13517,48419,Shelby,Texas,2012,2322,6879,91,9292,0.24989238054240206,0.740314248816186,0.009793370641411968,-226,49,249,72,-0.026463367830699885,0.005238056107789408,0.021225311722910534,-4557,-475,-0.490421868273784,-0.04768867955361045
13518,48419,Shelby,Texas,2016,1758,7179,149,9086,0.19348448162007484,0.790116662998019,0.01639885538190623,-564,58,300,-206,-0.056407898922327226,0.006605484740494261,0.049802414181832955,-5421,-864,-0.5966321813779442,-0.10621031310416018
13519,48421,Sherman,Texas,2000,144,998,21,1163,0.12381771281169389,0.8581255374032674,0.018056749785038694,0,0,0,0,0.0,0.0,0.0,-854,0,-0.7343078245915735,0.0
13520,48421,Sherman,Texas,2004,124,942,0,1066,0.11632270168855535,0.8836772983114447,0.0,-20,-21,-56,-97,-0.007495011123138537,-0.018056749785038694,0.025551760908177346,-818,36,-0.7673545966228894,-0.033046772031315896
13521,48421,Sherman,Texas,2008,127,884,9,1020,0.12450980392156863,0.8666666666666667,0.008823529411764706,3,9,-58,-46,0.008187102233013277,0.008823529411764706,-0.017010631644778007,-757,61,-0.7421568627450981,0.02519773387779134
13522,48421,Sherman,Texas,2012,121,908,9,1038,0.11657032755298652,0.8747591522157996,0.008670520231213872,-6,0,24,18,-0.00793947636858211,-0.0001530091805508338,0.008092485549132888,-787,-30,-0.758188824662813,-0.016031961917714943
13523,48421,Sherman,Texas,2016,96,807,32,935,0.10267379679144385,0.8631016042780749,0.034224598930481284,-25,23,-101,-103,-0.013896530761542666,0.025554078699267412,-0.011657547937724666,-711,76,-0.7604278074866311,-0.00223898282381807
13524,48423,Smith,Texas,2000,16470,43320,834,60624,0.27167458432304037,0.7145684877276326,0.013756927949327,0,0,0,0,0.0,0.0,0.0,-26850,0,-0.4428939034045922,0.0
13525,48423,Smith,Texas,2004,19970,53392,302,73664,0.2710957862728063,0.7248045178105995,0.004099695916594266,3500,-532,10072,13040,-0.0005787980502340861,-0.009657232032732733,0.010236030082966918,-33422,-6572,-0.45370873153779323,-0.010814828133201004
13526,48423,Smith,Texas,2008,23726,55187,648,79561,0.2982114352509395,0.6936438707406896,0.008144694008370935,3756,346,1795,5897,0.027115648978133233,0.004044998091776669,-0.031160647069909952,-31461,1961,-0.39543243548975004,0.058276296048043186
13527,48423,Smith,Texas,2012,21456,57331,814,79601,0.2695443524578837,0.7202296453562141,0.010226002185902187,-2270,166,2144,40,-0.028667082793055798,0.0020813081775312523,0.026585774615524582,-35875,-4414,-0.4506852928983304,-0.05525285740858038
13528,48423,Smith,Texas,2016,22300,58930,3538,84768,0.2630709701774254,0.6951915817289543,0.04173744809362023,844,2724,1599,5167,-0.006473382280458295,0.031511445907718046,-0.0250380636272598,-36630,-755,-0.4321206115515289,0.018564681346801504
13529,48425,Somervell,Texas,2000,752,2120,46,2918,0.2577107607950651,0.726525017135024,0.015764222069910898,0,0,0,0,0.0,0.0,0.0,-1368,0,-0.46881425633995893,0.0
13530,48425,Somervell,Texas,2004,831,2701,19,3551,0.23401858631371444,0.7606308082230357,0.005350605463249789,79,-27,581,633,-0.023692174481350664,-0.010413616606661109,0.034105791088011705,-1870,-502,-0.5266122219093213,-0.0577979655693624
13531,48425,Somervell,Texas,2008,799,2677,57,3533,0.22615341069912256,0.7577129917916785,0.01613359750919898,-32,38,-24,-18,-0.00786517561459188,0.010782992045949192,-0.0029178164313572452,-1878,-8,-0.531559581092556,-0.004947359183234634
13532,48425,Somervell,Texas,2012,613,2871,54,3538,0.17326172979084228,0.8114754098360656,0.015262860373092142,-186,-3,194,5,-0.05289168090828028,-0.0008707371361068392,0.053762418044387084,-2258,-380,-0.6382136800452233,-0.10665409895266731
13533,48425,Somervell,Texas,2016,541,3206,150,3897,0.1388247369771619,0.8226841159866564,0.03849114703618168,-72,96,335,359,-0.03443699281368037,0.023228286663089535,0.011208706150590775,-2665,-407,-0.6838593790094945,-0.045645698964271175
13534,48427,Starr,Texas,2000,6505,1911,48,8464,0.7685491493383743,0.22577977315689982,0.005671077504725898,0,0,0,0,0.0,0.0,0.0,4594,0,0.5427693761814745,0.0
13535,48427,Starr,Texas,2004,7199,2552,30,9781,0.7360188119824149,0.26091401697167976,0.0030671710459053265,694,-18,641,1317,-0.03253033735595934,-0.002603906458820572,0.03513424381477995,4647,53,0.47510479501073516,-0.06766458117073931
13536,48427,Starr,Texas,2008,8274,1492,26,9792,0.8449754901960784,0.15236928104575165,0.0026552287581699347,1075,-4,-1060,11,0.1089566782136635,-0.0004119422877353917,-0.10854473592592812,6782,2135,0.6926062091503268,0.21750141413959162
13537,48427,Starr,Texas,2012,10260,1547,76,11883,0.8634183287048726,0.1301859799713877,0.0063956913237397965,1986,50,55,2091,0.018442838508794135,0.0037404625655698617,-0.022183301074363948,8713,1931,0.7332323487334849,0.04062613958315808
13538,48427,Starr,Texas,2016,9289,2224,227,11740,0.7912265758091993,0.18943781942078364,0.019335604770017036,-971,151,677,-143,-0.07219175289567326,0.012939913446277238,0.05925183944939594,7065,-1648,0.6017887563884157,-0.1314435923450692
13539,48429,Stephens,Texas,2000,811,2425,55,3291,0.24642965663931934,0.736858097842601,0.01671224551807961,0,0,0,0,0.0,0.0,0.0,-1614,0,-0.49042844120328166,0.0
13540,48429,Stephens,Texas,2004,703,2803,13,3519,0.1997726626882637,0.7965331059960216,0.003694231315714692,-108,-42,378,228,-0.04665699395105563,-0.01301801420236492,0.05967500815342053,-2100,-486,-0.5967604433077578,-0.10633200210447613
13541,48429,Stephens,Texas,2008,626,2869,31,3526,0.1775382870107771,0.8136698808848554,0.008791832104367556,-77,18,66,7,-0.022234375677486623,0.005097600788652864,0.017136774888833806,-2243,-143,-0.6361315938740782,-0.039371150566320456
13542,48429,Stephens,Texas,2012,475,2892,45,3412,0.1392145369284877,0.8475967174677609,0.013188745603751465,-151,14,23,-114,-0.03832375008228939,0.00439691349938391,0.03392683658290552,-2417,-174,-0.7083821805392732,-0.0722505866651949
13543,48429,Stephens,Texas,2016,348,3034,79,3461,0.10054897428488876,0.8766252528171049,0.022825772898006358,-127,34,142,49,-0.03866556264359894,0.009637027294254892,0.02902853534934402,-2686,-269,-0.7760762785322162,-0.06769409799294301
13544,48431,Sterling,Texas,2000,132,520,7,659,0.20030349013657056,0.7890743550834598,0.010622154779969651,0,0,0,0,0.0,0.0,0.0,-388,0,-0.5887708649468892,0.0
13545,48431,Sterling,Texas,2004,71,544,0,615,0.11544715447154472,0.8845528455284553,0.0,-61,-7,24,-44,-0.08485633566502584,-0.010622154779969651,0.09547849044499546,-473,-85,-0.7691056910569105,-0.18033482611002127
13546,48431,Sterling,Texas,2008,97,520,2,619,0.1567043618739903,0.840064620355412,0.0032310177705977385,26,2,-24,4,0.041257207402445595,0.0032310177705977385,-0.044488225173043294,-423,50,-0.6833602584814217,0.08574543257548883
13547,48431,Sterling,Texas,2012,31,459,4,494,0.06275303643724696,0.9291497975708503,0.008097165991902834,-66,2,-61,-125,-0.09395132543674335,0.004866148221305096,0.0890851772154383,-428,-5,-0.8663967611336033,-0.18303650265218163
13548,48431,Sterling,Texas,2016,70,549,14,633,0.11058451816745656,0.8672985781990521,0.022116903633491312,39,10,90,139,0.047831481730209596,0.014019737641588478,-0.06185121937179816,-479,-51,-0.7567140600315956,0.10968270110200773
13549,48433,Stonewall,Texas,2000,294,496,9,799,0.36795994993742176,0.6207759699624531,0.011264080100125156,0,0,0,0,0.0,0.0,0.0,-202,0,-0.25281602002503134,0.0
13550,48433,Stonewall,Texas,2004,250,499,3,752,0.3324468085106383,0.663563829787234,0.003989361702127659,-44,-6,3,-47,-0.03551314142678347,-0.007274718397997496,0.04278785982478095,-249,-47,-0.33111702127659576,-0.07830100125156442
13551,48433,Stonewall,Texas,2008,206,524,5,735,0.2802721088435374,0.7129251700680272,0.006802721088435374,-44,2,25,-17,-0.052174699667100866,0.0028133593863077146,0.0493613402807932,-318,-69,-0.4326530612244898,-0.10153603994789406
13552,48433,Stonewall,Texas,2012,160,507,8,675,0.23703703703703705,0.7511111111111111,0.011851851851851851,-46,3,-17,-60,-0.04323507180650038,0.005049130763416477,0.038185941043083815,-347,-29,-0.514074074074074,-0.0814210128495842
13553,48433,Stonewall,Texas,2016,135,555,11,701,0.19258202567760344,0.7917261055634808,0.015691868758915834,-25,3,48,26,-0.04445501135943361,0.003840016907063983,0.04061499445236971,-420,-73,-0.5991440798858774,-0.08507000581180335
13554,48435,Sutton,Texas,2000,468,1063,9,1540,0.3038961038961039,0.6902597402597402,0.005844155844155844,0,0,0,0,0.0,0.0,0.0,-595,0,-0.38636363636363635,0.0
13555,48435,Sutton,Texas,2004,280,1173,0,1453,0.19270474879559532,0.8072952512044047,0.0,-188,-9,110,-87,-0.11119135510050857,-0.005844155844155844,0.11703551094466447,-893,-298,-0.6145905024088094,-0.22822686604517306
13556,48435,Sutton,Texas,2008,381,1189,8,1578,0.2414448669201521,0.7534854245880862,0.005069708491761723,101,8,16,125,0.04874011812455678,0.005069708491761723,-0.0538098266163185,-808,85,-0.5120405576679341,0.10254994474087531
13557,48435,Sutton,Texas,2012,369,1110,12,1491,0.24748490945674045,0.744466800804829,0.008048289738430584,-12,4,-79,-87,0.0060400425365883526,0.002978581246668861,-0.00901862378325724,-741,67,-0.4969818913480885,0.015058666319845593
13558,48435,Sutton,Texas,2016,313,1075,28,1416,0.221045197740113,0.759180790960452,0.01977401129943503,-56,16,-35,-75,-0.026439711716627456,0.011725721561004446,0.014713990155623025,-762,-21,-0.538135593220339,-0.04115370187225048
13559,48437,Swisher,Texas,2000,856,1612,33,2501,0.34226309476209515,0.6445421831267493,0.013194722111155539,0,0,0,0,0.0,0.0,0.0,-756,0,-0.3022790883646541,0.0
13560,48437,Swisher,Texas,2004,626,1487,7,2120,0.2952830188679245,0.7014150943396227,0.0033018867924528303,-230,-26,-125,-381,-0.046980075894170636,-0.00989283531870271,0.05687291121287341,-861,-105,-0.40613207547169816,-0.10385298710704405
13561,48437,Swisher,Texas,2008,813,1683,39,2535,0.3207100591715976,0.663905325443787,0.015384615384615385,187,32,196,415,0.0254270403036731,0.012082728592162556,-0.03750976889583568,-870,-9,-0.3431952662721894,0.06293680919950878
13562,48437,Swisher,Texas,2012,579,1655,36,2270,0.2550660792951542,0.7290748898678414,0.015859030837004406,-234,-3,-28,-265,-0.06564397987644344,0.00047441545238902094,0.06516956442405442,-1076,-206,-0.47400881057268723,-0.13081354430049785
13563,48437,Swisher,Texas,2016,462,1671,71,2204,0.20961887477313976,0.7581669691470054,0.03221415607985481,-117,35,16,-66,-0.04544720452201442,0.016355125242850405,0.029092079279164018,-1209,-133,-0.5485480943738656,-0.07453928380117841
13564,48439,Tarrant,Texas,2000,173758,286921,11710,472389,0.3678282093782878,0.6073828984163475,0.024788892205364645,0,0,0,0,0.0,0.0,0.0,-113163,0,-0.2395546890380597,0.0
13565,48439,Tarrant,Texas,2004,207286,349462,3393,560141,0.3700603955075597,0.6238822010886544,0.006057403403785832,33528,-8317,62541,87752,0.002232186129271896,-0.018731488801578815,0.016499302672306926,-142176,-29013,-0.25382180558109474,-0.01426711654303503
13566,48439,Tarrant,Texas,2008,274880,348420,5253,628553,0.4373219123924315,0.5543207971324614,0.008357290475107111,67594,1860,-1042,68412,0.06726151688487181,0.002299887071321279,-0.06956140395619304,-73540,68636,-0.1169988847400299,0.13682292084106484
13567,48439,Tarrant,Texas,2012,253071,348920,8899,610890,0.41426607081471295,0.5711666584818871,0.014567270703399958,-21809,3646,500,-17663,-0.02305584157771856,0.006209980228292847,0.016845861349425673,-95849,-22309,-0.15690058766717413,-0.039901702927144234
13568,48439,Tarrant,Texas,2016,288392,345921,34201,668514,0.431392611074712,0.5174476525547708,0.051159736370517295,35321,25302,-2999,57624,0.017126540259999046,0.03659246566711734,-0.053719005927116315,-57529,38320,-0.08605504148005877,0.07084554618711536
13569,48441,Taylor,Texas,2000,10504,31701,815,43020,0.24416550441655044,0.7368898186889818,0.018944676894467688,0,0,0,0,0.0,0.0,0.0,-21197,0,-0.4927243142724314,0.0
13570,48441,Taylor,Texas,2004,10648,37197,254,48099,0.22137674379924738,0.7733424811326639,0.005280775068088734,144,-561,5496,5079,-0.02278876061730306,-0.013663901826378954,0.03645266244368206,-26549,-5352,-0.5519657373334166,-0.05924142306098518
13571,48441,Taylor,Texas,2008,12690,34317,432,47439,0.2675014228799089,0.7233921457029027,0.00910643141718839,2042,178,-2880,-660,0.046124679080661535,0.0038256563490996556,-0.04995033542976124,-21627,4922,-0.45589072282299375,0.09607501451042283
13572,48441,Taylor,Texas,2012,9750,32904,609,43263,0.22536578600651827,0.7605575202829208,0.014076693710560988,-2940,177,-1413,-4176,-0.04213563687339064,0.004970262293372598,0.03716537458001812,-23154,-1527,-0.5351917342764025,-0.07930101145340879
13573,48441,Taylor,Texas,2016,10085,33250,2424,45759,0.22039380231211347,0.7266330120850543,0.05297318560283223,335,1815,346,2496,-0.004971983694404797,0.03889649189227124,-0.03392450819786652,-23165,-11,-0.5062392097729408,0.028952524503461752
13574,48443,Terrell,Texas,2000,219,243,15,477,0.4591194968553459,0.5094339622641509,0.031446540880503145,0,0,0,0,0.0,0.0,0.0,-24,0,-0.05031446540880502,0.0
13575,48443,Terrell,Texas,2004,159,306,4,469,0.3390191897654584,0.652452025586354,0.008528784648187633,-60,-11,63,-8,-0.1201003070898875,-0.02291775623231551,0.14301806332220302,-147,-123,-0.31343283582089554,-0.2631183704120905
13576,48443,Terrell,Texas,2008,186,323,10,519,0.3583815028901734,0.6223506743737958,0.019267822736030827,27,6,17,50,0.01936231312471498,0.010739038087843194,-0.03010135121255819,-137,10,-0.26396917148362237,0.04946366433727317
13577,48443,Terrell,Texas,2012,184,358,13,555,0.33153153153153153,0.645045045045045,0.023423423423423424,-2,3,35,36,-0.026849971358641866,0.004155600687392597,0.022694370671249242,-174,-37,-0.3135135135135135,-0.04954434202989111
13578,48443,Terrell,Texas,2016,140,288,10,438,0.319634703196347,0.6575342465753424,0.0228310502283105,-44,-3,-70,-117,-0.011896828335184517,-0.0005923731951129226,0.012489201530297422,-148,26,-0.3378995433789954,-0.02438602986548194
13579,48445,Terry,Texas,2000,1108,2910,36,4054,0.27331031080414403,0.7178095707942772,0.008880118401578688,0,0,0,0,0.0,0.0,0.0,-1802,0,-0.4444992599901332,0.0
13580,48445,Terry,Texas,2004,794,3166,10,3970,0.2,0.7974811083123425,0.0025188916876574307,-314,-26,256,-84,-0.07331031080414402,-0.006361226713921257,0.07967153751806533,-2372,-570,-0.5974811083123426,-0.1529818483222094
13581,48445,Terry,Texas,2008,1379,2879,22,4280,0.32219626168224297,0.6726635514018692,0.0051401869158878505,585,12,-287,310,0.12219626168224296,0.00262129522823042,-0.12481755691047336,-1500,872,-0.3504672897196262,0.24701381859271637
13582,48445,Terry,Texas,2012,1059,2602,48,3709,0.28552170396333243,0.7015368023726072,0.012941493664060394,-320,26,-277,-571,-0.03667455771891054,0.007801306748172543,0.028873250970738007,-1543,-43,-0.41601509840927475,-0.06554780868964855
13583,48445,Terry,Texas,2016,753,2459,143,3355,0.22444113263785395,0.7329359165424739,0.04262295081967213,-306,95,-143,-354,-0.06108057132547848,0.029681457155611733,0.03139911416986674,-1706,-163,-0.50849478390462,-0.09247968549534524
13584,48447,Throckmorton,Texas,2000,228,608,6,842,0.27078384798099764,0.7220902612826603,0.007125890736342043,0,0,0,0,0.0,0.0,0.0,-380,0,-0.45130641330166266,0.0
13585,48447,Throckmorton,Texas,2004,202,656,5,863,0.23406720741599074,0.7601390498261877,0.005793742757821553,-26,-1,48,21,-0.0367166405650069,-0.00133214797852049,0.038048788543527445,-454,-74,-0.526071842410197,-0.07476542910853434
13586,48447,Throckmorton,Texas,2008,166,671,1,838,0.19809069212410502,0.8007159904534606,0.0011933174224343676,-36,-4,15,-25,-0.035976515291885725,-0.004600425335387185,0.040576940627272906,-505,-51,-0.6026252983293556,-0.07655345591915863
13587,48447,Throckmorton,Texas,2012,109,700,4,813,0.13407134071340712,0.8610086100861009,0.004920049200492005,-57,3,29,-25,-0.0640193514106979,0.0037267317780576375,0.06029261963264021,-591,-86,-0.7269372693726938,-0.12431197104333813
13588,48447,Throckmorton,Texas,2016,84,715,9,808,0.10396039603960396,0.8849009900990099,0.011138613861386138,-25,5,15,-5,-0.030110944673803167,0.006218564660894133,0.023892380012909054,-631,-40,-0.780940594059406,-0.054003324686712206
13589,48449,Titus,Texas,2000,3008,4995,100,8103,0.37122053560409723,0.6164383561643836,0.012341108231519191,0,0,0,0,0.0,0.0,0.0,-1987,0,-0.24521782056028635,0.0
13590,48449,Titus,Texas,2004,3173,5709,25,8907,0.3562366677893791,0.6409565510272819,0.002806781183338947,165,-75,714,804,-0.01498386781471811,-0.009534327048180243,0.0245181948628983,-2536,-549,-0.28471988323790276,-0.03950206267761641
13591,48449,Titus,Texas,2008,3145,6028,72,9245,0.34018388318009735,0.6520281233098972,0.0077879935100054086,-28,47,319,338,-0.01605278460928178,0.004981212326666462,0.01107157228261535,-2883,-347,-0.3118442401297999,-0.027124356891897128
13592,48449,Titus,Texas,2012,2648,6084,122,8854,0.29907386491981025,0.6871470521798058,0.013779082900384007,-497,50,56,-391,-0.041110018260287096,0.005991089390378598,0.03511892886990853,-3436,-553,-0.3880731872599955,-0.07622894713019562
13593,48449,Titus,Texas,2016,2597,6511,311,9419,0.2757192907952012,0.6912623420745302,0.03301836713026861,-51,189,427,565,-0.023354574124609062,0.0192392842298846,0.004115289894724428,-3914,-478,-0.415543051279329,-0.02746986401933349
13594,48451,Tom Green,Texas,2000,9288,24733,605,34626,0.2682377404262693,0.7142898400046208,0.01747241956910992,0,0,0,0,0.0,0.0,0.0,-15445,0,-0.4460520995783515,0.0
13595,48451,Tom Green,Texas,2004,9007,28185,225,37417,0.24071945906940695,0.7532672314723254,0.006013309458267633,-281,-380,3452,2791,-0.02751828135686235,-0.011459110110842285,0.038977391467704625,-19178,-3733,-0.5125477724029185,-0.06649567282456698
13596,48451,Tom Green,Texas,2008,11158,27362,341,38861,0.2871259102956692,0.7040992254445331,0.008774864259797741,2151,116,-823,1444,0.046406451226262246,0.002761554801530108,-0.049168006027792366,-16204,2974,-0.4169733151488639,0.09557445725405461
13597,48451,Tom Green,Texas,2012,9294,26878,548,36720,0.2531045751633987,0.7319716775599129,0.014923747276688453,-1864,207,-484,-2141,-0.034021335132270514,0.006148883016890712,0.02787245211537981,-17584,-1380,-0.4788671023965142,-0.06189378724765032
13598,48451,Tom Green,Texas,2016,9173,27494,1812,38479,0.23838977104394604,0.7145196080979236,0.04709062085813041,-121,1264,616,1759,-0.01471480411945264,0.032166873581441956,-0.017452069461989295,-18321,-737,-0.47612983705397754,0.0027372653425366544
13599,48453,Travis,Texas,2000,125526,141235,34502,301263,0.4166658368269585,0.46880964472902414,0.11452451844401736,0,0,0,0,0.0,0.0,0.0,-15709,0,-0.05214380790206563,0.0
13600,48453,Travis,Texas,2004,197235,147885,6993,352113,0.5601468846648661,0.4199930136064275,0.01986010172870641,71709,-27509,6650,50850,0.14348104783790755,-0.09466441671531095,-0.048816631122596654,49350,65059,0.14015387105843857,0.1922976789605042
13601,48453,Travis,Texas,2008,254017,136981,8890,399888,0.6352203617012764,0.34254841355579563,0.02223122474292802,56782,1897,-10904,47775,0.07507347703641032,0.0023711230142216093,-0.07744460005063186,117036,67686,0.29267194814548075,0.15251807708704218
13602,48453,Travis,Texas,2012,232788,140152,14117,387057,0.6014307970143933,0.36209653875269016,0.0364726642329166,-21229,5227,3171,-12831,-0.0337895646868831,0.014241439489988579,0.019548125196894528,92636,-24400,0.23933425826170313,-0.05333768988377763
13603,48453,Travis,Texas,2016,308260,127209,33251,468720,0.657663423792456,0.2713965693804403,0.07094000682710361,75472,19134,-12943,81663,0.05623262677806273,0.03446734259418701,-0.09069996937224983,181051,88415,0.3862668544120157,0.14693259615031257
13604,48455,Trinity,Texas,2000,2142,3093,62,5297,0.4043798376439494,0.5839154238248065,0.0117047385312441,0,0,0,0,0.0,0.0,0.0,-951,0,-0.17953558618085713,0.0
13605,48455,Trinity,Texas,2004,2204,3985,24,6213,0.3547400611620795,0.6413970706582971,0.00386286817962337,62,-38,892,916,-0.0496397764818699,-0.00784187035162073,0.05748164683349055,-1781,-830,-0.2866570094962176,-0.10712142331536045
13606,48455,Trinity,Texas,2008,1925,4095,57,6077,0.3167681421754155,0.6738522297186111,0.009379628105973342,-279,33,110,-136,-0.03797191898666402,0.005516759926349972,0.03245515906031404,-2170,-389,-0.35708408754319565,-0.07042707804697806
13607,48455,Trinity,Texas,2012,1614,4537,84,6235,0.2588612670408982,0.7276663993584603,0.01347233360064154,-311,27,442,158,-0.05790687513451731,0.004092705494668197,0.053814169639849196,-2923,-753,-0.46880513231756216,-0.1117210447743665
13608,48455,Trinity,Texas,2016,1154,4737,94,5985,0.1928153717627402,0.7914786967418547,0.015705931495405178,-460,10,200,-250,-0.06604589527815799,0.0022335978947636385,0.06381229738339433,-3583,-660,-0.5986633249791145,-0.1298581926615523
13609,48457,Tyler,Texas,2000,2775,4236,105,7116,0.3899662731871838,0.5952782462057336,0.01475548060708263,0,0,0,0,0.0,0.0,0.0,-1461,0,-0.20531197301854975,0.0
13610,48457,Tyler,Texas,2004,2659,5043,43,7745,0.3433182698515171,0.6511297611362169,0.005551969012265978,-116,-62,807,629,-0.04664800333566671,-0.009203511594816652,0.05585151493048335,-2384,-923,-0.3078114912846998,-0.10249951826615006
13611,48457,Tyler,Texas,2008,2166,5644,100,7910,0.2738305941845765,0.7135271807838179,0.012642225031605562,-493,57,601,165,-0.06948767566694058,0.007090256019339584,0.06239741964760104,-3478,-1094,-0.43969658659924143,-0.13188509531454162
13612,48457,Tyler,Texas,2012,1668,5910,76,7654,0.21792526783381239,0.7721452835118892,0.009929448654298406,-498,-24,266,-256,-0.05590532635076412,-0.002712776377307156,0.05861810272807122,-4242,-764,-0.5542200156780768,-0.11452342907883534
13613,48457,Tyler,Texas,2016,1248,6624,144,8016,0.15568862275449102,0.8263473053892215,0.017964071856287425,-420,68,714,362,-0.06223664507932136,0.008034623201989019,0.05420202187733236,-5376,-1134,-0.6706586826347305,-0.11643866695665372
13614,48459,Upshur,Texas,2000,4180,8448,180,12808,0.3263585259212992,0.6595877576514678,0.014053716427232979,0,0,0,0,0.0,0.0,0.0,-4268,0,-0.3332292317301686,0.0
13615,48459,Upshur,Texas,2004,4225,10232,69,14526,0.29085777227041165,0.7043921244664739,0.004750103263114415,45,-111,1784,1718,-0.03550075365088756,-0.009303613164118565,0.0448043668150061,-6007,-1739,-0.41353435219606227,-0.08030512046589366
13616,48459,Upshur,Texas,2008,3790,11222,152,15164,0.24993405433922447,0.7400422052228963,0.010023740437879188,-435,83,990,638,-0.04092371793118718,0.005273637174764772,0.0356500807564224,-7432,-1425,-0.4901081508836719,-0.0765737986876096
13617,48459,Upshur,Texas,2012,2971,12015,152,15138,0.19626106486986392,0.7936979785969085,0.01004095653322764,-819,0,793,-26,-0.053672989469360555,1.721609534845181e-05,0.05365577337401217,-9044,-1612,-0.5974369137270445,-0.10732876284337267
13618,48459,Upshur,Texas,2016,2380,13209,424,16013,0.14862923874352088,0.8248922750265409,0.026478486229938175,-591,272,1194,875,-0.047631826126343035,0.016437529696710536,0.03119429642963245,-10829,-1785,-0.6762630362830201,-0.07882612255597554
13619,48461,Upton,Texas,2000,266,982,25,1273,0.208955223880597,0.7714061272584446,0.019638648860958365,0,0,0,0,0.0,0.0,0.0,-716,0,-0.5624509033778475,0.0
13620,48461,Upton,Texas,2004,185,1009,3,1197,0.1545530492898914,0.8429406850459482,0.002506265664160401,-81,-22,27,-76,-0.05440217459070562,-0.017132383196797964,0.07153455778750362,-824,-108,-0.6883876357560568,-0.12593673237820924
13621,48461,Upton,Texas,2008,288,898,11,1197,0.24060150375939848,0.7502088554720133,0.009189640768588136,103,8,-111,0,0.0860484544695071,0.006683375104427736,-0.09273182957393489,-610,214,-0.5096073517126148,0.17878028404344193
13622,48461,Upton,Texas,2012,333,953,14,1300,0.2561538461538462,0.7330769230769231,0.010769230769230769,45,3,55,103,0.015552342394447694,0.0015795900006426323,-0.017131932395090255,-620,-10,-0.4769230769230769,0.03268427478953795
13623,48461,Upton,Texas,2016,286,1007,54,1347,0.21232368225686712,0.7475872308834447,0.0400890868596882,-47,40,54,47,-0.04383016389697905,0.02931985609045743,0.014510307806521627,-721,-101,-0.5352635486265775,-0.05834047170350065
13624,48463,Uvalde,Texas,2000,3436,4855,129,8420,0.40807600950118766,0.5766033254156769,0.015320665083135392,0,0,0,0,0.0,0.0,0.0,-1419,0,-0.16852731591448927,0.0
13625,48463,Uvalde,Texas,2004,3298,5148,37,8483,0.38877755511022044,0.606860780384298,0.004361664505481551,-138,-92,293,63,-0.019298454390967223,-0.010959000577653841,0.03025745496862109,-1850,-431,-0.21808322527407759,-0.04955590935958831
13626,48463,Uvalde,Texas,2008,4126,4590,50,8766,0.4706821811544604,0.5236139630390144,0.005703855806525211,828,13,-558,283,0.08190462604423998,0.00134219130104366,-0.08324681734528361,-464,1386,-0.052931781884554,0.1651514433895236
13627,48463,Uvalde,Texas,2012,3825,4529,81,8435,0.45346769413159455,0.5369294605809128,0.009602845287492591,-301,31,-61,-331,-0.017214487022865876,0.00389898948096738,0.013315497541898424,-704,-240,-0.0834617664493183,-0.0305299845647643
13628,48463,Uvalde,Texas,2016,3867,4835,262,8964,0.43139223560910306,0.5393797411869701,0.02922802320392682,42,181,306,529,-0.022075458522491487,0.019625177916434228,0.0024502806060572313,-968,-264,-0.10798750557786702,-0.024525739128548718
13629,48465,Val Verde,Texas,2000,5056,6223,195,11474,0.4406484225204811,0.5423566323862646,0.016994945093254315,0,0,0,0,0.0,0.0,0.0,-1167,0,-0.10170820986578355,0.0
13630,48465,Val Verde,Texas,2004,4757,6968,70,11795,0.4033064857990674,0.5907587961000423,0.005934718100890208,-299,-125,745,321,-0.03734193672141367,-0.011060226992364107,0.0484021637137777,-2211,-1044,-0.18745231030097492,-0.08574410043519137
13631,48465,Val Verde,Texas,2008,6982,5752,86,12820,0.5446177847113884,0.4486739469578783,0.00670826833073323,2225,16,-1216,1025,0.14131129891232103,0.0007735502298430218,-0.14208484914216402,1230,3441,0.09594383775351012,0.28339614805448504
13632,48465,Val Verde,Texas,2012,6285,5635,161,12081,0.5202383908616837,0.4664348977733631,0.013326711364953232,-697,75,-117,-739,-0.024379393849704778,0.006618443034220003,0.01776095081548479,650,-580,0.05380349308832055,-0.042140344665189566
13633,48465,Val Verde,Texas,2016,6964,5890,763,13617,0.5114195490930454,0.4325475508555482,0.05603290005140633,679,602,255,1536,-0.00881884176863823,0.042706188686453095,-0.03388734691781492,1074,424,0.07887199823749724,0.02506850514917669
13634,48467,Van Zandt,Texas,2000,5245,12383,263,17891,0.2931641607512157,0.692135710692527,0.014700128556257337,0,0,0,0,0.0,0.0,0.0,-7138,0,-0.3989715499413113,0.0
13635,48467,Van Zandt,Texas,2004,4822,14976,58,19856,0.24284850926672039,0.7542304593070105,0.0029210314262691378,-423,-205,2593,1965,-0.05031565148449532,-0.0117790971299882,0.0620947486144835,-10154,-3016,-0.5113819500402901,-0.11241040009897879
13636,48467,Van Zandt,Texas,2008,4505,15734,156,20395,0.2208874724197107,0.7714635940181417,0.0076489335621475855,-317,98,758,539,-0.021961036847009674,0.004727902135878448,0.017233134711131193,-11229,-1075,-0.550576121598431,-0.03919417155814087
13637,48467,Van Zandt,Texas,2012,3084,15794,222,19100,0.16146596858638743,0.8269109947643979,0.01162303664921466,-1421,66,60,-1295,-0.059421503833323286,0.003974103087067074,0.055447400746256204,-12710,-1481,-0.6654450261780105,-0.11486890457957954
13638,48467,Van Zandt,Texas,2016,2799,18473,618,21890,0.127866605756053,0.8439013248058475,0.02823206943809959,-285,396,2679,2790,-0.033599362830334434,0.016609032788884932,0.016990330041449564,-15674,-2964,-0.7160347190497944,-0.05058969287178394
13639,48469,Victoria,Texas,2000,8176,18787,445,27408,0.29830706363105663,0.6854568009340338,0.016236135434909517,0,0,0,0,0.0,0.0,0.0,-10611,0,-0.3871497373029772,0.0
13640,48469,Victoria,Texas,2004,8553,20875,174,29602,0.28893318019052766,0.705188838591987,0.005877981217485305,377,-271,2088,2194,-0.009373883440528974,-0.010358154217424212,0.019732037657953172,-12322,-1711,-0.41625565840145934,-0.029105921098482146
13641,48469,Victoria,Texas,2008,9832,19878,310,30020,0.32751499000666223,0.6621585609593604,0.010326449033977348,1279,136,-997,418,0.03858180981613457,0.0044484678164920435,-0.04303027763262657,-10046,2276,-0.3346435709526982,0.08161208744876114
13642,48469,Victoria,Texas,2012,8802,19692,359,28853,0.3050635982393512,0.6824940214189166,0.012442380341732229,-1030,49,-186,-1167,-0.022451391767311035,0.0021159313077548803,0.020335460459556143,-10890,-844,-0.3774304231795654,-0.04278685222686718
13643,48469,Victoria,Texas,2016,8866,21275,982,31123,0.2848697105034862,0.6835780612408829,0.031552228255630886,64,623,1583,2270,-0.020193887735865,0.019109847913898657,0.001084039821966365,-12409,-1519,-0.39870835073739674,-0.021277927557831366
13644,48471,Walker,Texas,2000,4943,9076,355,14374,0.3438847919855294,0.6314178377626269,0.024697370251843608,0,0,0,0,0.0,0.0,0.0,-4133,0,-0.28753304577709754,0.0
13645,48471,Walker,Texas,2004,5977,11710,135,17822,0.33537201211985185,0.6570530804623499,0.007574907417798227,1034,-220,2634,3448,-0.008512779865677556,-0.01712246283404538,0.02563524269972295,-5733,-1600,-0.32168106834249804,-0.034148022565400504
13646,48471,Walker,Texas,2008,7334,11623,189,19146,0.38305651310978794,0.6070719732581218,0.009871513632090254,1357,54,-87,1324,0.047684500989936096,0.0022966062142920265,-0.049981107204228103,-4289,1444,-0.22401546014833384,0.0976656081941642
13647,48471,Walker,Texas,2012,6252,12140,293,18685,0.3345999464811346,0.6497190259566498,0.01568102756221568,-1082,104,517,-461,-0.04845656662865333,0.005809513930125427,0.042647052698527976,-5888,-1599,-0.31511907947551515,-0.0911036193271813
13648,48471,Walker,Texas,2016,6091,12884,821,19796,0.30768842190341483,0.6508385532430794,0.041473024853505756,-161,528,744,1111,-0.02691152457771978,0.025791997291290076,0.0011195272864296113,-6793,-905,-0.34315013133966454,-0.028031051864149392
13649,48473,Waller,Texas,2000,5046,5686,126,10858,0.4647264689629766,0.5236691840117885,0.01160434702523485,0,0,0,0,0.0,0.0,0.0,-640,0,-0.05894271504881193,0.0
13650,48473,Waller,Texas,2004,6145,7679,57,13881,0.44269144874288596,0.5532022188603126,0.004106332396801383,1099,-69,1993,3023,-0.02203502022009063,-0.007498014628433467,0.029533034848524098,-1534,-894,-0.11051077011742666,-0.05156805506861473
13651,48473,Waller,Texas,2008,7153,8265,90,15508,0.46124580861490844,0.5329507351044622,0.0058034562806293525,1008,33,586,1627,0.018554359872022474,0.0016971238838279692,-0.020251483755850397,-1112,422,-0.07170492648955379,0.03880584362787287
13652,48473,Waller,Texas,2012,6514,9244,144,15902,0.4096340083008427,0.5813105269777387,0.00905546472141869,-639,54,979,394,-0.05161180031406576,0.003252008440789337,0.048359791873276436,-2730,-1618,-0.17167651867689598,-0.0999715921873422
13653,48473,Waller,Texas,2016,5748,10531,505,16784,0.3424690181124881,0.6274428026692088,0.030088179218303146,-766,361,1287,882,-0.06716499018835459,0.021032714496884458,0.04613227569147016,-4783,-2053,-0.28497378455672073,-0.11329726587982475
13654,48475,Ward,Texas,2000,1256,2534,84,3874,0.3242127000516262,0.6541042849767682,0.021683014971605574,0,0,0,0,0.0,0.0,0.0,-1278,0,-0.329891584925142,0.0
13655,48475,Ward,Texas,2004,901,2856,11,3768,0.23911889596602973,0.7579617834394905,0.00291932059447983,-355,-73,322,-106,-0.0850938040855965,-0.018763694377125745,0.1038574984627223,-1955,-677,-0.5188428874734607,-0.18895130254831877
13656,48475,Ward,Texas,2008,899,2667,36,3602,0.2495835646862854,0.7404219877845641,0.009994447529150472,-2,25,-189,-166,0.010464668720255671,0.007075126934670642,-0.01753979565492636,-1768,187,-0.49083842309827874,0.028004464375182003
13657,48475,Ward,Texas,2012,841,2366,38,3245,0.25916795069337445,0.7291217257318953,0.011710323574730355,-58,2,-301,-357,0.009584386007089052,0.0017158760455798835,-0.011300262052668875,-1525,243,-0.4699537750385208,0.020884648059757926
13658,48475,Ward,Texas,2016,783,2547,115,3445,0.22728592162554426,0.7393323657474601,0.033381712626995644,-58,77,181,200,-0.03188202906783019,0.02167138905226529,0.01021064001556482,-1764,-239,-0.5120464441219158,-0.042092669083394985
13659,48477,Washington,Texas,2000,2996,8645,168,11809,0.25370480142264373,0.7320687611144042,0.014226437462951986,0,0,0,0,0.0,0.0,0.0,-5649,0,-0.4783639596917605,0.0
13660,48477,Washington,Texas,2004,3389,9597,77,13063,0.2594350455484957,0.7346704432366226,0.005894511214881727,393,-91,952,1254,0.005730244125851991,-0.008331926248070259,0.0026016821222183406,-6208,-559,-0.47523539768812684,0.0031285620036336503
13661,48477,Washington,Texas,2008,4034,10176,167,14377,0.2805870487584336,0.707797176045072,0.0116157751964944,645,90,579,1314,0.021152003209937875,0.005721263981612674,-0.026873267191550587,-6142,66,-0.4272101272866384,0.04802527040148846
13662,48477,Washington,Texas,2012,3381,10857,159,14397,0.23484059178995625,0.754115440716816,0.011043967493227756,-653,-8,681,20,-0.045746456968477345,-0.0005718077032666451,0.04631826467174405,-7476,-1334,-0.5192748489268597,-0.09206472164022134
13663,48477,Washington,Texas,2016,3382,10945,501,14828,0.22808200701375775,0.7381305637982196,0.03378742918802266,1,342,88,431,-0.006758584776198506,0.022743461694794905,-0.015984876918596402,-7563,-87,-0.5100485567844619,0.009226292142397785
13664,48479,Webb,Texas,2000,18120,13076,375,31571,0.5739444426847423,0.41417756802128536,0.011877989293972317,0,0,0,0,0.0,0.0,0.0,5044,0,0.15976687466345696,0.0
13665,48479,Webb,Texas,2004,23654,17753,149,41556,0.5692078159591876,0.42720666089132736,0.003585523149485032,5534,-226,4677,9985,-0.004736626725554749,-0.008292466144487285,0.013029092870042003,5901,857,0.1420011550678602,-0.01776571959559675
13666,48479,Webb,Texas,2008,33452,13119,250,46821,0.7144657311889964,0.28019478439161916,0.005339484419384464,9798,101,-4634,5265,0.1452579152298088,0.0017539612698994319,-0.1470118764997082,20333,14432,0.4342709467973772,0.292269791729517
13667,48479,Webb,Texas,2012,37597,11078,521,49196,0.7642287990893568,0.22518090901699325,0.01059029189364989,4145,271,-2041,2375,0.04976306790036045,0.005250807474265426,-0.055013875374625903,26519,6186,0.5390478900723635,0.10477694327498632
13668,48479,Webb,Texas,2016,42307,12947,1651,56905,0.7434671821456814,0.22751955012740532,0.029013267726913275,4710,1130,1869,7709,-0.0207616169436754,0.018422975833263383,0.002338641110412071,29360,2841,0.5159476320182761,-0.02310025805408744
13669,48481,Wharton,Texas,2000,4838,8455,133,13426,0.3603455980932519,0.6297482496648295,0.009906152241918665,0,0,0,0,0.0,0.0,0.0,-3617,0,-0.26940265157157756,0.0
13670,48481,Wharton,Texas,2004,4702,9288,49,14039,0.334924139896004,0.6615855830187335,0.0034902770852624832,-136,-84,833,613,-0.025421458197247893,-0.0064158751566561825,0.03183733335390404,-4586,-969,-0.3266614431227295,-0.05725879155115193
13671,48481,Wharton,Texas,2008,4937,9431,50,14418,0.34241919822444167,0.6541129144125398,0.0034678873630184493,235,1,143,379,0.007495058328437665,-2.238972224403394e-05,-0.0074726686061936665,-4494,92,-0.31169371618809816,0.014967726934631331
13672,48481,Wharton,Texas,2012,4235,9750,102,14087,0.3006317881734933,0.6921274934336622,0.007240718392844466,-702,52,319,-331,-0.04178741005094838,0.003772831029826017,0.038014579021122374,-5515,-1021,-0.3914957052601689,-0.07980198907207076
13673,48481,Wharton,Texas,2016,4238,10149,345,14732,0.28767309258756446,0.6889084985066521,0.02341840890578333,3,243,399,645,-0.012958695585928826,0.016177690512938863,-0.003218994927010055,-5911,-396,-0.4012354059190877,-0.00973970065891877
13674,48483,Wheeler,Texas,2000,579,1787,23,2389,0.2423608204269569,0.7480117203850983,0.009627459187944746,0,0,0,0,0.0,0.0,0.0,-1208,0,-0.5056508999581415,0.0
13675,48483,Wheeler,Texas,2004,420,1960,14,2394,0.17543859649122806,0.8187134502923976,0.005847953216374269,-159,-9,173,5,-0.06692222393572883,-0.0037795059715704776,0.07070172990729928,-1540,-332,-0.6432748538011696,-0.13762395384302806
13676,48483,Wheeler,Texas,2008,314,1918,13,2245,0.1398663697104677,0.8543429844097995,0.005790645879732739,-106,-1,-42,-149,-0.03557222678076036,-5.7307336641529254e-05,0.035629534117401884,-1604,-64,-0.7144766146993318,-0.07120176089816221
13677,48483,Wheeler,Texas,2012,232,1878,18,2128,0.10902255639097744,0.8825187969924813,0.008458646616541353,-82,5,-40,-117,-0.030843813319490265,0.0026680007368086135,0.02817581258268176,-1646,-42,-0.7734962406015038,-0.059019625902172024
13678,48483,Wheeler,Texas,2016,194,2087,25,2306,0.08412836079791847,0.9050303555941024,0.010841283607979185,-38,7,209,178,-0.02489419559305897,0.0023826369914378316,0.02251155860162113,-1893,-247,-0.820901994796184,-0.04740575419468018
13679,48485,Wichita,Texas,2000,14108,27802,803,42713,0.3302975674853089,0.6509025355278253,0.018799896986865825,0,0,0,0,0.0,0.0,0.0,-13694,0,-0.32060496804251637,0.0
13680,48485,Wichita,Texas,2004,12819,32472,254,45545,0.28145789878142496,0.7129651992534856,0.005576901965089472,-1289,-549,4670,2832,-0.048839668703883954,-0.013222995021776353,0.06206266372566027,-19653,-5959,-0.4315073004720606,-0.11090233242954423
13681,48485,Wichita,Texas,2008,13868,31731,383,45982,0.3015962768039668,0.6900743769301031,0.008329346265930147,1049,129,-741,437,0.020138378022541814,0.002752444300840675,-0.022890822323382465,-17863,1790,-0.3884781001261363,0.04302920034592428
13682,48485,Wichita,Texas,2012,10525,29812,681,41018,0.25659466575649714,0.7268028670339851,0.016602467209517774,-3343,298,-1919,-4964,-0.045001611047469636,0.008273120943587627,0.03672849010388202,-19287,-1424,-0.47020820127748797,-0.08173010115135165
13683,48485,Wichita,Texas,2016,8770,27631,1718,38119,0.23006899446470264,0.7248616175660432,0.04506938796925418,-1755,1037,-2181,-2899,-0.026525671291794506,0.028466920759736405,-0.0019412494679419412,-18861,426,-0.49479262310134053,-0.024584421823852565
13684,48487,Wilbarger,Texas,2000,1356,3138,83,4577,0.2962639283373389,0.6856019226567621,0.01813414900589906,0,0,0,0,0.0,0.0,0.0,-1782,0,-0.38933799431942323,0.0
13685,48487,Wilbarger,Texas,2004,1284,3685,21,4990,0.25731462925851706,0.7384769539078156,0.004208416833667334,-72,-62,547,413,-0.03894929907882183,-0.013925732172231727,0.05287503125105353,-2401,-619,-0.4811623246492986,-0.09182433032987536
13686,48487,Wilbarger,Texas,2008,1196,3283,30,4509,0.26524728321135504,0.7280993568418718,0.00665335994677312,-88,9,-402,-481,0.007932653952837987,0.002444943113105786,-0.010377597065943878,-2087,314,-0.4628520736305167,0.018310251018781865
13687,48487,Wilbarger,Texas,2012,971,2956,53,3980,0.24396984924623116,0.742713567839196,0.013316582914572864,-225,23,-327,-529,-0.021277433965123882,0.006663222967799744,0.014614210997324184,-1985,102,-0.4987437185929648,-0.035891644962448066
13688,48487,Wilbarger,Texas,2016,809,3166,130,4105,0.19707673568818515,0.7712545676004872,0.031668696711327646,-162,77,210,125,-0.04689311355804601,0.018352113796754783,0.028540999761291208,-2357,-372,-0.574177831912302,-0.07543411331933719
13689,48489,Willacy,Texas,2000,3218,1789,55,5062,0.6357171078625049,0.3534176214934808,0.010865270644014224,0,0,0,0,0.0,0.0,0.0,1429,0,0.2822994863690241,0.0
13690,48489,Willacy,Texas,2004,2734,2209,19,4962,0.550987505038291,0.44518339379282545,0.0038291011688835145,-484,-36,420,-100,-0.08472960282421393,-0.007036169475130709,0.09176577229934463,525,-904,0.10580411124546552,-0.17649537512355856
13691,48489,Willacy,Texas,2008,3409,1456,38,4903,0.6952885988170507,0.2969610442586172,0.007750356924332041,675,19,-753,-59,0.14430109377875977,0.003921255755448527,-0.14822234953420826,1953,1428,0.39832755455843355,0.29252344331296803
13692,48489,Willacy,Texas,2012,3600,1416,48,5064,0.7109004739336493,0.2796208530805687,0.009478672985781991,191,10,-40,161,0.015611875116598561,0.0017283160614499499,-0.01734019117804847,2184,231,0.4312796208530806,0.03295206629464703
13693,48489,Willacy,Texas,2016,3422,1547,126,5095,0.6716388616290481,0.30363101079489696,0.024730127576054955,-178,78,131,31,-0.039261612304601234,0.015251454590272964,0.02401015771432824,1875,-309,0.3680078508341511,-0.06327177001892947
13694,48491,Williamson,Texas,2000,26591,65041,4303,95935,0.27717725543336635,0.6779694584875176,0.04485328607911607,0,0,0,0,0.0,0.0,0.0,-38450,0,-0.4007922030541512,0.0
13695,48491,Williamson,Texas,2004,43117,83284,1797,128198,0.3363313000202811,0.6496513206134261,0.014017379366292765,16526,-2506,18243,32263,0.059154044586914756,-0.030835906712823304,-0.02831813787409143,-40167,-1717,-0.313320020593145,0.08747218246100619
13696,48491,Williamson,Texas,2008,67691,88323,3152,159166,0.42528555093424475,0.5549112247590566,0.019803224306698668,24574,1355,5039,30968,0.08895425091396364,0.0057858449404059025,-0.09474009585436949,-20632,19535,-0.12962567382481188,0.18369434676833313
13697,48491,Williamson,Texas,2012,61875,97006,4923,163804,0.37773802837537546,0.5922077604942493,0.030054211130375326,-5816,1771,8683,4638,-0.04754752255886929,0.010250986823676658,0.03729653573519265,-35131,-14499,-0.21446973211887382,-0.08484405829406194
13698,48491,Williamson,Texas,2016,84468,104175,14438,203081,0.41593255892968817,0.512972656230765,0.07109478483954679,22593,9515,7169,39277,0.03819453055431271,0.04104057370917146,-0.07923510426348424,-19707,15424,-0.09704009730107688,0.11742963481779695
13699,48493,Wilson,Texas,2000,3997,7509,192,11698,0.3416823388613438,0.6419045990767652,0.016413062061890922,0,0,0,0,0.0,0.0,0.0,-3512,0,-0.3002222602154214,0.0
13700,48493,Wilson,Texas,2004,4409,10400,76,14885,0.2962042324487739,0.6986899563318777,0.005105811219348337,412,-116,2891,3187,-0.045478106412569885,-0.011307250842542586,0.05678535725511247,-5991,-2479,-0.4024857238831038,-0.10226346366768235
13701,48493,Wilson,Texas,2008,5362,10904,100,16366,0.32763045337895635,0.6662593180984969,0.006110228522546743,953,24,504,1481,0.031426220930182436,0.0010044173031984061,-0.03243063823338077,-5542,449,-0.33862886471954057,0.0638568591635632
13702,48493,Wilson,Texas,2012,4821,12218,166,17205,0.28020924149956405,0.7101424004649811,0.00964835803545481,-541,66,1314,839,-0.0474212118793923,0.003538129512908067,0.043883082366484194,-7397,-1855,-0.42993315896541706,-0.0913042942458765
13703,48493,Wilson,Texas,2016,4790,13998,644,19432,0.2465006175380815,0.7203581720872787,0.03314121037463977,-31,478,1780,2227,-0.03370862396148255,0.02349285233918496,0.010215771622297587,-9208,-1811,-0.4738575545491972,-0.04392439558378014
13704,48495,Winkler,Texas,2000,556,1468,19,2043,0.272148800783162,0.7185511502692119,0.00930004894762604,0,0,0,0,0.0,0.0,0.0,-912,0,-0.4464023494860499,0.0
13705,48495,Winkler,Texas,2004,391,1604,7,2002,0.1953046953046953,0.8011988011988012,0.0034965034965034965,-165,-12,136,-41,-0.0768441054784667,-0.005803545451122544,0.08264765092958926,-1213,-301,-0.6058941058941059,-0.15949175640805596
13706,48495,Winkler,Texas,2008,477,1529,26,2032,0.23474409448818898,0.7524606299212598,0.012795275590551181,86,19,-75,30,0.03943939918349368,0.009298772094047685,-0.04873817127754132,-1052,161,-0.5177165354330708,0.08817757046103503
13707,48495,Winkler,Texas,2012,398,1311,16,1725,0.23072463768115942,0.76,0.00927536231884058,-79,-10,-218,-307,-0.004019456807029559,-0.0035199132717106014,0.007539370078740171,-913,139,-0.5292753623188406,-0.011558826885769813
13708,48495,Winkler,Texas,2016,420,1403,53,1876,0.22388059701492538,0.747867803837953,0.028251599147121536,22,37,92,151,-0.006844040666234036,0.018976236828280958,-0.012132196162046971,-983,-70,-0.5239872068230277,0.005288155495812963
13709,48497,Wise,Texas,2000,4830,11234,304,16368,0.29508797653958946,0.6863391984359726,0.01857282502443793,0,0,0,0,0.0,0.0,0.0,-6404,0,-0.3912512218963831,0.0
13710,48497,Wise,Texas,2004,4783,15177,87,20047,0.2385893151094927,0.7570708834239537,0.0043398014665535995,-47,-217,3943,3679,-0.05649866143009677,-0.01423302355788433,0.0707316849879811,-10394,-3990,-0.518481568314461,-0.1272303464180779
13711,48497,Wise,Texas,2008,4471,15973,195,20639,0.21662871263142594,0.7739231551916275,0.009448132176946558,-312,108,796,592,-0.02196060247806675,0.005108330710392958,0.016852271767673788,-11502,-1108,-0.5572944425602016,-0.038812874245740536
13712,48497,Wise,Texas,2012,3221,17207,317,20745,0.15526632923596048,0.8294528802120993,0.015280790551940227,-1250,122,1234,106,-0.06136238339546546,0.005832658374993669,0.05552972502047182,-13986,-2484,-0.6741865509761388,-0.11689210841593722
13713,48497,Wise,Texas,2016,3412,20670,694,24776,0.13771391669357444,0.8342751049402648,0.028010978366160802,191,377,3463,4031,-0.017552412542386042,0.012730187814220575,0.004822224728165514,-17258,-3272,-0.6965611882466903,-0.022374637270551556
13714,48499,Wood,Texas,2000,3893,9810,181,13884,0.2803946989340248,0.7065687121866897,0.013036588879285509,0,0,0,0,0.0,0.0,0.0,-5917,0,-0.4261740132526649,0.0
13715,48499,Wood,Texas,2004,4034,12831,64,16929,0.23828932600862426,0.7579301789828106,0.003780495008565184,141,-117,3021,3045,-0.042105372925400536,-0.009256093870720326,0.05136146679612086,-8797,-2880,-0.5196408529741863,-0.09346683972152137
13716,48499,Wood,Texas,2008,4010,13658,116,17784,0.22548358074673863,0.7679937022042285,0.0065227170490328385,-24,52,827,855,-0.012805745261885632,0.0027422220404676543,0.010063523221417903,-9648,-851,-0.5425101214574899,-0.022869268483303618
13717,48499,Wood,Texas,2012,3056,14351,174,17581,0.173824014561174,0.8162789374893351,0.009897047949490928,-954,58,693,-203,-0.05165956618556464,0.003374330900458089,0.04828523528510664,-11295,-1647,-0.6424549229281611,-0.0999448014706712
13718,48499,Wood,Texas,2016,2630,15700,397,18727,0.1404389384311422,0.8383617237144231,0.02119933785443477,-426,223,1349,1146,-0.033385076130031804,0.011302289904943844,0.02208278622508797,-13070,-1775,-0.6979227852832809,-0.0554678623551198
13719,48501,Yoakum,Texas,2000,531,1911,23,2465,0.2154158215010142,0.7752535496957403,0.009330628803245436,0,0,0,0,0.0,0.0,0.0,-1380,0,-0.5598377281947261,0.0
13720,48501,Yoakum,Texas,2004,376,2228,9,2613,0.14389590508993494,0.8526597780329124,0.003444316877152698,-155,-14,317,148,-0.07151991641107927,-0.005886311926092738,0.07740622833717203,-1852,-472,-0.7087638729429775,-0.1489261447482514
13721,48501,Yoakum,Texas,2008,450,1989,19,2458,0.18307567127746135,0.8091944670463792,0.007729861676159479,74,10,-239,-155,0.039179766187526416,0.004285544799006781,-0.04346531098653317,-1539,313,-0.6261187957689178,0.08264507717405967
13722,48501,Yoakum,Texas,2012,409,1698,21,2128,0.19219924812030076,0.7979323308270677,0.009868421052631578,-41,2,-291,-330,0.009123576842839404,0.002138559376472099,-0.011262136219311492,-1289,250,-0.605733082706767,0.020385713062150868
13723,48501,Yoakum,Texas,2016,426,1797,80,2303,0.1849761181068172,0.7802865827181936,0.03473729917498915,17,59,99,175,-0.00722313001348357,0.02486887812235757,-0.017645748108874093,-1371,-82,-0.5953104646113765,0.010422618095390468
13724,48503,Young,Texas,2000,1843,5022,89,6954,0.2650273224043716,0.722174288179465,0.01279838941616336,0,0,0,0,0.0,0.0,0.0,-3179,0,-0.45714696577509345,0.0
13725,48503,Young,Texas,2004,1511,5874,24,7409,0.20394115265217977,0.7928195437980834,0.0032393035497368067,-332,-65,852,455,-0.06108616975219183,-0.009559085866426552,0.07064525561861834,-4363,-1184,-0.5888783911459037,-0.13173142537081023
13726,48503,Young,Texas,2008,1303,5942,60,7305,0.1783709787816564,0.8134154688569473,0.008213552361396304,-208,36,68,-104,-0.025570173870523377,0.004974248811659497,0.020595925058863873,-4639,-276,-0.6350444900752908,-0.04616609892938717
13727,48503,Young,Texas,2012,992,6225,99,7316,0.13559322033898305,0.8508747949699289,0.013531984691088026,-311,39,283,11,-0.04277775844267334,0.0053184323296917215,0.03745932611298164,-5233,-594,-0.7152815746309459,-0.08023708455565504
13728,48503,Young,Texas,2016,876,6601,230,7707,0.11366290385363954,0.8564940962761126,0.029842999870247827,-116,131,376,391,-0.021930316485343507,0.016311015179159803,0.0056193013061837105,-5725,-492,-0.7428311924224731,-0.027549617791527203
13729,48505,Zapata,Texas,2000,1638,953,25,2616,0.6261467889908257,0.3642966360856269,0.0095565749235474,0,0,0,0,0.0,0.0,0.0,685,0,0.26185015290519875,0.0
13730,48505,Zapata,Texas,2004,1662,1228,8,2898,0.5734989648033126,0.42374051069703245,0.0027605244996549345,24,-17,275,282,-0.052647824187513015,-0.006796050423892466,0.059443874611405545,434,-251,0.1497584541062802,-0.11209169879891856
13731,48505,Zapata,Texas,2008,1939,919,8,2866,0.676552686671319,0.3206559665038381,0.0027913468248429866,277,0,-309,-32,0.10305372186800632,3.082232518805206e-05,-0.10308454419319435,1020,586,0.35589672016748086,0.20613826606120067
13732,48505,Zapata,Texas,2012,2527,997,19,3543,0.7132373694609089,0.2813999435506633,0.005362686988427886,588,11,78,677,0.03668468278958992,0.002571340163584899,-0.03925602295317482,1530,510,0.4318374259102456,0.07594070574276474
13733,48505,Zapata,Texas,2016,2063,1029,50,3142,0.6565881604073839,0.32749840865690644,0.015913430935709738,-464,31,32,-401,-0.056649209053524996,0.010550743947281851,0.04609846510624316,1034,-496,0.32908975175047744,-0.10274767415976815
13734,48507,Zavala,Texas,2000,2616,751,24,3391,0.7714538484222944,0.22146859333529934,0.00707755824240637,0,0,0,0,0.0,0.0,0.0,1865,0,0.549985255086995,0.0
13735,48507,Zavala,Texas,2004,2332,777,9,3118,0.7479153303399615,0.24919820397690828,0.0028864656831302116,-284,-15,26,-273,-0.02353851808233287,-0.004191092559276158,0.02772961064160895,1555,-310,0.4987171263630532,-0.05126812872394182
13736,48507,Zavala,Texas,2008,3263,596,17,3876,0.8418472652218782,0.15376676986584106,0.0043859649122807015,931,8,-181,758,0.09393193488191676,0.0014994992291504899,-0.09543143411106722,2667,1112,0.6880804953560372,0.189363368992984
13737,48507,Zavala,Texas,2012,3042,574,37,3653,0.8327402135231317,0.15713112510265534,0.010128661374212975,-221,20,-22,-223,-0.009107051698746593,0.005742696461932274,0.003364355236814276,2468,-199,0.6756090884204763,-0.012471406935560925
13738,48507,Zavala,Texas,2016,2636,694,66,3396,0.7762073027090695,0.2043580683156655,0.019434628975265017,-406,29,120,-257,-0.0565329108140622,0.009305967601052042,0.04722694321301016,1942,-526,0.571849234393404,-0.10375985402707233
13739,49001,Beaver,Utah,2000,541,1653,58,2252,0.24023090586145648,0.7340142095914742,0.02575488454706927,0,0,0,0,0.0,0.0,0.0,-1112,0,-0.4937833037300178,0.0
13740,49001,Beaver,Utah,2004,493,2023,28,2544,0.19378930817610063,0.7952044025157232,0.0110062893081761,-48,-30,370,292,-0.046441597685355857,-0.01474859523889317,0.06119019292424899,-1530,-418,-0.6014150943396226,-0.10763179060960482
13741,49001,Beaver,Utah,2008,542,1902,74,2518,0.21525019857029387,0.7553613979348689,0.02938840349483717,49,46,-121,-26,0.021460890394193244,0.018382114186661073,-0.039843004580854324,-1360,170,-0.5401111993645751,0.06130389497504751
13742,49001,Beaver,Utah,2012,346,2174,40,2560,0.13515625,0.84921875,0.015625,-196,-34,272,42,-0.08009394857029387,-0.013763403494837172,0.09385735206513113,-1828,-468,-0.7140625,-0.17395130063542497
13743,49001,Beaver,Utah,2016,264,1838,403,2505,0.10538922155688622,0.7337325349301397,0.16087824351297406,-82,363,-336,-55,-0.029767028443113783,0.14525324351297406,-0.11548621506986034,-1574,254,-0.6283433133732534,0.0857191866267466
13744,49003,Box Elder,Utah,2000,2555,12288,640,15483,0.16501969902473682,0.7936446425111412,0.04133565846412194,0,0,0,0,0.0,0.0,0.0,-9733,0,-0.6286249434864044,0.0
13745,49003,Box Elder,Utah,2004,2244,15751,373,18368,0.12216898954703832,0.8575239547038328,0.02030705574912892,-311,-267,3463,2885,-0.04285070947769849,-0.02102860271499302,0.0638793121926916,-13507,-3774,-0.7353549651567944,-0.10673002167039003
13746,49003,Box Elder,Utah,2008,3311,15228,678,19217,0.17229536348025187,0.7924233751365978,0.03528126138315034,1067,305,-523,849,0.05012637393321355,0.01497420563402142,-0.06510057956723503,-11917,1590,-0.6201280116563459,0.11522695350044854
13747,49003,Box Elder,Utah,2012,1984,17101,320,19405,0.10224169028600875,0.8812677145065705,0.01649059520742077,-1327,-358,1873,188,-0.07005367319424312,-0.01879066617572957,0.08884433936997271,-15117,-3200,-0.7790260242205618,-0.15889801256421587
13748,49003,Box Elder,Utah,2016,2282,12230,5366,19878,0.11480028171848275,0.6152530435657511,0.26994667471576617,298,5046,-4871,473,0.012558591432473995,0.2534560795083454,-0.26601467094081943,-9948,5169,-0.5004527618472683,0.2785732623732935
13749,49005,Cache,Utah,2000,5170,25920,2052,33142,0.15599541367449157,0.7820891919618611,0.06191539436364733,0,0,0,0,0.0,0.0,0.0,-20750,0,-0.6260937782873696,0.0
13750,49005,Cache,Utah,2004,6375,32486,870,39731,0.16045405350985376,0.8176486874229192,0.0218972590672271,1205,-1182,6566,6589,0.0044586398353621826,-0.04001813529642023,0.03555949546105808,-26111,-5361,-0.6571946339130654,-0.031100855625695867
13751,49005,Cache,Utah,2008,10294,29127,2501,41922,0.24555126186727733,0.6947903248890798,0.05965841324364295,3919,1631,-3359,2191,0.08509720835742357,0.03776115417641585,-0.12285836253383942,-18833,7278,-0.44923906302180244,0.207955570891263
13752,49005,Cache,Utah,2012,6244,35039,1010,42293,0.1476367247535053,0.8284822547466484,0.02388102049984631,-4050,-1491,5912,371,-0.09791453711377202,-0.03577739274379664,0.13369192985756861,-28795,-9962,-0.6808455299931431,-0.23160646697134063
13753,49005,Cache,Utah,2016,8563,21139,17016,46718,0.1832912367823965,0.4524808425018194,0.3642279207157841,2319,16006,-13900,4425,0.035654512028891194,0.3403469002159378,-0.37600141224482897,-12576,16219,-0.2691896057194229,0.41165592427372016
13754,49007,Carbon,Utah,2000,3298,3758,328,7384,0.44664138678223186,0.5089382448537378,0.044420368364030335,0,0,0,0,0.0,0.0,0.0,-460,0,-0.06229685807150598,0.0
13755,49007,Carbon,Utah,2004,3415,4950,143,8508,0.40138692994828395,0.581805359661495,0.01680771039022097,117,-185,1192,1124,-0.04525445683394791,-0.027612657973809365,0.0728671148077572,-1535,-1075,-0.1804184297132111,-0.11812157164170511
13756,49007,Carbon,Utah,2008,3468,4091,263,7822,0.44336486832012273,0.5230120173868575,0.03362311429301969,53,120,-859,-686,0.041977938371838774,0.016815403902798717,-0.058793342274637506,-623,912,-0.07964714906673481,0.10077128064647628
13757,49007,Carbon,Utah,2012,2275,5090,202,7567,0.30064754856614245,0.6726575921765561,0.026694859257301442,-1193,-61,999,-255,-0.14271731975398028,-0.0069282550357182456,0.14964557478969853,-2815,-2192,-0.3720100436104136,-0.2923628945436788
13758,49007,Carbon,Utah,2016,1717,5275,1007,7999,0.21465183147893488,0.6594574321790224,0.12589073634204276,-558,805,185,432,-0.08599571708720757,0.09919587708474131,-0.013200159997533656,-3558,-743,-0.44480560070008757,-0.07279555708967395
13759,49009,Daggett,Utah,2000,104,317,14,435,0.23908045977011494,0.728735632183908,0.03218390804597701,0,0,0,0,0.0,0.0,0.0,-213,0,-0.4896551724137931,0.0
13760,49009,Daggett,Utah,2004,108,380,11,499,0.21643286573146292,0.7615230460921844,0.022044088176352707,4,-3,63,64,-0.02264759403865202,-0.010139819869624304,0.03278741390827633,-272,-59,-0.5450901803607214,-0.05543500794692835
13761,49009,Daggett,Utah,2008,131,297,16,444,0.29504504504504503,0.668918918918919,0.036036036036036036,23,5,-83,-55,0.07861217931358211,0.013991947859683329,-0.09260412717326538,-166,106,-0.37387387387387394,0.1712163064868475
13762,49009,Daggett,Utah,2012,94,406,20,520,0.18076923076923077,0.7807692307692308,0.038461538461538464,-37,4,109,76,-0.11427581427581426,0.002425502425502428,0.1118503118503118,-312,-146,-0.6,-0.22612612612612604
13763,49009,Daggett,Utah,2016,77,331,69,477,0.16142557651991615,0.6939203354297694,0.14465408805031446,-17,49,-75,-43,-0.019343654249314612,0.106192549588776,-0.08684889533946138,-254,58,-0.5324947589098532,0.06750524109014677
13764,49011,Davis,Utah,2000,18845,64375,4635,87855,0.21450116669512265,0.7327414489784304,0.052757384326446985,0,0,0,0,0.0,0.0,0.0,-45530,0,-0.5182402822833078,0.0
13765,49011,Davis,Utah,2004,20893,86187,2188,109268,0.19120877109492257,0.7887670681260753,0.020024160779002088,2048,-2447,21812,21413,-0.023292395600200078,-0.0327332235474449,0.05602561914764492,-65294,-19764,-0.5975582970311528,-0.07931801474784506
13766,49011,Davis,Utah,2008,30477,77341,3084,110902,0.27481019278281726,0.6973814719301726,0.027808335287010152,9584,896,-8846,1634,0.0836014216878947,0.007784174508008064,-0.0913855961959027,-46864,18430,-0.42257127914735537,0.17498701788379745
13767,49011,Davis,Utah,2012,21889,96861,2318,121068,0.1807992202729045,0.8000545148181187,0.019146264908976772,-8588,-766,19520,10166,-0.09401097250991278,-0.00866207037803338,0.1026730428879461,-74972,-28108,-0.6192552945452142,-0.19668401539785885
13768,49011,Davis,Utah,2016,28776,62219,49293,140288,0.20512089416058393,0.4435090670620438,0.3513700387773723,6887,46975,-34642,19220,0.024321673887679446,0.3322237738683955,-0.35654544775607494,-33443,41529,-0.23838817290145986,0.38086712164375436
13769,49013,Duchesne,Utah,2000,779,3622,145,4546,0.1713594368675759,0.7967443906731192,0.031896172459304886,0,0,0,0,0.0,0.0,0.0,-2843,0,-0.6253849538055433,0.0
13770,49013,Duchesne,Utah,2004,738,4742,76,5556,0.132829373650108,0.853491720662347,0.013678905687544997,-41,-69,1120,1010,-0.03853006321746791,-0.018217266771759888,0.056747329989227824,-4004,-1161,-0.7206623470122391,-0.09527739320669582
13771,49013,Duchesne,Utah,2008,911,4689,172,5772,0.15783090783090784,0.8123700623700624,0.0297990297990298,173,96,-53,216,0.02500153418079984,0.0161201241114848,-0.041121658292284646,-3778,226,-0.6545391545391546,0.06612319247308451
13772,49013,Duchesne,Utah,2012,581,5698,100,6379,0.09108010659978052,0.8932434550870042,0.015676438313215236,-330,-72,1009,607,-0.06675080123112731,-0.014122591485814563,0.08087339271694183,-5117,-1339,-0.8021633484872237,-0.14762419394806914
13773,49013,Duchesne,Utah,2016,500,5508,980,6988,0.07155123068116771,0.7882083571837436,0.14024041213508873,-81,880,-190,609,-0.019528875918612812,0.1245639738218735,-0.1050350979032606,-5008,109,-0.7166571265025758,0.08550622198464786
13774,49015,Emery,Utah,2000,958,3243,197,4398,0.2178262846748522,0.737380627557981,0.044793087767166895,0,0,0,0,0.0,0.0,0.0,-2285,0,-0.5195543428831287,0.0
13775,49015,Emery,Utah,2004,831,3781,66,4678,0.17764001710132535,0.8082513894826849,0.01410859341598974,-127,-131,538,280,-0.04018626757352686,-0.030684494351177156,0.07087076192470398,-2950,-665,-0.6306113723813596,-0.11105702949823082
13776,49015,Emery,Utah,2008,973,3358,145,4476,0.21738159070598748,0.7502234137622877,0.03239499553172476,142,79,-423,-202,0.03974157360466213,0.01828640211573502,-0.058027975720397196,-2385,565,-0.5328418230563002,0.09776954932505932
13777,49015,Emery,Utah,2012,569,3777,103,4449,0.12789390874353787,0.8489548213081591,0.02315126994830299,-404,-42,419,-27,-0.0894876819624496,-0.009243725583421767,0.0987314075458714,-3208,-823,-0.7210609125646212,-0.188219089508321
13778,49015,Emery,Utah,2016,380,3425,510,4315,0.0880648899188876,0.7937427578215527,0.11819235225955968,-189,407,-352,-134,-0.03982901882465027,0.09504108231125669,-0.055212063486606455,-3045,163,-0.7056778679026651,0.015383044661956169
13779,49017,Garfield,Utah,2000,178,1719,71,1968,0.09044715447154472,0.8734756097560976,0.036077235772357726,0,0,0,0,0.0,0.0,0.0,-1541,0,-0.7830284552845529,0.0
13780,49017,Garfield,Utah,2004,264,1848,50,2162,0.12210915818686402,0.8547641073080481,0.02312673450508788,86,-21,129,194,0.0316620037153193,-0.012950501267269845,-0.018711502448049533,-1584,-43,-0.732654949121184,0.050373506163368886
13781,49017,Garfield,Utah,2008,405,1710,67,2182,0.1856095325389551,0.7836846929422548,0.0307057745187901,141,17,-138,20,0.06350037435209108,0.007579040013702219,-0.07107941436579324,-1305,279,-0.5980751604032998,0.13457978871788423
13782,49017,Garfield,Utah,2012,308,1832,42,2182,0.14115490375802017,0.8395967002749771,0.01924839596700275,-97,-25,122,0,-0.044454628780934924,-0.01145737855178735,0.05591200733272228,-1524,-219,-0.6984417965169569,-0.10036663611365715
13783,49017,Garfield,Utah,2016,358,1606,380,2344,0.15273037542662116,0.6851535836177475,0.1621160409556314,50,338,-226,162,0.011575471668600984,0.14286764498862864,-0.15444311665722965,-1248,276,-0.5324232081911263,0.1660185883258306
13784,49019,Grand,Utah,2000,1158,1822,634,3614,0.32042058660763695,0.5041505257332596,0.1754288876591035,0,0,0,0,0.0,0.0,0.0,-664,0,-0.18372993912562263,0.0
13785,49019,Grand,Utah,2004,1858,2130,177,4165,0.4460984393757503,0.5114045618247299,0.042496998799519806,700,-457,308,551,0.12567785276811333,-0.13293188885958368,0.0072540360914703506,-272,392,-0.06530612244897965,0.11842381667664298
13786,49019,Grand,Utah,2008,2067,1871,161,4099,0.5042693339838985,0.45645279336423517,0.03927787265186631,209,-16,-259,-66,0.05817089460814823,-0.0032191261476534963,-0.054951768460494765,196,468,0.04781654061966334,0.11312266306864299
13787,49019,Grand,Utah,2012,1727,1996,227,3950,0.43721518987341773,0.5053164556962025,0.057468354430379745,-340,66,125,-149,-0.06705414411048077,0.018190481778513436,0.04886366233196737,-269,-465,-0.0681012658227848,-0.11591780644244815
13788,49019,Grand,Utah,2016,1960,1975,666,4601,0.42599434905455336,0.42925450988915453,0.1447511410562921,233,439,-21,651,-0.011220840818864375,0.08728278662591236,-0.076061945807048,-15,254,-0.003260160834601178,0.06484110498818363
13789,49021,Iron,Utah,2000,1789,10106,699,12594,0.1420517706844529,0.8024456090201684,0.05550262029537875,0,0,0,0,0.0,0.0,0.0,-8317,0,-0.6603938383357155,0.0
13790,49021,Iron,Utah,2004,2267,12815,364,15446,0.14676939013336787,0.8296646380940049,0.023565971772627217,478,-335,2709,2852,0.004717619448914967,-0.031936648522751535,0.027219029073836554,-10548,-2231,-0.682895247960637,-0.02250140962492153
13791,49021,Iron,Utah,2008,3258,12518,902,16678,0.1953471639285286,0.7505696126633888,0.054083223408082505,991,538,-297,1232,0.048577773795160734,0.030517251635455288,-0.07909502543061608,-9260,1288,-0.5552224487348603,0.1276727992257768
13792,49021,Iron,Utah,2012,2148,14200,463,16811,0.12777348164892036,0.8446850276604604,0.027541490690619237,-1110,-439,1682,133,-0.06757368227960825,-0.026541732717463268,0.09411541499707154,-12052,-2792,-0.7169115460115401,-0.1616890972766798
13793,49021,Iron,Utah,2016,2450,11561,3820,17831,0.13740115529134653,0.6483652066625539,0.2142336380460995,302,3357,-2639,1020,0.009627673642426171,0.18669214735548026,-0.19631982099790646,-9111,2941,-0.5109640513712074,0.20594749464033268
13794,49023,Juab,Utah,2000,619,2023,143,2785,0.222262118491921,0.7263913824057451,0.05134649910233393,0,0,0,0,0.0,0.0,0.0,-1404,0,-0.5041292639138241,0.0
13795,49023,Juab,Utah,2004,605,2681,131,3417,0.17705589698565993,0.784606379865379,0.03833772314896108,-14,-12,658,632,-0.04520622150626108,-0.013008775953372853,0.05821499745963388,-2076,-672,-0.607550482879719,-0.10342121896589496
13796,49023,Juab,Utah,2008,741,2683,242,3666,0.20212765957446807,0.731860338243317,0.06601200218221495,136,111,2,249,0.02507176258880814,0.027674279033253875,-0.05274604162206198,-1942,134,-0.5297326786688489,0.07781780421087015
13797,49023,Juab,Utah,2012,451,3448,111,4010,0.11246882793017457,0.8598503740648379,0.02768079800498753,-290,-131,765,344,-0.0896588316442935,-0.03833120417722742,0.1279900358215209,-2997,-1055,-0.7473815461346633,-0.21764886746581447
13798,49023,Juab,Utah,2016,442,2827,952,4221,0.10471452262497039,0.6697465055674011,0.22553897180762852,-9,841,-621,211,-0.007754305305204184,0.19785817380264098,-0.19010386849743677,-2385,612,-0.5650319829424307,0.1823495631922326
13799,49025,Kane,Utah,2000,387,2254,161,2802,0.1381156316916488,0.8044254104211278,0.05745895788722341,0,0,0,0,0.0,0.0,0.0,-1867,0,-0.6663097787294789,0.0
13800,49025,Kane,Utah,2004,576,2414,61,3051,0.1887905604719764,0.7912159947558177,0.019993444772205833,189,-100,160,249,0.05067492878032759,-0.03746551311501758,-0.013209415665310087,-1838,29,-0.6024254342838413,0.06388434444563762
13801,49025,Kane,Utah,2008,856,2212,108,3176,0.2695214105793451,0.6964735516372796,0.03400503778337532,280,47,-202,125,0.08073085010736869,0.014011593011169485,-0.09474244311853808,-1356,482,-0.42695214105793455,0.17547329322590677
13802,49025,Kane,Utah,2012,744,2522,105,3371,0.22070602195194305,0.7481459507564521,0.031148027291604864,-112,-3,310,195,-0.048815388627402034,-0.0028570104917704543,0.05167239911917243,-1778,-422,-0.5274399288045091,-0.10048778774657452
13803,49025,Kane,Utah,2016,741,2265,531,3537,0.20949957591178966,0.640373197625106,0.15012722646310434,-3,426,-257,166,-0.01120644604015339,0.11897919917149948,-0.10777275313134604,-1524,254,-0.43087362171331633,0.09656630709119274
13804,49027,Millard,Utah,2000,696,3850,229,4775,0.14575916230366492,0.806282722513089,0.047958115183246074,0,0,0,0,0.0,0.0,0.0,-3154,0,-0.660523560209424,0.0
13805,49027,Millard,Utah,2004,626,4084,167,4877,0.12835759688332993,0.8374000410088169,0.03424236210785319,-70,-62,234,102,-0.017401565420334997,-0.013715753075392884,0.031117318495727964,-3458,-304,-0.709042444125487,-0.04851888391606296
13806,49027,Millard,Utah,2008,758,3653,328,4739,0.15994935640430472,0.770837729478793,0.0692129141169023,132,161,-431,-138,0.03159175952097479,0.034970552009049104,-0.0665623115300239,-2895,563,-0.6108883730744883,0.09815407105099871
13807,49027,Millard,Utah,2012,431,4478,146,5055,0.08526211671612265,0.8858555885262117,0.028882294757665676,-327,-182,825,316,-0.07468723968818207,-0.04033061935923662,0.11501785904741868,-4047,-1152,-0.8005934718100891,-0.18970509873560082
13808,49027,Millard,Utah,2016,431,3860,978,5269,0.08179920288479788,0.7325868286202315,0.18561396849497058,0,832,-618,214,-0.003462913831324771,0.1567316737373049,-0.1532687599059802,-3429,618,-0.6507876257354336,0.14980584607465552
13809,49029,Morgan,Utah,2000,553,2464,154,3171,0.17439293598233996,0.7770419426048565,0.04856512141280353,0,0,0,0,0.0,0.0,0.0,-1911,0,-0.6026490066225165,0.0
13810,49029,Morgan,Utah,2004,472,3301,68,3841,0.12288466545170529,0.8594116115594898,0.017703722988804998,-81,-86,837,670,-0.05150827053063467,-0.030861398423998532,0.08236966895463327,-2829,-918,-0.7365269461077845,-0.13387793948526794
13811,49029,Morgan,Utah,2008,689,3311,188,4188,0.16451766953199617,0.7905921680993314,0.044890162368672396,217,120,10,347,0.041633004080290886,0.027186439379867398,-0.06881944346015834,-2622,207,-0.6260744985673352,0.11045244754044925
13812,49029,Morgan,Utah,2012,403,4114,80,4597,0.08766586904502936,0.8949314770502501,0.01740265390472047,-286,-108,803,409,-0.07685180048696681,-0.027487508463951926,0.1043393089509187,-3711,-1089,-0.8072656080052207,-0.18119110943788552
13813,49029,Morgan,Utah,2016,577,3188,1427,5192,0.11113251155624038,0.6140215716486903,0.2748459167950693,174,1347,-926,595,0.023466642511211014,0.25744326289034886,-0.2809099054015598,-2611,1100,-0.5028890600924499,0.3043765479127708
13814,49031,Piute,Utah,2000,133,626,22,781,0.1702944942381562,0.8015364916773368,0.028169014084507043,0,0,0,0,0.0,0.0,0.0,-493,0,-0.6312419974391805,0.0
13815,49031,Piute,Utah,2004,123,646,4,773,0.1591203104786546,0.8357050452781372,0.00517464424320828,-10,-18,20,-8,-0.011174183759501605,-0.022994369841298764,0.0341685536008004,-523,-30,-0.6765847347994826,-0.04534273736030203
13816,49031,Piute,Utah,2008,141,635,25,801,0.1760299625468165,0.7927590511860175,0.031210986267166042,18,21,-11,28,0.01690965206816189,0.026036342023957763,-0.04294599409211963,-494,29,-0.6167290886392011,0.059855646160281495
13817,49031,Piute,Utah,2012,74,697,11,782,0.09462915601023018,0.8913043478260869,0.014066496163682864,-67,-14,62,-19,-0.08140080653658631,-0.01714449010348318,0.09854529664006939,-623,-129,-0.7966751918158568,-0.17994610317665571
13818,49031,Piute,Utah,2016,47,626,56,729,0.0644718792866941,0.8587105624142661,0.07681755829903979,-27,45,-71,-53,-0.03015727672353609,0.06275106213535692,-0.032593785411820786,-579,44,-0.7942386831275721,0.002436508688284711
13819,49033,Rich,Utah,2000,152,736,15,903,0.16832779623477298,0.8150609080841639,0.016611295681063124,0,0,0,0,0.0,0.0,0.0,-584,0,-0.6467331118493909,0.0
13820,49033,Rich,Utah,2004,109,922,6,1037,0.1051108968177435,0.8891031822565092,0.0057859209257473485,-43,-9,186,134,-0.06321689941702949,-0.010825374755315776,0.07404227417234532,-813,-229,-0.7839922854387658,-0.1372591735893749
13821,49033,Rich,Utah,2008,154,831,24,1009,0.15262636273538158,0.8235877106045589,0.023785926660059464,45,18,-91,-28,0.04751546591763808,0.018000005734312118,-0.06551547165195026,-677,136,-0.6709613478691774,0.11303093756958837
13822,49033,Rich,Utah,2012,83,915,17,1015,0.08177339901477833,0.9014778325123153,0.016748768472906402,-71,-7,84,6,-0.07085296372060325,-0.007037158187153062,0.07789012190775635,-832,-155,-0.819704433497537,-0.14874308562835958
13823,49033,Rich,Utah,2016,104,797,208,1109,0.09377817853922453,0.7186654643823264,0.18755635707844906,21,191,-118,94,0.012004779524446202,0.17080758860554265,-0.1828123681299889,-693,139,-0.6248872858431018,0.19481714765443514
13824,49035,Salt Lake,Utah,2000,107576,171585,28097,307258,0.35011618900077457,0.5584394873363753,0.09144432366285012,0,0,0,0,0.0,0.0,0.0,-64009,0,-0.2083232983356007,0.0
13825,49035,Salt Lake,Utah,2004,135949,215728,10461,362138,0.3754066129486549,0.5957066090827253,0.028886777968619697,28373,-17636,44143,54880,0.025290423947880336,-0.06255754569423042,0.03726712174635005,-79779,-15770,-0.22029999613407042,-0.011976697798469715
13826,49035,Salt Lake,Utah,2008,176988,176692,13764,367444,0.48167339785110114,0.48086783292147917,0.03745876922741969,41039,3303,-39036,5306,0.10626678490244623,0.008571991258799993,-0.11483877616124616,296,80075,0.0008055649296219713,0.2211055610636924
13827,49035,Salt Lake,Utah,2012,146147,223811,14190,384148,0.3804445161760571,0.5826165956870789,0.03693888813686392,-30841,426,47119,16704,-0.10122888167504401,-0.000519881090555771,0.10174876276559974,-77664,-77960,-0.20217207951102178,-0.20297764444064376
13828,49035,Salt Lake,Utah,2016,175863,138043,109837,423743,0.41502278503715695,0.3257705732012092,0.2592066417616338,29716,95647,-85768,39595,0.034578268861099826,0.22226775362476991,-0.2568460224858697,37820,115484,0.08925221183594773,0.2914242913469695
13829,49037,San Juan,Utah,2000,1838,2721,185,4744,0.3874367622259696,0.573566610455312,0.038996627318718384,0,0,0,0,0.0,0.0,0.0,-883,0,-0.18612984822934237,0.0
13830,49037,San Juan,Utah,2004,1906,2971,73,4950,0.38505050505050503,0.6002020202020202,0.014747474747474747,68,-112,250,206,-0.00238625717546459,-0.02424915257124364,0.026635409746708194,-1065,-182,-0.21515151515151515,-0.029021666922172784
13831,49037,San Juan,Utah,2008,2406,2638,86,5130,0.46900584795321637,0.5142300194931774,0.01676413255360624,500,13,-333,180,0.08395534290271134,0.0020166578061314912,-0.08597200070884281,-232,833,-0.045224171539961,0.16992734361155415
13832,49037,San Juan,Utah,2012,2139,3074,94,5307,0.4030525720746184,0.5792349726775956,0.017712455247785943,-267,8,436,177,-0.06595327587859795,0.0009483226941797047,0.06500495318441823,-935,-703,-0.17618240060297718,-0.13095822906301618
13833,49037,San Juan,Utah,2016,2042,2645,847,5534,0.368991687748464,0.47795446331767255,0.1530538489338634,-97,753,-429,227,-0.034060884326154395,0.13534139368607745,-0.10128050935992305,-603,332,-0.10896277556920853,0.06721962503376866
13834,49039,Sanpete,Utah,2000,1211,5781,438,7430,0.1629878869448183,0.7780619111709287,0.058950201884253026,0,0,0,0,0.0,0.0,0.0,-4570,0,-0.6150740242261103,0.0
13835,49039,Sanpete,Utah,2004,1189,7004,314,8507,0.13976725049958857,0.8233219701422358,0.03691077935817562,-22,-124,1223,1077,-0.02322063644522973,-0.022039422526077407,0.04526005897130714,-5815,-1245,-0.6835547196426472,-0.0684806954165369
13836,49039,Sanpete,Utah,2008,1631,6664,583,8878,0.18371254787114216,0.7506195088984006,0.06566794323045731,442,269,-340,371,0.04394529737155359,0.028757163872281694,-0.07270246124383528,-5033,782,-0.5669069610272583,0.1166477586153889
13837,49039,Sanpete,Utah,2012,980,8406,161,9547,0.10265004713522573,0.8804860165497015,0.016863936315072797,-651,-422,1742,669,-0.08106250073591643,-0.048804006915384515,0.12986650765130092,-7426,-2393,-0.7778359694144757,-0.2109290083872174
13838,49039,Sanpete,Utah,2016,1061,6673,2513,10247,0.10354250024397385,0.6512149897530984,0.24524251000292768,81,2352,-1733,700,0.000892453108748123,0.22837857368785489,-0.22927102679660305,-5612,1814,-0.5476724895091246,0.23016347990535113
13839,49041,Sevier,Utah,2000,1046,5763,268,7077,0.14780274127455137,0.8143281051292921,0.037869153596156564,0,0,0,0,0.0,0.0,0.0,-4717,0,-0.6665253638547407,0.0
13840,49041,Sevier,Utah,2004,920,6597,124,7641,0.12040308860096846,0.8633686690223793,0.016228242376652272,-126,-144,834,564,-0.027399652673582908,-0.021640911219504292,0.0490405638930872,-5677,-960,-0.7429655804214108,-0.0764402165666701
13841,49041,Sevier,Utah,2008,1359,6394,305,8058,0.16865227103499628,0.7934971456937205,0.0378505832712832,439,181,-203,417,0.048249182434027815,0.021622340894630925,-0.06987152332865876,-5035,642,-0.6248448746587243,0.11812070576268652
13842,49041,Sevier,Utah,2012,738,7207,124,8069,0.09146114760193333,0.8931713967034329,0.015367455694633783,-621,-181,813,11,-0.07719112343306295,-0.022483127576649414,0.09967425100971239,-6469,-1434,-0.8017102491014996,-0.17686537444277528
13843,49041,Sevier,Utah,2016,695,6740,1219,8654,0.08030968338340652,0.7788305985671365,0.1408597180494569,-43,1095,-467,585,-0.011151464218526808,0.12549226235482314,-0.11434079813629638,-6045,424,-0.69852091518373,0.10318933391776952
13844,49043,Summit,Utah,2000,4601,6168,1352,12121,0.37958914280999917,0.508868905205841,0.11154195198415973,0,0,0,0,0.0,0.0,0.0,-1567,0,-0.12927976239584188,0.0
13845,49043,Summit,Utah,2004,6977,7936,399,15312,0.4556556948798328,0.5182863113897597,0.026057993730407524,2376,-953,1768,3191,0.07606655206983365,-0.0854839582537522,0.00941740618391862,-959,608,-0.06263061650992685,0.06664914588591503
13846,49043,Summit,Utah,2008,9532,6956,432,16920,0.5633569739952718,0.4111111111111111,0.02553191489361702,2555,33,-980,1608,0.10770127911543903,-0.0005260788367905042,-0.10717520027864857,2576,3535,0.15224586288416075,0.2148764793940876
13847,49043,Summit,Utah,2012,8072,8884,641,17597,0.45871455361709385,0.5048587827470592,0.03642666363584702,-1460,209,1928,677,-0.104642420378178,0.010894748742229999,0.0937476716359481,-812,-3388,-0.04614422912996535,-0.1983900920141261
13848,49043,Summit,Utah,2016,10503,7333,3049,20885,0.5028968158965765,0.35111323916686615,0.14598994493655734,2431,2408,-1551,3288,0.04418226227948269,0.10956328130071033,-0.15374554358019304,3170,3982,0.15178357672971038,0.19792780585967573
13849,49045,Tooele,Utah,2000,4001,7807,672,12480,0.32059294871794874,0.6255608974358975,0.05384615384615385,0,0,0,0,0.0,0.0,0.0,-3806,0,-0.30496794871794874,0.0
13850,49045,Tooele,Utah,2004,4130,12181,353,16664,0.24783965434469515,0.7309769563130101,0.021183389342294766,129,-319,4374,4184,-0.07275329437325359,-0.03266276450385908,0.10541605887711258,-8051,-4245,-0.48313730196831495,-0.1781693532503662
13851,49045,Tooele,Utah,2008,5830,10998,635,17463,0.3338487086983909,0.6297886961003264,0.03636259520128271,1700,282,-1183,799,0.08600905435369574,0.015179205858987944,-0.10118826021268368,-5168,2883,-0.2959399874019355,0.18719731456637945
13852,49045,Tooele,Utah,2012,4524,14268,550,19342,0.23389515044979836,0.7376693206493641,0.028435528900837555,-1306,-85,3270,1879,-0.09995355824859253,-0.007927066300445155,0.10788062454903768,-9744,-4576,-0.5037741701995657,-0.20783418279763022
13853,49045,Tooele,Utah,2016,4573,11169,6220,21962,0.208223294781896,0.5085602404152627,0.2832164648028413,49,5670,-3099,2620,-0.025671855667902366,0.25478093590200374,-0.22910908023410137,-6596,3148,-0.3003369456333667,0.203437224566199
13854,49047,Uintah,Utah,2000,1387,6733,277,8397,0.1651780397761105,0.8018339883291652,0.032987971894724306,0,0,0,0,0.0,0.0,0.0,-5346,0,-0.6366559485530547,0.0
13855,49047,Uintah,Utah,2004,1266,8518,173,9957,0.12714673094305515,0.8554785577985337,0.01737471125841117,-121,-104,1785,1560,-0.03803130883305536,-0.015613260636313138,0.053644569469368464,-7252,-1906,-0.7283318268554785,-0.09167587830242374
13856,49047,Uintah,Utah,2008,1462,8441,286,10189,0.14348807537540484,0.8284424379232506,0.028069486701344588,196,113,-77,232,0.01634134443234969,0.01069477544293342,-0.027036119875283093,-6979,273,-0.6849543625478457,0.043377464307632785
13857,49047,Uintah,Utah,2012,997,10421,193,11611,0.0858668504004823,0.8975109809663251,0.01662216863319266,-465,-93,1980,1422,-0.057621224974922544,-0.011447318068151927,0.06906854304307453,-9424,-2445,-0.8116441305658428,-0.12668976801799714
13858,49047,Uintah,Utah,2016,995,9810,2059,12864,0.0773476368159204,0.7625932835820896,0.16005907960199006,-2,1866,-611,1253,-0.008519213584561897,0.1434369109687974,-0.13491769738423554,-8815,609,-0.6852456467661692,0.12639848379967367
13859,49049,Utah,Utah,2000,16445,98255,5556,120256,0.1367499334752528,0.8170486295902075,0.046201436934539646,0,0,0,0,0.0,0.0,0.0,-81810,0,-0.6802986961149547,0.0
13860,49049,Utah,Utah,2004,17357,128269,3547,149173,0.11635483633097142,0.8598674022778922,0.023777761391136465,912,-2009,30014,28917,-0.02039509714428138,-0.02242367554340318,0.042818772687684636,-110912,-29102,-0.7435125659469207,-0.06321386983196597
13861,49049,Utah,Utah,2008,29567,122224,5488,157279,0.18799076799827058,0.7771158260161878,0.034893405985541616,12210,1941,-6045,8106,0.07163593166729916,0.011115644594405151,-0.08275157626170437,-92657,18255,-0.5891250580179173,0.15438750792900346
13862,49049,Utah,Utah,2012,17281,156950,3477,177708,0.09724379318882662,0.8831904022328764,0.019565804578296982,-12286,-2011,34726,20429,-0.09074697480944396,-0.015327601407244634,0.10607457621668859,-139669,-47012,-0.7859466090440498,-0.19682155102613252
13863,49049,Utah,Utah,2016,28522,102182,72938,203642,0.14005951620981918,0.5017727187908192,0.35816776499936165,11241,69461,-54768,25934,0.04281572302099257,0.33860196042106466,-0.3814176834420572,-73660,66009,-0.36171320258100004,0.42423340646304974
13864,49051,Wasatch,Utah,2000,1476,3819,380,5675,0.26008810572687224,0.6729515418502202,0.06696035242290749,0,0,0,0,0.0,0.0,0.0,-2343,0,-0.41286343612334797,0.0
13865,49051,Wasatch,Utah,2004,1854,5503,155,7512,0.24680511182108625,0.7325612353567625,0.020633652822151224,378,-225,1684,1837,-0.013282993905785995,-0.04632669960075626,0.05960969350654233,-3649,-1306,-0.4857561235356763,-0.07289268741232835
13866,49051,Wasatch,Utah,2008,2892,5430,303,8625,0.335304347826087,0.6295652173913043,0.035130434782608695,1038,148,-73,1113,0.08849923600500073,0.01449678196045747,-0.10299601796545821,-2538,1111,-0.29426086956521735,0.19149525397045897
13867,49051,Wasatch,Utah,2012,2191,7220,229,9640,0.22728215767634855,0.7489626556016598,0.0237551867219917,-701,-74,1790,1015,-0.10802219014973843,-0.011375248060616995,0.11939743821035542,-5029,-2491,-0.5216804979253112,-0.22741962836009388
13868,49051,Wasatch,Utah,2016,3063,6115,3088,12266,0.24971465840534812,0.4985325289417903,0.2517528126528616,872,2859,-1105,2626,0.022432500728999577,0.2279976259308699,-0.25043012665986947,-3052,1977,-0.24881787053644217,0.2728626273888691
13869,49053,Washington,Utah,2000,5465,25481,1515,32461,0.16835587320168818,0.7849727365145868,0.046671390283725085,0,0,0,0,0.0,0.0,0.0,-20016,0,-0.6166168633128986,0.0
13870,49053,Washington,Utah,2004,7513,35633,872,44018,0.1706801762915171,0.8095097460129946,0.01981007769548821,2048,-643,10152,11557,0.002324303089828922,-0.026861312588236874,0.02453700949840787,-28120,-8104,-0.6388295697214775,-0.022212706408578975
13871,49053,Washington,Utah,2008,10826,37311,1898,50035,0.21636854202058559,0.7456980113920256,0.03793344658738883,3313,1026,1678,6017,0.04568836572906848,0.018123368891900617,-0.06381173462096901,-26485,1635,-0.5293294693714401,0.10950010035003743
13872,49053,Washington,Utah,2012,8337,44698,1191,54226,0.15374543576881938,0.8242909305499208,0.021963633681259913,-2489,-707,7387,4191,-0.0626231062517662,-0.015969812906128915,0.07859291915789512,-36361,-9876,-0.6705454947811014,-0.14121602540966127
13873,49053,Washington,Utah,2016,10288,42650,9433,62371,0.16494845360824742,0.6838113867021532,0.15124015968959933,1951,8242,-2048,8145,0.011203017839428037,0.12927652600833942,-0.1404795438477675,-32362,3999,-0.5188629330939059,0.15168256168719552
13874,49055,Wayne,Utah,2000,202,953,70,1225,0.16489795918367348,0.7779591836734694,0.05714285714285714,0,0,0,0,0.0,0.0,0.0,-751,0,-0.6130612244897959,0.0
13875,49055,Wayne,Utah,2004,279,1062,19,1360,0.2051470588235294,0.7808823529411765,0.013970588235294118,77,-51,109,135,0.04024909963985593,-0.043172268907563024,0.002923169267707082,-783,-32,-0.575735294117647,0.03732593037214893
13876,49055,Wayne,Utah,2008,335,940,67,1342,0.2496274217585693,0.7004470938897168,0.04992548435171386,56,48,-122,-18,0.0444803629350399,0.03595489611641974,-0.08043525905145965,-605,178,-0.4508196721311475,0.12491562198649953
13877,49055,Wayne,Utah,2012,215,1089,23,1327,0.16201959306706856,0.8206480783722683,0.01733232856066315,-120,-44,149,-15,-0.08760782869150074,-0.03259315579105071,0.12020098448255145,-874,-269,-0.6586284853051997,-0.2078088131740522
13878,49055,Wayne,Utah,2016,271,966,189,1426,0.1900420757363254,0.6774193548387096,0.13253856942496495,56,166,-123,99,0.028022482669256832,0.1152062408643018,-0.14322872353355864,-695,179,-0.48737727910238426,0.17125120620281542
13879,49057,Weber,Utah,2000,19890,39254,3598,62742,0.31701252749354497,0.625641516049855,0.057345956456600046,0,0,0,0,0.0,0.0,0.0,-19364,0,-0.30862898855631,0.0
13880,49057,Weber,Utah,2004,19862,51199,1630,72691,0.2732387778404479,0.7043375383472507,0.022423683812301386,-28,-1968,11945,9949,-0.04377374965309705,-0.03492227264429866,0.0786960222973957,-31337,-11973,-0.43109876050680274,-0.12246977195049275
13881,49057,Weber,Utah,2008,25666,45885,2471,74022,0.3467347545324363,0.6198832779443949,0.033381967523168785,5804,841,-5314,1331,0.07349597669198837,0.010958283710867399,-0.08445426040285575,-20219,11118,-0.2731485234119586,0.15795023709484413
13882,49057,Weber,Utah,2012,19841,54224,2225,76290,0.26007340411587365,0.710761567702189,0.029165028181937343,-5825,-246,8339,2268,-0.08666135041656264,-0.004216939341231442,0.0908782897577941,-34383,-14164,-0.45068816358631536,-0.17753964017435675
13883,49057,Weber,Utah,2016,23131,40235,22640,86006,0.26894635258005256,0.46781619886984627,0.26323744855010117,3290,20415,-13989,9716,0.00887294846417891,0.23407242036816384,-0.24294536883234275,-17104,17279,-0.1988698462897937,0.25181831729652165
13884,50001,Addison,Vermont,2000,8936,6953,1538,17427,0.5127675446146783,0.3989785964308257,0.0882538589544959,0,0,0,0,0.0,0.0,0.0,1983,0,0.1137889481838526,0.0
13885,50001,Addison,Vermont,2004,11147,7077,355,18579,0.5999784703159481,0.3809139350880026,0.019107594596049302,2211,-1183,124,1152,0.08721092570126976,-0.0691462643584466,-0.01806466134282314,4070,2087,0.2190645352279455,0.1052755870440929
13886,50001,Addison,Vermont,2008,13202,5667,369,19238,0.6862459715147105,0.29457324046158645,0.01918078802370309,2055,14,-1410,659,0.08626750119876236,7.319342765378656e-05,-0.08634069462641614,7535,3465,0.391672731053124,0.1726081958251785
13887,50001,Addison,Vermont,2012,12257,5203,450,17910,0.6843662758235622,0.29050809603573424,0.02512562814070352,-945,81,-464,-1328,-0.0018796956911482088,0.00594484011700043,-0.004065144425852207,7054,-481,0.393858179787828,0.0021854487347039986
13888,50001,Addison,Vermont,2016,11219,5297,2515,19031,0.5895118490883295,0.27833534759077294,0.1321528033208975,-1038,2065,94,1121,-0.0948544267352327,0.10702717518019397,-0.012172748444961301,5922,-1132,0.3111765014975566,-0.0826816782902714
13889,50003,Bennington,Vermont,2000,9021,7284,1372,17677,0.5103241500254568,0.4120608700571364,0.0776149799174068,0,0,0,0,0.0,0.0,0.0,1737,0,0.09826327996832046,0.0
13890,50003,Bennington,Vermont,2004,11069,7616,380,19065,0.580592709152898,0.399475478625754,0.01993181222134802,2048,-992,332,1388,0.07026855912744112,-0.05768316769605879,-0.012585391431382376,3453,1716,0.18111723052714396,0.0828539505588235
13891,50003,Bennington,Vermont,2008,12524,6133,472,19129,0.6547127398191228,0.32061268231481,0.024674577866067228,1455,92,-1483,64,0.07412003066622486,0.004742765644719208,-0.078862796310944,6391,2938,0.3341000575043128,0.15298282697716886
13892,50003,Bennington,Vermont,2012,11514,5687,392,17593,0.6544648439720343,0.3232535667595066,0.022281589268459048,-1010,-80,-446,-1536,-0.0002478958470885084,-0.0023929885976081804,0.002640884444696623,5827,-564,0.3312112772125277,-0.0028887802917851313
13893,50003,Bennington,Vermont,2016,9539,5925,1917,17381,0.5488176744721247,0.34088947701513145,0.1102928485127438,-1975,1525,238,-212,-0.1056471694999096,0.08801125924428475,0.01763591025562483,3614,-2213,0.20792819745699326,-0.12328307975553443
13894,50005,Caledonia,Vermont,2000,5859,6746,1036,13641,0.4295139652518144,0.4945385235686533,0.07594751117953229,0,0,0,0,0.0,0.0,0.0,-887,0,-0.0650245583168389,0.0
13895,50005,Caledonia,Vermont,2004,7106,6765,340,14211,0.5000351840123848,0.47603968756597004,0.023925128421645205,1247,-696,19,570,0.07052121876057038,-0.05202238275788708,-0.01849883600268326,341,1228,0.023995496446414744,0.08902005476325364
13896,50005,Caledonia,Vermont,2008,8900,5472,356,14728,0.6042911461162411,0.37153720803910917,0.024171645844649647,1794,16,-1293,517,0.10425596210385635,0.00024651742300444215,-0.10450247952686087,3428,3087,0.23275393807713196,0.20875844163071722
13897,50005,Caledonia,Vermont,2012,8192,5088,381,13661,0.5996632750164702,0.3724471122172608,0.027889612766268942,-708,25,-384,-1067,-0.004627871099770919,0.0037179669216192944,0.0009099041781516215,3104,-324,0.22721616279920942,-0.005537775277922541
13898,50005,Caledonia,Vermont,2016,6445,5534,2095,14074,0.45793662071905644,0.39320733267017194,0.14885604661077165,-1747,1714,446,413,-0.14172665429741377,0.1209664338445027,0.02076022045291115,911,-2193,0.0647292880488845,-0.16248687475032492
13899,50007,Chittenden,Vermont,2000,39156,26105,6756,72017,0.5437049585514532,0.36248385797797744,0.09381118347056945,0,0,0,0,0.0,0.0,0.0,13051,0,0.18122110057347574,0.0
13900,50007,Chittenden,Vermont,2004,49369,26422,1905,77696,0.6354123764415156,0.34006898682042835,0.024518636738056012,10213,-4851,317,5679,0.09170741789006243,-0.06929254673251344,-0.022414871157549088,22947,9896,0.29534338962108725,0.11412228904761151
13901,50007,Chittenden,Vermont,2008,59611,22237,1592,83440,0.7144175455417067,0.26650287631831254,0.019079578139980825,10242,-313,-4185,5744,0.07900516910019106,-0.005439058598075187,-0.07356611050211581,37374,14427,0.4479146692233941,0.15257127960230688
13902,50007,Chittenden,Vermont,2012,53626,21571,1883,77080,0.6957187337830825,0.27985210171250646,0.024429164504411002,-5985,291,-666,-6360,-0.0186988117586242,0.005349586364430177,0.01334922539419392,32055,-5319,0.415866632070576,-0.03204803715281812
13903,50007,Chittenden,Vermont,2016,54814,18601,10001,83416,0.657116140788338,0.22299079313321185,0.11989306607845018,1188,8118,-2970,6336,-0.038602592994744445,0.09546390157403918,-0.05686130857929461,36213,4158,0.43412534765512617,0.018258715584550167
13904,50009,Essex,Vermont,2000,1129,1564,199,2892,0.390387275242047,0.5408022130013831,0.06881051175656985,0,0,0,0,0.0,0.0,0.0,-435,0,-0.15041493775933606,0.0
13905,50009,Essex,Vermont,2004,1276,1591,70,2937,0.4344569288389513,0.5417092271024855,0.02383384405856316,147,-129,27,45,0.04406965359690429,-0.04497666769800669,0.000907014101102388,-315,120,-0.10725229826353416,0.0431626394958019
13906,50009,Essex,Vermont,2008,1733,1284,84,3101,0.5588519832312158,0.41405998065140276,0.02708803611738149,457,14,-307,164,0.12439505439226445,0.003254192058818328,-0.12764924645108272,449,764,0.144792002579813,0.25204430084334717
13907,50009,Essex,Vermont,2012,1539,1164,95,2798,0.550035739814153,0.41601143674052893,0.03395282344531808,-194,11,-120,-303,-0.008816243417062775,0.006864787327936592,0.001951456089126169,375,-74,0.13402430307362406,-0.010767699506188944
13908,50009,Essex,Vermont,2016,1019,1506,400,2925,0.3483760683760684,0.5148717948717949,0.13675213675213677,-520,305,342,127,-0.2016596714380846,0.10279931330681868,0.09886035813126598,-487,-862,-0.16649572649572653,-0.3005200295693506
13909,50011,Franklin,Vermont,2000,9514,8395,1285,19194,0.4956757319995832,0.4373762634156507,0.06694800458476607,0,0,0,0,0.0,0.0,0.0,1119,0,0.05829946858393248,0.0
13910,50011,Franklin,Vermont,2004,10598,8936,386,19920,0.5320281124497992,0.44859437751004017,0.019377510040160643,1084,-899,541,726,0.03635238045021599,-0.047570494544605435,0.011218114094389442,1662,543,0.08343373493975903,0.02513426635582655
13911,50011,Franklin,Vermont,2008,13179,7853,428,21460,0.6141192917054986,0.36593662628145385,0.01994408201304753,2581,42,-1083,1540,0.08209117925569942,0.0005665719728868875,-0.08265775122858632,5326,3664,0.24818266542404477,0.16474893048428574
13912,50011,Franklin,Vermont,2012,12057,7405,426,19888,0.606244971842317,0.3723350764279968,0.02141995172968624,-1122,-2,-448,-1572,-0.007874319863181656,0.0014758697166387114,0.006398450146542944,4652,-674,0.23390989541432017,-0.0142727700097246
13913,50011,Franklin,Vermont,2016,9351,8752,3308,21411,0.43673812526271544,0.4087618513848022,0.15450002335248236,-2706,2882,1347,1523,-0.16950684657960152,0.13308007162279611,0.03642677495680541,599,-4053,0.027976273877913238,-0.20593362153640693
13914,50013,Grand Isle,Vermont,2000,1835,1550,253,3638,0.5043980208905993,0.42605827377680044,0.06954370533260033,0,0,0,0,0.0,0.0,0.0,285,0,0.07833974711379882,0.0
13915,50013,Grand Isle,Vermont,2004,2246,1754,77,4077,0.5508952661270542,0.43021829776796666,0.01888643610497915,411,-176,204,439,0.04649724523645493,-0.050657269227621184,0.004160023991166217,492,207,0.12067696835908753,0.042337221245288714
13916,50013,Grand Isle,Vermont,2008,2694,1490,85,4269,0.6310611384399156,0.3490278753806512,0.019910986179433123,448,8,-264,192,0.08016587231286143,0.0010245500744539733,-0.08119042238731544,1204,712,0.2820332630592644,0.16135629470017687
13917,50013,Grand Isle,Vermont,2012,2531,1471,73,4075,0.6211042944785276,0.36098159509202454,0.017914110429447853,-163,-12,-19,-194,-0.009956843961388073,-0.0019968757499852705,0.011953719711373323,1060,-144,0.260122699386503,-0.021910563672761396
13918,50013,Grand Isle,Vermont,2016,2094,1487,528,4109,0.5096130445363836,0.3618885373570212,0.1284984181065953,-437,455,16,34,-0.11149124994214399,0.11058430767714744,0.0009069422649966574,607,-453,0.14772450717936236,-0.11239819220714065
13919,50015,Lamoille,Vermont,2000,5676,4456,1114,11246,0.5047127867686289,0.3962297705850969,0.09905744264627422,0,0,0,0,0.0,0.0,0.0,1220,0,0.10848301618353196,0.0
13920,50015,Lamoille,Vermont,2004,7636,4260,285,12181,0.6268779246367293,0.34972498152861015,0.023397093834660536,1960,-829,-196,935,0.12216513786810046,-0.07566034881161368,-0.04650478905648675,3376,2156,0.27715294310811917,0.1686699269245872
13921,50015,Lamoille,Vermont,2008,8914,3515,239,12668,0.7036627723397537,0.2774707925481528,0.018866435112093464,1278,-46,-745,487,0.0767848477030244,-0.004530658722567072,-0.07225418898045732,5399,2023,0.4261919797916009,0.14903903668348173
13922,50015,Lamoille,Vermont,2012,8371,3342,275,11988,0.6982816149482817,0.27877877877877877,0.022939606272939606,-543,36,-173,-680,-0.005381157391472047,0.004073171160846142,0.001307986230625946,5029,-370,0.4195028361695029,-0.006689143622097993
13923,50015,Lamoille,Vermont,2016,7241,3570,1951,12762,0.5673875568092775,0.27973671838269865,0.15287572480802383,-1130,1676,228,774,-0.13089405813900412,0.12993611853508422,0.0009579396039198773,3671,-1358,0.2876508384265789,-0.131851997742924
13924,50017,Orange,Vermont,2000,6694,6858,1143,14695,0.4555290915277305,0.46668935011908813,0.07778155835318136,0,0,0,0,0.0,0.0,0.0,-164,0,-0.011160258591357608,0.0
13925,50017,Orange,Vermont,2004,8159,6421,315,14895,0.5477677072843236,0.43108425646189996,0.021148036253776436,1465,-828,-437,200,0.09223861575659303,-0.05663352209940492,-0.03560509365718817,1738,1902,0.1166834508224236,0.1278437094137812
13926,50017,Orange,Vermont,2008,9799,5047,333,15179,0.6455629488108571,0.3324988470913762,0.021938204097766652,1640,18,-1374,284,0.09779524152653352,0.0007901678439902159,-0.09858540937052374,4752,3014,0.31306410171948085,0.19638065089705725
13927,50017,Orange,Vermont,2012,9076,4588,389,14053,0.6458407457482388,0.3264783320287483,0.02768092222301288,-723,56,-459,-1126,0.0002777969373817246,0.005742718125246227,-0.006020515062627907,4488,-264,0.3193624137194905,0.0062983120000096315
13928,50017,Orange,Vermont,2016,7541,5007,2101,14649,0.5147791658133661,0.3417980749539218,0.14342275923271214,-1535,1712,419,596,-0.13106157993487266,0.11574183700969926,0.015319742925173463,2534,-1954,0.17298109085944435,-0.14638132286004613
13929,50019,Orleans,Vermont,2000,5472,5799,861,12132,0.45103857566765576,0.47799208704253215,0.07096933728981207,0,0,0,0,0.0,0.0,0.0,-327,0,-0.026953511374876393,0.0
13930,50019,Orleans,Vermont,2004,6330,5666,246,12242,0.5170723737951315,0.4628328704460056,0.02009475575886293,858,-615,-133,110,0.06603379812747573,-0.05087458153094914,-0.015159216596526581,664,991,0.05423950334912592,0.08119301472400231
13931,50019,Orleans,Vermont,2008,7998,4482,291,12771,0.6262626262626263,0.35095137420718814,0.022785999530185577,1668,45,-1184,529,0.10919025246749481,0.0026912437713226475,-0.11188149623881743,3516,2852,0.27531125205543816,0.22107174870631224
13932,50019,Orleans,Vermont,2012,7117,4306,269,11692,0.6087068080738967,0.36828600752651386,0.023007184399589462,-881,-22,-176,-1079,-0.017555818188729644,0.00022118486940388496,0.01733463331932572,2811,-705,0.2404208005473828,-0.034890451508055365
13933,50019,Orleans,Vermont,2016,5185,5159,1702,12046,0.43043333886767393,0.4282749460401793,0.14129171509214677,-1932,1433,853,354,-0.17827346920622272,0.11828453069255732,0.059988938513665435,26,-2785,0.0021583928274946373,-0.23826240771988816
13934,50021,Rutland,Vermont,2000,13990,13546,1826,29362,0.47646618077787617,0.4613445950548328,0.06218922416729106,0,0,0,0,0.0,0.0,0.0,444,0,0.015121585723043396,0.0
13935,50021,Rutland,Vermont,2004,15904,14440,631,30975,0.5134463276836159,0.466182405165456,0.020371267150928168,1914,-1195,894,1613,0.0369801469057397,-0.041817957016362886,0.004837810110623231,1464,1020,0.04726392251815986,0.032142336795116466
13936,50021,Rutland,Vermont,2008,19355,11584,678,31617,0.6121706676787804,0.36638517253376346,0.021444159787456115,3451,47,-2856,642,0.0987243399951645,0.0010728926365279473,-0.09979723263169255,7771,6307,0.2457854951450169,0.19852157262685705
13937,50021,Rutland,Vermont,2012,17088,10835,686,28609,0.5972945576566815,0.3787269740291517,0.02397846831416687,-2267,8,-749,-3008,-0.014876110022098876,0.002534308526710754,0.012341801495388216,6253,-1518,0.21856758362752982,-0.027217911517487092
13938,50021,Rutland,Vermont,2016,13635,12479,3501,29615,0.46040857673476276,0.4213743035623839,0.11821711970285328,-3453,2815,1644,1006,-0.13688598092191873,0.09423865138868642,0.04264732953323225,1156,-5097,0.03903427317237884,-0.17953331045515097
13939,50023,Washington,Vermont,2000,15281,11448,3020,29749,0.5136643248512555,0.38481965780362365,0.10151601734512085,0,0,0,0,0.0,0.0,0.0,3833,0,0.1288446670476318,0.0
13940,50023,Washington,Vermont,2004,19177,11461,810,31448,0.6098003052658356,0.36444288984991097,0.02575680488425337,3896,-2210,13,1699,0.09613598041458016,-0.07575921246086748,-0.020376767953712682,7716,3883,0.24535741541592465,0.11651274836829284
13941,50023,Washington,Vermont,2008,22324,9129,747,32200,0.6932919254658385,0.2835093167701863,0.023198757763975154,3147,-63,-2332,752,0.08349162020000289,-0.0025580471202782153,-0.08093357307972465,13195,5479,0.4097826086956522,0.16442519327972754
13942,50023,Washington,Vermont,2012,20351,8093,863,29307,0.6944074794417716,0.2761456307366841,0.02944688982154434,-1973,116,-1036,-2893,0.0011155539759331035,0.0062481320575691855,-0.007363686033502237,12258,-937,0.41826184870508754,0.00847924000943534
13943,50023,Washington,Vermont,2016,18594,7993,4499,31086,0.5981470758540822,0.2571253940680692,0.14472753007784855,-1757,3636,-100,1779,-0.09626040358768939,0.11528064025630422,-0.019020236668614854,10601,-1657,0.341021681786013,-0.07724016691907454
13944,50025,Windham,Vermont,2000,11319,7358,2814,21491,0.526685589316458,0.34237587827462657,0.13093853240891537,0,0,0,0,0.0,0.0,0.0,3961,0,0.18430971104183147,0.0
13945,50025,Windham,Vermont,2004,15489,7280,547,23316,0.6643077714873906,0.3122319437296277,0.023460284782981643,4170,-2267,-78,1825,0.13762218217093258,-0.10747824762593372,-0.030143934544998863,8209,4248,0.3520758277577629,0.16776611671593145
13946,50025,Windham,Vermont,2008,17585,5997,499,24081,0.7302437606411694,0.24903450853369877,0.020721730825131845,2096,-48,-1283,765,0.06593598915377874,-0.002738553957849797,-0.06319743519592894,11588,3379,0.48120925210747056,0.12913342434970765
13947,50025,Windham,Vermont,2012,16026,5347,564,21937,0.7305465651638784,0.24374344714409446,0.02570998769202717,-1559,65,-650,-2144,0.0003028045227090326,0.004988256866895323,-0.005291061389604307,10679,-909,0.48680311801978393,0.005593865912313367
13948,50025,Windham,Vermont,2016,14340,5454,2840,22634,0.6335601307767076,0.24096492003181055,0.12547494919148183,-1686,2276,107,697,-0.0969864343871708,0.09976496149945466,-0.0027785271122839073,8886,-1793,0.392595210744897,-0.09420790727488693
13949,50027,Windsor,Vermont,2000,15140,11713,2294,29147,0.5194359625347377,0.40185953957525644,0.07870449789000583,0,0,0,0,0.0,0.0,0.0,3427,0,0.11757642295948123,0.0
13950,50027,Windsor,Vermont,2004,18561,11491,715,30767,0.6032762375272207,0.3734845776318783,0.023239184840900966,3421,-1579,-222,1620,0.08384027499248303,-0.05546531304910486,-0.02837496194337813,7070,3643,0.2297916598953424,0.11221523693586116
13951,50027,Windsor,Vermont,2008,21444,9084,637,31165,0.6880795764479384,0.2914808278517568,0.02043959570030483,2883,-78,-2407,398,0.08480333892071767,-0.002799589140596137,-0.08200374978012154,12360,5290,0.3965987485961816,0.1668070887008392
13952,50027,Windsor,Vermont,2012,19494,8598,607,28699,0.6792571169727168,0.29959232028990557,0.021150562737377608,-1950,-30,-486,-2466,-0.008822459475221534,0.0007109670370727787,0.008111492438148793,10896,-1464,0.3796647966828113,-0.016933951913370326
13953,50027,Windsor,Vermont,2016,17556,8605,3767,29928,0.5866078588612671,0.28752338946805667,0.1258687516706763,-1938,3160,7,1229,-0.09264925811144975,0.10471818893329868,-0.0120689308218489,8951,-1945,0.29908446939321043,-0.08058032728960085
13954,51001,Accomack,Virginia,2000,5092,6352,481,11925,0.4270020964360587,0.5326624737945492,0.040335429769392035,0,0,0,0,0.0,0.0,0.0,-1260,0,-0.10566037735849054,0.0
13955,51001,Accomack,Virginia,2004,5518,7726,112,13356,0.4131476489967056,0.5784666067684936,0.008385744234800839,426,-369,1374,1431,-0.013854447439353101,-0.031949685534591196,0.04580413297394437,-2208,-948,-0.165318957771788,-0.05965858041329747
13956,51001,Accomack,Virginia,2008,7607,7833,183,15623,0.48691032452153876,0.5013761761505473,0.011713499327913972,2089,71,107,2267,0.07376267552483318,0.0033277550931131335,-0.07709043061794629,-226,1982,-0.014465851629008541,0.15085310614277947
13957,51001,Accomack,Virginia,2012,7655,8213,183,16051,0.4769173260233007,0.5116815151703944,0.011401158806304903,48,0,380,428,-0.009992998498238037,-0.00031234052160906967,0.010305339019847093,-558,-332,-0.03476418914709367,-0.02029833751808513
13958,51001,Accomack,Virginia,2016,6740,8583,495,15818,0.4260968516879504,0.542609685168795,0.03129346314325452,-915,312,370,-233,-0.05082047433535031,0.019892304336949617,0.030928169998400645,-1843,-1285,-0.11651283348084462,-0.08174864433375095
13959,51003,Albemarle,Virginia,2000,16255,18291,2300,36846,0.4411605058893774,0.4964175215762905,0.062421972534332085,0,0,0,0,0.0,0.0,0.0,-2036,0,-0.0552570156869131,0.0
13960,51003,Albemarle,Virginia,2004,22088,21189,449,43726,0.5051456799158396,0.4845858299409962,0.01026849014316425,5833,-1851,2898,6880,0.0639851740264622,-0.052153482391167835,-0.011831691635294295,899,2935,0.02055984997484339,0.0758168656617565
13961,51003,Albemarle,Virginia,2008,29792,20576,616,50984,0.5843401851561274,0.4035775929703436,0.01208222187352895,7704,167,-613,7258,0.07919450524028782,0.0018137317303647,-0.08100823697065257,9216,8317,0.18076259218578378,0.16020274221094039
13962,51003,Albemarle,Virginia,2012,29757,23297,853,53907,0.5520062329567589,0.4321702190810099,0.01582354796223125,-35,237,2721,2923,-0.03233395219936852,0.0037413260887023004,0.028592626110666264,6460,-2756,0.11983601387574899,-0.060926578310034785
13963,51003,Albemarle,Virginia,2016,33345,19259,4122,56726,0.587825688396855,0.3395092197581356,0.07266509184500934,3588,3269,-4038,2819,0.035819455440096126,0.056841543882778095,-0.0926609993228743,14086,7626,0.24831646863871942,0.12848045476297043
13964,51005,Alleghany,Virginia,2000,2214,2808,101,5123,0.43216865118094866,0.5481163380831544,0.019715010735896935,0,0,0,0,0.0,0.0,0.0,-594,0,-0.11594768690220575,0.0
13965,51005,Alleghany,Virginia,2004,3203,3962,30,7195,0.44517025712300207,0.5506601806810285,0.004169562195969423,989,-71,1154,2072,0.013001605942053407,-0.015545448539927512,0.002543842597874102,-759,-165,-0.10548992355802644,0.010457763344179305
13966,51005,Alleghany,Virginia,2008,3553,3715,101,7369,0.48215497353779346,0.5041389605102456,0.013706065951960918,350,71,-247,174,0.036984716414791396,0.009536503755991495,-0.04652122017078286,-162,597,-0.021983986972452185,0.08350593658557426
13967,51005,Alleghany,Virginia,2012,3403,3595,175,7173,0.47441795622473165,0.5011849993029416,0.02439704447232678,-150,74,-120,-196,-0.007737017313061811,0.010690978520365864,-0.0029539612073040677,-192,-30,-0.02676704307820993,-0.004783056105757744
13968,51005,Alleghany,Virginia,2016,2166,4874,285,7325,0.2956996587030717,0.6653924914675768,0.03890784982935153,-1237,110,1279,152,-0.17871829752165996,0.014510805357024752,0.16420749216463526,-2708,-2516,-0.36969283276450515,-0.3429257896862952
13969,51007,Amelia,Virginia,2000,1754,2947,87,4788,0.3663324979114453,0.6154970760233918,0.018170426065162906,0,0,0,0,0.0,0.0,0.0,-1193,0,-0.24916457811194648,0.0
13970,51007,Amelia,Virginia,2004,1862,3499,36,5397,0.3450064850843061,0.6483231424865666,0.006670372429127293,108,-51,552,609,-0.021326012827139196,-0.011500053636035613,0.032826066463174874,-1637,-444,-0.30331665740226055,-0.05415207929031407
13971,51007,Amelia,Virginia,2008,2488,3970,71,6529,0.3810690764282432,0.6080563639148415,0.0108745596569153,626,35,471,1132,0.036062591343937134,0.004204187227788008,-0.040266778571725115,-1482,155,-0.2269872874865983,0.07632936991566225
13972,51007,Amelia,Virginia,2012,2490,4331,94,6915,0.3600867678958785,0.6263195950831526,0.013593637020968908,2,23,361,386,-0.020982308532364713,0.002719077364053607,0.018263231168311078,-1841,-359,-0.2662328271872741,-0.03924553970067579
13973,51007,Amelia,Virginia,2016,2128,4708,204,7040,0.30227272727272725,0.66875,0.028977272727272727,-362,110,377,125,-0.057814040623151264,0.015383635706303819,0.04243040491684735,-2580,-739,-0.3664772727272727,-0.10024444553999862
13974,51009,Amherst,Virginia,2000,4812,6660,240,11712,0.4108606557377049,0.5686475409836066,0.020491803278688523,0,0,0,0,0.0,0.0,0.0,-1848,0,-0.15778688524590168,0.0
13975,51009,Amherst,Virginia,2004,4866,7758,71,12695,0.3833005120126034,0.6111067349350138,0.005592753052382828,54,-169,1098,983,-0.027560143725101516,-0.014899050226305695,0.04245919395140718,-2892,-1044,-0.22780622292241037,-0.0700193376765087
13976,51009,Amherst,Virginia,2008,6094,8470,136,14700,0.4145578231292517,0.5761904761904761,0.00925170068027211,1228,65,712,2005,0.03125731111664831,0.0036589476278892814,-0.03491625874453763,-2376,516,-0.16163265306122443,0.06617356986118594
13977,51009,Amherst,Virginia,2012,5900,8876,194,14970,0.39412157648630597,0.5929191716766867,0.012959251837007349,-194,58,406,270,-0.020436246642945743,0.0037075511567352393,0.016728695486210587,-2976,-600,-0.19879759519038076,-0.03716494212915633
13978,51009,Amherst,Virginia,2016,5057,9719,620,15396,0.32846193816575736,0.6312678617822811,0.040270200051961545,-843,426,843,426,-0.06565963832054861,0.027310948214954195,0.038348690105594385,-4662,-1686,-0.30280592361652375,-0.10400832842614299
13979,51011,Appomattox,Virginia,2000,2132,3654,141,5927,0.35970980259827906,0.6165007592373882,0.023789438164332714,0,0,0,0,0.0,0.0,0.0,-1522,0,-0.25679095663910917,0.0
13980,51011,Appomattox,Virginia,2004,2191,4366,98,6655,0.32922614575507136,0.6560480841472577,0.014725770097670924,59,-43,712,728,-0.030483656843207696,-0.00906366806666179,0.03954732490986945,-2175,-653,-0.3268219383921863,-0.07003098175307715
13981,51011,Appomattox,Virginia,2008,2641,4903,86,7630,0.34613368283093054,0.6425950196592398,0.011271297509829619,450,-12,537,975,0.01690753707585918,-0.0034544725878413052,-0.013453064488017863,-2262,-87,-0.2964613368283093,0.030360601563877043
13982,51011,Appomattox,Virginia,2012,2453,5340,142,7935,0.30913673597983615,0.6729678638941399,0.017895400126023944,-188,56,437,305,-0.03699694685109439,0.0066241026161943245,0.030372844234900054,-2887,-625,-0.3638311279143037,-0.06736979108599445
13983,51011,Appomattox,Virginia,2016,2023,5715,259,7997,0.2529698636988871,0.7146429911216706,0.032387145179442293,-430,117,375,62,-0.056166872280949076,0.01449174505341835,0.04167512722753075,-3692,-805,-0.46167312742278355,-0.09784199950847983
13984,51013,Arlington,Virginia,2000,50260,28555,4744,83559,0.6014911619334842,0.34173458274991325,0.05677425531660264,0,0,0,0,0.0,0.0,0.0,21705,0,0.2597565791835709,0.0
13985,51013,Arlington,Virginia,2004,63987,29635,1028,94650,0.6760380348652932,0.3131008980454305,0.010861067089276281,13727,-3716,1080,11091,0.07454687293180906,-0.04591318822732636,-0.028633684704482743,34352,12647,0.3629371368198627,0.1031805576362918
13986,51013,Arlington,Virginia,2008,78994,29876,1283,110153,0.7171298103546885,0.27122275380606975,0.011647435839241781,15007,255,241,15503,0.041091775489395244,0.0007863687499655003,-0.04187814423936076,49118,14766,0.44590705654861873,0.082969919728756
13987,51013,Arlington,Virginia,2012,81269,34474,1865,117608,0.6910159172845385,0.2931263179375553,0.015857764777906264,2275,582,4598,7455,-0.026113893070149996,0.004210328938664482,0.02190356413148553,46795,-2323,0.3978895993469832,-0.04801745720163553
13988,51013,Arlington,Virginia,2016,92016,20186,9137,121339,0.7583382094792276,0.16636036229077214,0.07530142823000024,10747,7272,-14288,3731,0.0673222921946891,0.05944366345209398,-0.12676595564678314,71830,25035,0.5919778471884555,0.19408824784147227
13989,51015,Augusta,Virginia,2000,6643,17744,884,25271,0.2628704839539393,0.7021487080052233,0.03498080804083732,0,0,0,0,0.0,0.0,0.0,-11101,0,-0.439278224051284,0.0
13990,51015,Augusta,Virginia,2004,7019,22100,585,29704,0.2362981416644223,0.7440075410719095,0.019694317263668194,376,-299,4356,4433,-0.026572342289516993,-0.015286490777169127,0.04185883306668614,-15081,-3980,-0.5077093994074872,-0.06843117535620313
13991,51015,Augusta,Virginia,2008,9825,23120,393,33338,0.29470874077629133,0.693502909592657,0.011788349631051652,2806,-192,1020,3634,0.05841059911186902,-0.007905967632616542,-0.05050463147925244,-13295,1786,-0.3987941688163657,0.10891523059112146
13992,51015,Augusta,Virginia,2012,9451,23624,597,33672,0.2806783083867902,0.701591827037301,0.017729864575908767,-374,204,504,334,-0.014030432389501135,0.005941514944857115,0.008088917444644017,-14173,-878,-0.42091351865051085,-0.022119349834145152
13993,51015,Augusta,Virginia,2016,8177,26163,2003,36343,0.22499518476735547,0.7198910381641581,0.055113777068486365,-1274,1406,2539,2671,-0.05568312361943473,0.037383912492577595,0.018299211126857062,-17986,-3813,-0.49489585339680264,-0.07398233474629179
13994,51017,Bath,Virginia,2000,822,1311,77,2210,0.3719457013574661,0.5932126696832579,0.03484162895927602,0,0,0,0,0.0,0.0,0.0,-489,0,-0.22126696832579185,0.0
13995,51017,Bath,Virginia,2004,828,1432,22,2282,0.3628396143733567,0.6275197195442594,0.009640666082383873,6,-55,121,72,-0.009106086984109363,-0.025200962876892146,0.034307049861001526,-604,-115,-0.26468010517090274,-0.04341313684511089
13996,51017,Bath,Virginia,2008,1043,1349,40,2432,0.42886513157894735,0.5546875,0.01644736842105263,215,18,-83,150,0.06602551720559063,0.0068067023386687575,-0.07283221954425945,-306,298,-0.12582236842105265,0.13885773674985008
13997,51017,Bath,Virginia,2012,894,1274,55,2223,0.40215924426450744,0.5730994152046783,0.024741340530814216,-149,15,-75,-209,-0.026705887314439902,0.008293972109761585,0.01841191520467833,-380,-74,-0.1709401709401709,-0.04511780251911823
13998,51017,Bath,Virginia,2016,603,1548,102,2253,0.26764314247669774,0.6870838881491345,0.045272969374167776,-291,47,274,30,-0.1345161017878097,0.02053162884335356,0.11398447294445613,-945,-565,-0.4194407456724367,-0.24850057473226583
13999,51019,Bedford,Virginia,2000,8160,17224,765,26149,0.3120578224788711,0.6586867566637348,0.029255420857394163,0,0,0,0,0.0,0.0,0.0,-9064,0,-0.3466289341848637,0.0
14000,51019,Bedford,Virginia,2004,9102,21925,377,31404,0.28983568972105467,0.6981594701311935,0.01200484014775188,942,-388,4701,5255,-0.022222132757816426,-0.017250580709642284,0.03947271346745873,-12823,-3759,-0.40832378041013884,-0.06169484622527516
14001,51019,Bedford,Virginia,2008,11017,24420,393,35830,0.30747976555958695,0.6815517722578844,0.010968462182528607,1915,16,2495,4426,0.01764407583853228,-0.0010363779652232726,-0.01660769787330907,-13403,-580,-0.3740720066982975,0.03425177371184135
14002,51019,Bedford,Virginia,2012,10209,26679,537,37425,0.2727855711422846,0.7128657314629259,0.014348697394789578,-808,144,2259,1595,-0.03469419441730237,0.0033802352122609715,0.03131395920504143,-16470,-3067,-0.4400801603206413,-0.0660081536223438
14003,51019,Bedford,Virginia,2016,9768,30659,2098,42525,0.22970017636684303,0.7209641387419166,0.04933568489124045,-441,1561,3980,5100,-0.04308539477544154,0.03498698749645087,0.008098407278990694,-20891,-4421,-0.4912639623750735,-0.05118380205443224
14004,51021,Bland,Virginia,2000,851,1759,78,2688,0.3165922619047619,0.6543898809523809,0.029017857142857144,0,0,0,0,0.0,0.0,0.0,-908,0,-0.337797619047619,0.0
14005,51021,Bland,Virginia,2004,846,1962,57,2865,0.29528795811518327,0.6848167539267016,0.019895287958115182,-5,-21,203,177,-0.02130430378957865,-0.009122569184741962,0.030426872974320673,-1116,-208,-0.38952879581151834,-0.05173117676389932
14006,51021,Bland,Virginia,2008,864,2031,64,2959,0.2919905373436972,0.6863805339641771,0.021628928692125717,18,7,69,94,-0.0032974207714860926,0.0017336407340105345,0.0015637800374754818,-1167,-51,-0.3943899966204799,-0.004861200808961574
14007,51021,Bland,Virginia,2012,735,2144,69,2948,0.24932157394843962,0.7272727272727273,0.023405698778833108,-129,5,113,-11,-0.04266896339525755,0.0017767700867073917,0.040892193308550207,-1409,-242,-0.47795115332428767,-0.08356115670380776
14008,51021,Bland,Virginia,2016,453,2573,113,3139,0.14431347562918126,0.8196877986619943,0.03599872570882447,-282,44,429,191,-0.10500809831925836,0.012593026929991358,0.09241507138926697,-2120,-711,-0.675374323032813,-0.1974231697085253
14009,51023,Botetourt,Virginia,2000,4627,8867,346,13840,0.3343208092485549,0.6406791907514451,0.025,0,0,0,0,0.0,0.0,0.0,-4240,0,-0.3063583815028902,0.0
14010,51023,Botetourt,Virginia,2004,4801,10865,131,15797,0.30391846553143004,0.6877888206621511,0.00829271380641894,174,-215,1998,1957,-0.030402343717124858,-0.016707286193581063,0.047109629910706,-6064,-1824,-0.38387035513072104,-0.07751197362783085
14011,51023,Botetourt,Virginia,2008,5693,11471,242,17406,0.32707112489945994,0.6590256233482708,0.013903251752269332,892,111,606,1609,0.023152659368029904,0.005610537945850392,-0.02876319731388033,-5778,286,-0.3319544984488108,0.05191585668191023
14012,51023,Botetourt,Virginia,2012,5452,12479,310,18241,0.2988871224165342,0.6841181952743819,0.016994682309083933,-241,68,1008,835,-0.02818400248292574,0.0030914305568146005,0.02509257192611114,-7027,-1249,-0.3852310728578477,-0.05327657440903688
14013,51023,Botetourt,Virginia,2016,4494,13375,870,18739,0.23982069480762047,0.7137520678798228,0.0464272373125567,-958,560,896,498,-0.05906642760891373,0.029432555003472766,0.029633872605440925,-8881,-1854,-0.47393137307220234,-0.08870030021435465
14014,51025,Brunswick,Virginia,2000,3387,2561,49,5997,0.5647823911955978,0.42704685676171417,0.008170752042688011,0,0,0,0,0.0,0.0,0.0,826,0,0.13773553443388364,0.0
14015,51025,Brunswick,Virginia,2004,4062,2852,12,6926,0.5864857060352295,0.41178169217441524,0.0017326017903551833,675,-37,291,929,0.021703314839631727,-0.0064381502523328275,-0.01526516458729893,1210,384,0.1747040138608143,0.036968479426930656
14016,51025,Brunswick,Virginia,2008,4973,2877,64,7914,0.6283800859236796,0.36353297952994695,0.008086934546373515,911,52,25,988,0.04189437988845002,0.006354332756018331,-0.04824871264446828,2096,886,0.2648471063937326,0.0901430925329183
14017,51025,Brunswick,Virginia,2012,4994,2968,75,8037,0.6213761353738957,0.36929202438720915,0.00933184023889511,21,11,91,123,-0.007003950549783866,0.001244905692521595,0.005759044857262197,2026,-70,0.25208411098668654,-0.012762995407046063
14018,51025,Brunswick,Virginia,2016,4481,3046,142,7669,0.5843004303038206,0.3971834659016821,0.018516103794497328,-513,67,78,-368,-0.03707570507007507,0.009184263555602219,0.027891441514472926,1435,-591,0.18711696440213854,-0.064967146584548
14019,51027,Buchanan,Virginia,2000,5745,3867,244,9856,0.5828936688311688,0.39234983766233766,0.024756493506493508,0,0,0,0,0.0,0.0,0.0,1878,0,0.1905438311688311,0.0
14020,51027,Buchanan,Virginia,2004,5275,4507,47,9829,0.5366771797741378,0.4585410519890121,0.004781768236850137,-470,-197,640,-27,-0.04621648905703102,-0.01997472526964337,0.06619121432667446,768,-1110,0.07813612778512563,-0.11240770338370548
14021,51027,Buchanan,Virginia,2008,4063,4541,130,8734,0.46519349667964277,0.519922143347836,0.014884359972521181,-1212,83,34,-1095,-0.07148368309449499,0.010102591735671044,0.061381091358823914,-478,-1246,-0.05472864666819327,-0.1328647744533189
14022,51027,Buchanan,Virginia,2012,3094,6436,116,9646,0.32075471698113206,0.6672195728799503,0.012025710138917687,-969,-14,1895,912,-0.1444387796985107,-0.002858649833603495,0.14729742953211422,-3342,-2864,-0.3464648558988182,-0.29173620923062493
14023,51027,Buchanan,Virginia,2016,1721,7296,230,9247,0.1861144154861036,0.789012652752244,0.02487293176165243,-1373,114,860,-399,-0.13464030149502845,0.012847221622734743,0.12179307987229371,-5575,-2233,-0.6028982372661403,-0.25643338136732213
14024,51029,Buckingham,Virginia,2000,2561,2738,155,5454,0.4695636230289696,0.502016868353502,0.02841950861752842,0,0,0,0,0.0,0.0,0.0,-177,0,-0.03245324532453242,0.0
14025,51029,Buckingham,Virginia,2004,2789,3185,53,6027,0.46275095404015265,0.5284552845528455,0.008793761407001825,228,-102,447,573,-0.006812668988816939,-0.019625747210526595,0.026438416199343506,-396,-219,-0.06570433051269287,-0.033251085188160445
14026,51029,Buckingham,Virginia,2008,3489,3428,77,6994,0.49885616242493563,0.49013440091507005,0.01100943665999428,700,24,243,967,0.03610520838478298,0.0022156752529924554,-0.03832088363777547,61,457,0.008721761509865589,0.07442609202255845
14027,51029,Buckingham,Virginia,2012,3750,3569,138,7457,0.5028831969961111,0.47861070135443207,0.018506101649456885,261,61,141,463,0.004027034571175425,0.007496664989462604,-0.011523699560637979,181,120,0.024272495641678993,0.015550734131813404
14028,51029,Buckingham,Virginia,2016,3128,3950,211,7289,0.42913979969817534,0.541912470846481,0.028947729455343667,-622,73,381,-168,-0.07374339729793572,0.010441627805886783,0.06330176949204891,-822,-1003,-0.11277267114830564,-0.13704516678998463
14029,51031,Campbell,Virginia,2000,6659,13162,506,20327,0.3275938407044817,0.6475131598366705,0.024892999458847837,0,0,0,0,0.0,0.0,0.0,-6503,0,-0.31991931913218874,0.0
14030,51031,Campbell,Virginia,2004,6862,15891,244,22997,0.298386746097317,0.6910031743270861,0.010610079575596816,203,-262,2729,2670,-0.029207094607164696,-0.01428291988325102,0.043490014490415674,-9029,-2526,-0.3926164282297691,-0.07269710909758037
14031,51031,Campbell,Virginia,2008,8091,17444,279,25814,0.31343457038816147,0.675757340977764,0.010808088634074533,1229,35,1553,2817,0.015047824290844447,0.00019800905847771645,-0.015245833349322169,-9353,-324,-0.3623227705896025,0.030293657640166616
14032,51031,Campbell,Virginia,2012,7595,17695,406,25696,0.29557129514321295,0.6886285803237858,0.015800124533001246,-496,127,251,-118,-0.017863275244948518,0.004992035898926713,0.012871239346021857,-10100,-747,-0.39305728518057287,-0.030734514590970374
14033,51031,Campbell,Virginia,2016,6664,19551,1320,27535,0.24201924822952606,0.7100417650263301,0.04793898674414382,-931,914,1856,1839,-0.053552046913686896,0.03213886221114257,0.021413184702544275,-12887,-2787,-0.46802251679680407,-0.0749652316162312
14034,51033,Caroline,Virginia,2000,4314,3873,164,8351,0.5165848401389055,0.46377679319841936,0.019638366662675127,0,0,0,0,0.0,0.0,0.0,441,0,0.05280804694048613,0.0
14035,51033,Caroline,Virginia,2004,4878,4999,77,9954,0.49005424954792043,0.5022101667671288,0.007735583684950774,564,-87,1126,1603,-0.02653059059098506,-0.011902782977724354,0.03843337356870946,-121,-562,-0.01215591721920839,-0.06496396415969452
14036,51033,Caroline,Virginia,2008,7163,5617,139,12919,0.5544546791547333,0.43478597414660575,0.010759346698660887,2285,62,618,2965,0.06440042960681291,0.0030237630137101134,-0.06742419262052307,1546,1667,0.1196687050081276,0.13182462222733599
14037,51033,Caroline,Virginia,2012,7276,6151,225,13652,0.53296220334017,0.4505566949897451,0.016481101670084968,113,86,534,733,-0.021492475814563372,0.005721754971424081,0.015770720843139352,1125,-421,0.08240550835042487,-0.037263196657702724
14038,51033,Caroline,Virginia,2016,6432,7147,669,14248,0.4514317798989332,0.501614261650758,0.046953958450308815,-844,444,996,596,-0.08153042344123679,0.030472856780223847,0.051057566661012854,-715,-1840,-0.05018248175182477,-0.13258799010224964
14039,51035,Carroll,Virginia,2000,3638,7142,221,11001,0.33069720934460506,0.6492137078447414,0.020089082810653577,0,0,0,0,0.0,0.0,0.0,-3504,0,-0.31851649850013636,0.0
14040,51035,Carroll,Virginia,2004,3888,8173,67,12128,0.32058047493403696,0.6738951187335093,0.005524406332453826,250,-154,1031,1127,-0.010116734410568096,-0.014564676478199751,0.024681410888767852,-4285,-781,-0.3533146437994723,-0.03479814529933595
14041,51035,Carroll,Virginia,2008,4109,8187,283,12579,0.3266555370061213,0.6508466491772001,0.02249781381667859,221,216,14,451,0.0060750620720843584,0.016973407484224767,-0.023048469556309126,-4078,207,-0.3241911121710788,0.029123531628393484
14042,51035,Carroll,Virginia,2012,3685,8736,497,12918,0.2852608762966403,0.6762656758012077,0.038473447902152035,-424,214,549,339,-0.041394660709481,0.015975634085473443,0.025419026624007524,-5051,-973,-0.39100479950456735,-0.06681368733348853
14043,51035,Carroll,Virginia,2016,2559,10663,433,13655,0.1874038813621384,0.780886122299524,0.031709996338337605,-1126,-64,1927,737,-0.09785699493450192,-0.006763451563814429,0.10462044649831637,-8104,-3053,-0.5934822409373857,-0.20247744143281832
14044,51036,Charles City,Virginia,2000,1981,1023,62,3066,0.6461187214611872,0.3336594911937378,0.020221787345075015,0,0,0,0,0.0,0.0,0.0,958,0,0.31245923026744943,0.0
14045,51036,Charles City,Virginia,2004,2155,1254,30,3439,0.6266356498982262,0.36464088397790057,0.008723466123873218,174,-32,231,373,-0.01948307156296103,-0.011498321221201797,0.030981392784162787,901,-57,0.2619947659203256,-0.050464464347123816
14046,51036,Charles City,Virginia,2008,2838,1288,27,4153,0.6833614254755599,0.31013725018059235,0.006501324343847821,683,-3,34,714,0.056725775577333715,-0.002222141780025397,-0.054503633797308215,1550,649,0.37322417529496754,0.11122940937464193
14047,51036,Charles City,Virginia,2012,2772,1396,64,4232,0.6550094517958412,0.32986767485822305,0.015122873345935728,-66,37,108,79,-0.028351973679718645,0.008621549002087907,0.019730424677630698,1376,-174,0.3251417769376182,-0.04808239835734934
14048,51036,Charles City,Virginia,2016,2496,1476,135,4107,0.6077428780131483,0.3593864134404675,0.03287070854638422,-276,71,80,-125,-0.047266573782692944,0.017747835200448495,0.029518738582244464,1020,-356,0.2483564645726808,-0.07678531236493741
14049,51037,Charlotte,Virginia,2000,2017,2855,122,4994,0.4038846615939127,0.5716860232278734,0.024429315178213857,0,0,0,0,0.0,0.0,0.0,-838,0,-0.16780136163396075,0.0
14050,51037,Charlotte,Virginia,2004,2223,3166,49,5438,0.4087899963221773,0.5821993379919088,0.00901066568591394,206,-73,311,444,0.004905334728264599,-0.015418649492299917,0.010513314764035386,-943,-105,-0.17340934166973154,-0.005607980035770788
14051,51037,Charlotte,Virginia,2008,2705,3372,80,6157,0.4393373396134481,0.5476693194737697,0.0129933409127822,482,31,206,719,0.030547343291270845,0.00398267522686826,-0.03453001851813908,-667,276,-0.10833197986032161,0.06507736180940993
14052,51037,Charlotte,Virginia,2012,2503,3311,84,5898,0.42438114615123773,0.5613767378772465,0.014242115971515769,-202,4,-61,-259,-0.014956193462210388,0.001248775058733569,0.013707418403476779,-808,-141,-0.13699559172600878,-0.028663611865687166
14053,51037,Charlotte,Virginia,2016,2155,3479,173,5807,0.3711038401928707,0.599104529016704,0.02979163079042535,-348,89,168,-91,-0.05327730595836705,0.015549514818909581,0.037727791139457456,-1324,-516,-0.2280006888238333,-0.0910050970978245
14054,51041,Chesterfield,Virginia,2000,38638,69924,2389,110951,0.3482438193436742,0.6302241530044794,0.021532027651846312,0,0,0,0,0.0,0.0,0.0,-31286,0,-0.2819803336608052,0.0
14055,51041,Chesterfield,Virginia,2004,49346,83745,723,133814,0.3687656000119569,0.6258313778827328,0.005403022105310356,10708,-1666,13821,22863,0.020521780668282696,-0.016129005546535957,-0.004392775121746628,-34399,-3113,-0.2570657778707759,0.024914555790029325
14056,51041,Chesterfield,Virginia,2008,74310,86413,1365,162088,0.4584546666008588,0.5331239820344504,0.008421351364690785,24964,642,2668,28274,0.08968906658890191,0.0030183292593804287,-0.09270739584828236,-12103,22296,-0.07466931543359162,0.18239646243718427
14057,51041,Chesterfield,Virginia,2012,77694,90934,2360,170988,0.45438276370271596,0.5318150981355417,0.013802138161742344,3384,995,4521,8900,-0.004071902898142854,0.005380786797051559,-0.0013088838989087082,-13240,-1137,-0.07743233443282577,-0.002763018999234146
14058,51041,Chesterfield,Virginia,2016,81074,85045,10243,176362,0.459702203422506,0.48221839171703657,0.05807940486045747,3380,7883,-5889,5374,0.005319439719790042,0.04427726669871512,-0.049596706418505165,-3971,9269,-0.02251618829453056,0.05491614613829521
14059,51043,Clarke,Virginia,2000,2166,2883,235,5284,0.4099167297501892,0.5456093868281605,0.04447388342165026,0,0,0,0,0.0,0.0,0.0,-717,0,-0.1356926570779713,0.0
14060,51043,Clarke,Virginia,2004,2699,3741,65,6505,0.4149116064565719,0.5750960799385089,0.009992313604919293,533,-170,858,1221,0.004994876706382656,-0.03448156981673097,0.02948669311034835,-1042,-325,-0.16018447348193698,-0.024491816403965694
14061,51043,Clarke,Virginia,2008,3457,3840,134,7431,0.46521329565334407,0.5167541380702463,0.018032566276409635,758,69,99,926,0.05030168919677219,0.008040252671490342,-0.05834194186826258,-383,659,-0.05154084241690221,0.10864363106503477
14062,51043,Clarke,Virginia,2012,3239,4296,227,7762,0.4172893584127802,0.5534656016490596,0.02924503993816027,-218,93,456,331,-0.047923937240563874,0.011212473661750634,0.036711463578813275,-1057,-674,-0.13617624323627936,-0.08463540081937715
14063,51043,Clarke,Virginia,2016,3051,4661,501,8213,0.37148423231462313,0.5675149153780592,0.061000852307317666,-188,274,365,451,-0.04580512609815707,0.031755812369157393,0.014049313728999646,-1610,-553,-0.19603068306343607,-0.059854439827156714
14064,51045,Craig,Virginia,2000,851,1580,62,2493,0.34135579622944245,0.6337745687926193,0.02486963497793823,0,0,0,0,0.0,0.0,0.0,-729,0,-0.29241877256317683,0.0
14065,51045,Craig,Virginia,2004,901,1706,14,2621,0.3437619229301793,0.6508966043494849,0.00534147272033575,50,-48,126,128,0.002406126700736866,-0.01952816225760248,0.017122035556865645,-805,-76,-0.3071346814193056,-0.014715908856128779
14066,51045,Craig,Virginia,2008,877,1695,49,2621,0.3346051125524609,0.646699732926364,0.018695154521175122,-24,35,-11,0,-0.009156810377718427,0.013353681800839373,-0.004196871423120974,-818,-13,-0.31209462037390306,-0.004959938954597454
14067,51045,Craig,Virginia,2012,830,1757,80,2667,0.31121109861267343,0.6587926509186351,0.029996250468691414,-47,31,62,46,-0.02339401393978746,0.011301095947516292,0.01209291799227119,-927,-109,-0.3475815523059617,-0.03548693193205865
14068,51045,Craig,Virginia,2016,541,2140,110,2791,0.19383733428878538,0.7667502687208886,0.039412396990326046,-289,30,383,124,-0.11737376432388805,0.009416146521634632,0.10795761780225344,-1599,-672,-0.5729129344321032,-0.2253313821261415
14069,51047,Culpeper,Virginia,2000,4364,7440,440,12244,0.3564194707611891,0.6076445606011107,0.0359359686377001,0,0,0,0,0.0,0.0,0.0,-3076,0,-0.2512250898399216,0.0
14070,51047,Culpeper,Virginia,2004,5476,10026,103,15605,0.3509131688561358,0.6424863825696892,0.006600448574174944,1112,-337,2586,3361,-0.005506301905053301,-0.029335520063525154,0.034841821968578435,-4550,-1474,-0.2915732137135533,-0.040348123873631736
14071,51047,Culpeper,Virginia,2008,8802,10711,228,19741,0.44587406919608935,0.5425763639126691,0.011549566891241578,3326,125,685,4136,0.09496090033995352,0.004949118317066634,-0.0999100186570201,-1909,2641,-0.0967022947165797,0.19487091899697362
14072,51047,Culpeper,Virginia,2012,8285,11580,346,20211,0.40992528820939095,0.5729553213596557,0.01711939043095344,-517,118,869,470,-0.0359487809866984,0.0055698235397118635,0.0303789574469866,-3295,-1386,-0.1630300331502647,-0.066327738433685
14073,51047,Culpeper,Virginia,2016,7759,13349,1110,22218,0.3492213520568908,0.6008191556395716,0.049959492303537675,-526,764,1769,2007,-0.06070393615250014,0.03284010187258424,0.0278638342799159,-5590,-2295,-0.25159780358268075,-0.08856777043241604
14074,51049,Cumberland,Virginia,2000,1405,1974,128,3507,0.4006273167949815,0.562874251497006,0.03649843170801255,0,0,0,0,0.0,0.0,0.0,-569,0,-0.1622469347020245,0.0
14075,51049,Cumberland,Virginia,2004,1721,2377,28,4126,0.4171110033931168,0.5761027629665536,0.0067862336403296175,316,-100,403,619,0.016483686598135316,-0.02971219806768293,0.013228511469547621,-656,-87,-0.1589917595734368,0.003255175128587695
14076,51049,Cumberland,Virginia,2008,2255,2418,51,4724,0.4773497036409822,0.5118543607112617,0.010795935647756138,534,23,41,598,0.06023870024786543,0.004009702007426521,-0.06424840225529194,-163,493,-0.03450465707027944,0.12448710250315737
14077,51049,Cumberland,Virginia,2012,2422,2538,88,5048,0.47979397781299526,0.5027733755942948,0.017432646592709985,167,37,120,324,0.002444274172013039,0.006636710944953847,-0.009080985116966866,-116,47,-0.022979397781299538,0.011525259288979905
14078,51049,Cumberland,Virginia,2016,2036,2697,173,4906,0.415002038320424,0.5497350183448838,0.035262943334692216,-386,85,159,-142,-0.06479193949257128,0.01783029674198223,0.046961642750589006,-661,-545,-0.13473298002445983,-0.11175358224316029
14079,51051,Dickenson,Virginia,2000,3951,3122,153,7226,0.5467755327982287,0.4320509272073069,0.021173539994464433,0,0,0,0,0.0,0.0,0.0,829,0,0.11472460559092174,0.0
14080,51051,Dickenson,Virginia,2004,3761,3591,54,7406,0.5078314879827167,0.4848771266540643,0.007291385363219011,-190,-99,469,180,-0.03894404481551195,-0.013882154631245421,0.05282619944675737,170,-659,0.022954361328652417,-0.09177024426226932
14081,51051,Dickenson,Virginia,2008,3278,3324,151,6753,0.48541389012290836,0.49222567747667706,0.02236043240041463,-483,97,-267,-653,-0.022417597859808347,0.01506904703719562,0.007348550822612765,-46,-216,-0.006811787353768695,-0.029766148682421112
14082,51051,Dickenson,Virginia,2012,2473,4274,157,6904,0.3581981460023175,0.6190614136732329,0.022740440324449593,-805,6,950,151,-0.1272157441205909,0.0003800079240349613,0.1268357361965558,-1801,-1755,-0.2608632676709154,-0.2540514803171467
14083,51051,Dickenson,Virginia,2016,1335,4932,173,6440,0.20729813664596272,0.7658385093167702,0.02686335403726708,-1138,16,658,-464,-0.15090000935635475,0.004122913712817488,0.14677709564353736,-3597,-1796,-0.5585403726708075,-0.2976771049998921
14084,51053,Dinwiddie,Virginia,2000,4001,4959,176,9136,0.4379378283712785,0.5427977232924693,0.01926444833625219,0,0,0,0,0.0,0.0,0.0,-958,0,-0.10485989492119085,0.0
14085,51053,Dinwiddie,Virginia,2004,4569,6193,77,10839,0.42153335178522006,0.5713626718331949,0.007103976381585017,568,-99,1234,1703,-0.016404476586058425,-0.012160471954667173,0.028564948540725554,-1624,-666,-0.14982932004797483,-0.04496942512678398
14086,51053,Dinwiddie,Virginia,2008,6246,6526,120,12892,0.4844865032578343,0.5062053986968663,0.00930809804529941,1677,43,333,2053,0.06295315147261427,0.002204121663714394,-0.06515727313632858,-280,1344,-0.021718895439031993,0.12811042460894284
14087,51053,Dinwiddie,Virginia,2012,6550,6875,164,13589,0.4820075060710869,0.5059239090440798,0.012068584884833321,304,44,349,697,-0.0024789971867474336,0.0027604868395339106,-0.00028148965278651517,-325,-45,-0.023916402972992912,-0.0021975075339609185
14088,51053,Dinwiddie,Virginia,2016,5765,7447,363,13575,0.42467771639042357,0.5485819521178638,0.026740331491712708,-785,199,572,-14,-0.05732978968066332,0.014671746606879386,0.04265804307378396,-1682,-1357,-0.12390423572744019,-0.09998783275444728
14089,51057,Essex,Virginia,2000,1750,1995,86,3831,0.45679979117723835,0.5207517619420516,0.02244844688071,0,0,0,0,0.0,0.0,0.0,-245,0,-0.06395197076481329,0.0
14090,51057,Essex,Virginia,2004,2007,2304,33,4344,0.4620165745856354,0.5303867403314917,0.007596685082872928,257,-53,309,513,0.005216783408397041,-0.01485176179783707,0.009634978389440052,-297,-52,-0.0683701657458563,-0.004418194981043011
14091,51057,Essex,Virginia,2008,2934,2379,51,5364,0.5469798657718121,0.44351230425055926,0.009507829977628635,927,18,75,1020,0.08496329118617674,0.001911144894755707,-0.08687443608093243,555,852,0.10346756152125286,0.17183772726710916
14092,51057,Essex,Virginia,2012,3016,2602,57,5675,0.5314537444933921,0.4585022026431718,0.010044052863436124,82,6,223,311,-0.015526121278420013,0.0005362228858074893,0.014989898392612555,414,-141,0.07295154185022029,-0.030516019671032568
14093,51057,Essex,Virginia,2016,2542,2657,173,5372,0.47319434102755026,0.49460163812360386,0.03220402084884587,-474,116,55,-303,-0.05825940346584185,0.022159967985409743,0.03609943548043204,-115,-529,-0.0214072970960536,-0.09435883894627389
14094,51059,Fairfax,Virginia,2000,196501,202181,15093,413775,0.4748981934626307,0.48862546069723883,0.03647634584013051,0,0,0,0,0.0,0.0,0.0,-5680,0,-0.013727267234608154,0.0
14095,51059,Fairfax,Virginia,2004,245671,211980,3728,461379,0.5324711354439625,0.4594487395395109,0.008080125016526543,49170,-11365,9799,47604,0.05757294198133184,-0.028396220823603963,-0.02917672115772796,33691,39371,0.07302239590445164,0.0867496631390598
14096,51059,Fairfax,Virginia,2008,310359,200994,4901,516254,0.601175003002398,0.38933160808439254,0.009493388913209388,64688,1173,-10986,54875,0.0687038675584355,0.0014132638966828457,-0.07011713145511833,109365,75674,0.21184339491800547,0.13882099901355383
14097,51059,Fairfax,Virginia,2012,315273,206773,7241,529287,0.5956560429407863,0.3906632885372208,0.013680668521992794,4914,2340,5779,13033,-0.005518960061611677,0.004187279608783406,0.0013316804528282766,108500,-865,0.2049927544035655,-0.006850640514439954
14098,51059,Fairfax,Virginia,2016,355133,157710,38340,551183,0.644310510302386,0.28613001489523443,0.0695594748023796,39860,31099,-49063,21896,0.04865446736159962,0.05587880628038681,-0.10453327364198639,197423,88923,0.3581804954071515,0.153187741003586
14099,51061,Fauquier,Virginia,2000,8296,14456,729,23481,0.35330692900643074,0.6156466930709936,0.0310463779225757,0,0,0,0,0.0,0.0,0.0,-6160,0,-0.2623397640645629,0.0
14100,51061,Fauquier,Virginia,2004,10712,19011,192,29915,0.3580812301520976,0.6355005849908073,0.006418184857095103,2416,-537,4555,6434,0.004774301145666848,-0.024628193065480596,0.019853891919813682,-8299,-2139,-0.2774193548387097,-0.015079590774146834
14101,51061,Fauquier,Virginia,2008,14616,19227,376,34219,0.42713112598264125,0.5618808264414507,0.01098804757590812,3904,184,216,4304,0.06904989583054366,0.004569862718813018,-0.07361975854935665,-4611,3688,-0.1347497004588094,0.1426696543799003
14102,51061,Fauquier,Virginia,2012,13965,21034,556,35555,0.39277176205878217,0.5915904936014625,0.01563774433975531,-651,180,1807,1336,-0.034359363923859076,0.004649696763847189,0.029709667160011888,-7069,-2458,-0.19881873154268037,-0.06406903108387096
14103,51061,Fauquier,Virginia,2016,12971,22127,2362,37460,0.346262680192205,0.5906833956219968,0.06305392418579818,-994,1806,1093,1905,-0.04650908186657715,0.04741617984604287,-0.0009070979794657541,-9156,-2087,-0.24442071542979177,-0.0456019838871114
14104,51063,Floyd,Virginia,2000,1957,3423,359,5739,0.3410001742463844,0.5964453737584945,0.06255445199512111,0,0,0,0,0.0,0.0,0.0,-1466,0,-0.2554451995121101,0.0
14105,51063,Floyd,Virginia,2004,2488,4162,84,6734,0.3694683694683695,0.618057618057618,0.012474012474012475,531,-275,739,995,0.02846819522198507,-0.05008043952110863,0.021612244299123562,-1674,-208,-0.24858924858924858,0.006855950922861509
14106,51063,Floyd,Virginia,2008,2937,4441,138,7516,0.39076636508781265,0.5908728046833422,0.018360830228845132,449,54,279,782,0.021297995619443177,0.005886817754832657,-0.027184813374275807,-1504,170,-0.2001064395955296,0.048482808993718984
14107,51063,Floyd,Virginia,2012,2732,4673,239,7644,0.3574045002616431,0.6113291470434328,0.03126635269492412,-205,101,232,128,-0.03336186482616954,0.01290552246607899,0.02045634236009053,-1941,-437,-0.25392464678178966,-0.05381820718626007
14108,51063,Floyd,Virginia,2016,2300,5293,457,8050,0.2857142857142857,0.6575155279503105,0.056770186335403726,-432,218,620,406,-0.07169021454735741,0.025503833640479603,0.046186380906877766,-2993,-1052,-0.37180124223602484,-0.11787659545423518
14109,51065,Fluvanna,Virginia,2000,3431,4962,313,8706,0.394096025729382,0.5699517574086836,0.0359522168619343,0,0,0,0,0.0,0.0,0.0,-1531,0,-0.17585573167930163,0.0
14110,51065,Fluvanna,Virginia,2004,4415,6458,84,10957,0.40293876060965594,0.5893949073651547,0.007666332025189376,984,-229,1496,2251,0.008842734880273928,-0.02828588483674492,0.019443149956471006,-2043,-512,-0.1864561467554987,-0.010600415076197078
14111,51065,Fluvanna,Virginia,2008,6185,6420,130,12735,0.4856694149980369,0.5041224970553593,0.010208087946603848,1770,46,-38,1778,0.08273065438838095,0.002541755921414472,-0.08527241030979538,-235,1808,-0.01845308205732238,0.16800306469817633
14112,51065,Fluvanna,Virginia,2012,5893,6678,178,12749,0.4622323319476037,0.5238057886893089,0.013961879363087302,-292,48,258,14,-0.023437083050433183,0.003753791416483453,0.019683291633949662,-785,-550,-0.061573456741705224,-0.043120374684382845
14113,51065,Fluvanna,Virginia,2016,5760,7025,807,13592,0.42377869334902885,0.5168481459682166,0.05937316068275456,-133,629,347,843,-0.03845363859857487,0.04541128131966726,-0.006957642721092339,-1265,-480,-0.09306945261918775,-0.03149599587748253
14114,51067,Franklin,Virginia,2000,7145,11225,459,18829,0.3794678421583727,0.5961548674916353,0.024377290349992035,0,0,0,0,0.0,0.0,0.0,-4080,0,-0.21668702533326256,0.0
14115,51067,Franklin,Virginia,2004,8002,14048,173,22223,0.36007739729109484,0.6321378751743689,0.007784727534536291,857,-286,2823,3394,-0.019390444867277867,-0.016592562815455743,0.03598300768273366,-6046,-1966,-0.2720604778832741,-0.055373452550011526
14116,51067,Franklin,Virginia,2008,9618,15414,369,25401,0.37864650997992205,0.6068265028935869,0.014526987126491083,1616,196,1366,3178,0.018569112688827216,0.006742259591954792,-0.025311372280782063,-5796,250,-0.2281799929136648,0.04388048496960928
14117,51067,Franklin,Virginia,2012,9090,16718,899,26707,0.34036020518965066,0.6259782079604598,0.03366158684988954,-528,530,1304,1306,-0.0382863047902714,0.019134599723398458,0.019151705066872915,-7628,-1832,-0.2856180027708091,-0.05743800985714431
14118,51067,Franklin,Virginia,2016,7257,18569,1145,26971,0.269066775425457,0.6884802194950131,0.042453005079529864,-1833,246,1851,264,-0.07129342976419367,0.008791418229640323,0.06250201153455337,-11312,-3684,-0.41941344406955616,-0.13379544129874704
14119,51069,Frederick,Virginia,2000,7158,14574,660,22392,0.3196677384780279,0.6508574490889604,0.02947481243301179,0,0,0,0,0.0,0.0,0.0,-7416,0,-0.3311897106109325,0.0
14120,51069,Frederick,Virginia,2004,8853,19386,301,28540,0.3101962158374212,0.6792571829011913,0.010546601261387527,1695,-359,4812,6148,-0.009471522640606689,-0.018928211171624264,0.028399733812230932,-10533,-3117,-0.3690609670637701,-0.03787125645283762
14121,51069,Frederick,Virginia,2008,12961,20149,502,33612,0.38560633107223613,0.5994585267166488,0.014935142211115079,4108,201,763,5072,0.07541011523481495,0.004388540949727552,-0.07979865618454252,-7188,3345,-0.21385219564441266,0.15520877141935746
14122,51069,Frederick,Virginia,2012,12690,22858,846,36394,0.3486838489860966,0.628070561081497,0.02324558993240644,-271,344,2709,2782,-0.03692248208613952,0.008310447721291362,0.02861203436484816,-10168,-2980,-0.27938671209540034,-0.06553451645098768
14123,51069,Frederick,Virginia,2016,11932,26083,2425,40440,0.2950544015825915,0.6449802176063304,0.05996538081107814,-758,1579,3225,4046,-0.053629447403505115,0.0367197908786717,0.01690965652483345,-14151,-3983,-0.3499258160237389,-0.07053910392833856
14124,51071,Giles,Virginia,2000,3004,3574,242,6820,0.4404692082111437,0.5240469208211144,0.035483870967741936,0,0,0,0,0.0,0.0,0.0,-570,0,-0.08357771260997066,0.0
14125,51071,Giles,Virginia,2004,3047,4320,131,7498,0.4063750333422246,0.5761536409709256,0.017471325686849826,43,-111,746,678,-0.034094174868919136,-0.01801254528089211,0.052106720149811214,-1273,-703,-0.169778607628701,-0.08620089501873035
14126,51071,Giles,Virginia,2008,3192,4462,141,7795,0.40949326491340604,0.5724182168056446,0.018088518280949328,145,10,142,297,0.0031182315711814623,0.0006171925940995013,-0.003735424165280943,-1270,3,-0.1629249518922386,0.006853655736462405
14127,51071,Giles,Virginia,2012,2730,4660,168,7558,0.3612066684308018,0.6165652288965334,0.022228102672664726,-462,27,198,-237,-0.04828659648260425,0.004139584391715398,0.04414701209088878,-1930,-660,-0.25535856046573163,-0.09243360857349303
14128,51071,Giles,Virginia,2016,1950,5910,352,8212,0.23745737944471504,0.7196785192401364,0.04286410131514856,-780,184,1250,654,-0.12374928898608675,0.020635998642483836,0.10311329034360295,-3960,-2030,-0.48222113979542136,-0.22686257932968973
14129,51073,Gloucester,Virginia,2000,4553,8718,428,13699,0.33236002627929045,0.6363968172859332,0.03124315643477626,0,0,0,0,0.0,0.0,0.0,-4165,0,-0.30403679100664277,0.0
14130,51073,Gloucester,Virginia,2004,5105,11084,144,16333,0.3125573991305945,0.67862609441009,0.008816506459315497,552,-284,2366,2634,-0.01980262714869596,-0.022426649975460764,0.042229277124156805,-5979,-1814,-0.36606869527949554,-0.06203190427285277
14131,51073,Gloucester,Virginia,2008,6916,12089,217,19222,0.359796067006555,0.6289147851420248,0.011289147851420248,1811,73,1005,2889,0.04723866787596048,0.002472641392104751,-0.04971130926806522,-5173,806,-0.26911871813546984,0.0969499771440257
14132,51073,Gloucester,Virginia,2012,6764,12137,382,19283,0.35077529430067933,0.6294145101903231,0.019810195508997562,-152,165,48,61,-0.009020772705875646,0.008521047657577314,0.0004997250482983162,-5373,-200,-0.2786392158896438,-0.009520497754173962
14133,51073,Gloucester,Virginia,2016,5404,13096,1119,19619,0.27544727050308376,0.667516183291707,0.05703654620520924,-1360,737,959,336,-0.07532802379759557,0.03722635069621168,0.038101673101383904,-7692,-2319,-0.39206891278862327,-0.11342969689897947
14134,51075,Goochland,Virginia,2000,3197,5378,202,8777,0.36424746496525007,0.6127378375299077,0.0230146975048422,0,0,0,0,0.0,0.0,0.0,-2181,0,-0.24849037256465767,0.0
14135,51075,Goochland,Virginia,2004,3583,6668,87,10338,0.3465854130392726,0.644999032694912,0.008415554265815438,386,-115,1290,1561,-0.017662051925977473,-0.014599143239026762,0.03226119516500425,-3085,-904,-0.2984136196556394,-0.049923247090981726
14136,51075,Goochland,Virginia,2008,4813,7643,106,12562,0.3831396274478586,0.6084222257602293,0.008438146791912116,1230,19,975,2224,0.03655421440858603,2.2592526096678472e-05,-0.03657680693468268,-2830,255,-0.22528259831237069,0.07313102134326871
14137,51075,Goochland,Virginia,2012,4676,8448,191,13315,0.3511828764551258,0.6344723995493804,0.014344723995493804,-137,85,805,753,-0.03195675099273282,0.005906577203581688,0.026050173789151088,-3772,-942,-0.2832895230942546,-0.058006924781883906
14138,51075,Goochland,Virginia,2016,4889,8384,764,14037,0.3482937949704353,0.5972786207879176,0.05442758424164708,213,573,-64,722,-0.0028890814846905255,0.040082860246153276,-0.03719377876146279,-3495,277,-0.24898482581748232,0.03430469727677227
14139,51077,Grayson,Virginia,2000,2467,4236,149,6852,0.36004086398131935,0.6182136602451839,0.021745475773496788,0,0,0,0,0.0,0.0,0.0,-1769,0,-0.2581727962638645,0.0
14140,51077,Grayson,Virginia,2004,2430,4655,52,7137,0.34047919293820933,0.6522348325627014,0.007285974499089253,-37,-97,419,285,-0.019561671043110018,-0.014459501274407534,0.034021172317517556,-2225,-456,-0.3117556396244921,-0.053582843360627574
14141,51077,Grayson,Virginia,2008,2480,4540,200,7220,0.34349030470914127,0.628808864265928,0.027700831024930747,50,148,-115,83,0.00301111177093194,0.020414856525841494,-0.02342596829677346,-2060,165,-0.2853185595567867,0.0264370800677054
14142,51077,Grayson,Virginia,2012,2068,4801,252,7121,0.29040865047043957,0.6742030613677854,0.035388288161775035,-412,52,261,-99,-0.0530816542387017,0.007687457136844288,0.045394197101857436,-2733,-673,-0.38379441089734584,-0.09847585134055914
14143,51077,Grayson,Virginia,2016,1407,5592,286,7285,0.1931365820178449,0.7676046671242278,0.039258750857927245,-661,34,791,164,-0.09727206845259467,0.0038704626961522104,0.09340160575644241,-4185,-1452,-0.5744680851063829,-0.19067367420903708
14144,51079,Greene,Virginia,2000,1774,3375,263,5412,0.32779009608277904,0.6236141906873615,0.048595713229859575,0,0,0,0,0.0,0.0,0.0,-1601,0,-0.2958240946045824,0.0
14145,51079,Greene,Virginia,2004,2240,4570,129,6939,0.32281308545899984,0.6585963395301917,0.018590575010808474,466,-134,1195,1527,-0.004977010623779199,-0.0300051382190511,0.03498214884283024,-2330,-729,-0.33578325407119186,-0.03995915946660944
14146,51079,Greene,Virginia,2008,3174,4980,106,8260,0.3842615012106538,0.6029055690072639,0.012832929782082324,934,-23,410,1321,0.06144841575165394,-0.00575764522872615,-0.05569077052292781,-1806,524,-0.2186440677966101,0.11713918627458175
14147,51079,Greene,Virginia,2012,3290,5569,164,9023,0.3646237393328161,0.6172004876426909,0.018175773024492962,116,58,589,763,-0.019637761877837667,0.005342843242410638,0.014294918635426979,-2279,-473,-0.25257674830987475,-0.033932680513264646
14148,51079,Greene,Virginia,2016,2924,5945,738,9607,0.30436140314354115,0.6188196107005308,0.07681898615592797,-366,574,376,584,-0.060262336189274956,0.05864321313143501,0.0016191230578399551,-3021,-742,-0.31445820755698967,-0.06188145924711491
14149,51081,Greensville,Virginia,2000,2314,1565,27,3906,0.5924219150025601,0.40066564260112647,0.0069124423963133645,0,0,0,0,0.0,0.0,0.0,749,0,0.19175627240143367,0.0
14150,51081,Greensville,Virginia,2004,2514,1732,12,4258,0.5904180366369187,0.40676373884452793,0.0028182245185533112,200,-15,167,352,-0.0020038783656414205,-0.004094217877760053,0.006098096243401463,782,33,0.18365429779239079,-0.008101974609042883
14151,51081,Greensville,Virginia,2008,3122,1729,36,4887,0.6388377327603847,0.3537957847350113,0.007366482504604052,608,24,-3,629,0.04841969612346597,0.004548257986050741,-0.05296795410951666,1393,611,0.2850419480253734,0.10138765023298263
14152,51081,Greensville,Virginia,2012,3135,1766,25,4926,0.6364190012180267,0.35850588712951686,0.005075111652456354,13,-11,37,39,-0.0024187315423579436,-0.002291370852147698,0.004710102394505589,1369,-24,0.2779131140885099,-0.007128833936863532
14153,51081,Greensville,Virginia,2016,2558,1737,68,4363,0.5862938345175338,0.3981205592482237,0.015585606234242494,-577,43,-29,-563,-0.05012516670049294,0.010510494581786139,0.03961467211870684,821,-548,0.1881732752693101,-0.08973983881919978
14154,51083,Halifax,Virginia,2000,5963,7732,377,14072,0.4237492893689596,0.5494599204093235,0.026790790221716886,0,0,0,0,0.0,0.0,0.0,-1769,0,-0.12571063104036384,0.0
14155,51083,Halifax,Virginia,2004,6220,8363,73,14656,0.4243995633187773,0.5706195414847162,0.0049808951965065506,257,-304,631,584,0.0006502739498177035,-0.021809895025210337,0.02115962107539271,-2143,-374,-0.14621997816593885,-0.020509347125575006
14156,51083,Halifax,Virginia,2008,8126,8600,124,16850,0.4822551928783383,0.5103857566765578,0.007359050445103857,1906,51,237,2194,0.05785562955956097,0.0023781552485973067,-0.06023378480815833,-474,1669,-0.028130563798219543,0.1180894143677193
14157,51083,Halifax,Virginia,2012,7766,8694,232,16692,0.46525281572010546,0.5208483105679368,0.013898873711957823,-360,108,94,-158,-0.01700237715823283,0.006539823266853966,0.010462553891378956,-928,-454,-0.05559549484783133,-0.027464931049611785
14158,51083,Halifax,Virginia,2016,6897,9704,393,16994,0.40584912321996,0.5710250676709426,0.02312580910909733,-869,161,1010,302,-0.05940369250014549,0.009226935397139506,0.05017675710300584,-2807,-1879,-0.16517594445098266,-0.10958044960315133
14159,51085,Hanover,Virginia,2000,12044,28614,927,41585,0.28962366237826137,0.6880846459059757,0.022291691715762896,0,0,0,0,0.0,0.0,0.0,-16570,0,-0.39846098352771436,0.0
14160,51085,Hanover,Virginia,2004,13941,35404,266,49611,0.2810062284573986,0.7136320574066235,0.005361714135977908,1897,-661,6790,8026,-0.008617433920862783,-0.01692997757978499,0.025547411500647765,-21463,-4893,-0.4326258289492249,-0.03416484542151055
14161,51085,Hanover,Virginia,2008,18447,37344,457,56248,0.3279583274071967,0.6639169392689518,0.008124733323851515,4506,191,1940,6637,0.04695209894979813,0.0027630191878736075,-0.04971511813767171,-18897,2566,-0.3359586118617551,0.09666721708746984
14162,51085,Hanover,Virginia,2012,18294,39940,824,59058,0.3097632835517627,0.6762843306579972,0.013952385790240104,-153,367,2596,2810,-0.018195043855434023,0.005827652466388588,0.012367391389045412,-21646,-2749,-0.3665210471062345,-0.030562435244479436
14163,51085,Hanover,Virginia,2016,19382,39630,3711,62723,0.30900945426717474,0.631825646094734,0.05916489963809129,1088,2887,-310,3665,-0.000753829284587948,0.04521251384785119,-0.044458684563263184,-20248,1398,-0.3228161918275593,0.043704855278675236
14164,51087,Henrico,Virginia,2000,48645,62887,2720,114252,0.42576935195882787,0.5504236249693659,0.023807023071806183,0,0,0,0,0.0,0.0,0.0,-14242,0,-0.12465427301053805,0.0
14165,51087,Henrico,Virginia,2004,60864,71809,745,133418,0.4561903191473414,0.5382257266635686,0.005583954189089928,12219,-1975,8922,19166,0.03042096718851356,-0.018223068882716256,-0.012197898305797317,-10945,3297,-0.08203540751622718,0.042618865494310876
14166,51087,Henrico,Virginia,2008,86323,67381,1262,154966,0.5570447711110824,0.434811507040254,0.008143721848663578,25459,517,-4428,21548,0.10085445196374099,0.00255976765957365,-0.1034142196233146,18942,29887,0.1222332640708284,0.20426867158705558
14167,51087,Henrico,Virginia,2012,89594,70449,2198,162241,0.5522278585560987,0.43422439457350487,0.01354774687039651,3271,936,3068,7275,-0.004816912554983732,0.005404025021732931,-0.0005871124667491401,19145,203,0.11800346398259381,-0.004229800088234592
14168,51087,Henrico,Virginia,2016,93935,59857,9744,163536,0.5743995205948538,0.36601726836904414,0.059583211036102146,4341,7546,-10592,1295,0.02217166203875509,0.046035464165705635,-0.06820712620446073,34078,14933,0.20838225222580964,0.09037878824321582
14169,51089,Henry,Virginia,2000,8898,11870,695,21463,0.41457391790523224,0.5530447747286027,0.03238130736616503,0,0,0,0,0.0,0.0,0.0,-2972,0,-0.13847085682337046,0.0
14170,51089,Henry,Virginia,2004,9851,13358,249,23458,0.41994202404297043,0.5694432602949953,0.010614715662034275,953,-446,1488,1995,0.005368106137738193,-0.021766591704130752,0.016398485566392562,-3507,-535,-0.14950123625202483,-0.011030379428654369
14171,51089,Henry,Virginia,2008,11118,13758,339,25215,0.4409280190362879,0.5456276026174895,0.013444378346222486,1267,90,400,1757,0.02098599499331749,0.0028296626841882114,-0.02381565767750571,-2640,867,-0.10469958358120163,0.0448016526708232
14172,51089,Henry,Virginia,2012,10317,13984,662,24963,0.41329167167407765,0.5601890798381605,0.02651924848776189,-801,323,226,-252,-0.027636347362210267,0.013074870141539402,0.014561477220670915,-3667,-1027,-0.1468974081640828,-0.04219782458288118
14173,51089,Henry,Virginia,2016,8198,15208,685,24091,0.3402930554979038,0.6312730895355112,0.028433854966585032,-2119,23,1224,-872,-0.07299861617617387,0.0019146064788231436,0.07108400969735074,-7010,-3343,-0.2909800340376074,-0.1440826258735246
14174,51091,Highland,Virginia,2000,453,942,42,1437,0.31524008350730687,0.6555323590814196,0.029227557411273485,0,0,0,0,0.0,0.0,0.0,-489,0,-0.34029227557411273,0.0
14175,51091,Highland,Virginia,2004,522,982,16,1520,0.34342105263157896,0.6460526315789473,0.010526315789473684,69,-26,40,83,0.028180969124272093,-0.0187012416217998,-0.00947972750247228,-460,29,-0.30263157894736836,0.03766069662674437
14176,51091,Highland,Virginia,2008,590,930,34,1554,0.37966537966537967,0.5984555984555985,0.021879021879021878,68,18,-52,34,0.036244327033800705,0.011352706089548194,-0.04759703312334884,-340,120,-0.21879021879021882,0.08384136015714955
14177,51091,Highland,Virginia,2012,459,924,30,1413,0.3248407643312102,0.6539278131634819,0.021231422505307854,-131,-4,-6,-141,-0.05482461533416949,-0.0006475993737140237,0.05547221470788344,-465,-125,-0.32908704883227174,-0.11029683004205293
14178,51091,Highland,Virginia,2016,371,958,62,1391,0.26671459381739754,0.6887131560028756,0.04457225017972682,-88,32,34,-22,-0.058126170513812636,0.023340827674418963,0.03478534283939372,-587,-122,-0.4219985621854781,-0.09291151335320635
14179,51093,Isle of Wight,Virginia,2000,5162,7587,201,12950,0.39861003861003863,0.5858687258687258,0.015521235521235521,0,0,0,0,0.0,0.0,0.0,-2425,0,-0.18725868725868722,0.0
14180,51093,Isle of Wight,Virginia,2004,5871,9929,71,15871,0.36991997983743935,0.6256064520194065,0.00447356814315418,709,-130,2342,2921,-0.02869005877259928,-0.011047667378081341,0.03973772615068061,-4058,-1633,-0.2556864721819671,-0.06842778492327989
14181,51093,Isle of Wight,Virginia,2008,8573,11258,166,19997,0.4287143071460719,0.5629844476671501,0.008301245186778017,2702,95,1329,4126,0.058794327308632544,0.003827677043623837,-0.0626220043522564,-2685,1373,-0.13427014052107816,0.12141633166088894
14182,51093,Isle of Wight,Virginia,2012,8761,11802,264,20827,0.42065587938733373,0.5666682671532146,0.012675853459451674,188,98,544,830,-0.008058427758738163,0.0043746082726736565,0.0036838194860645546,-3041,-356,-0.14601238776588088,-0.011742247244802717
14183,51093,Isle of Wight,Virginia,2016,7881,12204,990,21075,0.37395017793594304,0.5790747330960854,0.04697508896797153,-880,726,402,248,-0.04670570145139069,0.034299235508519856,0.012406465942870759,-4323,-1282,-0.20512455516014233,-0.05911216739426145
14184,51095,James City,Virginia,2000,9090,14628,774,24492,0.37114159725624696,0.5972562469377756,0.031602155805977465,0,0,0,0,0.0,0.0,0.0,-5538,0,-0.2261146496815286,0.0
14185,51095,James City,Virginia,2004,11934,18949,207,31090,0.3838533290447089,0.6094885815374719,0.006658089417819235,2844,-567,4321,6598,0.012711731788461966,-0.02494406638815823,0.012232334599696304,-7015,-1477,-0.22563525249276295,0.0004793971887656623
14186,51095,James City,Virginia,2008,17352,20912,339,38603,0.4494987436209621,0.5417195554749631,0.008781700904074813,5418,132,1963,7513,0.06564541457625317,0.0021236114862555784,-0.06776902606250879,-3560,3455,-0.092220811854001,0.13341444063876196
14187,51095,James City,Virginia,2012,17879,22843,518,41240,0.4335354025218235,0.5539039767216295,0.012560620756547042,527,179,1931,2637,-0.015963341099138606,0.0037789198524722286,0.01218442124666641,-4964,-1404,-0.12036857419980601,-0.028147762345805016
14188,51095,James City,Virginia,2016,19105,21306,2758,43169,0.4425629502652366,0.4935486112719776,0.0638884384627858,1226,2240,-1537,1929,0.009027547743413133,0.05132781770623876,-0.06035536544965192,-2201,2763,-0.05098566100674096,0.06938291319306505
14189,51097,King and Queen,Virginia,2000,1387,1423,49,2859,0.4851346624693949,0.49772647778943685,0.01713885974116824,0,0,0,0,0.0,0.0,0.0,-36,0,-0.012591815320041944,0.0
14190,51097,King and Queen,Virginia,2004,1506,1737,43,3286,0.45830797321972,0.5286062081558125,0.013085818624467437,119,-6,314,427,-0.026826689249674907,-0.004053041116700804,0.030879730366375646,-231,-195,-0.0702982349360925,-0.05770641961605055
14191,51097,King and Queen,Virginia,2008,1918,1763,24,3705,0.5176788124156545,0.47584345479082324,0.006477732793522267,412,-19,26,419,0.0593708391959345,-0.00660808583094517,-0.05276275336498926,155,386,0.04183535762483126,0.11213359256092376
14192,51097,King and Queen,Virginia,2012,1745,1865,45,3655,0.4774281805745554,0.5102599179206566,0.012311901504787962,-173,21,102,-50,-0.040250631841099116,0.005834168711265695,0.034416463129833375,-120,-275,-0.03283173734610123,-0.07466709497093249
14193,51097,King and Queen,Virginia,2016,1468,2099,123,3690,0.3978319783197832,0.5688346883468834,0.03333333333333333,-277,78,234,35,-0.07959620225477221,0.02102143182854537,0.05857477042622683,-631,-511,-0.17100271002710027,-0.13817097268099904
14194,51099,King George,Virginia,2000,2070,3590,192,5852,0.3537252221462748,0.6134654818865345,0.032809295967190705,0,0,0,0,0.0,0.0,0.0,-1520,0,-0.2597402597402597,0.0
14195,51099,King George,Virginia,2004,2739,5124,58,7921,0.3457896730210832,0.6468880191894962,0.007322307789420527,669,-134,1534,2069,-0.007935549125191566,-0.025486988177770176,0.03342253730296174,-2385,-865,-0.301098346168413,-0.04135808642815331
14196,51099,King George,Virginia,2008,4473,5888,113,10474,0.4270574756540004,0.5621539049073897,0.01078861943860989,1734,55,764,2553,0.08126780263291716,0.0034663116491893634,-0.08473411428210653,-1415,970,-0.13509642925338933,0.1660019169150237
14197,51099,King George,Virginia,2012,4477,6604,244,11325,0.39532008830022075,0.5831346578366446,0.021545253863134658,4,131,716,851,-0.03173738735377962,0.010756634424524767,0.020980752929254942,-2127,-712,-0.1878145695364239,-0.052718140283034565
14198,51099,King George,Virginia,2016,4007,7341,702,12050,0.3325311203319502,0.6092116182572614,0.05825726141078838,-470,458,737,725,-0.06278896796827055,0.03671200754765372,0.0260769604206168,-3334,-1207,-0.27668049792531124,-0.08886592838888735
14199,51101,King William,Virginia,2000,2125,3547,97,5769,0.3683480672560236,0.6148379268504074,0.016814005893569076,0,0,0,0,0.0,0.0,0.0,-1422,0,-0.2464898595943838,0.0
14200,51101,King William,Virginia,2004,2436,4397,39,6872,0.35448195576251457,0.6398428405122235,0.005675203725261932,311,-58,850,1103,-0.013866111493509026,-0.011138802168307144,0.02500491366181612,-1961,-539,-0.28536088474970894,-0.038871025155325145
14201,51101,King William,Virginia,2008,3344,4966,78,8388,0.3986647591797806,0.5920362422508345,0.009298998569384835,908,39,569,1516,0.04418280341726605,0.003623794844122903,-0.047806598261389,-1622,339,-0.1933714830710539,0.09198940167865505
14202,51101,King William,Virginia,2012,3344,5466,113,8923,0.37476185139527063,0.6125742463297097,0.012663902275019612,0,35,500,535,-0.023902907784509986,0.003364903705634777,0.020538004078875183,-2122,-500,-0.23781239493443906,-0.04444091186338517
14203,51101,King William,Virginia,2016,2760,5975,411,9146,0.30177126612726873,0.6532910561994314,0.0449376776732998,-584,298,509,223,-0.0729905852680019,0.03227377539828019,0.040716809869721704,-3215,-1093,-0.35151979007216266,-0.1137073951377236
14204,51103,Lancaster,Virginia,2000,1937,3411,107,5455,0.3550870760769936,0.6252978918423465,0.019615032080659945,0,0,0,0,0.0,0.0,0.0,-1474,0,-0.27021081576535294,0.0
14205,51103,Lancaster,Virginia,2004,2477,3724,29,6230,0.3975922953451043,0.597752808988764,0.004654895666131621,540,-78,313,775,0.04250521926811074,-0.014960136414528324,-0.02754508285358248,-1247,227,-0.20016051364365972,0.07005030212169322
14206,51103,Lancaster,Virginia,2008,3235,3647,56,6938,0.4662727010665898,0.5256558085903719,0.00807149034303834,758,27,-77,708,0.06868040572148548,0.0034165946769067184,-0.07209700039839217,-412,835,-0.059383107523782064,0.14077740611987766
14207,51103,Lancaster,Virginia,2012,3149,3753,59,6961,0.4523775319637983,0.5391466743284011,0.008475793707800603,-86,3,106,23,-0.013895169102791483,0.00040430336476226375,0.013490865738029267,-604,-192,-0.08676914236460281,-0.02738603484082075
14208,51103,Lancaster,Virginia,2016,2869,3523,253,6645,0.43175319789315275,0.5301730624529721,0.038073739653875095,-280,194,-230,-316,-0.020624334070645567,0.02959794594607449,-0.008973611875429,-654,-50,-0.09841986455981938,-0.011650722195216567
14209,51105,Lee,Virginia,2000,4031,4551,166,8748,0.46079103795153176,0.5202331961591221,0.018975765889346137,0,0,0,0,0.0,0.0,0.0,-520,0,-0.059442158207590357,0.0
14210,51105,Lee,Virginia,2004,4005,5664,101,9770,0.40992835209826,0.5797338792221085,0.010337768679631525,-26,-65,1113,1022,-0.05086268585327175,-0.008637997209714612,0.05950068306298639,-1659,-1139,-0.1698055271238485,-0.11036336891625814
14211,51105,Lee,Virginia,2008,3219,5825,183,9227,0.3488674542104693,0.6312994472743036,0.019833098515227052,-786,82,161,-543,-0.06106089788779073,0.009495329835595527,0.05156556805219514,-2606,-947,-0.2824319930638344,-0.11262646593998588
14212,51105,Lee,Virginia,2012,2583,6847,168,9598,0.2691185663679933,0.7133777870389665,0.017503646593040215,-636,-15,1022,371,-0.07974888784247597,-0.002329451922186837,0.08207833976466283,-4264,-1658,-0.4442592206709732,-0.1618272276071388
14213,51105,Lee,Virginia,2016,1627,7543,229,9399,0.1731035216512395,0.8025321842749229,0.024364294073837642,-956,61,696,-199,-0.09601504471675382,0.006860647480797427,0.08915439723595642,-5916,-1652,-0.6294286626236834,-0.18516944195271018
14214,51107,Loudoun,Virginia,2000,30938,42453,2262,75653,0.4089461092091523,0.5611542172815355,0.029899673509312254,0,0,0,0,0.0,0.0,0.0,-11515,0,-0.15220810807238316,0.0
14215,51107,Loudoun,Virginia,2004,47271,60382,777,108430,0.4359586830213041,0.5568754034861201,0.007165913492575855,16333,-1485,17929,32777,0.027012573812151774,-0.0227337600167364,-0.004278813795415393,-13111,-1596,-0.120916720464816,0.03129138760756717
14216,51107,Loudoun,Virginia,2008,74845,63336,1278,139459,0.5366810317010734,0.4541549846191354,0.009163983679791193,27574,501,2954,31029,0.10072234867976931,0.001998070187215337,-0.10272041886698469,11509,24620,0.082526047081938,0.203442767546754
14217,51107,Loudoun,Virginia,2012,82479,75292,2289,160060,0.5153005123078845,0.4703986005248032,0.014300887167312258,7634,1011,11956,20601,-0.021380519393188857,0.005136903487521065,0.016243615905667808,7187,-4322,0.04490191178308134,-0.037624135298856665
14218,51107,Loudoun,Virginia,2016,100795,69949,12306,183050,0.5506419011199126,0.38213056541928436,0.06722753346080305,18316,10017,-5343,22990,0.035341388812028085,0.052926646293490795,-0.08826803510551884,30846,23659,0.16851133570062826,0.12360942391754692
14219,51109,Louisa,Virginia,2000,4309,5461,326,10096,0.4268026941362916,0.5409072900158478,0.03229001584786054,0,0,0,0,0.0,0.0,0.0,-1152,0,-0.11410459587955618,0.0
14220,51109,Louisa,Virginia,2004,4844,7083,108,12035,0.402492729538845,0.5885334441213128,0.008973826339842127,535,-218,1622,1939,-0.02430996459744661,-0.02331618950801841,0.047626154105465,-2239,-1087,-0.1860407145824678,-0.07193611870291161
14221,51109,Louisa,Virginia,2008,6978,8182,193,15353,0.4545040057317788,0.5329251612062789,0.012570833061942292,2134,85,1099,3318,0.052011276192933775,0.003597006722100164,-0.055608282915033946,-1204,1035,-0.07842115547450007,0.10761955910796772
14222,51109,Louisa,Virginia,2012,6953,9215,284,16452,0.42262338925358617,0.5601142718210552,0.017262338925358618,-25,91,1033,1099,-0.031880616478192625,0.004691505863416327,0.027189110614776357,-2262,-1058,-0.13749088256746905,-0.05906972709296898
14223,51109,Louisa,Virginia,2016,6212,10528,872,17612,0.35271405859641153,0.5977742448330684,0.0495116965705201,-741,588,1313,1160,-0.06990933065717464,0.03224935764516148,0.03765997301201318,-4316,-2054,-0.24506018623665687,-0.10756930366918782
14224,51111,Lunenburg,Virginia,2000,2026,2510,55,4591,0.44129819211500765,0.5467218470921368,0.011979960792855586,0,0,0,0,0.0,0.0,0.0,-484,0,-0.10542365497712913,0.0
14225,51111,Lunenburg,Virginia,2004,2362,2858,25,5245,0.45033365109628215,0.5448999046711154,0.004766444232602479,336,-30,348,654,0.009035458981274502,-0.0072135165602531075,-0.0018219424210214052,-496,-12,-0.09456625357483323,0.010857401402295908
14226,51111,Lunenburg,Virginia,2008,2703,2900,47,5650,0.4784070796460177,0.5132743362831859,0.00831858407079646,341,22,42,405,0.028073428549735546,0.0035521398381939805,-0.031625568387929515,-197,299,-0.034867256637168165,0.05969899693766506
14227,51111,Lunenburg,Virginia,2012,2684,2969,81,5734,0.46808510638297873,0.5177886292291594,0.014126264387861876,-19,34,69,84,-0.010321973263038964,0.005807680317065416,0.004514292945973497,-285,-88,-0.049703522846180626,-0.01483626620901246
14228,51111,Lunenburg,Virginia,2016,2227,3204,155,5586,0.3986752595775152,0.5735767991407089,0.027747941281775868,-457,74,235,-148,-0.06940984680546353,0.013621676893913992,0.05578816991154956,-977,-692,-0.1749015395631937,-0.12519801671701308
14229,51113,Madison,Virginia,2000,1844,2940,243,5027,0.3668191764471852,0.5848418539884623,0.0483389695643525,0,0,0,0,0.0,0.0,0.0,-1096,0,-0.21802267754127713,0.0
14230,51113,Madison,Virginia,2004,2176,3556,40,5772,0.376992376992377,0.6160776160776161,0.00693000693000693,332,-203,616,745,0.010173200545191774,-0.04140896263434557,0.031235762089153796,-1380,-284,-0.23908523908523915,-0.021062561543962022
14231,51113,Madison,Virginia,2008,2862,3758,79,6699,0.4272279444693238,0.560979250634423,0.011792804896253173,686,39,202,927,0.050235567476946796,0.004862797966246243,-0.05509836544319313,-896,484,-0.13375130616509923,0.10533393292013993
14232,51113,Madison,Virginia,2012,2639,3869,106,6614,0.3990021167221046,0.5849712730571515,0.016026610220743878,-223,27,111,-85,-0.028225827747219157,0.004233805324490705,0.023992022422728465,-1230,-334,-0.18596915633504685,-0.05221785016994762
14233,51113,Madison,Virginia,2016,2203,4419,357,6979,0.3156612695228543,0.6331852700960023,0.05115346038114343,-436,251,550,365,-0.08334084719925033,0.03512685016039955,0.048213997038850875,-2216,-986,-0.31752400057314806,-0.1315548442381012
14234,51115,Mathews,Virginia,2000,1499,2951,159,4609,0.3252332393143849,0.6402690388370579,0.03449772184855717,0,0,0,0,0.0,0.0,0.0,-1452,0,-0.31503579952267297,0.0
14235,51115,Mathews,Virginia,2004,1589,3497,43,5129,0.3098069799181127,0.6818093195554689,0.008383700526418405,90,-116,546,520,-0.015426259396272235,-0.026114021322138768,0.04154028071841098,-1908,-456,-0.3720023396373562,-0.05696654011468322
14236,51115,Mathews,Virginia,2008,1934,3456,50,5440,0.35551470588235295,0.6352941176470588,0.009191176470588236,345,7,-41,311,0.045707725964240276,0.0008074759441698311,-0.046515201908410075,-1522,386,-0.27977941176470583,0.09222292787265035
14237,51115,Mathews,Virginia,2012,1807,3488,79,5374,0.3362486043915147,0.6490509862299962,0.01470040937848902,-127,29,32,-66,-0.01926610149083824,0.005509232907900785,0.013756868582937454,-1681,-159,-0.3128023818384815,-0.03302297007377569
14238,51115,Mathews,Virginia,2016,1563,3517,231,5311,0.29429485972509883,0.6622105064959518,0.04349463377894935,-244,152,29,-63,-0.04195374466641588,0.028794224400460325,0.013159520265955571,-1954,-273,-0.367915646770853,-0.05511326493237145
14239,51117,Mecklenburg,Virginia,2000,4797,6600,257,11654,0.4116183284709113,0.5663291573708598,0.022052514158228936,0,0,0,0,0.0,0.0,0.0,-1803,0,-0.15471082889994847,0.0
14240,51117,Mecklenburg,Virginia,2004,5293,7319,168,12780,0.4141627543035994,0.5726917057902974,0.013145539906103286,496,-89,719,1126,0.002544425832688102,-0.00890697425212565,0.006362548419437619,-2026,-223,-0.158528951486698,-0.003818122586749517
14241,51117,Mecklenburg,Virginia,2008,7127,7817,138,15082,0.47255005967378333,0.5182999602174778,0.009149980108738895,1834,-30,498,2302,0.05838730537018394,-0.003995559797364391,-0.05439174557281956,-690,1336,-0.04574990054369449,0.1127790509430035
14242,51117,Mecklenburg,Virginia,2012,6921,7973,183,15077,0.45904357630828413,0.528818730516681,0.012137693175034821,-206,45,156,-5,-0.0135064833654992,0.0029877130662959266,0.010518770299203228,-1052,-362,-0.06977515420839692,-0.02402525366470243
14243,51117,Mecklenburg,Virginia,2016,6285,8288,372,14945,0.420541987286718,0.5545667447306791,0.024891267982602876,-636,189,315,-132,-0.03850158902156614,0.012753574807568054,0.025748014213998083,-2003,-951,-0.13402475744396114,-0.06424960323556422
14244,51119,Middlesex,Virginia,2000,1671,2844,174,4689,0.3563659628918746,0.6065259117082533,0.037108125399872044,0,0,0,0,0.0,0.0,0.0,-1173,0,-0.2501599488163787,0.0
14245,51119,Middlesex,Virginia,2004,1914,3336,127,5377,0.35596057281011717,0.6204203087223359,0.02361911846754696,243,-47,492,688,-0.0004053900817574396,-0.013489006932325083,0.013894397014082571,-1422,-249,-0.2644597359122187,-0.01429978709584001
14246,51119,Middlesex,Virginia,2008,2391,3545,70,6006,0.3981018981018981,0.5902430902430903,0.011655011655011656,477,-57,209,629,0.04214132529178094,-0.011964106812535305,-0.030177218479245593,-1154,268,-0.19214119214119219,0.07231854377102653
14247,51119,Middlesex,Virginia,2012,2370,3619,91,6080,0.38980263157894735,0.5952302631578947,0.014967105263157894,-21,21,74,74,-0.008299266522950766,0.0033120936081462386,0.004987172914804439,-1249,-95,-0.2054276315789474,-0.013286439437755204
14248,51119,Middlesex,Virginia,2016,2108,3670,239,6017,0.35034070134618583,0.6099385075619079,0.039720791091906266,-262,148,51,-63,-0.03946193023276151,0.024753685828748373,0.014708244404013193,-1562,-313,-0.2595978062157221,-0.054170174636774704
14249,51121,Montgomery,Virginia,2000,11720,13991,1449,27160,0.43151693667157587,0.5151325478645066,0.053350515463917524,0,0,0,0,0.0,0.0,0.0,-2271,0,-0.0836156111929307,0.0
14250,51121,Montgomery,Virginia,2004,14128,17070,317,31515,0.4482944629541488,0.5416468348405521,0.010058702205299063,2408,-1132,3079,4355,0.016777526282572952,-0.04329181325861846,0.02651428697604552,-2942,-671,-0.09335237188640327,-0.009736760693472568
14251,51121,Montgomery,Virginia,2008,21031,19028,594,40653,0.5173295943718791,0.4680589378397658,0.014611467788355103,6903,277,1958,9138,0.06903513141773027,0.0045527655830560395,-0.07358789700078627,2003,4945,0.049270656532113266,0.14262302841851654
14252,51121,Montgomery,Virginia,2012,19903,20006,1100,41009,0.4853324879904411,0.4878441317759516,0.026823380233607256,-1128,506,978,356,-0.03199710638143799,0.012211912445252153,0.019785193936185774,-103,-2106,-0.002511643785510498,-0.051782300317623764
14253,51121,Montgomery,Virginia,2016,20021,19459,3551,43031,0.4652692245125607,0.4522088726731891,0.08252190281425019,118,2451,-547,2022,-0.0200632634778804,0.05569852258064294,-0.035635259102762495,562,665,0.013060351839371598,0.015571995624882096
14254,51125,Nelson,Virginia,2000,2907,2913,325,6145,0.4730675345809601,0.47404393816110657,0.05288852725793328,0,0,0,0,0.0,0.0,0.0,-6,0,-0.0009764035801464455,0.0
14255,51125,Nelson,Virginia,2004,3543,3539,57,7139,0.4962879955175795,0.4957276929541953,0.007984311528225242,636,-268,626,994,0.02322046093661939,-0.044904215729708034,0.021683754793088705,4,10,0.0005603025633842407,0.0015367061435306861
14256,51125,Nelson,Virginia,2008,4391,3647,95,8133,0.5398991761957457,0.44842001721382024,0.011680806590434033,848,38,108,994,0.04361118067816616,0.0036964950622087912,-0.04730767574037503,744,740,0.09147915898192543,0.0909188564185412
14257,51125,Nelson,Virginia,2012,4171,3947,132,8250,0.5055757575757576,0.4784242424242424,0.016,-220,37,300,117,-0.03432341861998811,0.004319193409565967,0.030004225210422175,224,-520,0.02715151515151515,-0.06432764383041029
14258,51125,Nelson,Virginia,2016,3689,4154,468,8311,0.44386957044880276,0.4998195163036939,0.05631091324750331,-482,336,207,61,-0.0617061871269548,0.040310913247503306,0.021395273879451504,-465,-689,-0.05594994585489116,-0.08310146100640631
14259,51127,New Kent,Virginia,2000,2055,3934,125,6114,0.3361138370951914,0.6434412823029113,0.020444880601897284,0,0,0,0,0.0,0.0,0.0,-1879,0,-0.30732744520771993,0.0
14260,51127,New Kent,Virginia,2004,2443,5414,89,7946,0.30745028945381325,0.6813491064686634,0.011200604077523282,388,-36,1480,1832,-0.02866354764137813,-0.009244276524374002,0.03790782416575211,-2971,-1092,-0.37389881701485017,-0.06657137180713024
14261,51127,New Kent,Virginia,2008,3493,6385,113,9991,0.3496146531878691,0.6390751676508858,0.01131017916124512,1050,24,971,2045,0.042164363734055854,0.0001095750837218374,-0.042273938817777634,-2892,79,-0.2894605144630167,0.08443830255183349
14262,51127,New Kent,Virginia,2012,3555,7246,152,10953,0.3245686113393591,0.6615539121701817,0.013877476490459235,62,39,861,962,-0.025046041848510003,0.0025672973292141157,0.02247874451929588,-3691,-799,-0.33698530083082257,-0.04752478636780588
14263,51127,New Kent,Virginia,2016,3546,8118,569,12233,0.2898716586283005,0.6636148123927083,0.046513528978991255,-9,417,872,1280,-0.034696952711058604,0.03263605248853202,0.002060900222526585,-4572,-881,-0.37374315376440775,-0.03675785293358519
14264,51131,Northampton,Virginia,2000,2340,2299,253,4892,0.4783319705641864,0.4699509403107114,0.05171708912510221,0,0,0,0,0.0,0.0,0.0,41,0,0.00838103025347503,0.0
14265,51131,Northampton,Virginia,2004,2775,2669,55,5499,0.5046372067648663,0.48536097472267686,0.01000181851245681,435,-198,370,607,0.026305236200679927,-0.0417152706126454,0.015410034411965479,106,65,0.01927623204218948,0.010895201788714448
14266,51131,Northampton,Virginia,2008,3800,2713,73,6586,0.5769814758578804,0.4119344063164288,0.011084117825690859,1025,18,44,1087,0.07234426909301406,0.0010822993132340482,-0.07342656840624806,1087,981,0.1650470695414516,0.14577083749926212
14267,51131,Northampton,Virginia,2012,3741,2676,74,6491,0.5763364658758281,0.41226313356955785,0.011400400554614082,-59,1,-37,-95,-0.0006450099820523025,0.0003162827289232232,0.0003287272531290464,1065,-22,0.16407333230627025,-0.0009737372351813489
14268,51131,Northampton,Virginia,2016,3255,2686,227,6168,0.5277237354085603,0.435473411154345,0.03680285343709468,-486,153,10,-323,-0.04861273046726777,0.0254024528824806,0.023210277584787165,569,-496,0.09225032425421531,-0.07182300805205494
14269,51133,Northumberland,Virginia,2000,2118,3362,125,5605,0.37787689562890275,0.599821587867975,0.02230151650312221,0,0,0,0,0.0,0.0,0.0,-1244,0,-0.22194469223907226,0.0
14270,51133,Northumberland,Virginia,2004,2548,3832,29,6409,0.3975659229208925,0.5979091902012794,0.004524886877828055,430,-96,470,804,0.019689027291989736,-0.017776629625294155,-0.0019123976666955977,-1284,-40,-0.20034326728038693,0.021601424958685334
14271,51133,Northumberland,Virginia,2008,3312,4041,53,7406,0.4472049689440994,0.5456386713475561,0.007156359708344585,764,24,209,997,0.0496390460232069,0.0026314728305165307,-0.05227051885372336,-729,555,-0.09843370240345667,0.10190956487693026
14272,51133,Northumberland,Virginia,2012,3191,4310,57,7558,0.42220164064567345,0.5702566816618153,0.007541677692511246,-121,4,269,152,-0.025003328298425942,0.00038531798416666097,0.024618010314259253,-1119,-390,-0.14805504101614186,-0.049621338612685195
14273,51133,Northumberland,Virginia,2016,2852,4302,243,7397,0.3855617142084629,0.5815871299175341,0.032851155874002974,-339,186,-8,-161,-0.036639926437210535,0.025309478181491728,0.011330448255718828,-1450,-331,-0.19602541570907123,-0.04797037469292936
14274,51135,Nottoway,Virginia,2000,2460,2870,162,5492,0.4479242534595776,0.5225782957028405,0.029497450837581936,0,0,0,0,0.0,0.0,0.0,-410,0,-0.07465404224326294,0.0
14275,51135,Nottoway,Virginia,2004,2635,3303,92,6030,0.4369817578772803,0.5477611940298508,0.015257048092868989,175,-70,433,538,-0.010942495582297318,-0.014240402744712947,0.02518289832701026,-668,-258,-0.11077943615257052,-0.03612539390930758
14276,51135,Nottoway,Virginia,2008,3413,3499,76,6988,0.4884087006296508,0.5007155123068117,0.010875787063537493,778,-16,196,958,0.05142694275237053,-0.0043812610293314964,-0.047045681723039134,-86,582,-0.012306811677160856,0.09847262447540966
14277,51135,Nottoway,Virginia,2012,3344,3409,93,6846,0.48846041484078295,0.49795501022494887,0.013584574934268186,-69,17,-90,-142,5.17142111321478e-05,0.002708787870730693,-0.0027605020818627923,-65,21,-0.009494595384165916,0.00281221629299494
14278,51135,Nottoway,Virginia,2016,2829,3712,203,6744,0.4194839857651246,0.5504151838671412,0.030100830367734283,-515,110,303,-102,-0.06897642907565837,0.016516255433466097,0.0524601736421923,-883,-818,-0.1309311981020166,-0.12143660271785067
14279,51137,Orange,Virginia,2000,4126,5991,366,10483,0.393589621291615,0.5714967089573595,0.03491366975102547,0,0,0,0,0.0,0.0,0.0,-1865,0,-0.17790708766574448,0.0
14280,51137,Orange,Virginia,2004,5015,7749,164,12928,0.38791769801980197,0.5993966584158416,0.012685643564356437,889,-202,1758,2445,-0.00567192327181304,-0.022228026186669036,0.027899949458482065,-2734,-869,-0.21147896039603958,-0.033571872730295105
14281,51137,Orange,Virginia,2008,7107,8506,188,15801,0.4497816593886463,0.5383203594709196,0.01189798114043415,2092,24,757,2873,0.06186396136884431,-0.0007876624239222859,-0.06107629894492195,-1399,1335,-0.08853870008227332,0.12294026031376626
14282,51137,Orange,Virginia,2012,6870,9244,240,16354,0.42008071419836124,0.5652439770086829,0.014675308792955852,-237,52,738,553,-0.029700945190285044,0.002777327652521701,0.02692361753776329,-2374,-975,-0.14516326281032166,-0.05662456272804833
14283,51137,Orange,Virginia,2016,5957,10521,789,17267,0.34499333989691316,0.6093125615335612,0.045694098569525686,-913,549,1277,913,-0.07508737430144807,0.031018789776569834,0.044068584524878274,-4564,-2190,-0.264319221636648,-0.11915595882632635
14284,51139,Page,Virginia,2000,2726,5089,181,7996,0.3409204602301151,0.6364432216108054,0.02263631815907954,0,0,0,0,0.0,0.0,0.0,-2363,0,-0.2955227613806903,0.0
14285,51139,Page,Virginia,2004,3324,6221,58,9603,0.34614183067791315,0.6478183900864313,0.006039779235655524,598,-123,1132,1607,0.005221370447798079,-0.016596538923424015,0.011375168475625919,-2897,-534,-0.3016765594085181,-0.006153798027827839
14286,51139,Page,Virginia,2008,4235,6041,113,10389,0.40764269900856676,0.5814804119742035,0.010876889017229762,911,55,-180,786,0.0615008683306536,0.004837109781574238,-0.06633797811222775,-1806,1091,-0.17383771296563677,0.12783884644288135
14287,51139,Page,Virginia,2012,3724,6344,160,10228,0.3640985529917872,0.6202581149784904,0.01564333202972233,-511,47,303,-161,-0.04354414601677953,0.00476644301249257,0.038777703004286845,-2620,-814,-0.25615956198670314,-0.08232184902106637
14288,51139,Page,Virginia,2016,2514,7831,395,10740,0.2340782122905028,0.7291433891992551,0.03677839851024209,-1210,235,1487,512,-0.13002034070128443,0.021135066480519757,0.10888527422076477,-5317,-2697,-0.49506517690875235,-0.2389056149220492
14289,51141,Patrick,Virginia,2000,2254,4901,230,7385,0.3052132701421801,0.663642518618822,0.03114421123899797,0,0,0,0,0.0,0.0,0.0,-2647,0,-0.35842924847664187,0.0
14290,51141,Patrick,Virginia,2004,2572,5507,136,8215,0.31308581862446744,0.6703590992087645,0.01655508216676811,318,-94,606,830,0.007872548482287356,-0.01458912907222986,0.006716580589942511,-2935,-288,-0.357273280584297,0.0011559678923448446
14291,51141,Patrick,Virginia,2008,2879,5491,161,8531,0.337475090845153,0.643652561247216,0.018872347907630992,307,25,-16,316,0.024389272220685543,0.002317265740862884,-0.026706537961548427,-2612,323,-0.30617747040206306,0.05109581018223397
14292,51141,Patrick,Virginia,2012,2417,5622,220,8259,0.29265044194212375,0.6807119505993462,0.02663760745853009,-462,59,131,-272,-0.04482464890302923,0.007765259550899097,0.037059389352130157,-3205,-593,-0.38806150865722244,-0.08188403825515939
14293,51141,Patrick,Virginia,2016,1768,6454,303,8525,0.2073900293255132,0.7570674486803519,0.0355425219941349,-649,83,832,266,-0.08526041261661055,0.00890491453560481,0.07635549808100572,-4686,-1481,-0.5496774193548387,-0.16161591069761627
14294,51143,Pittsylvania,Virginia,2000,7834,15760,661,24255,0.32298495155638013,0.6497629354772212,0.027252112966398682,0,0,0,0,0.0,0.0,0.0,-7926,0,-0.32677798392084106,0.0
14295,51143,Pittsylvania,Virginia,2004,9274,17673,470,27417,0.33825728562570667,0.6446000656526972,0.01714264872159609,1440,-191,1913,3162,0.015272334069326543,-0.010109464244802593,-0.0051628698245239635,-8399,-473,-0.30634278002699056,0.020435203893850507
14296,51143,Pittsylvania,Virginia,2008,11415,18730,288,30433,0.3750862550520816,0.6154503335195347,0.009463411428383663,2141,-182,1057,3016,0.036828969426374925,-0.007679237293212425,-0.02914973213316252,-7315,1084,-0.2403640784674531,0.06597870155953744
14297,51143,Pittsylvania,Virginia,2012,10858,19263,560,30681,0.35389980769857565,0.6278478537205436,0.018252338580880677,-557,272,533,248,-0.021186447353505944,0.008788927152497013,0.012397520201008927,-8405,-1090,-0.273948046021968,-0.03358396755451487
14298,51143,Pittsylvania,Virginia,2016,9199,21554,845,31598,0.29112602063421733,0.6821317804924363,0.026742198873346414,-1659,285,2291,917,-0.06277378706435832,0.008489860292465738,0.05428392677189264,-12355,-3950,-0.39100575985821895,-0.11705771383625097
14299,51145,Powhatan,Virginia,2000,2708,6820,183,9711,0.27885902584697764,0.7022963649469673,0.01884460920605499,0,0,0,0,0.0,0.0,0.0,-4112,0,-0.4234373390999897,0.0
14300,51145,Powhatan,Virginia,2004,3112,8955,96,12163,0.2558579297870591,0.7362492806051139,0.007892789607827017,404,-87,2135,2452,-0.023001096059918513,-0.010951819598227974,0.03395291565814651,-5843,-1731,-0.48039135081805473,-0.05695401171806502
14301,51145,Powhatan,Virginia,2008,4237,10088,131,14456,0.2930962921970116,0.697841726618705,0.009061981184283342,1125,35,1133,2293,0.037238362409952486,0.0011691915764563254,-0.03840755398640883,-5851,-8,-0.4047454344216934,0.07564591639636131
14302,51145,Powhatan,Virginia,2012,4088,11200,237,15525,0.26331723027375203,0.7214170692431562,0.015265700483091787,-149,106,1112,1069,-0.029779061923259575,0.006203719298808445,0.023575342624451157,-7112,-1261,-0.45809983896940415,-0.05335440454771073
14303,51145,Powhatan,Virginia,2016,4060,11885,943,16888,0.24040738986262436,0.7037541449549977,0.05583846518237802,-28,706,685,1363,-0.022909840411127674,0.04057276469928623,-0.01766292428815852,-7825,-713,-0.46334675509237333,-0.005246916122969181
14304,51147,Prince Edward,Virginia,2000,2922,3214,227,6363,0.4592173503064592,0.5051076536225051,0.03567499607103568,0,0,0,0,0.0,0.0,0.0,-292,0,-0.04589030331604588,0.0
14305,51147,Prince Edward,Virginia,2004,3632,3571,113,7316,0.49644614543466375,0.4881082558775287,0.015445598687807545,710,-114,357,953,0.03722879512820454,-0.020229397383228133,-0.016999397744976386,61,353,0.008337889557135048,0.054228192873180925
14306,51147,Prince Edward,Virginia,2008,5101,4174,113,9388,0.5433532168726033,0.4446101406050277,0.012036642522368982,1469,0,603,2072,0.04690707143793954,-0.0034089561654385633,-0.043498115272501026,927,866,0.09874307626757561,0.09040518671044057
14307,51147,Prince Edward,Virginia,2012,5132,3952,155,9239,0.5554713713605368,0.42775192120359345,0.016776707435869682,31,42,-222,-149,0.012118154487933519,0.004740064913500701,-0.016858219401434227,1180,253,0.12771945015694336,0.028976373889367746
14308,51147,Prince Edward,Virginia,2016,4591,4101,451,9143,0.5021327791753254,0.44853986656458494,0.04932735426008968,-541,296,149,-96,-0.05333859218521142,0.03255064682422,0.02078794536099149,490,-690,0.05359291261074045,-0.07412653754620291
14309,51149,Prince George,Virginia,2000,4182,6579,139,10900,0.3836697247706422,0.6035779816513761,0.012752293577981652,0,0,0,0,0.0,0.0,0.0,-2397,0,-0.2199082568807339,0.0
14310,51149,Prince George,Virginia,2004,5066,8131,57,13254,0.38222423419345103,0.6134751773049646,0.004300588501584427,884,-82,1552,2354,-0.0014454905771911775,-0.008451705076397226,0.009897195653588486,-3065,-668,-0.23125094311151356,-0.011342686230779664
14311,51149,Prince George,Virginia,2008,7130,8752,124,16006,0.4454579532675247,0.5467949518930401,0.007747094839435212,2064,67,621,2752,0.06323371907407366,0.003446506337850785,-0.06668022541192453,-1622,1443,-0.10133699862551537,0.1299139444859982
14312,51149,Prince George,Virginia,2012,6991,8879,176,16046,0.4356849058955503,0.5533466284432257,0.01096846566122398,-139,52,127,40,-0.009773047371974375,0.0032213708217887684,0.0065516765501856256,-1888,-266,-0.11766172254767537,-0.01632472392216
14313,51149,Prince George,Virginia,2016,6419,9157,608,16184,0.39662629757785467,0.5658057340583292,0.037567968363816116,-572,432,278,138,-0.03905860831769564,0.026599502702592134,0.01245910561510355,-2738,-850,-0.16917943648047457,-0.05151771393279919
14314,51153,Prince William,Virginia,2000,44745,52788,2978,100511,0.4451751549581638,0.5251962471769259,0.02962859786491031,0,0,0,0,0.0,0.0,0.0,-8043,0,-0.08002109221876214,0.0
14315,51153,Prince William,Virginia,2004,61271,69776,1016,132063,0.4639528104010964,0.5283538917032022,0.007693297895701294,16526,-1962,16988,31552,0.01877765544293264,-0.021935299969209017,0.0031576445262763153,-8505,-462,-0.06440108130210581,0.015620010916656324
14316,51153,Prince William,Virginia,2008,93435,67621,1390,162446,0.5751757507110055,0.416267559681371,0.008556689607623456,32164,374,-2155,30383,0.11122294030990904,0.0008633917119221617,-0.11208633202183121,25814,34319,0.15890819102963444,0.22330927233174025
14317,51153,Prince William,Virginia,2012,103331,74458,2406,180195,0.5734398845694941,0.41320791364910237,0.01335220178140348,9896,1016,6837,17749,-0.001735866141511333,0.004795512173780023,-0.003059646032268659,28873,3059,0.16023197092039176,0.0013237798907573262
14318,51153,Prince William,Virginia,2016,113144,71721,11577,196442,0.5759664430213498,0.3651001313364759,0.058933425642174284,9813,9171,-2737,16247,0.002526558451855676,0.045581223860770806,-0.04810778231262647,41423,12550,0.2108663116848739,0.050634340764482144
14319,51155,Pulaski,Virginia,2000,5255,7089,353,12697,0.4138772938489407,0.5583208631960306,0.027801842955028747,0,0,0,0,0.0,0.0,0.0,-1834,0,-0.1444435693470899,0.0
14320,51155,Pulaski,Virginia,2004,5310,8769,172,14251,0.3726054311978107,0.6153252403340117,0.012069328468177671,55,-181,1680,1554,-0.041271862651129976,-0.015732514486851076,0.05700437713798112,-3459,-1625,-0.242719809136201,-0.0982762397891111
14321,51155,Pulaski,Virginia,2008,5918,8857,275,15050,0.39322259136212623,0.5885049833887043,0.018272425249169437,608,103,88,799,0.02061716016431553,0.006203096780991766,-0.02682025694530743,-2939,520,-0.19528239202657804,0.04743741710962296
14322,51155,Pulaski,Virginia,2012,5292,8920,468,14680,0.36049046321525885,0.6076294277929155,0.03188010899182561,-626,193,63,-370,-0.03273212814686738,0.013607683742656175,0.019124444404211238,-3628,-689,-0.24713896457765666,-0.05185657255107862
14323,51155,Pulaski,Virginia,2016,4172,10322,671,15165,0.27510715463237717,0.6806462248598747,0.0442466205077481,-1120,203,1402,485,-0.08538330858288168,0.012366511515922489,0.07301679706695918,-6150,-2522,-0.4055390702274975,-0.15840010564984086
14324,51157,Rappahannock,Virginia,2000,1462,1850,201,3513,0.4161685169370908,0.5266154284087674,0.05721605465414176,0,0,0,0,0.0,0.0,0.0,-388,0,-0.11044691147167662,0.0
14325,51157,Rappahannock,Virginia,2004,1837,2172,41,4050,0.45358024691358023,0.5362962962962963,0.010123456790123457,375,-160,322,537,0.03741172997648945,-0.0470925978640183,0.009680867887528866,-335,53,-0.08271604938271604,0.027730862088960584
14326,51157,Rappahannock,Virginia,2008,2105,2227,73,4405,0.4778660612939841,0.5055618615209989,0.016572077185017027,268,32,55,355,0.02428581438040389,0.00644862039489357,-0.03073443477529736,-122,213,-0.02769580022701479,0.05502024915570125
14327,51157,Rappahannock,Virginia,2012,1980,2311,66,4357,0.4544411292173514,0.5304108331420703,0.01514803764057838,-125,-7,84,-48,-0.02342493207663271,-0.0014240395444386472,0.02484897162107136,-331,-209,-0.07596970392471886,-0.04827390369770407
14328,51157,Rappahannock,Virginia,2016,1747,2539,197,4483,0.38969440107071157,0.5663618112870845,0.04394378764220388,-233,131,228,126,-0.06474672814663984,0.0287957500016255,0.035950978145014245,-792,-461,-0.17666741021637294,-0.10069770629165409
14329,51159,Richmond,Virginia,2000,1076,1784,89,2949,0.3648694472702611,0.6049508307900984,0.030179721939640556,0,0,0,0,0.0,0.0,0.0,-708,0,-0.24008138351983727,0.0
14330,51159,Richmond,Virginia,2004,1243,2082,36,3361,0.3698304076167807,0.6194584944956858,0.010711097887533471,167,-53,298,412,0.004960960346519605,-0.019468624052107086,0.014507663705587426,-839,-131,-0.2496280868789051,-0.00954670335906782
14331,51159,Richmond,Virginia,2008,1618,2092,35,3745,0.4320427236315087,0.558611481975968,0.009345794392523364,375,-1,10,384,0.062212316014727986,-0.0013653034950101076,-0.0608470125197178,-474,365,-0.1265687583444593,0.12305932853444579
14332,51159,Richmond,Virginia,2012,1574,2160,36,3770,0.41750663129973475,0.5729442970822282,0.009549071618037135,-44,1,68,25,-0.014536092331773942,0.00020327722551377082,0.014332815106260166,-586,-112,-0.1554376657824934,-0.028868907438034108
14333,51159,Richmond,Virginia,2016,1347,2213,101,3661,0.36793225894564324,0.6044796503687517,0.027588090685605027,-227,65,53,-109,-0.04957437235409151,0.018039019067567892,0.03153535328652357,-866,-280,-0.2365473914231085,-0.08110972564061508
14334,51161,Roanoke,Virginia,2000,16141,25740,936,42817,0.37697643459373614,0.6011630894270967,0.021860475979167154,0,0,0,0,0.0,0.0,0.0,-9599,0,-0.2241866548333606,0.0
14335,51161,Roanoke,Virginia,2004,16082,30596,295,46973,0.3423668916185894,0.6513529048602389,0.006280203521171737,-59,-641,4856,4156,-0.034609542975146734,-0.015580272457995419,0.05018981543314216,-14514,-4915,-0.3089860132416495,-0.0847993584082889
14336,51161,Roanoke,Virginia,2008,19812,30571,592,50975,0.38866110838646395,0.5997253555664541,0.011613536047081903,3730,297,-25,4002,0.04629421676787454,0.005333332525910167,-0.05162754929378477,-10759,3755,-0.21106424717999017,0.09792176606165931
14337,51161,Roanoke,Virginia,2012,18711,31624,882,51217,0.3653279184645723,0.617451236894,0.01722084464142765,-1101,290,1053,242,-0.02333318992189165,0.005607308594345746,0.017725881327545934,-12913,-2154,-0.25212331842942776,-0.041059071249437584
14338,51161,Roanoke,Virginia,2016,17200,31408,2881,51489,0.3340519334226728,0.6099943677290295,0.05595369884829769,-1511,1999,-216,272,-0.03127598504189949,0.038732854206870046,-0.00745686916497057,-14208,-1295,-0.2759424343063567,-0.02381911587692892
14339,51163,Rockbridge,Virginia,2000,2953,4522,352,7827,0.3772837613389549,0.5777437076785487,0.044972530982496484,0,0,0,0,0.0,0.0,0.0,-1569,0,-0.20045994633959374,0.0
14340,51163,Rockbridge,Virginia,2004,3627,5412,142,9181,0.39505500490142686,0.5894782703409215,0.015466724757651672,674,-210,890,1354,0.01777124356247195,-0.029505806224844812,0.011734562662372827,-1785,-216,-0.19442326543949462,0.006036680900099123
14341,51163,Rockbridge,Virginia,2008,4347,5732,116,10195,0.4263854830799412,0.5622363903874448,0.011378126532614026,720,-26,320,1014,0.03133047817851431,-0.004088598225037645,-0.02724187995347671,-1385,400,-0.1358509073075036,0.05857235813199102
14342,51163,Rockbridge,Virginia,2012,4088,5898,191,10177,0.4016900854868822,0.5795421047459959,0.018767809767121942,-259,75,166,-18,-0.024695397593059,0.007389683234507916,0.017305714358551105,-1810,-425,-0.1778520192591137,-0.042001111951610104
14343,51163,Rockbridge,Virginia,2016,3508,6680,607,10795,0.32496526169522927,0.618805002315887,0.05622973598888374,-580,416,782,618,-0.07672482379165291,0.037461926221761796,0.0392628975698911,-3172,-1362,-0.2938397406206577,-0.115987721361544
14344,51165,Rockingham,Virginia,2000,5834,17482,678,23994,0.24314411936317412,0.7285988163707594,0.028257064266066518,0,0,0,0,0.0,0.0,0.0,-11648,0,-0.48545469700758526,0.0
14345,51165,Rockingham,Virginia,2004,7273,21737,206,29216,0.24893893756845564,0.7440101314348302,0.007050930996714129,1439,-472,4255,5222,0.005794818205281521,-0.02120613326935239,0.015411315064070785,-14464,-2816,-0.49507119386637455,-0.009616496858789292
14346,51165,Rockingham,Virginia,2008,10453,22468,413,33334,0.31358372832543346,0.6740265194696106,0.012389752204955902,3180,207,731,4118,0.06464479075697782,0.0053388212082417725,-0.06998361196521963,-12015,2449,-0.3604427911441771,0.13462840272219745
14347,51165,Rockingham,Virginia,2012,10065,24186,615,34866,0.28867664773705043,0.6936843916709688,0.017638960591980727,-388,202,1718,1532,-0.024907080588383035,0.005249208387024825,0.019657872201358284,-14121,-2106,-0.4050077439339184,-0.04456495278974132
14348,51165,Rockingham,Virginia,2016,9366,25990,2131,37487,0.24984661349267745,0.6933070130978739,0.056846373409448606,-699,1516,1804,2621,-0.03883003424437298,0.03920741281746788,-0.00037737857309494416,-16624,-2503,-0.44346039960519645,-0.038452655671278035
14349,51167,Russell,Virginia,2000,5442,5065,285,10792,0.5042624166048925,0.4693291326908821,0.02640845070422535,0,0,0,0,0.0,0.0,0.0,377,0,0.03493328391401035,0.0
14350,51167,Russell,Virginia,2004,5167,6077,179,11423,0.45233301234351747,0.531996848463626,0.01567013919285652,-275,-106,1012,631,-0.05192940426137499,-0.010738311511368833,0.06266771577274394,-910,-1287,-0.07966383612010858,-0.11459712003411893
14351,51167,Russell,Virginia,2008,4932,6389,173,11494,0.42909344005568123,0.5558552288150339,0.015051331129284844,-235,-6,312,71,-0.02323957228783624,-0.0006188080635716742,0.02385838035140786,-1457,-547,-0.12676178875935268,-0.0470979526392441
14352,51167,Russell,Virginia,2012,3718,8180,190,12088,0.307577763070814,0.6767041694242224,0.0157180675049636,-1214,17,1791,594,-0.1215156769848672,0.0006667363756787566,0.1208489406091885,-4462,-3005,-0.3691264063534084,-0.2423646175940557
14353,51167,Russell,Virginia,2016,2330,9521,395,12246,0.19026620937448963,0.777478360280908,0.03225543034460232,-1388,205,1341,158,-0.1173115536963244,0.01653736283963872,0.1007741908566856,-7191,-2729,-0.5872121509064183,-0.21808574455300994
14354,51169,Scott,Virginia,2000,3552,5535,248,9335,0.3805034815211569,0.5929298339582217,0.026566684520621317,0,0,0,0,0.0,0.0,0.0,-1983,0,-0.2124263524370648,0.0
14355,51169,Scott,Virginia,2004,3324,6479,164,9967,0.33350055182100935,0.6500451489916725,0.01645429918731815,-228,-84,944,632,-0.04700292970014758,-0.010112385333303168,0.0571153150334508,-3155,-1172,-0.3165445971706632,-0.10411824473359838
14356,51169,Scott,Virginia,2008,2725,6980,170,9875,0.2759493670886076,0.7068354430379746,0.017215189873417722,-599,6,501,-92,-0.05755118473240173,0.0007608906860995732,0.05679029404630209,-4255,-1100,-0.430886075949367,-0.11434147877870382
14357,51169,Scott,Virginia,2012,2395,7439,158,9992,0.23969175340272217,0.7444955964771818,0.015812650120096076,-330,-12,459,117,-0.036257613685885454,-0.001402539753321646,0.037660153439207145,-5044,-789,-0.5048038430744596,-0.07391776712509257
14358,51169,Scott,Virginia,2016,1581,8247,272,10100,0.15653465346534653,0.8165346534653465,0.02693069306930693,-814,114,808,108,-0.08315709993737563,0.011118042949210854,0.0720390569881647,-6666,-1622,-0.6599999999999999,-0.15519615692554034
14359,51171,Shenandoah,Virginia,2000,4420,9636,396,14452,0.305840022142264,0.6667589261001937,0.02740105175754221,0,0,0,0,0.0,0.0,0.0,-5216,0,-0.3609189039579297,0.0
14360,51171,Shenandoah,Virginia,2004,5186,11820,140,17146,0.3024612154438353,0.6893736148372799,0.008165169718884872,766,-256,2184,2694,-0.0033788066984287157,-0.019235882038657337,0.022614688737086164,-6634,-1418,-0.3869123993934446,-0.02599349543551488
14361,51171,Shenandoah,Virginia,2008,6912,12005,306,19223,0.35956926598345734,0.6245123029704001,0.015918431046142642,1726,166,185,2077,0.057108050539622035,0.00775326132725777,-0.06486131186687982,-5093,1541,-0.2649430369869427,0.12196936240650186
14362,51171,Shenandoah,Virginia,2012,6469,12538,366,19373,0.33391833995767306,0.6471893872915914,0.01889227275073556,-443,60,533,150,-0.025650926025784282,0.0029738417045929166,0.02267708432119131,-6069,-976,-0.3132710473339183,-0.04832801034697559
14363,51171,Shenandoah,Virginia,2016,5273,14094,1141,20508,0.25711917300565634,0.68724400234055,0.05563682465379364,-1196,775,1556,1135,-0.07679916695201672,0.03674455190305808,0.040054615048958686,-8821,-2752,-0.4301248293348937,-0.1168537820009754
14364,51173,Smyth,Virginia,2000,4836,6580,324,11740,0.4119250425894378,0.5604770017035775,0.02759795570698467,0,0,0,0,0.0,0.0,0.0,-1744,0,-0.1485519591141397,0.0
14365,51173,Smyth,Virginia,2004,4143,7906,270,12319,0.336309765403036,0.6417728711746084,0.02191736342235571,-693,-54,1326,579,-0.07561527718640182,-0.0056805922846289575,0.08129586947103085,-3763,-2019,-0.3054631057715724,-0.15691114665743267
14366,51173,Smyth,Virginia,2008,4239,7817,246,12302,0.3445781173792879,0.6354251341245326,0.019996748496179485,96,-24,-89,-17,0.00826835197625192,-0.001920614926176227,-0.006347737050075741,-3578,185,-0.2908470167452447,0.014616089026327661
14367,51173,Smyth,Virginia,2012,4171,8379,227,12777,0.3264459575800266,0.6557877436017845,0.017766298818188933,-68,-19,562,475,-0.018132159799261305,-0.0022304496779905515,0.02036260947725188,-4208,-630,-0.3293417860217579,-0.038494769276513185
14368,51173,Smyth,Virginia,2016,2665,9750,475,12890,0.20674941815360745,0.756400310318076,0.036850271528316526,-1506,248,1371,113,-0.11969653942641914,0.019083972710127593,0.10061256671629148,-7085,-2877,-0.5496508921644685,-0.2203091061427106
14369,51175,Southampton,Virginia,2000,3359,3293,62,6714,0.5002978850163837,0.4904676794757224,0.009234435507893953,0,0,0,0,0.0,0.0,0.0,66,0,0.00983020554066133,0.0
14370,51175,Southampton,Virginia,2004,3431,4018,43,7492,0.4579551521623065,0.5363053924185798,0.005739455419113721,72,-19,725,778,-0.04234273285407725,-0.0034949800887802323,0.04583771294285738,-587,-653,-0.0783502402562733,-0.08818044579693463
14371,51175,Southampton,Virginia,2008,4402,4583,82,9067,0.48549685673320836,0.5054593581118342,0.009043785154957538,971,39,565,1575,0.02754170457090188,0.0033043297358438172,-0.030846034306745596,-181,406,-0.01996250137862582,0.05838773887764748
14372,51175,Southampton,Virginia,2012,4437,4733,94,9264,0.4789507772020725,0.5109024179620034,0.010146804835924008,35,12,150,197,-0.00654607953113584,0.0011030196809664692,0.005443059850169241,-296,-115,-0.0319516407599309,-0.01198913938130508
14373,51175,Southampton,Virginia,2016,3595,5035,242,8872,0.4052073940486925,0.5675157799819658,0.02727682596934175,-842,148,302,-392,-0.07374338315338003,0.017130021133417744,0.056613362019962366,-1440,-1144,-0.1623083859332733,-0.1303567451733424
14374,51177,Spotsylvania,Virginia,2000,13455,20739,827,35021,0.38419805259701323,0.5921875446160875,0.02361440278689929,0,0,0,0,0.0,0.0,0.0,-7284,0,-0.20798949201907424,0.0
14375,51177,Spotsylvania,Virginia,2004,16623,28527,295,45445,0.3657828143910221,0.6277258224227088,0.0064913631862691164,3168,-532,7788,10424,-0.018415238205991113,-0.01712303960063017,0.03553827780662133,-11904,-4620,-0.2619430080316867,-0.053953516012612446
14376,51177,Spotsylvania,Virginia,2008,24897,28610,562,54069,0.460467180824502,0.5291386931513437,0.010394126024154321,8274,267,83,8624,0.09468436643347988,0.0039027628378852045,-0.09858712927136515,-3713,8191,-0.06867151232684165,0.19327149570484503
14377,51177,Spotsylvania,Virginia,2012,25165,31844,965,57974,0.4340738951943975,0.5492807120433297,0.016645392762272743,268,403,3234,3905,-0.026393285630104513,0.006251266738118422,0.02014201889198608,-6679,-2966,-0.11520681684893225,-0.04653530452209059
14378,51177,Spotsylvania,Virginia,2016,24207,34623,3719,62549,0.387008585269149,0.5535340293210124,0.059457385409838685,-958,2754,2779,4575,-0.04706530992524849,0.04281199264756594,0.004253317277682633,-10416,-3737,-0.16652544405186337,-0.05131862720293112
14379,51179,Stafford,Virginia,2000,12596,20731,919,34246,0.3678093791975705,0.6053553699702156,0.02683525083221398,0,0,0,0,0.0,0.0,0.0,-8135,0,-0.23754599077264504,0.0
14380,51179,Stafford,Virginia,2004,17208,28500,278,45986,0.3742008437350498,0.6197538381246467,0.006045318140303571,4612,-641,7769,11740,0.006391464537479297,-0.020789932691910408,0.014398468154431132,-11292,-3157,-0.24555299438959688,-0.008007003616951835
14381,51179,Stafford,Virginia,2008,25716,29221,518,55455,0.46372734649715985,0.5269317464610945,0.009340907041745559,8508,240,721,9469,0.08952650276211005,0.0032955889014419882,-0.09282209166355215,-3505,7787,-0.06320439996393468,0.1823485944256622
14382,51179,Stafford,Virginia,2012,27182,32480,921,60583,0.4486737203505934,0.5361239951801661,0.015202284469240546,1466,403,3259,5128,-0.015053626146566468,0.0058613774274949865,0.009192248719071539,-5298,-1793,-0.08745027482957268,-0.024245874865638006
14383,51179,Stafford,Virginia,2016,27908,33868,4158,65934,0.4232717566050899,0.513665180331847,0.06306306306306306,726,3237,1388,5351,-0.025401963745503464,0.04786077859382251,-0.02245881484831902,-5960,-662,-0.09039342372675713,-0.0029431488971844444
14384,51181,Surry,Virginia,2000,1845,1313,72,3230,0.5712074303405573,0.4065015479876161,0.022291021671826627,0,0,0,0,0.0,0.0,0.0,532,0,0.1647058823529412,0.0
14385,51181,Surry,Virginia,2004,1954,1543,25,3522,0.5547984099943214,0.43810335036910847,0.007098239636570131,109,-47,230,292,-0.016409020346235925,-0.015192782035256496,0.03160180238149235,411,-121,0.11669505962521293,-0.048010822727728275
14386,51181,Surry,Virginia,2008,2626,1663,36,4325,0.6071676300578035,0.3845086705202312,0.008323699421965317,672,11,120,803,0.0523692200634821,0.0012254597853951863,-0.05359467984887728,963,552,0.2226589595375723,0.10596389991235938
14387,51181,Surry,Virginia,2012,2576,1671,61,4308,0.5979572887650882,0.387883008356546,0.014159702878365831,-50,25,8,-17,-0.009210341292715252,0.005836003456400514,0.0033743378363148002,905,-58,0.21007428040854226,-0.012584679129030052
14388,51181,Surry,Virginia,2016,2272,1819,137,4228,0.5373699148533586,0.4302270577105014,0.03240302743614002,-304,76,148,-80,-0.060587373911729636,0.01824332455777419,0.042344049353955415,453,-452,0.1071428571428572,-0.10293142326568505
14389,51183,Sussex,Virginia,2000,2006,1745,155,3906,0.5135688684075781,0.44674859190988225,0.03968253968253968,0,0,0,0,0.0,0.0,0.0,261,0,0.06682027649769584,0.0
14390,51183,Sussex,Virginia,2004,2420,1890,35,4345,0.5569620253164557,0.43498273878020716,0.00805523590333717,414,-120,145,439,0.04339315690887757,-0.03162730377920251,-0.011765853129675097,530,269,0.12197928653624851,0.05515901003855267
14391,51183,Sussex,Virginia,2008,3301,2026,36,5363,0.6155137050158493,0.3777736341599851,0.006712660824165579,881,1,136,1018,0.05855167969939368,-0.0013425750791715907,-0.05720910462022205,1275,745,0.23774007085586424,0.11576078431961573
14392,51183,Sussex,Virginia,2012,3358,2021,61,5440,0.6172794117647059,0.3715073529411765,0.011213235294117647,57,25,-5,77,0.0017657067488565659,0.004500574469952068,-0.0062662812188086225,1337,62,0.24577205882352943,0.008031987967665188
14393,51183,Sussex,Virginia,2016,2879,2055,110,5044,0.5707771609833465,0.40741475019825535,0.021808088818398096,-479,49,34,-396,-0.04650225078135939,0.010594853524280448,0.035907397257078866,824,-513,0.16336241078509117,-0.08240964803843825
14394,51185,Tazewell,Virginia,2000,7227,8655,462,16344,0.44218061674008813,0.5295521292217328,0.02826725403817915,0,0,0,0,0.0,0.0,0.0,-1428,0,-0.08737151248164465,0.0
14395,51185,Tazewell,Virginia,2004,7184,10039,257,17480,0.41098398169336386,0.5743135011441648,0.014702517162471396,-43,-205,1384,1136,-0.031196635046724264,-0.013564736875707754,0.044761371922432014,-2855,-1427,-0.16332951945080093,-0.07595800696915628
14396,51185,Tazewell,Virginia,2008,5596,11201,264,17061,0.3279995310943087,0.656526581091378,0.015473887814313346,-1588,7,1162,-419,-0.08298445059905518,0.0007713706518419506,0.08221307994721316,-5605,-2750,-0.3285270499970693,-0.16519753054626835
14397,51185,Tazewell,Virginia,2012,3661,13843,228,17732,0.20646289194676293,0.7806789984209339,0.012858109632303182,-1935,-36,2642,671,-0.12153663914754576,-0.0026157781820101648,0.12415241732955595,-10182,-4577,-0.574216106474171,-0.2456890564771017
14398,51185,Tazewell,Virginia,2016,2895,15168,503,18566,0.1559301949800711,0.8169772702790047,0.02709253474092427,-766,275,1325,834,-0.050532696966691826,0.01423442510862109,0.036298271858070774,-12273,-2091,-0.6610470752989336,-0.0868309688247626
14399,51187,Warren,Virginia,2000,4313,6335,518,11166,0.3862618663800824,0.5673473043166756,0.04639082930324198,0,0,0,0,0.0,0.0,0.0,-2022,0,-0.18108543793659315,0.0
14400,51187,Warren,Virginia,2004,5241,8600,227,14068,0.37254762581745804,0.6113164628945124,0.01613591128802957,928,-291,2265,2902,-0.01371424056262438,-0.03025491801521241,0.04396915857783679,-3359,-1337,-0.23876883707705432,-0.05768339914046117
14401,51187,Warren,Virginia,2008,6997,8879,250,16126,0.4338955723676051,0.5506015130844599,0.015502914547935011,1756,23,279,2058,0.06134794655014708,-0.0006329967400945605,-0.06071494981005243,-1882,1477,-0.1167059407168548,0.12206289636019951
14402,51187,Warren,Virginia,2012,6452,9869,377,16698,0.3863935800694694,0.5910288657324231,0.022577554198107558,-545,127,990,572,-0.04750199229813573,0.007074639650172547,0.040427352647963155,-3417,-1535,-0.2046352856629537,-0.08792934494609889
14403,51187,Warren,Virginia,2016,5169,11773,1009,17951,0.28795053200378806,0.6558409002283996,0.05620856776781238,-1283,632,1904,1253,-0.09844304806568133,0.03363101356970482,0.0648120344959765,-6604,-3187,-0.3678903682246115,-0.16325508256165783
14404,51191,Washington,Virginia,2000,7549,12064,609,20222,0.37330630006923154,0.5965779843734547,0.030115715557313818,0,0,0,0,0.0,0.0,0.0,-4515,0,-0.22327168430422312,0.0
14405,51191,Washington,Virginia,2004,7339,14749,426,22514,0.3259749489206716,0.6551034911610554,0.018921559918273073,-210,-183,2685,2292,-0.047331351148559964,-0.011194155639040745,0.05852550678760071,-7410,-2895,-0.3291285422403838,-0.10585685793616068
14406,51191,Washington,Virginia,2008,8063,16077,360,24500,0.32910204081632655,0.6562040816326531,0.014693877551020407,724,-66,1328,1986,0.0031270918956549654,-0.004227682367252666,0.0011005904715977177,-8014,-604,-0.32710204081632654,0.0020265014240572476
14407,51191,Washington,Virginia,2012,7076,18141,415,25632,0.2760611735330836,0.7077481273408239,0.016190699126092386,-987,55,2064,1132,-0.05304086728324292,0.0014968215750719785,0.05154404570817084,-11065,-3051,-0.4316869538077403,-0.10458491299141376
14408,51191,Washington,Virginia,2016,5553,19320,973,25846,0.21484949315174495,0.7475044494312466,0.03764605741700843,-1523,558,1179,214,-0.06121168038133867,0.021455358290916045,0.03975632209042268,-13767,-2702,-0.5326549562795017,-0.10096800247176135
14409,51193,Westmoreland,Virginia,2000,2922,2932,172,6026,0.48489877198805176,0.4865582475937604,0.02854298041818785,0,0,0,0,0.0,0.0,0.0,-10,0,-0.0016594756057086157,0.0
14410,51193,Westmoreland,Virginia,2004,3370,3433,45,6848,0.4921144859813084,0.5013142523364486,0.0065712616822429905,448,-127,501,822,0.007215713993256656,-0.021971718735944862,0.014756004742688178,-63,-53,-0.009199766355140138,-0.007540290749431522
14411,51193,Westmoreland,Virginia,2008,4577,3719,81,8377,0.5463769846006924,0.4439536827026382,0.009669332696669452,1207,36,286,1529,0.05426249861938398,0.0030980710144264617,-0.057360569633810365,858,921,0.10242330189805421,0.11162306825319435
14412,51193,Westmoreland,Virginia,2012,4295,3731,94,8120,0.5289408866995073,0.45948275862068966,0.011576354679802956,-282,13,12,-257,-0.017436097901185055,0.0019070219831335035,0.015529075918051471,564,-294,0.06945812807881768,-0.032965173819236526
14413,51193,Westmoreland,Virginia,2016,3836,4448,290,8574,0.44739911359925355,0.5187777000233263,0.03382318637742011,-459,196,717,454,-0.08154177310025379,0.022246831697617153,0.05929494140263669,-612,-1176,-0.0713785864240728,-0.14083671450289048
14414,51195,Wise,Virginia,2000,6412,6504,394,13310,0.48174305033809167,0.4886551465063862,0.029601803155522164,0,0,0,0,0.0,0.0,0.0,-92,0,-0.006912096168294524,0.0
14415,51195,Wise,Virginia,2004,5802,8330,180,14312,0.40539407490218,0.5820290665176076,0.01257685858021241,-610,-214,1826,1002,-0.07634897543591168,-0.017024944575309755,0.09337392001122136,-2528,-2436,-0.17663499161542756,-0.16972289544713304
14416,51195,Wise,Virginia,2008,4995,8914,229,14138,0.35330315461875794,0.6304993634177394,0.016197481963502618,-807,49,584,-174,-0.05209092028342205,0.0036206233832902085,0.048470296900131826,-3919,-1391,-0.27719620879898144,-0.10056121718355387
14417,51195,Wise,Virginia,2012,3760,11076,182,15018,0.25036622719403384,0.7375149820215741,0.012118790784392063,-1235,-47,2162,880,-0.1029369274247241,-0.004078691179110555,0.10701561860383468,-7316,-3397,-0.4871487548275402,-0.20995254602855878
14418,51195,Wise,Virginia,2016,2701,12086,376,15163,0.1781309767196465,0.7970718195607729,0.02479720371958056,-1059,194,1010,145,-0.07223525047438734,0.012678412935188496,0.059556837539198826,-9385,-2069,-0.6189408428411264,-0.13179208801358616
14419,51197,Wythe,Virginia,2000,3462,6539,224,10225,0.33858190709046454,0.6395110024449878,0.02190709046454768,0,0,0,0,0.0,0.0,0.0,-3077,0,-0.3009290953545233,0.0
14420,51197,Wythe,Virginia,2004,3581,7911,62,11554,0.3099359529167388,0.6846979401073221,0.005366106975939069,119,-162,1372,1329,-0.02864595417372573,-0.01654098348860861,0.04518693766233428,-4330,-1253,-0.3747619871905833,-0.07383289183606001
14421,51197,Wythe,Virginia,2008,4107,8207,177,12491,0.3287967336482267,0.6570330638059403,0.014170202545833,526,115,296,937,0.01886078073148789,0.008804095569893932,-0.027664876301381813,-4100,230,-0.3282363301577136,0.046525657032869705
14422,51197,Wythe,Virginia,2012,3783,8324,251,12358,0.30611749474024924,0.6735717753681826,0.020310729891568215,-324,74,117,-133,-0.02267923890797746,0.0061405273457352146,0.016538711562242292,-4541,-441,-0.36745428062793334,-0.03921795047021975
14423,51197,Wythe,Virginia,2016,2770,10046,512,13328,0.20783313325330133,0.7537515006002401,0.03841536614645858,-1013,261,1722,970,-0.09828436148694791,0.018104636254890366,0.08017972523205752,-7276,-2735,-0.5459183673469388,-0.17846408671900543
14424,51199,York,Virginia,2000,8622,15312,649,24583,0.3507301793922629,0.6228694626367816,0.026400357970955537,0,0,0,0,0.0,0.0,0.0,-6690,0,-0.27213928324451864,0.0
14425,51199,York,Virginia,2004,10276,19396,208,29880,0.34390896921017405,0.6491298527443106,0.0069611780455153946,1654,-441,4084,5297,-0.006821210182088866,-0.019439179925440142,0.026260390107529008,-9120,-2430,-0.3052208835341365,-0.033081600289617874
14426,51199,York,Virginia,2008,13700,19833,364,33897,0.4041655603740744,0.5850960261970086,0.010738413428917013,3424,156,437,4017,0.060256591163900364,0.003777235383401619,-0.06403382654730194,-6133,2987,-0.1809304658229342,0.1242904177112023
14427,51199,York,Virginia,2012,13183,20204,566,33953,0.3882720230907431,0.5950578741201072,0.016670102789149707,-517,202,371,56,-0.015893537283331316,0.005931689360232693,0.009961847923098621,-7021,-888,-0.20678585102936414,-0.025855385206429937
14428,51199,York,Virginia,2016,12999,18837,2277,34113,0.38105707501539005,0.5521941781725442,0.06674874681206579,-184,1711,-1367,160,-0.007214948075353056,0.05007864402291608,-0.04286369594756301,-5838,1183,-0.1711371031571542,0.03564874787220995
14429,51510,Alexandria,Virginia,2000,33633,19043,2523,55199,0.6093045163861665,0.3449881338430044,0.04570734977082918,0,0,0,0,0.0,0.0,0.0,14590,0,0.26431638254316203,0.0
14430,51510,Alexandria,Virginia,2004,41116,19844,555,61515,0.6683898236202552,0.3225879866699179,0.00902218970982687,7483,-1968,801,6316,0.05908530723408878,-0.03668516006100231,-0.022400147173086526,21272,6682,0.34580183695033734,0.0814854544071753
14431,51510,Alexandria,Virginia,2008,50473,19181,710,70364,0.717312830424649,0.27259678244556873,0.010090387129782274,9357,155,-663,8849,0.048923006804393765,0.0010681974199554037,-0.04999120422434916,31292,10020,0.44471604797908026,0.09891421102874293
14432,51510,Alexandria,Virginia,2012,52199,20249,963,73411,0.7110514772990424,0.27583059759436596,0.013117925106591655,1726,253,1068,3047,-0.006261353125606606,0.00302753797680938,0.0032338151487972255,31950,658,0.43522087970467643,-0.009495168274403831
14433,51510,Alexandria,Virginia,2016,57242,13285,5235,75762,0.7555502758638896,0.1753517594572477,0.06909796467886276,5043,4272,-6964,2351,0.044498798564847175,0.0559800395722711,-0.10047883813711825,43957,12007,0.5801985164066419,0.14497763670196545
14434,51520,Bristol,Virginia,2000,2646,3495,138,6279,0.4214046822742475,0.5566172957477306,0.02197802197802198,0,0,0,0,0.0,0.0,0.0,-849,0,-0.13521261347348307,0.0
14435,51520,Bristol,Virginia,2004,2400,4275,49,6724,0.35693039857227843,0.6357822724568709,0.007287328970850684,-246,-89,780,445,-0.06447428370196906,-0.014690693007171296,0.07916497670914036,-1875,-1026,-0.2788518738845925,-0.14363926041110942
14436,51520,Bristol,Virginia,2008,2665,4579,115,7359,0.3621415953254518,0.6222312814241066,0.015627123250441636,265,66,304,635,0.005211196753173386,0.008339794279590952,-0.013550991032764359,-1914,-39,-0.26008968609865474,0.018762187785937745
14437,51520,Bristol,Virginia,2012,2492,4780,115,7387,0.3373493975903614,0.6470827128739678,0.015567889535670773,-173,0,201,28,-0.024792197735090393,-5.923371477086284e-05,0.02485143144986124,-2288,-374,-0.30973331528360637,-0.04964362918495163
14438,51520,Bristol,Virginia,2016,1835,4892,300,7027,0.26113561975238364,0.6961719083534936,0.04269247189412267,-657,185,112,-360,-0.07621377783797778,0.027124582358451894,0.04908919547952584,-3057,-769,-0.43503628860111,-0.12530297331750362
14439,51530,Buena Vista,Virginia,2000,941,980,54,1975,0.47645569620253164,0.4962025316455696,0.027341772151898733,0,0,0,0,0.0,0.0,0.0,-39,0,-0.019746835443037958,0.0
14440,51530,Buena Vista,Virginia,2004,936,1417,36,2389,0.39179573043114274,0.5931352030138133,0.01506906655504395,-5,-18,437,414,-0.0846599657713889,-0.012272705596854783,0.09693267136824368,-481,-442,-0.20133947258267054,-0.18159263713963258
14441,51530,Buena Vista,Virginia,2008,1108,1282,33,2423,0.4572843582335947,0.5290961617829137,0.01361947998349154,172,-3,-135,34,0.06548862780245196,-0.0014495865715524105,-0.06403904123089954,-174,307,-0.07181180354931904,0.1295276690333515
14442,51530,Buena Vista,Virginia,2012,919,1564,43,2526,0.36381631037212986,0.6191607284243864,0.017022961203483768,-189,10,282,103,-0.09346804786146484,0.0034034812199922274,0.09006456664147267,-645,-471,-0.25534441805225655,-0.1835326145029375
14443,51530,Buena Vista,Virginia,2016,693,1430,284,2407,0.28791026173660156,0.5941005400914001,0.11798919817199834,-226,241,-134,-119,-0.0759060486355283,0.10096623696851456,-0.02506018833298629,-737,-92,-0.30619027835479856,-0.05084586030254201
14444,51540,Charlottesville,Virginia,2000,7762,4034,1428,13224,0.586963097398669,0.30505142165759225,0.10798548094373865,0,0,0,0,0.0,0.0,0.0,3728,0,0.2819116757410768,0.0
14445,51540,Charlottesville,Virginia,2004,11088,4172,190,15450,0.7176699029126213,0.2700323624595469,0.012297734627831715,3326,-1238,138,2226,0.1307068055139523,-0.09568774631590693,-0.03501905919804532,6916,3188,0.4476375404530744,0.16572586471199763
14446,51540,Charlottesville,Virginia,2008,15705,4078,261,20044,0.7835262422670126,0.2034524047096388,0.013021353023348633,4617,71,-94,4594,0.06585633935439128,0.0007236183955169184,-0.06657995774990813,11627,4711,0.5800738375573739,0.13243629710429944
14447,51540,Charlottesville,Virginia,2012,16510,4844,443,21797,0.7574436849107675,0.22223241730513374,0.02032389778409873,805,182,766,1753,-0.026082557356245095,0.007302544760750098,0.018780012595494944,11666,39,0.5352112676056338,-0.044862569951740094
14448,51540,Charlottesville,Virginia,2016,17901,2960,1606,22467,0.7967685939377754,0.13174878710998353,0.07148261895224106,1391,1163,-1884,670,0.039324909027007915,0.05115872116814233,-0.09048363019515021,14941,3275,0.6650198068277919,0.12980853922215818
14449,51550,Chesapeake,Virginia,2000,33578,39684,1323,74585,0.4501977609438895,0.5320640879533418,0.017738151102768652,0,0,0,0,0.0,0.0,0.0,-6106,0,-0.08186632700945229,0.0
14450,51550,Chesapeake,Virginia,2004,38744,52283,514,91541,0.42324204454834446,0.5711429851104969,0.005614970341158607,5166,-809,12599,16956,-0.02695571639554506,-0.012123180761610045,0.03907889715715507,-13539,-7433,-0.14790094056215242,-0.06603461355270013
14451,51550,Chesapeake,Virginia,2008,53994,52625,902,107521,0.5021716687902829,0.48943927232819634,0.00838905888152082,15250,388,342,15980,0.07892962424193839,0.0027740885403622125,-0.08170371278230054,1369,14908,0.012732396462086515,0.16063333702423893
14452,51550,Chesapeake,Virginia,2012,55052,53900,1473,110425,0.49854652479058187,0.48811410459587956,0.013339370613538602,1058,571,1275,2904,-0.003625143999700986,0.004950311732017782,-0.0013251677323167788,1152,-217,0.010432420194702308,-0.0022999762673842072
14453,51550,Chesapeake,Virginia,2016,52627,54047,5988,112662,0.46712289858159806,0.47972697093962474,0.05315013047877723,-2425,4515,147,2237,-0.03142362620898381,0.03981075986523863,-0.00838713365625482,-1420,-2572,-0.012604072358026686,-0.023036492552728993
14454,51570,Colonial Heights,Virginia,2000,2100,5519,163,7782,0.26985350809560527,0.7092007196093549,0.020945772295039834,0,0,0,0,0.0,0.0,0.0,-3419,0,-0.43934721151374967,0.0
14455,51570,Colonial Heights,Virginia,2004,2061,6129,41,8231,0.25039484874255863,0.7446239825051634,0.004981168752277974,-39,-122,610,449,-0.019458659353046637,-0.01596460354276186,0.03542326289580844,-4068,-649,-0.49422913376260474,-0.054881922248855075
14456,51570,Colonial Heights,Virginia,2008,2562,6161,126,8849,0.2895242400271217,0.6962368629223641,0.014238897050514182,501,85,32,618,0.03912939128456305,0.009257728298236208,-0.04838711958279929,-3599,469,-0.4067126228952424,0.08751651086736234
14457,51570,Colonial Heights,Virginia,2012,2544,5941,139,8624,0.2949907235621521,0.68889146567718,0.016117810760667903,-18,13,-220,-225,0.005466483535030431,0.0018789137101537217,-0.0073453972451841265,-3397,202,-0.39390074211502785,0.012811880780214557
14458,51570,Colonial Heights,Virginia,2016,2367,5681,409,8457,0.2798864845689961,0.6717512120137165,0.04836230341728746,-177,270,-260,-167,-0.015104238993155994,0.03224449265661955,-0.0171402536634635,-3314,83,-0.39186472744472034,0.0020360146703075066
14459,51580,Covington,Virginia,2000,1168,966,80,2214,0.5275519421860885,0.4363143631436314,0.036133694670280034,0,0,0,0,0.0,0.0,0.0,202,0,0.09123757904245705,0.0
14460,51580,Covington,Virginia,2004,1179,1104,18,2301,0.5123859191655802,0.47979139504563234,0.007822685788787484,11,-62,138,87,-0.01516602302050829,-0.02831100888149255,0.04347703190200092,75,-127,0.03259452411994784,-0.05864305492250921
14461,51580,Covington,Virginia,2008,1304,1020,30,2354,0.5539507221750213,0.4333050127442651,0.012744265080713678,125,12,-84,53,0.0415648030094411,0.004921579291926194,-0.04648638230136726,284,209,0.1206457094307562,0.08805118531080836
14462,51580,Covington,Virginia,2012,1319,975,36,2330,0.5660944206008584,0.4184549356223176,0.015450643776824034,15,6,-45,-24,0.012143698425837068,0.0027063786961103557,-0.01485007712194747,344,60,0.14763948497854074,0.026993775547784538
14463,51580,Covington,Virginia,2016,914,1349,119,2382,0.38371116708648195,0.5663308144416457,0.049958018471872374,-405,83,374,52,-0.1823832535143764,0.03450737469504834,0.14787587881932807,-435,-779,-0.18261964735516373,-0.33025913233370446
14464,51590,Danville,Virginia,2000,8221,9427,659,18307,0.4490631998689026,0.5149396405746436,0.035997159556453814,0,0,0,0,0.0,0.0,0.0,-1206,0,-0.065876440705741,0.0
14465,51590,Danville,Virginia,2004,9436,9399,277,19112,0.49372122226873166,0.4917852658015906,0.01449351192967769,1215,-382,-28,805,0.04465802239982908,-0.021503647626776125,-0.023154374773052988,37,1243,0.0019359564671410645,0.06781239717288207
14466,51590,Danville,Virginia,2008,12352,8361,177,20890,0.5912876974629009,0.40023934897079944,0.008472953566299665,2916,-100,-1038,1778,0.09756647519416922,-0.006020558363378024,-0.09154591683079116,3991,3954,0.19104834849210145,0.18911239202496039
14467,51590,Danville,Virginia,2012,12218,7763,223,20204,0.6047317362898436,0.384230845377153,0.011037418333003366,-134,46,-598,-686,0.013444038826942672,0.002564464766703701,-0.016008503593646417,4455,464,0.22050089091269054,0.02945254242058909
14468,51590,Danville,Virginia,2016,11059,7303,578,18940,0.58389651531151,0.3855860612460401,0.030517423442449843,-1159,355,-460,-1264,-0.02083522097833357,0.019480005109446474,0.0013552158688870941,3756,-699,0.19831045406546988,-0.022190436847220663
14469,51595,Emporia,Virginia,2000,1116,938,26,2080,0.5365384615384615,0.45096153846153847,0.0125,0,0,0,0,0.0,0.0,0.0,178,0,0.08557692307692305,0.0
14470,51595,Emporia,Virginia,2004,1247,970,4,2221,0.5614588023412878,0.43674020711391265,0.0018009905447996398,131,-22,32,141,0.024920340802826235,-0.01069900945520036,-0.01422133134762582,277,99,0.1247185952273751,0.039141672150452056
14471,51595,Emporia,Virginia,2008,1702,897,18,2617,0.6503630110813909,0.34275888421857087,0.006878104700038212,455,14,-73,396,0.08890420874010319,0.005077114155238572,-0.09398132289534178,805,528,0.30760412686282007,0.18288553163544496
14472,51595,Emporia,Virginia,2012,1793,886,17,2696,0.6650593471810089,0.32863501483679525,0.006305637982195846,91,-1,-11,79,0.014696336099617957,-0.000572466717842366,-0.014123869381775622,907,102,0.33642433234421365,0.02882020548139358
14473,51595,Emporia,Virginia,2016,1530,789,47,2366,0.6466610312764159,0.3334742180896027,0.019864750633981403,-263,30,-97,-330,-0.018398315904592955,0.013559112651785558,0.004839203252807456,741,-166,0.31318681318681324,-0.02323751915740041
14474,51600,Fairfax City,Virginia,2000,4361,4762,433,9556,0.4563624947676852,0.4983256592716618,0.04531184596065299,0,0,0,0,0.0,0.0,0.0,-401,0,-0.04196316450397658,0.0
14475,51600,Fairfax City,Virginia,2004,5395,5045,106,10546,0.5115683671534231,0.47838042859852076,0.010051204248056136,1034,-327,283,990,0.05520587238573793,-0.03526064171259685,-0.019945230673141023,350,751,0.033187938554902374,0.07515110305887895
14476,51600,Fairfax City,Virginia,2008,6575,4691,132,11398,0.5768555886997719,0.4115634321810844,0.011580979119143709,1180,26,-354,852,0.0652872215463488,0.001529774871087573,-0.06681699641743638,1884,1534,0.16529215651868756,0.1321042179637852
14477,51600,Fairfax City,Virginia,2012,6651,4775,203,11629,0.5719322383695933,0.41061140252816236,0.017456359102244388,76,71,84,231,-0.004923350330178655,0.005875379983100679,-0.0009520296529220151,1876,-8,0.16132083584143092,-0.00397132067725664
14478,51600,Fairfax City,Virginia,2016,7367,3702,959,12028,0.6124875290987696,0.3077818423678084,0.07973062853342201,716,756,-1073,399,0.040555290729176297,0.06227426943117763,-0.10282956016035394,3665,1789,0.30470568673096116,0.14338485088953024
14479,51610,Falls Church,Virginia,2000,3109,2131,353,5593,0.5558734131950652,0.381011979259789,0.06311460754514572,0,0,0,0,0.0,0.0,0.0,978,0,0.1748614339352762,0.0
14480,51610,Falls Church,Virginia,2004,3944,2074,80,6098,0.6467694326008527,0.3401115119711381,0.013119055428009183,835,-273,-57,505,0.09089601940578751,-0.04999555211713654,-0.04090046728865093,1870,892,0.30665792062971464,0.13179648669443844
14481,51610,Falls Church,Virginia,2008,4695,1970,85,6750,0.6955555555555556,0.29185185185185186,0.012592592592592593,751,5,-104,652,0.04878612295470286,-0.0005264628354165902,-0.04825966011928623,2725,855,0.40370370370370373,0.09704578307398909
14482,51610,Falls Church,Virginia,2012,5015,2147,114,7276,0.6892523364485982,0.2950797141286421,0.015667949422759758,320,29,177,526,-0.006303219106957414,0.0030753568301671655,0.0032278622767902276,2868,143,0.3941726223199561,-0.009531081383747642
14483,51610,Falls Church,Virginia,2016,5819,1324,614,7757,0.7501611447724635,0.17068454299342528,0.07915431223411112,804,500,-823,481,0.06090880832386536,0.06348636281135137,-0.12439517113521681,4495,1627,0.5794766017790383,0.18530397945908217
14484,51620,Franklin City,Virginia,2000,1763,1393,35,3191,0.5524913820119085,0.43654026950799124,0.010968348480100282,0,0,0,0,0.0,0.0,0.0,370,0,0.11595111250391726,0.0
14485,51620,Franklin City,Virginia,2004,1910,1613,13,3536,0.540158371040724,0.4561651583710407,0.003676470588235294,147,-22,220,345,-0.012333010971184555,-0.007291877891864988,0.019624888863049472,297,-73,0.08399321266968324,-0.03195789983423403
14486,51620,Franklin City,Virginia,2008,2819,1576,32,4427,0.6367743392816806,0.35599728936074093,0.007228371357578495,909,19,-37,891,0.09661596824095664,0.0035519007693432013,-0.10016786901029978,1243,946,0.28077704992093966,0.19678383725125642
14487,51620,Franklin City,Virginia,2012,2833,1496,31,4360,0.6497706422018349,0.3431192660550459,0.0071100917431192664,14,-1,-80,-67,0.012996302920154301,-0.00011827961445922894,-0.012878023305695041,1337,94,0.306651376146789,0.025874326225849342
14488,51620,Franklin City,Virginia,2016,2519,1421,121,4061,0.6202905688254124,0.34991381433144547,0.029795616843142084,-314,90,-75,-299,-0.029480073376422444,0.022685525100022818,0.006794548276399581,1098,-239,0.270376754493967,-0.036274621652822026
14489,51630,Fredericksburg,Virginia,2000,3360,2935,386,6681,0.5029187247418051,0.4393054931896423,0.05777578206855261,0,0,0,0,0.0,0.0,0.0,425,0,0.06361323155216281,0.0
14490,51630,Fredericksburg,Virginia,2004,4085,3390,67,7542,0.541633518960488,0.4494828957836118,0.008883585255900292,725,-319,455,861,0.038714794218682846,-0.04889219681265232,0.010177402593969487,695,270,0.09215062317687617,0.02853739162471336
14491,51630,Fredericksburg,Virginia,2008,6155,3413,109,9677,0.6360442285832386,0.3526919499844993,0.011263821432262065,2070,42,23,2135,0.09441070962275067,0.0023802361763617733,-0.09679094579911246,2742,2047,0.2833522785987393,0.19120165542186313
14492,51630,Fredericksburg,Virginia,2012,7131,4060,246,11437,0.6235026667832474,0.3549881962052986,0.021509137011454054,976,137,647,1760,-0.012541561799991219,0.01024531557919199,0.0022962462207992695,3071,329,0.2685144705779488,-0.014837808020790488
14493,51630,Fredericksburg,Virginia,2016,6707,3744,806,11257,0.5958070533890024,0.33259305321133514,0.07159989339966243,-424,560,-316,-180,-0.027695613394244978,0.05009075638820837,-0.022395142993963446,2963,-108,0.2632140001776673,-0.005300470400281532
14494,51640,Galax,Virginia,2000,996,1160,57,2213,0.4500677812923633,0.5241753276095797,0.025756891098056935,0,0,0,0,0.0,0.0,0.0,-164,0,-0.07410754631721644,0.0
14495,51640,Galax,Virginia,2004,987,1336,12,2335,0.4226980728051392,0.5721627408993576,0.005139186295503212,-9,-45,176,122,-0.027369708487224087,-0.020617704802553722,0.04798741328977785,-349,-185,-0.14946466809421838,-0.07535712177700193
14496,51640,Galax,Virginia,2008,1052,1317,33,2402,0.4379683597002498,0.548293089092423,0.013738551207327226,65,21,-19,67,0.015270286895110563,0.008599364911824014,-0.023869651806934566,-265,84,-0.11032472939217325,0.03913993870204513
14497,51640,Galax,Virginia,2012,900,1332,45,2277,0.3952569169960474,0.5849802371541502,0.019762845849802372,-152,12,15,-125,-0.04271144270420235,0.0060242946424751455,0.036687148061727126,-432,-167,-0.18972332015810273,-0.07939859076592948
14498,51640,Galax,Virginia,2016,681,1603,92,2376,0.2866161616161616,0.6746632996632996,0.03872053872053872,-219,47,271,99,-0.10864075537988582,0.018957692870736346,0.08968306250914948,-922,-490,-0.38804713804713803,-0.1983238178890353
14499,51650,Hampton,Virginia,2000,27490,19561,836,47887,0.574059765698415,0.4084824691461148,0.017457765155470168,0,0,0,0,0.0,0.0,0.0,7929,0,0.1655772965523002,0.0
14500,51650,Hampton,Virginia,2004,32016,23399,326,55741,0.5743707504350478,0.4197807717837857,0.005848477781166466,4526,-510,3838,7854,0.00031098473663282444,-0.011609287374303702,0.011298302637670898,8617,688,0.15458997865126212,-0.010987317901038074
14501,51650,Hampton,Virginia,2008,46917,20476,550,67943,0.6905347129211251,0.3013702662525941,0.008095020826280852,14901,224,-2923,12202,0.1161639624860773,0.0022465430451143863,-0.11841050553119159,26441,17824,0.389164446668531,0.2345744680172689
14502,51650,Hampton,Virginia,2012,46966,18640,884,66490,0.7063618589261543,0.2803429087080764,0.013295232365769289,49,334,-1836,-1453,0.015827146005029213,0.005200211539488436,-0.021027357544517733,28326,1885,0.42601895021807795,0.036854503549546946
14503,51650,Hampton,Virginia,2016,41312,17902,3063,62277,0.6633588644282801,0.287457648891244,0.04918348668047594,-5654,2179,-738,-4213,-0.04300299449787426,0.03588825431470665,0.0071147401831676005,23410,-4916,0.3759012155370361,-0.05011773468104186
14504,51660,Harrisonburg,Virginia,2000,3482,5741,735,9958,0.34966860815424783,0.5765213898373167,0.07381000200843543,0,0,0,0,0.0,0.0,0.0,-2259,0,-0.22685278168306888,0.0
14505,51660,Harrisonburg,Virginia,2004,4726,6165,139,11030,0.42846781504986403,0.5589301903898459,0.012601994560290118,1244,-596,424,1072,0.0787992068956162,-0.061208007448145314,-0.017591199447470784,-1439,820,-0.1304623753399819,0.09639040634308699
14506,51660,Harrisonburg,Virginia,2008,8444,6048,183,14675,0.5754003407155025,0.41212947189097104,0.012470187393526405,3718,44,-117,3645,0.14693252566563847,-0.00013180716676371336,-0.14680071849887488,2396,3835,0.16327086882453146,0.29373324416451335
14507,51660,Harrisonburg,Virginia,2012,8654,6565,374,15593,0.5549926248957866,0.42102225357532225,0.02398512152889117,210,191,517,918,-0.0204077158197159,0.011514934135364764,0.008892781684351203,2089,-307,0.13397037132046435,-0.029300497504067102
14508,51660,Harrisonburg,Virginia,2016,10212,6262,1513,17987,0.5677433702118196,0.3481403235670206,0.08411630622115973,1558,1139,-303,2394,0.01275074531603304,0.060131184692268566,-0.07288193000830162,3950,1861,0.21960304664479902,0.08563267532433466
14509,51670,Hopewell,Virginia,2000,3024,3749,205,6978,0.43336199484092863,0.5372599598738894,0.029378045285182,0,0,0,0,0.0,0.0,0.0,-725,0,-0.10389796503296078,0.0
14510,51670,Hopewell,Virginia,2004,3573,4251,112,7936,0.45022681451612906,0.5356602822580645,0.014112903225806451,549,-93,502,958,0.016864819675200426,-0.01526514205937555,-0.0015996776158249126,-678,47,-0.08543346774193544,0.01846449729102534
14511,51670,Hopewell,Virginia,2008,5285,4149,90,9524,0.5549139017219655,0.4356362872742545,0.009449811003779925,1712,-22,-102,1588,0.10468708720583647,-0.004663092222026526,-0.10002399498380998,1136,1814,0.11927761444771101,0.20471108218964645
14512,51670,Hopewell,Virginia,2012,5179,3739,113,9031,0.5734691617761045,0.4140183811316576,0.012512457092237847,-106,23,-410,-493,0.01855526005413899,0.003062646088457922,-0.0216179061425969,1440,304,0.1594507806444469,0.04017316619673589
14513,51670,Hopewell,Virginia,2016,4724,3885,399,9008,0.5244227353463587,0.4312833037300178,0.04429396092362345,-455,286,146,-23,-0.04904642642974577,0.0317815038313856,0.017264922598360155,839,-601,0.09313943161634097,-0.06631134902810593
14514,51678,Lexington,Virginia,2000,1048,957,135,2140,0.4897196261682243,0.44719626168224297,0.0630841121495327,0,0,0,0,0.0,0.0,0.0,91,0,0.04252336448598132,0.0
14515,51678,Lexington,Virginia,2004,1340,982,27,2349,0.5704555129842486,0.41805023414218817,0.011494252873563218,292,-108,25,209,0.08073588681602428,-0.051589859275969485,-0.029146027540054797,358,267,0.1524052788420604,0.10988191435607908
14516,51678,Lexington,Virginia,2008,1543,914,22,2479,0.6224283985478015,0.3686970552642194,0.008874546187979023,203,-5,-68,130,0.05197288556355295,-0.0026197066855841947,-0.04935317887796875,629,271,0.2537313432835821,0.1013260644415217
14517,51678,Lexington,Virginia,2012,1486,1146,55,2687,0.5530331224413845,0.4264979531075549,0.020468924451060664,-57,33,232,208,-0.06939527610641705,0.01159437826308164,0.057800897843335475,340,-289,0.12653516933382958,-0.12719617394975252
14518,51678,Lexington,Virginia,2016,1514,766,185,2465,0.6141987829614605,0.3107505070993915,0.07505070993914807,28,130,-380,-222,0.06116566052007599,0.05458178548808741,-0.11574744600816339,748,408,0.30344827586206896,0.17691310652823938
14519,51680,Lynchburg,Virginia,2000,10374,12518,614,23506,0.44133412745681955,0.532544882157747,0.026120990385433505,0,0,0,0,0.0,0.0,0.0,-2144,0,-0.09121075470092743,0.0
14520,51680,Lynchburg,Virginia,2004,11727,14400,213,26340,0.4452164009111617,0.5466970387243736,0.008086560364464692,1353,-401,1882,2834,0.0038822734543421666,-0.018034430020968814,0.014152156566626606,-2673,-529,-0.10148063781321187,-0.01026988311228444
14521,51680,Lynchburg,Virginia,2008,16269,17638,434,34341,0.4737485804140823,0.5136134649544276,0.012637954631490056,4542,221,3238,8001,0.028532179502920585,0.004551394267025364,-0.03308357376994597,-1369,1304,-0.03986488454034531,0.06161575327286656
14522,51680,Lynchburg,Virginia,2012,15948,19806,694,36448,0.4375548726953468,0.5434043020193152,0.019040825285338014,-321,260,2168,2107,-0.03619370771873548,0.006402870653847958,0.02979083706488761,-3858,-2489,-0.1058494293239684,-0.06598454478362309
14523,51680,Lynchburg,Virginia,2016,14792,17982,2883,35657,0.4148414056146058,0.5043049050677286,0.08085368931766554,-1156,2189,-1824,-791,-0.022713467080741012,0.061812864032327525,-0.039099396951586596,-3190,668,-0.08946349945312282,0.016385929870845584
14524,51683,Manassas,Virginia,2000,5262,6752,396,12410,0.42401289282836424,0.5440773569701853,0.03190975020145044,0,0,0,0,0.0,0.0,0.0,-1490,0,-0.12006446414182109,0.0
14525,51683,Manassas,Virginia,2004,5562,7257,84,12903,0.4310625435945129,0.5624273424784934,0.006510113926993723,300,-312,505,493,0.007049650766148663,-0.025399636274456718,0.01834998550830802,-1695,-205,-0.13136479888398045,-0.011300334742159357
14526,51683,Manassas,Virginia,2008,7518,5975,134,13627,0.5516988331987965,0.4384677478535261,0.009833418947677405,1956,50,-1282,724,0.12063628960428363,0.0033233050206836826,-0.12395959462496725,1543,3238,0.11323108534527043,0.24459588422925088
14527,51683,Manassas,Virginia,2012,8478,6463,259,15200,0.5577631578947368,0.42519736842105266,0.017039473684210528,960,125,488,1573,0.006064324695940315,0.007206054736533123,-0.013270379432473445,2015,472,0.1325657894736842,0.01933470412841376
14528,51683,Manassas,Virginia,2016,8423,5953,1035,15411,0.5465576536240347,0.38628252546882097,0.06715982090714424,-55,776,-510,211,-0.011205504270702105,0.050120347222933716,-0.03891484295223169,2470,455,0.16027512815521378,0.027709338681529583
14529,51685,Manassas Park,Virginia,2000,1048,1460,72,2580,0.4062015503875969,0.5658914728682171,0.027906976744186046,0,0,0,0,0.0,0.0,0.0,-412,0,-0.15968992248062014,0.0
14530,51685,Manassas Park,Virginia,2004,1498,1807,27,3332,0.4495798319327731,0.5423169267707083,0.008103241296518607,450,-45,347,752,0.0433782815451762,-0.01980373544766744,-0.023574546097508753,-309,103,-0.09273709483793519,0.06695282764268495
14531,51685,Manassas Park,Virginia,2008,2463,1634,43,4140,0.5949275362318841,0.39468599033816426,0.01038647342995169,965,16,-173,808,0.14534770429911098,0.0022832321334330836,-0.14763093643254405,829,1138,0.20024154589371984,0.292978640731655
14532,51685,Manassas Park,Virginia,2012,2879,1699,78,4656,0.6183419243986255,0.3649054982817869,0.01675257731958763,416,35,65,516,0.02341438816674135,0.0063661038896359375,-0.02978049205637734,1180,351,0.25343642611683853,0.05319488022311869
14533,51685,Manassas Park,Virginia,2016,3204,1733,295,5232,0.6123853211009175,0.3312308868501529,0.05638379204892966,325,217,34,576,-0.005956603297707974,0.03963121472934203,-0.03367461143163403,1471,291,0.2811544342507646,0.027718008133926053
14534,51690,Martinsville,Virginia,2000,3048,2560,86,5694,0.5353003161222339,0.4495960660344222,0.01510361784334387,0,0,0,0,0.0,0.0,0.0,488,0,0.08570425008781174,0.0
14535,51690,Martinsville,Virginia,2004,3036,2538,29,5603,0.5418525789755488,0.45297162234517224,0.005175798679278957,-12,-57,-22,-91,0.006552262853314894,-0.009927819164064912,0.0033755563107500386,498,10,0.0888809566303766,0.0031767065425648555
14536,51690,Martinsville,Virginia,2008,4139,2311,70,6520,0.6348159509202455,0.3544478527607362,0.010736196319018405,1103,41,-227,917,0.09296337194469662,0.005560397639739448,-0.09852376958443604,1828,1330,0.28036809815950925,0.19148714152913265
14537,51690,Martinsville,Virginia,2012,3855,2312,117,6284,0.6134627625716105,0.3679185232336092,0.018618714194780395,-284,47,1,-236,-0.021353188348634977,0.00788251787576199,0.013470670472872981,1543,-285,0.2455442393380013,-0.03482385882150796
14538,51690,Martinsville,Virginia,2016,3533,2149,225,5907,0.5981039444726596,0.3638056543084476,0.03809040121889284,-322,108,-163,-377,-0.0153588180989509,0.019471687024112443,-0.004112868925161606,1384,-159,0.234298290164212,-0.011245949173789294
14539,51700,Newport News,Virginia,2000,29779,27006,1040,57825,0.5149848681366191,0.467029831387808,0.017985300475572848,0,0,0,0,0.0,0.0,0.0,2773,0,0.04795503674881113,0.0
14540,51700,Newport News,Virginia,2004,35319,32208,425,67952,0.5197639510242524,0.47398163409465505,0.0062544148810925355,5540,-615,5202,10127,0.00477908288763329,-0.011730885594480312,0.006951802706847032,3111,338,0.04578231692959739,-0.002172719819213742
14541,51700,Newport News,Virginia,2008,51972,28667,656,81295,0.6393013100436681,0.3526293129958792,0.008069376960452672,16653,231,-3541,13343,0.11953735901941565,0.0018149620793601363,-0.12135232109877586,23305,20194,0.2866719970477889,0.2408896801181915
14542,51700,Newport News,Virginia,2012,51100,27230,1114,79444,0.6432203816524847,0.34275716227783093,0.014022456069684306,-872,458,-1437,-1851,0.00391907160881666,0.005953079109231634,-0.009872150718048256,23870,565,0.3004632193746538,0.013791222326864916
14543,51700,Newport News,Virginia,2016,45618,25468,4551,75637,0.6031175218477729,0.33671351322765314,0.06016896492457395,-5482,3437,-1762,-3807,-0.04010285980471184,0.04614650885488965,-0.006043649050177791,20150,-3720,0.26640400862011976,-0.03405921075453405
14544,51710,Norfolk,Virginia,2000,38221,21920,1805,61946,0.6170051335033739,0.353856584767378,0.029138281729248056,0,0,0,0,0.0,0.0,0.0,16301,0,0.2631485487359959,0.0
14545,51710,Norfolk,Virginia,2004,43518,26401,651,70570,0.6166643049454442,0.37411081195975626,0.00922488309479949,5297,-1154,4481,8624,-0.00034082855792971767,-0.01991339863444857,0.020254227192378238,17117,816,0.24255349298568796,-0.020595055750307956
14546,51710,Norfolk,Virginia,2008,62819,24814,813,88446,0.7102525834972752,0.28055536711665874,0.009192049386066074,19301,162,-1587,17876,0.09358827855183094,-3.283370873341518e-05,-0.09355544484309752,38005,20888,0.4296972163806164,0.18714372339492846
14547,51710,Norfolk,Virginia,2012,62687,23147,1209,87043,0.7201842767367853,0.26592603655664443,0.013889686706570316,-132,396,-1667,-1403,0.009931693239510153,0.004697637320504242,-0.014629330560014309,39540,1535,0.4542582401801409,0.024561023799524462
14548,51710,Norfolk,Virginia,2016,57023,21552,4810,83385,0.6838520117527133,0.2584637524734664,0.05768423577382023,-5664,3601,-1595,-3658,-0.03633226498407205,0.043794549067249916,-0.007462284083178006,35471,-4069,0.42538825927924684,-0.028869980900894043
14549,51720,Norton,Virginia,2000,867,639,24,1530,0.5666666666666667,0.4176470588235294,0.01568627450980392,0,0,0,0,0.0,0.0,0.0,228,0,0.14901960784313723,0.0
14550,51720,Norton,Virginia,2004,725,768,11,1504,0.4820478723404255,0.5106382978723404,0.007313829787234043,-142,-13,129,-26,-0.08461879432624114,-0.008372444722569879,0.09299123904881096,-43,-271,-0.028590425531914876,-0.1776100333750521
14551,51720,Norton,Virginia,2008,743,744,25,1512,0.4914021164021164,0.49206349206349204,0.016534391534391533,18,14,-24,8,0.009354244061690886,0.00922056174715749,-0.01857480580884835,-1,42,-0.0006613756613756405,0.027929049870539235
14552,51720,Norton,Virginia,2012,566,895,31,1492,0.37935656836461124,0.5998659517426274,0.020777479892761394,-177,6,151,-20,-0.11204554803750516,0.004243088358369861,0.10780245967913532,-329,-328,-0.22050938337801612,-0.21984800771664048
14553,51720,Norton,Virginia,2016,383,1021,56,1460,0.2623287671232877,0.6993150684931507,0.038356164383561646,-183,25,126,-32,-0.11702780124132356,0.017578684490800252,0.09944911675052337,-638,-309,-0.43698630136986305,-0.21647691799184693
14554,51730,Petersburg,Virginia,2000,8751,2109,202,11062,0.7910866027843066,0.19065268486711265,0.018260712348580725,0,0,0,0,0.0,0.0,0.0,6642,0,0.600433917917194,0.0
14555,51730,Petersburg,Virginia,2004,9682,2238,29,11949,0.8102770106285044,0.18729600803414512,0.002426981337350406,931,-173,129,887,0.019190407844197788,-0.01583373101123032,-0.003356676832967531,7444,802,0.6229810025943593,0.022547084677165263
14556,51730,Petersburg,Virginia,2008,13774,1583,183,15540,0.8863577863577864,0.10186615186615186,0.011776061776061776,4092,154,-655,3591,0.07608077572928196,0.00934908043871137,-0.08542985616799326,12191,4747,0.7844916344916345,0.16151063189727521
14557,51730,Petersburg,Virginia,2012,14283,1527,98,15908,0.8978501382951973,0.09598943927583606,0.006160422428966558,509,-85,-56,368,0.011492351937410938,-0.005615639347095218,-0.005876712590315802,12756,565,0.8018606990193613,0.017369064527726796
14558,51730,Petersburg,Virginia,2016,12021,1451,314,13786,0.8719715653561584,0.10525170462788336,0.02277673001595822,-2262,216,-76,-2122,-0.025878572939038946,0.01661630758699166,0.0092622653520473,10570,-2186,0.766719860728275,-0.035140838291086274
14559,51735,Poquoson,Virginia,2000,1448,4271,142,5861,0.24705681624296194,0.7287152363077973,0.024227947449240745,0,0,0,0,0.0,0.0,0.0,-2823,0,-0.4816584200648354,0.0
14560,51735,Poquoson,Virginia,2004,1424,5004,52,6480,0.21975308641975308,0.7722222222222223,0.008024691358024692,-24,-90,733,619,-0.02730372982320886,-0.016203256091216055,0.04350698591442492,-3580,-757,-0.5524691358024691,-0.07081071573763376
14561,51735,Poquoson,Virginia,2008,1748,5229,88,7065,0.24741684359518754,0.7401273885350318,0.012455767869780608,324,36,225,585,0.027663757175434456,0.004431076511755916,-0.03209483368719046,-3481,99,-0.49271054493984423,0.059758590862624916
14562,51735,Poquoson,Virginia,2012,1679,5312,115,7106,0.2362792006754855,0.7475372924289333,0.0161835068955812,-69,27,83,41,-0.01113764291970204,0.0037277390258005916,0.007409903893901504,-3633,-152,-0.5112580917534478,-0.0185475468136036
14563,51735,Poquoson,Virginia,2016,1601,5092,484,7177,0.2230737076773025,0.70948864428034,0.06743764804235754,-78,369,-220,71,-0.013205492998182994,0.05125414114677634,-0.03804864814859332,-3491,142,-0.4864149366030375,0.024843155150410356
14564,51740,Portsmouth,Virginia,2000,22286,12628,541,35455,0.6285714285714286,0.35616979269496546,0.015258778733605979,0,0,0,0,0.0,0.0,0.0,9658,0,0.2724016358764631,0.0
14565,51740,Portsmouth,Virginia,2004,24112,15212,210,39534,0.6099053978853645,0.38478271867253505,0.005311883442100471,1826,-331,2584,4079,-0.018666030686064095,-0.009946895291505508,0.028612925977569592,8900,-758,0.2251226792128294,-0.04727895666363369
14566,51740,Portsmouth,Virginia,2008,32327,13984,354,46665,0.6927461695060538,0.2996678452801886,0.007585985213757634,8215,144,-1228,7131,0.08284077162068937,0.0022741017716571632,-0.08511487339234647,18343,9443,0.39307832422586525,0.16795564501303584
14567,51740,Portsmouth,Virginia,2012,32501,12858,563,45922,0.7077435651757328,0.279996515831192,0.012259918993075214,174,209,-1126,-743,0.014997395669678948,0.00467393377931758,-0.019671329448996577,19643,1300,0.4277470493445408,0.034668725118675525
14568,51740,Portsmouth,Virginia,2016,28497,12795,1969,43261,0.6587226370171748,0.2957629273479577,0.045514435634867435,-4004,1406,-63,-2661,-0.049020928158557964,0.03325451664179222,0.01576641151676572,15702,-3941,0.3629597096692171,-0.06478733967532369
14569,51750,Radford,Virginia,2000,2063,2190,195,4448,0.46380395683453235,0.49235611510791366,0.043839928057553955,0,0,0,0,0.0,0.0,0.0,-127,0,-0.028552158273381312,0.0
14570,51750,Radford,Virginia,2004,2244,2564,37,4845,0.4631578947368421,0.5292053663570692,0.0076367389060887515,181,-158,374,397,-0.0006460620976902476,-0.036203189151465205,0.0368492512491555,-320,-193,-0.06604747162022706,-0.03749531334684575
14571,51750,Radford,Virginia,2008,2930,2418,81,5429,0.5396942346656843,0.4453858905875852,0.01491987474673052,686,44,-146,584,0.07653633992884223,0.007283135840641769,-0.08381947576948395,512,832,0.09430834407809913,0.1603558156983262
14572,51750,Radford,Virginia,2012,2732,2520,147,5399,0.5060196332654195,0.46675310242637524,0.027227264308205223,-198,66,102,-30,-0.03367460140026479,0.012307389561474702,0.021367211838790034,212,-300,0.0392665308390443,-0.055041813239054826
14573,51750,Radford,Virginia,2016,2925,2638,519,6082,0.48092732653732323,0.4337389016770799,0.08533377178559684,193,372,118,683,-0.025092306728096314,0.058106507477391614,-0.03301420074929534,287,75,0.04718842486024333,0.007921894021199027
14574,51760,Richmond City,Virginia,2000,42717,20265,2944,65926,0.6479537663440827,0.3073901040560629,0.044656129599854384,0,0,0,0,0.0,0.0,0.0,22452,0,0.3405636622880199,0.0
14575,51760,Richmond City,Virginia,2004,52167,21637,521,74325,0.7018768920282543,0.29111335351496803,0.007009754456777666,9450,-2423,1372,8399,0.05392312568417157,-0.03764637514307672,-0.016276750541094842,30530,8078,0.4107635385132863,0.07019987622526641
14576,51760,Richmond City,Virginia,2008,73623,18649,813,93085,0.7909222753397432,0.20034377182145352,0.008733952838803244,21456,292,-2988,18760,0.08904538331148892,0.0017241983820255775,-0.09076958169351451,54974,24444,0.5905785035182898,0.1798149650050035
14577,51760,Richmond City,Virginia,2012,75921,20050,1598,97569,0.7781262491160102,0.20549559798706557,0.01637815289692423,2298,785,1401,4484,-0.012796026223732992,0.007644200058120986,0.00515182616561205,55871,897,0.5726306511289447,-0.017947852389345043
14578,51760,Richmond City,Virginia,2016,81259,15581,6566,103406,0.7858248070711564,0.15067791037270564,0.06349728255613794,5338,4968,-4469,5837,0.007698557955146179,0.047119129659213714,-0.05481768761435993,65678,9807,0.6351468966984508,0.06251624556950608
14579,51770,Roanoke City,Virginia,2000,17920,14630,892,33442,0.5358531188326057,0.437473835296932,0.026673045870462292,0,0,0,0,0.0,0.0,0.0,3290,0,0.09837928353567366,0.0
14580,51770,Roanoke City,Virginia,2004,18862,16661,477,36000,0.5239444444444444,0.4628055555555556,0.01325,942,-415,2031,2558,-0.011908674388161233,-0.013423045870462292,0.02533172025862357,2201,-1089,0.061138888888888854,-0.0372403946467848
14581,51770,Roanoke City,Virginia,2008,24934,15394,444,40772,0.6115471401942509,0.3775630334543314,0.01088982635141764,6072,-33,-1267,4772,0.0876026957498065,-0.00236017364858236,-0.08524252210122418,9540,7339,0.23398410673991954,0.17284521785103069
14582,51770,Roanoke City,Virginia,2012,24134,14991,1030,40155,0.6010210434566057,0.373328352633545,0.025650603909849332,-800,586,-403,-617,-0.010526096737645263,0.014760777558431692,-0.004234680820786374,9143,-397,0.22769269082306065,-0.006291415916858889
14583,51770,Roanoke City,Virginia,2016,22286,14789,2391,39466,0.5646885927127148,0.3747276136421223,0.06058379364516293,-1848,1361,-202,-689,-0.03633245074389091,0.03493318973531359,0.0013992610085772905,7497,-1646,0.18996097907059245,-0.0377317117524682
14584,51775,Salem,Virginia,2000,4348,6188,234,10770,0.40371402042711235,0.5745589600742804,0.021727019498607242,0,0,0,0,0.0,0.0,0.0,-1840,0,-0.17084493964716807,0.0
14585,51775,Salem,Virginia,2004,4254,7115,115,11484,0.3704284221525601,0.6195576454197144,0.010013932427725532,-94,-119,927,714,-0.03328559827455224,-0.01171308707088171,0.04499868534543394,-2861,-1021,-0.24912922326715425,-0.07828428361998618
14586,51775,Salem,Virginia,2008,5164,7088,154,12406,0.41625020151539577,0.571336450104788,0.012413348379816218,910,39,-27,922,0.04582177936283566,0.002399415952090686,-0.04822119531492641,-1924,937,-0.15508624858939218,0.09404297467776207
14587,51775,Salem,Virginia,2012,4760,7299,259,12318,0.38642636791686963,0.5925474914758889,0.021026140607241436,-404,105,211,-88,-0.02982383359852614,0.008612792227425219,0.02121104137110097,-2539,-615,-0.2061211235590193,-0.05103487496962711
14588,51775,Salem,Virginia,2016,4202,7226,797,12225,0.34372188139059306,0.5910838445807771,0.06519427402862986,-558,538,-73,-93,-0.042704486526276564,0.04416813342138842,-0.0014636468951118031,-3024,-485,-0.24736196319018405,-0.04124083963116476
14589,51790,Staunton,Virginia,2000,3324,4878,312,8514,0.390415785764623,0.572938689217759,0.036645525017618044,0,0,0,0,0.0,0.0,0.0,-1554,0,-0.18252290345313604,0.0
14590,51790,Staunton,Virginia,2004,3756,5805,68,9629,0.39007165853151937,0.6028663412607748,0.007062000207705889,432,-244,927,1115,-0.00034412723310361937,-0.029583524809912155,0.02992765204301573,-2049,-495,-0.2127946827292554,-0.03027177927611935
14591,51790,Staunton,Virginia,2008,5569,5330,116,11015,0.505583295506128,0.48388561053109397,0.01053109396277803,1813,48,-475,1386,0.11551163697460864,0.0034690937550721406,-0.1189807307296808,239,2288,0.02169768497503405,0.23449236770428944
14592,51790,Staunton,Virginia,2012,5728,5272,210,11210,0.5109723461195361,0.47029438001784124,0.01873327386262266,159,94,-58,195,0.005389050613408108,0.00820217989984463,-0.013591230513252728,456,217,0.040677966101694885,0.018980281126660836
14593,51790,Staunton,Virginia,2016,5333,5133,789,11255,0.47383385162150155,0.4560639715681919,0.07010217681030653,-395,579,-139,45,-0.03713849449803458,0.05136890294768387,-0.014230408449649345,200,-256,0.01776988005330965,-0.022908086048385234
14594,51800,Suffolk,Virginia,2000,12471,11836,354,24661,0.5056972547747456,0.47994809618425854,0.014354649040995905,0,0,0,0,0.0,0.0,0.0,635,0,0.025749158590487042,0.0
14595,51800,Suffolk,Virginia,2004,15233,16763,193,32189,0.47323619870141975,0.5207679642113766,0.005995837087203703,2762,-161,4927,7528,-0.032461056073325834,-0.008358811953792202,0.04081986802711807,-1530,-2165,-0.04753176550995686,-0.0732809241004439
14596,51800,Suffolk,Virginia,2008,22446,17165,297,39908,0.5624436203267515,0.43011426280445025,0.007442116868798236,7213,104,402,7719,0.0892074216253318,0.001446279781594533,-0.09065370140692636,5281,6811,0.1323293575223013,0.17986112303225815
14597,51800,Suffolk,Virginia,2012,24267,17820,479,42566,0.5701028990273928,0.418643988159564,0.011253112813043274,1821,182,655,2658,0.007659278700641203,0.0038109959442450382,-0.011470274644886258,6447,1166,0.15145891086782876,0.01912955334552746
14598,51800,Suffolk,Virginia,2016,23280,18006,1954,43240,0.5383903792784459,0.41641998149861237,0.04518963922294172,-987,1475,186,674,-0.031712519748946844,0.03393652640989844,-0.0022240066609516274,5274,-1173,0.12197039777983354,-0.029488513087995216
14599,51810,Virginia Beach,Virginia,2000,62268,83674,3829,149771,0.41575471887080945,0.5586795841651588,0.025565696964031756,0,0,0,0,0.0,0.0,0.0,-21406,0,-0.1429248652943494,0.0
14600,51810,Virginia Beach,Virginia,2004,70666,103752,1269,175687,0.40222668723354604,0.590550239915304,0.007223072851150056,8398,-2560,20078,25916,-0.013528031637263405,-0.0183426241128817,0.03187065575014514,-33086,-11680,-0.18832355268175793,-0.04539868738740854
14601,51810,Virginia Beach,Virginia,2008,98885,100319,2045,201249,0.4913564787899567,0.4984819800346834,0.010161541175359877,28219,776,-3433,25562,0.08912979155641065,0.002938468324209821,-0.09206825988062056,-1434,31652,-0.007125501244726717,0.18119805143703122
14602,51810,Virginia Beach,Virginia,2012,94299,99291,3051,196641,0.4795490258898195,0.5049353898729156,0.015515584237264863,-4586,1006,-1028,-4608,-0.011807452900137183,0.005354043061904986,0.006453409838232227,-4992,-3558,-0.025386363983096127,-0.01826086273836941
14603,51810,Virginia Beach,Virginia,2016,91032,98224,13763,203019,0.4483915298568114,0.48381678562105024,0.06779168452213832,-3267,10712,-1067,6378,-0.031157496033008103,0.052276100284873464,-0.021118604251865403,-7192,-2200,-0.03542525576423883,-0.0100388917811427
14604,51820,Waynesboro,Virginia,2000,2737,4084,281,7102,0.3853843987609124,0.5750492818924247,0.03956631934666291,0,0,0,0,0.0,0.0,0.0,-1347,0,-0.18966488313151225,0.0
14605,51820,Waynesboro,Virginia,2004,2792,5092,79,7963,0.3506216250156976,0.6394574908953912,0.009920884088911215,55,-202,1008,861,-0.0347627737452148,-0.029645435257751693,0.06440820900296651,-2300,-953,-0.28883586587969357,-0.09917098274818131
14606,51820,Waynesboro,Virginia,2008,3906,4815,139,8860,0.44085778781038376,0.5434537246049661,0.015688487584650114,1114,60,-277,897,0.09023616279468616,0.005767603495738899,-0.09600376629042506,-909,1391,-0.10259593679458234,0.18623992908511122
14607,51820,Waynesboro,Virginia,2012,3840,4790,161,8791,0.43681037424638836,0.5448754407917188,0.018314184961892844,-66,22,-25,-69,-0.004047413563995406,0.00262569737724273,0.0014217161867526862,-950,-41,-0.10806506654533043,-0.005469129750748092
14608,51820,Waynesboro,Virginia,2016,3764,4801,639,9204,0.40895262929161236,0.5216210343328987,0.06942633637548892,-76,478,11,413,-0.027857744954775998,0.05111215141359608,-0.023254406458820043,-1037,-87,-0.11266840504128639,-0.004603338495955955
14609,51830,Williamsburg,Virginia,2000,1724,1777,224,3725,0.4628187919463087,0.4770469798657718,0.06013422818791946,0,0,0,0,0.0,0.0,0.0,-53,0,-0.01422818791946312,0.0
14610,51830,Williamsburg,Virginia,2004,2216,2064,40,4320,0.512962962962963,0.4777777777777778,0.009259259259259259,492,-184,287,595,0.05014417101665425,-0.050874968928660204,0.000730797912005976,152,205,0.03518518518518515,0.04941337310464827
14611,51830,Williamsburg,Virginia,2008,4328,2353,106,6787,0.6376897008987771,0.34669220568734344,0.015618093413879475,2112,66,289,2467,0.12472673793581412,0.006358834154620217,-0.13108557209043437,1975,1823,0.29099749521143364,0.2558123100262485
14612,51830,Williamsburg,Virginia,2012,4903,2682,163,7748,0.6328084667010841,0.34615384615384615,0.021037687145069695,575,57,329,961,-0.00488123419769293,0.00541959373119022,-0.0005383595334972902,2221,246,0.286654620547238,-0.0043428746641956395
14613,51830,Williamsburg,Virginia,2016,5206,1925,495,7626,0.6826645685811696,0.25242591135588777,0.06490952006294257,303,332,-757,-122,0.04985610188008549,0.043871832917872874,-0.09372793479795838,3281,1060,0.4302386572252819,0.14358403667804387
14614,51840,Winchester,Virginia,2000,3318,4314,254,7886,0.4207456251585088,0.5470453969059093,0.03220897793558204,0,0,0,0,0.0,0.0,0.0,-996,0,-0.12629977174740048,0.0
14615,51840,Winchester,Virginia,2004,3967,5283,93,9343,0.4245959541903029,0.5654500695708017,0.00995397623889543,649,-161,969,1457,0.0038503290317941086,-0.022255001696686615,0.01840467266489243,-1316,-320,-0.1408541153804988,-0.014554343633098321
14616,51840,Winchester,Virginia,2008,5268,4725,133,10126,0.5202449140825598,0.4666205806833893,0.013134505234050959,1301,40,-558,783,0.09564895989225691,0.0031805289951555293,-0.09882948888741239,543,1859,0.0536243333991705,0.1944784487796693
14617,51840,Winchester,Virginia,2012,5094,4946,256,10296,0.49475524475524474,0.48038073038073037,0.024864024864024864,-174,123,221,170,-0.025489669327315057,0.011729519629973905,0.013760149697341073,148,-395,0.014374514374514369,-0.03924981902465613
14618,51840,Winchester,Virginia,2016,5164,4790,711,10665,0.4842006563525551,0.44913267698077824,0.06666666666666667,70,455,-156,369,-0.010554588402689635,0.0418026418026418,-0.031248053399952125,374,226,0.03506797937177686,0.02069346499726249
14619,53001,Adams,Washington,2000,1406,3440,128,4974,0.28266988339364696,0.6915963007639726,0.025733815842380377,0,0,0,0,0.0,0.0,0.0,-2034,0,-0.40892641737032565,0.0
14620,53001,Adams,Washington,2004,1315,3751,61,5127,0.25648527403939925,0.731616929978545,0.011897795982055783,-91,-67,311,153,-0.026184609354247712,-0.013836019860324594,0.04002062921457239,-2436,-402,-0.47513165593914575,-0.0662052385688201
14621,53001,Adams,Washington,2008,1552,3222,84,4858,0.3194730341704405,0.6632358995471387,0.01729106628242075,237,23,-529,-269,0.06298776013104124,0.005393270300364968,-0.06838103043140631,-1670,766,-0.3437628653766982,0.13136879056244755
14622,53001,Adams,Washington,2012,1540,3171,111,4822,0.3193695562007466,0.6576109498133554,0.023019493985897966,-12,27,-51,-36,-0.00010347796969389922,0.005728427703477215,-0.005624949733783247,-1631,39,-0.33824139361260885,0.005521471764089347
14623,53001,Adams,Washington,2016,1299,3083,400,4782,0.2716436637390213,0.6447093266415725,0.0836470096194061,-241,289,-88,-40,-0.04772589246172526,0.06062751563350814,-0.012901623171782894,-1784,-153,-0.3730656629025512,-0.03482426928994237
14624,53003,Asotin,Washington,2000,2736,4909,340,7985,0.34264245460237946,0.6147777082028804,0.042579837194740136,0,0,0,0,0.0,0.0,0.0,-2173,0,-0.2721352536005009,0.0
14625,53003,Asotin,Washington,2004,3319,5320,147,8786,0.37776007284315954,0.605508763942636,0.016731163214204415,583,-193,411,801,0.03511761824078008,-0.02584867398053572,-0.009268944260244383,-2001,172,-0.22774869109947643,0.04438656250102446
14626,53003,Asotin,Washington,2008,4139,5451,190,9780,0.4232106339468303,0.557361963190184,0.019427402862985686,820,43,131,994,0.04545056110367074,0.0026962396487812713,-0.048146800752451924,-1312,689,-0.13415132924335377,0.09359736185612266
14627,53003,Asotin,Washington,2012,4003,5654,315,9972,0.40142398716405936,0.566987565182511,0.0315884476534296,-136,125,203,192,-0.021786646782770924,0.012161044790443915,0.009625601992326982,-1651,-339,-0.16556357801845167,-0.031412248775097906
14628,53003,Asotin,Washington,2016,3134,5741,1099,9974,0.3142169641066774,0.575596551032685,0.11018648486063766,-869,784,87,2,-0.08720702305738198,0.07859803720720807,0.008608985850174,-2607,-956,-0.26137958692600766,-0.09581600890755598
14629,53005,Benton,Washington,2000,19512,38367,1900,59779,0.326402248281169,0.6418140149550846,0.03178373676374647,0,0,0,0,0.0,0.0,0.0,-18855,0,-0.31541176667391563,0.0
14630,53005,Benton,Washington,2004,21549,44350,993,66892,0.32214614602643066,0.6630090294803564,0.01484482449321294,2037,-907,5983,7113,-0.004256102254738325,-0.016938912270533527,0.021195014525271838,-22801,-3946,-0.3408628834539258,-0.025451116780010163
14631,53005,Benton,Washington,2008,26288,45345,1708,73341,0.35843525449612085,0.6182762711171105,0.023288474386768655,4739,715,995,6449,0.03628910846969019,0.008443649893555715,-0.04473275836324597,-19057,3744,-0.25984101662098963,0.08102186683293616
14632,53005,Benton,Washington,2012,28145,49461,2607,80213,0.3508782865620286,0.6166207472604192,0.032500966177552264,1857,899,4116,6872,-0.0075569679340922735,0.009212491790783608,-0.001655523856691321,-21316,-2259,-0.2657424606983906,-0.0059014440774009524
14633,53005,Benton,Washington,2016,26360,47194,10038,83592,0.3153411809742559,0.5645755574696143,0.12008326155612978,-1785,7431,-2267,3379,-0.03553710558777268,0.08758229537857751,-0.05204518979080486,-20834,482,-0.2492343764953584,0.01650808420303218
14634,53007,Chelan,Washington,2000,8412,16980,1184,26576,0.3165261890427453,0.6389223359422035,0.044551475015051176,0,0,0,0,0.0,0.0,0.0,-8568,0,-0.32239614689945817,0.0
14635,53007,Chelan,Washington,2004,10471,18482,477,29430,0.35579340808698606,0.6279986408426775,0.01620795107033639,2059,-707,1502,2854,0.03926721904424074,-0.028343523944714785,-0.010923695099525954,-8011,557,-0.2722052327556915,0.050190914143766696
14636,53007,Chelan,Washington,2008,13781,17605,777,32163,0.4284737120293505,0.5473680937723471,0.024158194198302396,3310,300,-877,2733,0.07268030394236441,0.007950243127966005,-0.08063054707033046,-3824,4187,-0.1188943817429966,0.15331085101269487
14637,53007,Chelan,Washington,2012,13112,18402,974,32488,0.4035951736025609,0.566424525978823,0.029980300418616105,-669,197,797,325,-0.024878538426789554,0.005822106220313709,0.019056432206475904,-5290,-1466,-0.16282935237626206,-0.04393497063326546
14638,53007,Chelan,Washington,2016,13032,18114,3287,34433,0.37847413818139575,0.5260651119565533,0.09546074986205094,-80,2313,-288,1945,-0.025121035421165172,0.06548044944343484,-0.040359414022269724,-5082,208,-0.1475909737751575,0.015238378601104552
14639,53009,Clallam,Washington,2000,13779,16251,2202,32232,0.42749441548771405,0.5041883842144452,0.06831720029784065,0,0,0,0,0.0,0.0,0.0,-2472,0,-0.07669396872673118,0.0
14640,53009,Clallam,Washington,2004,17049,18871,846,36766,0.46371647718000325,0.513273132785726,0.023010390034270793,3270,-1356,2620,4534,0.0362220616922892,-0.045306810263569856,0.00908474857128072,-1822,650,-0.0495566556057227,0.027137313121008477
14641,53009,Clallam,Washington,2008,19470,18199,851,38520,0.5054517133956387,0.4724558670820353,0.022092419522326063,2421,5,-672,1754,0.04173523621563541,-0.0009179705119447303,-0.04081726570369065,1271,3093,0.03299584631360336,0.08255250191932606
14642,53009,Clallam,Washington,2012,18580,18437,1368,38385,0.4840432460596587,0.48031783248664844,0.03563892145369285,-890,517,238,-135,-0.021408467335979953,0.013546501931366788,0.007861965404613147,143,-1128,0.003725413573010261,-0.0292704327405931
14643,53009,Clallam,Washington,2016,17677,18794,4062,40533,0.4361137838304591,0.46367157624651517,0.10021463992302568,-903,2694,357,2148,-0.04792946222919958,0.06457571846933283,-0.016646256240133273,-1117,-1260,-0.02755779241605605,-0.03128320598906631
14644,53011,Clark,Washington,2000,61767,67219,6558,135544,0.4556970430266187,0.49592014401227646,0.04838281296110488,0,0,0,0,0.0,0.0,0.0,-5452,0,-0.04022310098565779,0.0
14645,53011,Clark,Washington,2004,79538,88646,2311,170495,0.4665122144344409,0.5199331358690871,0.013554649696472037,17771,-4247,21427,34951,0.010815171407822233,-0.034828163264632846,0.024012991856810606,-9108,-3656,-0.05342092143464616,-0.013197820448988373
14646,53011,Clark,Washington,2008,95356,84212,4357,183925,0.5184504553486475,0.4578605409813783,0.023689003669974174,15818,2046,-4434,13430,0.051938240914206624,0.010134353973502137,-0.062072594887708776,11144,20252,0.06058991436726924,0.1140108358019154
14647,53011,Clark,Washington,2012,93382,92951,5843,192176,0.48591915743901426,0.4836764216135209,0.030404420947464823,-1974,1486,8739,8251,-0.03253129790963327,0.00671541727749065,0.02581588063214263,431,-10713,0.002242735825493336,-0.0583471785417759
14648,53011,Clark,Washington,2016,92757,92441,23287,208485,0.4449097057342255,0.44339400916133054,0.11169628510444396,-625,17444,-510,16309,-0.04100945170478876,0.08129186415697914,-0.040282412452190386,316,-115,0.0015156965728949645,-0.0007270392525983715
14649,53013,Columbia,Washington,2000,515,1523,69,2107,0.24442335073564309,0.722828666350261,0.03274798291409587,0,0,0,0,0.0,0.0,0.0,-1008,0,-0.4784053156146179,0.0
14650,53013,Columbia,Washington,2004,605,1470,32,2107,0.28713811105837683,0.6976744186046512,0.015187470336971999,90,-37,-53,0,0.04271476032273375,-0.01756051257712387,-0.025154247745609815,-865,143,-0.41053630754627435,0.06786900806834356
14651,53013,Columbia,Washington,2008,686,1499,73,2258,0.3038086802480071,0.6638618246235607,0.032329495128432244,81,41,29,151,0.01667056918963028,0.017142024791460243,-0.03381259398109049,-813,52,-0.3600531443755536,0.05048316317072077
14652,53013,Columbia,Washington,2012,645,1568,67,2280,0.28289473684210525,0.6877192982456141,0.029385964912280703,-41,-6,69,22,-0.020913943405901858,-0.002943530216151541,0.02385747362205337,-923,-110,-0.4048245614035088,-0.04477141702795523
14653,53013,Columbia,Washington,2016,526,1497,206,2229,0.23598026020637056,0.6716016150740243,0.0924181247196052,-119,139,-71,-51,-0.0469144766357347,0.06303215980732449,-0.01611768317158979,-971,-48,-0.43562135486765374,-0.030796793464144934
14654,53015,Cowlitz,Washington,2000,18233,16873,1856,36962,0.493290406363292,0.45649586061360314,0.05021373302310481,0,0,0,0,0.0,0.0,0.0,1360,0,0.03679454574968888,0.0
14655,53015,Cowlitz,Washington,2004,21589,20217,724,42530,0.5076181518927816,0.47535857042087937,0.017023277686339055,3356,-1132,3344,5568,0.014327745529489566,-0.03319045533676576,0.018862709807276223,1372,12,0.03225958147190222,-0.004534964277786657
14656,53015,Cowlitz,Washington,2008,24597,19554,1361,45512,0.5404508701001933,0.4296449288099842,0.029904201089822464,3008,637,-663,2982,0.03283271820741174,0.012880923403483409,-0.045713641610895195,5043,3671,0.11080594129020915,0.07854635981830693
14657,53015,Cowlitz,Washington,2012,22726,20746,1540,45012,0.5048875855327468,0.4608993157380254,0.03421309872922776,-1871,179,1192,-500,-0.03556328456744651,0.004308897639405295,0.03125438692804122,1980,-3063,0.043988269794721424,-0.06681767149548773
14658,53015,Cowlitz,Washington,2016,17908,24185,5049,47142,0.3798735734589114,0.5130244792329558,0.10710194730813287,-4818,3509,3439,2130,-0.12501401207383545,0.07288884857890511,0.052125163494930404,-6277,-8257,-0.13315090577404443,-0.17713917556876585
14659,53017,Douglas,Washington,2000,3822,8512,521,12855,0.297316219369895,0.6621548035783742,0.04052897705173084,0,0,0,0,0.0,0.0,0.0,-4690,0,-0.3648385842084792,0.0
14660,53017,Douglas,Washington,2004,4306,8900,166,13372,0.32201615315584803,0.665569847442417,0.012413999401734968,484,-355,388,517,0.024699933785953032,-0.028114977649995876,0.0034150438640427883,-4594,96,-0.34355369428656896,0.021284889921910244
14661,53017,Douglas,Washington,2008,5848,9098,339,15285,0.38259731763166505,0.5952240758913968,0.022178606476938173,1542,173,198,1913,0.06058116447581702,0.009764607075203205,-0.07034577155102018,-3250,1344,-0.21262675825973176,0.1309269360268372
14662,53017,Douglas,Washington,2012,5166,9425,469,15060,0.3430278884462151,0.6258300132802125,0.031142098273572377,-682,130,327,-225,-0.03956942918544992,0.008963491796634204,0.030605937388815674,-4259,-1009,-0.28280212483399736,-0.0701753665742656
14663,53017,Douglas,Washington,2016,4918,9603,1380,15901,0.3092887239796239,0.60392428149173,0.086786994528646,-248,911,178,841,-0.0337391644665912,0.055644896255073614,-0.02190573178848243,-4685,-426,-0.2946355575121061,-0.011833432678108768
14664,53019,Ferry,Washington,2000,932,1896,210,3038,0.3067807768268598,0.6240947992100065,0.06912442396313365,0,0,0,0,0.0,0.0,0.0,-964,0,-0.31731402238314677,0.0
14665,53019,Ferry,Washington,2004,1201,2019,124,3344,0.3591507177033493,0.603767942583732,0.03708133971291866,269,-86,123,306,0.052369940876489496,-0.03204308425021499,-0.020326856626274536,-818,146,-0.24461722488038273,0.07269679750276403
14666,53019,Ferry,Washington,2008,1467,1916,153,3536,0.41487556561085975,0.5418552036199095,0.04326923076923077,266,29,-103,192,0.05572484790751048,0.006187891056312109,-0.061912738963822544,-449,369,-0.1269796380090497,0.11763758687133302
14667,53019,Ferry,Washington,2012,1294,1995,199,3488,0.3709862385321101,0.5719610091743119,0.05705275229357798,-173,46,79,-48,-0.04388932707874965,0.013783521524347211,0.030105805554402454,-701,-252,-0.20097477064220182,-0.0739951326331521
14668,53019,Ferry,Washington,2016,1098,2202,344,3644,0.3013172338090011,0.6042810098792536,0.09440175631174534,-196,145,207,156,-0.069669004723109,0.03734900401816736,0.032320000704941676,-1104,-403,-0.3029637760702525,-0.10198900542805067
14669,53021,Franklin,Washington,2000,4653,8594,367,13614,0.3417805200528867,0.6312619362421037,0.026957543705009548,0,0,0,0,0.0,0.0,0.0,-3941,0,-0.28948141618921697,0.0
14670,53021,Franklin,Washington,2004,5188,10757,214,16159,0.32105947150194936,0.6656971347236834,0.013243393774367226,535,-153,2163,2545,-0.02072104855093737,-0.013714149930642322,0.03443519848157972,-5569,-1628,-0.34463766322173406,-0.05515624703251709
14671,53021,Franklin,Washington,2008,7361,12037,397,19795,0.3718615812073756,0.6080828492043445,0.020055569588279868,2173,183,1280,3636,0.05080210970542626,0.006812175813912642,-0.05761428551933889,-4676,893,-0.2362212679969689,0.10841639522476515
14672,53021,Franklin,Washington,2012,8398,13748,618,22764,0.368915832015463,0.6039360393603936,0.027148128624143383,1037,221,1711,2969,-0.0029457491919125944,0.007092559035863515,-0.004146809843950883,-5350,-674,-0.23502020734493062,0.0012010606520382883
14673,53021,Franklin,Washington,2016,8886,13206,2522,24614,0.36101405704070855,0.5365239294710328,0.10246201348825872,488,1904,-542,1850,-0.007901774974754472,0.07531388486411533,-0.06741210988936086,-4320,1030,-0.17550987243032423,0.05951033491460639
14674,53023,Garfield,Washington,2000,300,982,47,1329,0.22573363431151242,0.7389014296463506,0.035364936042136946,0,0,0,0,0.0,0.0,0.0,-682,0,-0.5131677953348383,0.0
14675,53023,Garfield,Washington,2004,365,935,20,1320,0.2765151515151515,0.7083333333333334,0.015151515151515152,65,-27,-47,-9,0.050781517203639076,-0.020213420890621794,-0.030568096313017268,-570,112,-0.4318181818181819,0.08134961351665637
14676,53023,Garfield,Washington,2008,385,968,20,1373,0.28040786598689005,0.7050254916241806,0.014566642388929352,20,0,33,53,0.0038927144717385564,-0.0005848727625858002,-0.00330784170915277,-583,-13,-0.42461762563729055,0.0072005561808913265
14677,53023,Garfield,Washington,2012,336,913,32,1281,0.26229508196721313,0.7127244340359095,0.02498048399687744,-49,12,-55,-92,-0.01811278401967692,0.010413841607948088,0.00769894241172886,-577,6,-0.45042935206869633,-0.02581172643140578
14678,53023,Garfield,Washington,2016,279,851,136,1266,0.22037914691943128,0.6721958925750395,0.10742496050552923,-57,104,-62,-15,-0.04191593504778185,0.08244447650865179,-0.04052854146086993,-572,5,-0.45181674565560825,-0.0013873935869119225
14679,53025,Grant,Washington,2000,7073,15830,895,23798,0.29720984956719054,0.6651819480628625,0.03760820236994705,0,0,0,0,0.0,0.0,0.0,-8757,0,-0.3679720984956719,0.0
14680,53025,Grant,Washington,2004,7779,17799,417,25995,0.29924985574148877,0.6847085978072707,0.01604154645124062,706,-478,1969,2197,0.0020400061742982256,-0.02156665591870643,0.01952664974440821,-10020,-1263,-0.3854587420657819,-0.017486643570109983
14681,53025,Grant,Washington,2008,9601,17153,880,27634,0.34743432004052976,0.6207208511254252,0.03184482883404502,1822,463,-646,1639,0.048184464299041,0.015803282382804398,-0.06398774668184548,-7552,2468,-0.2732865310848954,0.11217221098088648
14682,53025,Grant,Washington,2012,8950,17852,1027,27829,0.32160695677171297,0.6414890941104603,0.036903949117826726,-651,147,699,195,-0.025827363268816794,0.005059120283781707,0.0207682429850351,-8902,-1350,-0.3198821373387473,-0.046595606253851896
14683,53025,Grant,Washington,2016,7810,18518,2930,29258,0.2669355389978809,0.6329209105201996,0.10014355048191947,-1140,1903,666,1429,-0.054671417773832054,0.06323960136409275,-0.00856818359026068,-10708,-1806,-0.3659853715223187,-0.04610323418357137
14684,53027,Grays Harbor,Washington,2000,13304,11225,1443,25972,0.5122439550284922,0.43219621130448177,0.05555983366702603,0,0,0,0,0.0,0.0,0.0,2079,0,0.08004774372401041,0.0
14685,53027,Grays Harbor,Washington,2004,14583,12871,499,27953,0.5216971344757271,0.46045147211390547,0.017851393410367403,1279,-944,1646,1981,0.009453179447234894,-0.03770844025665862,0.0282552608094237,1712,-367,0.06124566236182161,-0.018802081362188805
14686,53027,Grays Harbor,Washington,2008,16354,12104,726,29184,0.5603755482456141,0.4147478070175439,0.024876644736842105,1771,227,-767,1231,0.03867841376988701,0.007025251326474701,-0.04570366509636159,4250,2538,0.1456277412280702,0.0843820788662486
14687,53027,Grays Harbor,Washington,2012,15960,11914,1073,28947,0.5513524717587315,0.41157978374270215,0.03706774449856635,-394,347,-190,-237,-0.009023076486882609,0.012191099761724243,-0.0031680232748417247,4046,-204,0.13977268801602932,-0.005855053212040884
14688,53027,Grays Harbor,Washington,2016,12020,14067,3214,29301,0.4102249069997611,0.4800860038906522,0.1096890891095867,-3940,2141,2153,354,-0.14112756475897037,0.07262134461102035,0.06850622014795005,-2047,-6093,-0.0698610968908911,-0.20963378490692042
14689,53029,Island,Washington,2000,14778,16408,1818,33004,0.44776390740516303,0.4971518603805599,0.05508423221427706,0,0,0,0,0.0,0.0,0.0,-1630,0,-0.04938795297539689,0.0
14690,53029,Island,Washington,2004,18216,19754,610,38580,0.47216174183514775,0.5120269569725246,0.01581130119232763,3438,-1208,3346,5576,0.02439783442998472,-0.039272931021949425,0.014875096591964732,-1538,92,-0.0398652151373769,0.00952273783801999
14691,53029,Island,Washington,2008,22058,19426,680,42164,0.5231477089460203,0.46072478891945734,0.01612750213452234,3842,70,-328,3584,0.0509859671108725,0.00031620094219471026,-0.05130216805306731,2632,4170,0.06242292002656291,0.10228813516393981
14692,53029,Island,Washington,2012,21478,19605,1289,42372,0.5068913433399415,0.46268762390257717,0.030421032757481356,-580,609,179,208,-0.016256365606078793,0.014293530622959016,0.001962834983119832,1873,-759,0.044203719437364286,-0.018219200589198625
14693,53029,Island,Washington,2016,20960,18465,4848,44273,0.47342624172746367,0.41707135274320695,0.10950240552932938,-518,3559,-1140,1901,-0.03346510161247779,0.07908137277184803,-0.045616271159370225,2495,622,0.056354888984256724,0.012151169546892437
14694,53031,Jefferson,Washington,2000,8281,6095,1457,15833,0.523021537295522,0.38495547274679465,0.09202298995768332,0,0,0,0,0.0,0.0,0.0,2186,0,0.13806606454872739,0.0
14695,53031,Jefferson,Washington,2004,11610,6650,390,18650,0.6225201072386058,0.35656836461126007,0.02091152815013405,3329,-1067,555,2817,0.09949856994308381,-0.07111146180754926,-0.028387108135534578,4960,2774,0.2659517426273458,0.1278856780786184
14696,53031,Jefferson,Washington,2008,13252,6330,541,20123,0.6585499180042738,0.3145654226506982,0.026884659345028077,1642,151,-320,1473,0.03602981076566791,0.005973131194894028,-0.04200294196056187,6922,1962,0.34398449535357556,0.07803275272622978
14697,53031,Jefferson,Washington,2012,12739,6405,817,19961,0.6381944792345073,0.32087570762987827,0.040929813135614446,-513,276,75,-162,-0.02035543876976642,0.014045153790586368,0.00631028497918007,6334,-588,0.31731877160462907,-0.02666572374894649
14698,53031,Jefferson,Washington,2016,12656,6037,2186,20879,0.6061592988169932,0.2891422002969491,0.10469850088605775,-83,1369,-368,918,-0.032035180417514186,0.06376868775044331,-0.03173350733292918,6619,285,0.31701709852004406,-0.00030167308458500797
14699,53033,King,Washington,2000,476700,273171,44325,794196,0.6002296662284877,0.34395917380596225,0.05581115996555006,0,0,0,0,0.0,0.0,0.0,203529,0,0.2562704924225255,0.0
14700,53033,King,Washington,2004,580378,301043,13307,894728,0.6486641750342004,0.3364631485769977,0.01487267638880196,103678,-31018,27872,100532,0.04843450880571265,-0.040938483576748105,-0.007496025228964531,279335,75806,0.31220102645720266,0.05593053403467718
14701,53033,King,Washington,2008,648230,259716,18511,926457,0.6996870874741083,0.2803324924956042,0.019980420030287428,67852,5204,-41327,31729,0.051022912439907975,0.005107743641485467,-0.056130656081393504,388514,109179,0.41935459497850414,0.10715356852130148
14702,53033,King,Washington,2012,668004,275700,28317,972021,0.6872320659738833,0.28363584737366787,0.029132086652448867,19774,9806,15984,45564,-0.012455021500225039,0.00915166662216144,0.003303354878063658,392304,3790,0.40359621860021544,-0.015758376378288697
14703,53033,King,Washington,2016,718322,216339,93789,1028450,0.6984510671398707,0.21035441684087705,0.09119451601925227,50318,65472,-59361,56429,0.011219001165987397,0.0620624293668034,-0.07328143053279082,501983,109679,0.48809665029899363,0.08450043169877819
14704,53035,Kitsap,Washington,2000,50302,46427,6138,102867,0.48900035968775213,0.4513303586184102,0.05966928169383767,0,0,0,0,0.0,0.0,0.0,3875,0,0.03767000106934193,0.0
14705,53035,Kitsap,Washington,2004,60796,55608,2266,118670,0.5123114519255078,0.46859357883205527,0.01909496924243701,10494,-3872,9181,15803,0.023311092237755626,-0.04057431245140066,0.01726322021364507,5188,1313,0.043717873093452486,0.006047872024110557
14706,53035,Kitsap,Washington,2008,68624,53297,3090,125011,0.54894369295502,0.4263384822135652,0.024717824831414836,7828,824,-2311,6341,0.036632241029512236,0.005622855588977824,-0.042255096618490084,15327,10139,0.1226052107414548,0.07888733764800232
14707,53035,Kitsap,Washington,2012,67277,52846,3978,124101,0.5421148902909727,0.42583057348450054,0.032054536224526795,-1347,888,-451,-910,-0.006828802664047284,0.007336711393111959,-0.0005079087290646433,14431,-896,0.11628431680647217,-0.006320893934982641
14708,53035,Kitsap,Washington,2016,63156,49018,16596,128770,0.49045585151821075,0.38066319794983305,0.1288809505319562,-4121,12618,-3828,4669,-0.051659038772761956,0.0968264143074294,-0.04516737553466749,14138,-293,0.1097926535683777,-0.0064916632380944694
14709,53037,Kittitas,Washington,2000,5516,7727,843,14086,0.3915944909839557,0.5485588527616073,0.05984665625443703,0,0,0,0,0.0,0.0,0.0,-2211,0,-0.1569643617776516,0.0
14710,53037,Kittitas,Washington,2004,6731,9052,331,16114,0.4177113069380663,0.5617475487154028,0.020541144346530968,1215,-512,1325,2028,0.026116815954110584,-0.039305511907906064,0.01318869595379546,-2321,-110,-0.14403624177733648,0.012928120000315124
14711,53037,Kittitas,Washington,2008,8030,9471,476,17977,0.44668187127996883,0.5268398509206208,0.02647827779941036,1299,145,419,1863,0.028970564341902538,0.005937133452879391,-0.03490769779478198,-1441,880,-0.08015797964065197,0.06387826213668452
14712,53037,Kittitas,Washington,2012,7949,9782,562,18293,0.4345378013447767,0.5347400645055486,0.03072213414967474,-81,86,311,316,-0.012144069935192126,0.004243856350264381,0.007900213584927762,-1833,-392,-0.10020226316077185,-0.020044283520119888
14713,53037,Kittitas,Washington,2016,7489,10100,2026,19615,0.38179964313025744,0.5149120570991588,0.10328829977058374,-460,1464,318,1322,-0.05273815821451927,0.07256616562090899,-0.01982800740638979,-2611,-778,-0.13311241396890133,-0.03291015080812948
14714,53039,Klickitat,Washington,2000,3062,4557,562,8181,0.3742818726317076,0.557022368903557,0.06869575846473536,0,0,0,0,0.0,0.0,0.0,-1495,0,-0.18274049627184946,0.0
14715,53039,Klickitat,Washington,2004,4036,5016,198,9250,0.43632432432432433,0.5422702702702703,0.021405405405405406,974,-364,459,1069,0.06204245169261674,-0.04729035305932995,-0.014752098633286748,-980,515,-0.10594594594594597,0.07679455032590349
14716,53039,Klickitat,Washington,2008,4965,4944,255,10164,0.4884887839433294,0.48642266824085006,0.025088547815820542,929,57,-72,914,0.052164459619005066,0.0036831424104151363,-0.05584760202942024,21,1001,0.002066115702479332,0.1080120616484253
14717,53039,Klickitat,Washington,2012,4598,5316,477,10391,0.442498315850255,0.5115965739582331,0.04590511019151189,-367,222,372,227,-0.04599046809307439,0.020816562375691346,0.02517390571738304,-718,-739,-0.0690982581079781,-0.07116437381045743
14718,53039,Klickitat,Washington,2016,4194,5789,1091,11074,0.37872494130395523,0.52275600505689,0.09851905363915478,-404,614,473,683,-0.06377337454629978,0.05261394344764289,0.011159431098656913,-1595,-877,-0.14403106375293478,-0.07493280564495669
14719,53041,Lewis,Washington,2000,9891,18565,1530,29986,0.3298539318348563,0.6191222570532915,0.051023811111852196,0,0,0,0,0.0,0.0,0.0,-8674,0,-0.2892683252184352,0.0
14720,53041,Lewis,Washington,2004,10726,21042,660,32428,0.33076353768348343,0.6488836807697052,0.0203527815468114,835,-870,2477,2442,0.0009096058486271485,-0.030671029565040798,0.02976142371641366,-10316,-1642,-0.3181201430862217,-0.02885181786778651
14721,53041,Lewis,Washington,2008,13624,20278,1067,34969,0.38960221910835313,0.5798850410363465,0.030512739855300407,2898,407,-764,2541,0.0588386814248697,0.010159958308489009,-0.06899863973335862,-6654,3662,-0.1902828219279934,0.12783732115822832
14722,53041,Lewis,Washington,2012,12664,20452,1204,34320,0.368997668997669,0.595920745920746,0.035081585081585084,-960,137,174,-649,-0.020604550110684128,0.004568845226284677,0.016035704884399427,-7788,-1134,-0.22692307692307695,-0.036640254995083554
14723,53041,Lewis,Washington,2016,9654,21992,3553,35199,0.2742691553737322,0.6247904770021876,0.10094036762408023,-3010,2349,1540,879,-0.0947285136239368,0.06585878254249515,0.02886973108144164,-12338,-4550,-0.3505213216284554,-0.12359824470537845
14724,53043,Lincoln,Washington,2000,1417,3546,234,5197,0.2726573022897826,0.6823167211852992,0.04502597652491822,0,0,0,0,0.0,0.0,0.0,-2129,0,-0.4096594188955166,0.0
14725,53043,Lincoln,Washington,2004,1706,4015,90,5811,0.2935811392187231,0.6909309929444157,0.015487867836861126,289,-144,469,614,0.02092383692894051,-0.029538108688057098,0.008614271759116554,-2309,-180,-0.39734985372569265,0.012309565169823955
14726,53043,Lincoln,Washington,2008,2032,3803,173,6008,0.3382157123834887,0.6329893475366178,0.028794940079893475,326,83,-212,197,0.0446345731647656,0.013307072243032349,-0.05794164540779789,-1771,538,-0.29477363515312915,0.1025762185725635
14727,53043,Lincoln,Washington,2012,1673,4063,175,5911,0.2830316359330063,0.6873625444087295,0.029605819658264254,-359,2,260,-97,-0.0551840764504824,0.0008108795783707788,0.05437319687211162,-2390,-619,-0.40433090847572317,-0.10955727332259402
14728,53043,Lincoln,Washington,2016,1244,4108,509,5861,0.21225046920320764,0.7009042825456406,0.08684524825115168,-429,334,45,-50,-0.07078116672979864,0.05723942859288743,0.013541738136911174,-2864,-474,-0.48865381334243296,-0.08432290486670979
14729,53045,Mason,Washington,2000,10876,10257,1347,22480,0.4838078291814947,0.4562722419928826,0.059919928825622776,0,0,0,0,0.0,0.0,0.0,619,0,0.0275355871886121,0.0
14730,53045,Mason,Washington,2004,12894,11987,513,25394,0.5077577380483579,0.4720406395211467,0.020201622430495392,2018,-834,1730,2914,0.023949908866863212,-0.039718306395127384,0.015768397528264144,907,288,0.035717098527211166,0.008181511338599068
14731,53045,Mason,Washington,2008,15050,12600,863,28513,0.5278294111457932,0.44190369305229193,0.030266895801914915,2156,350,613,3119,0.020071673097435294,0.010065273371419523,-0.030136946468854786,2450,1543,0.08592571809350125,0.05020861956629008
14732,53045,Mason,Washington,2012,14764,12761,964,28489,0.5182351082874092,0.4479272701744533,0.033837621538137526,-286,101,161,-24,-0.00959430285838403,0.003570725736222611,0.006023577122161339,2003,-447,0.07030783811295588,-0.015617879980545368
14733,53045,Mason,Washington,2016,11993,13677,3333,29003,0.4135089473502741,0.47157190635451507,0.11491914629521084,-2771,2369,916,514,-0.10472616093713505,0.08108152475707331,0.023644636180061795,-1684,-3687,-0.058062959004240966,-0.12837079711719684
14734,53047,Okanogan,Washington,2000,4335,9384,1079,14798,0.29294499256656303,0.6341397486146777,0.0729152588187593,0,0,0,0,0.0,0.0,0.0,-5049,0,-0.34119475604811467,0.0
14735,53047,Okanogan,Washington,2004,6309,9636,397,16342,0.3860604577163138,0.5896463101211602,0.024293232162526008,1974,-682,252,1544,0.09311546514975078,-0.04862202665623329,-0.0444934384935175,-3327,1722,-0.2035858524048464,0.13760890364326828
14736,53047,Okanogan,Washington,2008,7613,8798,576,16987,0.4481662447754165,0.5179254724200859,0.03390828280449756,1304,179,-838,645,0.06210578705910269,0.009615050641971549,-0.07172083770107429,-1185,2142,-0.06975922764466941,0.13382662476017698
14737,53047,Okanogan,Washington,2012,7108,9221,672,17001,0.41809305334980296,0.5423798600082348,0.039527086641962236,-505,96,423,14,-0.030073191425613544,0.0056188038374646795,0.024454387588148885,-2113,-928,-0.12428680665843184,-0.05452757901376243
14738,53047,Okanogan,Washington,2016,6298,9610,1648,17556,0.3587377534745956,0.5473912052859421,0.09387104123946229,-810,976,389,555,-0.05935529987520738,0.05434395459750005,0.005011345277707302,-3312,-1199,-0.18865345181134652,-0.06436664515291468
14739,53049,Pacific,Washington,2000,4895,4042,582,9519,0.5142346885177015,0.4246244353398466,0.061140876142451936,0,0,0,0,0.0,0.0,0.0,853,0,0.08961025317785487,0.0
14740,53049,Pacific,Washington,2004,5570,4634,227,10431,0.5339852363148307,0.4442527082734158,0.02176205541175343,675,-355,592,912,0.01975054779712926,-0.03937882073069851,0.01962827293356917,936,83,0.08973252804141496,0.0001222748635600901
14741,53049,Pacific,Washington,2008,6094,4555,406,11055,0.5512437810945273,0.4120307553143374,0.03672546359113523,524,179,-79,624,0.017258544779696572,0.014963408179381802,-0.03222195295907837,1539,603,0.1392130257801899,0.04948049773877494
14742,53049,Pacific,Washington,2012,5711,4499,426,10636,0.5369499811959383,0.4229973674313652,0.0400526513726965,-383,20,-56,-419,-0.014293799898589032,0.0033271877815612694,0.010966612117027763,1212,-327,0.11395261376457311,-0.025260412015616796
14743,53049,Pacific,Washington,2016,4620,5360,992,10972,0.4210718191760846,0.4885162231133795,0.09041195771053591,-1091,566,861,336,-0.11587816201985368,0.05035930633783941,0.06551885568201432,-740,-1952,-0.0674444039372949,-0.181397017701868
14744,53051,Pend Oreille,Washington,2000,1973,3076,389,5438,0.36281721221037144,0.5656491357116586,0.07153365207796984,0,0,0,0,0.0,0.0,0.0,-1103,0,-0.2028319235012872,0.0
14745,53051,Pend Oreille,Washington,2004,2310,3693,195,6198,0.3727008712487899,0.595837366892546,0.03146176185866408,337,-194,617,760,0.00988365903841848,-0.04007189021930576,0.030188231180887315,-1383,-280,-0.22313649564375604,-0.020304572142468835
14746,53051,Pend Oreille,Washington,2008,2562,3717,326,6605,0.387887963663891,0.5627554882664648,0.04935654806964421,252,131,24,407,0.015187092415101078,0.017894786210980125,-0.03308187862608114,-1155,228,-0.17486752460257382,0.04826897104118222
14747,53051,Pend Oreille,Washington,2012,2508,3952,289,6749,0.371610608979108,0.5855682323307156,0.042821158690176324,-54,-37,235,144,-0.016277354684782974,-0.006535389379467883,0.022812744064250823,-1444,-289,-0.21395762335160762,-0.0390900987490338
14748,53051,Pend Oreille,Washington,2016,1934,4373,709,7016,0.27565564424173317,0.6232896237172177,0.10105473204104903,-574,420,421,267,-0.09595496473737486,0.05823357335087271,0.0377213913865021,-2439,-995,-0.3476339794754846,-0.13367635612387696
14749,53053,Pierce,Washington,2000,138249,118431,12246,268926,0.5140782222618862,0.44038508734744874,0.04553669039066509,0,0,0,0,0.0,0.0,0.0,19818,0,0.07369313491443741,0.0
14750,53053,Pierce,Washington,2004,158231,150783,4779,313793,0.5042528035998254,0.48051741115958607,0.015229785240588541,19982,-7467,32352,44867,-0.00982541866206077,-0.030306905150076547,0.04013232381213733,7448,-12370,0.02373539244023931,-0.0499577424741981
14751,53053,Pierce,Washington,2008,181824,141673,7839,331336,0.5487601709442982,0.42758106574594973,0.023658763309752036,23593,3060,-9110,17543,0.044507367344472804,0.008428978069163495,-0.05293634541363634,40151,32703,0.12117910519834846,0.09744371275810915
14752,53053,Pierce,Washington,2012,186430,148467,10035,344932,0.5404833416441501,0.4304239676226039,0.029092690733245972,4606,2196,6794,13596,-0.008276829300148059,0.005433927423493936,0.002842901876654147,37963,-2188,0.11005937402154625,-0.011119731176802206
14753,53053,Pierce,Washington,2016,172538,146824,40655,360017,0.4792495909915365,0.40782518603288176,0.1129252229755817,-13892,30620,-1643,15085,-0.061233750652613606,0.08383253224233574,-0.022598781589722117,25714,-12249,0.07142440495865476,-0.03863496906289149
14754,53055,San Juan,Washington,2000,4426,3005,993,8424,0.525403608736942,0.35671889838556503,0.11787749287749288,0,0,0,0,0.0,0.0,0.0,1421,0,0.168684710351377,0.0
14755,53055,San Juan,Washington,2004,6589,3290,225,10104,0.6521179730799683,0.3256136183689628,0.022268408551068885,2163,-768,285,1680,0.1267143643430263,-0.095609084326424,-0.031105280016602233,3299,1878,0.32650435471100553,0.15781964435962853
14756,53055,San Juan,Washington,2008,7374,2958,254,10586,0.6965803891932741,0.27942565652748913,0.02399395427923673,785,29,-332,482,0.044462416113305814,0.001725545728167844,-0.04618796184147367,4416,1117,0.417154732665785,0.09065037795477948
14757,53055,San Juan,Washington,2012,7125,3111,456,10692,0.6663860830527497,0.2909652076318743,0.04264870931537598,-249,202,153,106,-0.03019430614052443,0.018654755036139253,0.011539551104385148,4014,-402,0.37542087542087543,-0.04173385724490958
14758,53055,San Juan,Washington,2016,7172,2688,1274,11134,0.6441530447278606,0.24142266930123946,0.11442428597089994,47,818,-423,442,-0.0222330383248891,0.07177557665552396,-0.04954253833063482,4484,470,0.40273037542662116,0.027309500005745724
14759,53057,Skagit,Washington,2000,20432,22163,2626,45221,0.4518254793127087,0.49010415514915634,0.05807036553813494,0,0,0,0,0.0,0.0,0.0,-1731,0,-0.03827867583644762,0.0
14760,53057,Skagit,Washington,2004,25131,26139,1029,52299,0.4805254402569839,0.4997992313428555,0.019675328400160615,4699,-1597,3976,7078,0.028699960944275182,-0.03839503713797432,0.009695076193699137,-1008,723,-0.019273791085871572,0.019004884750576045
14761,53057,Skagit,Washington,2008,30053,24687,1513,56253,0.5342470623788953,0.4388565943149699,0.026896343306134784,4922,484,-1452,3954,0.053721622121911394,0.0072210149059741685,-0.060942637027885604,5366,6374,0.09539046806392543,0.114664259149797
14762,53057,Skagit,Washington,2012,28688,25071,1938,55697,0.5150726250965043,0.4501319640196061,0.03479541088388962,-1365,425,384,-556,-0.019174437282390988,0.007899067577754836,0.011275369704636218,3617,-1749,0.06494066107689822,-0.030449806987027206
14763,53057,Skagit,Washington,2016,26690,24736,6633,58059,0.45970478306550233,0.4260493635784288,0.11424585335606882,-1998,4695,-335,2362,-0.05536784203100198,0.0794504424721792,-0.02408260044117727,1954,-1663,0.03365541948707351,-0.03128524158982471
14764,53059,Skamania,Washington,2000,1753,2151,345,4249,0.4125676629795246,0.5062367615909625,0.08119557542951282,0,0,0,0,0.0,0.0,0.0,-398,0,-0.09366909861143796,0.0
14765,53059,Skamania,Washington,2004,2374,2695,90,5159,0.4601666989726691,0.5223880597014925,0.01744524132583834,621,-255,544,910,0.04759903599314452,-0.06375033410367448,0.016151298110529955,-321,77,-0.062221360728823394,0.03144773788261457
14766,53059,Skamania,Washington,2008,2817,2524,149,5490,0.5131147540983606,0.4597449908925319,0.027140255009107467,443,59,-171,331,0.05294805512569151,0.009695013683269128,-0.06264306880896059,293,614,0.0533697632058287,0.1155911239346521
14767,53059,Skamania,Washington,2012,2628,2687,217,5532,0.4750542299349241,0.48571945046999276,0.03922631959508315,-189,68,163,42,-0.03806052416343653,0.012086064585975685,0.025974459577460862,-59,-352,-0.010665220535068687,-0.06403498374089739
14768,53059,Skamania,Washington,2016,2232,2928,669,5829,0.3829130211013896,0.5023160061760165,0.11477097272259393,-396,452,241,297,-0.0921412088335345,0.07554465312751077,0.016596555706023697,-696,-637,-0.11940298507462688,-0.10873776453955819
14769,53061,Snohomish,Washington,2000,129612,109615,12101,251328,0.5157085561497327,0.43614320728291317,0.048148236567354216,0,0,0,0,0.0,0.0,0.0,19997,0,0.07956534886681949,0.0
14770,53061,Snohomish,Washington,2004,156468,134317,4629,295414,0.5296566851943374,0.4546737798479422,0.015669534957720353,26856,-7472,24702,44086,0.01394812904460474,-0.03247870160963386,0.018530572565029046,22151,2154,0.07498290534639518,-0.004582443520424306
14771,53061,Snohomish,Washington,2008,187294,126722,8183,322199,0.5812991350066263,0.39330351739142577,0.025397347601947864,30826,3554,-7595,26785,0.05164244981228894,0.00972781264422751,-0.061370262456516445,60572,38421,0.18799561761520056,0.11301271226880538
14772,53061,Snohomish,Washington,2012,188516,133016,10436,331968,0.5678740119529593,0.4006892230576441,0.03143676498939657,1222,2253,6294,9769,-0.013425123053667054,0.006039417387448707,0.007385705666218323,55500,-5072,0.16718478889531518,-0.020810828719885377
14773,53061,Snohomish,Washington,2016,185227,128255,41252,354734,0.5221574475522505,0.3615525999763203,0.1162899524714293,-3289,30816,-4761,22766,-0.045716564400708815,0.08485318748203273,-0.03913662308132382,56972,1472,0.1606048475759302,-0.0065799413193849965
14774,53063,Spokane,Washington,2000,74604,89299,8209,172112,0.4334619317653621,0.5188423817049364,0.04769568652970159,0,0,0,0,0.0,0.0,0.0,-14695,0,-0.08538044993957428,0.0
14775,53063,Spokane,Washington,2004,87490,111606,3491,202587,0.4318638412138982,0.5509040560351849,0.01723210275091689,12886,-4718,22307,30475,-0.001598090551463871,-0.0304635837787847,0.032061674330248535,-24116,-9421,-0.11904021482128668,-0.033659764881712406
14776,53063,Spokane,Washington,2008,105786,108314,6907,221007,0.4786545222549512,0.4900930739750325,0.03125240377001633,18296,3416,-3292,18420,0.046790681041052995,0.014020301019099443,-0.060810982060152396,-2528,21588,-0.011438551720081291,0.10760166310120539
14777,53063,Spokane,Washington,2012,102295,115285,8174,225754,0.45312596897507906,0.5106664776703845,0.036207553354536355,-3491,1267,6971,4747,-0.025528553279872135,0.004955149584520022,0.020573403695352044,-12990,-10462,-0.05754050869530547,-0.04610195697522418
14778,53063,Spokane,Washington,2016,93767,113435,28848,236050,0.39723363694132596,0.4805549671679729,0.12221139589070112,-8528,20674,-1850,10296,-0.0558923320337531,0.08600384253616478,-0.03011151050241162,-19668,-6678,-0.08332133022664695,-0.02578082153134148
14779,53065,Stevens,Washington,2000,5560,11299,1140,17999,0.3089060503361298,0.6277570976165342,0.06333685204733597,0,0,0,0,0.0,0.0,0.0,-5739,0,-0.3188510472804044,0.0
14780,53065,Stevens,Washington,2004,6822,13015,503,20340,0.33539823008849556,0.6398721730580138,0.02472959685349066,1262,-637,1716,2341,0.026492179752365785,-0.03860725519384531,0.012115075441479606,-6193,-454,-0.30447394296951824,0.01437710431088618
14781,53065,Stevens,Washington,2008,8499,13132,960,22591,0.37621176574742154,0.5812934354388916,0.04249479881368687,1677,457,117,2251,0.04081353565892598,0.01776520196019621,-0.058578737619122245,-4633,1560,-0.20508166969147001,0.09939227327804823
14782,53065,Stevens,Washington,2012,7762,13691,1047,22500,0.34497777777777777,0.6084888888888889,0.046533333333333336,-737,87,559,-91,-0.031233987969643773,0.004038534519646468,0.027195453449997298,-5929,-1296,-0.2635111111111111,-0.05842944141964107
14783,53065,Stevens,Washington,2016,5767,15161,2467,23395,0.24650566360333404,0.6480444539431502,0.1054498824535157,-1995,1420,1470,895,-0.09847211417444374,0.05891654912018237,0.03955556505426139,-9394,-3465,-0.4015387903398162,-0.13802767922870512
14784,53067,Thurston,Washington,2000,50467,39924,7031,97422,0.5180246761511773,0.40980476689043543,0.07217055695838723,0,0,0,0,0.0,0.0,0.0,10543,0,0.10821990926074188,0.0
14785,53067,Thurston,Washington,2004,62650,47992,2147,112789,0.5554619688090151,0.42550248694464887,0.019035544246336078,12183,-4884,8068,15367,0.037437292657837795,-0.05313501271205115,0.015697720054213438,14658,4115,0.12995948186436623,0.021739572603624358
14786,53067,Thurston,Washington,2008,75882,48366,3142,127390,0.595666849831227,0.3796687338095612,0.02466441635921187,13232,995,374,14601,0.04020488102221187,0.005628872112875792,-0.045833753135087696,27516,12858,0.2159981160216658,0.08603863415729956
14787,53067,Thurston,Washington,2012,74037,49287,4416,127740,0.5795913574448097,0.38583842179426964,0.03457022076092062,-1845,1274,921,350,-0.016075492386417256,0.009905804401708747,0.006169687984708461,24750,-2766,0.19375293565054008,-0.022245180371125717
14788,53067,Thurston,Washington,2016,68798,48624,16769,134191,0.5126871399721292,0.3623491888427689,0.12496367118510184,-5239,12353,-663,6451,-0.0669042174726805,0.09039345042418122,-0.023489232951500738,20174,-4576,0.15033795112936033,-0.043414984521179756
14789,53069,Wahkiakum,Washington,2000,803,1033,137,1973,0.40699442473390773,0.523568170299037,0.06943740496705525,0,0,0,0,0.0,0.0,0.0,-230,0,-0.11657374556512928,0.0
14790,53069,Wahkiakum,Washington,2004,1021,1171,43,2235,0.45682326621923935,0.523937360178971,0.01923937360178971,218,-94,138,262,0.04982884148533162,-0.050198031365265544,0.000369189879933951,-150,80,-0.06711409395973161,0.04945965160539767
14791,53069,Wahkiakum,Washington,2008,1121,1105,80,2306,0.48612315698178665,0.47918473547268,0.03469210754553339,100,37,-66,71,0.029299890762547298,0.01545273394374368,-0.04475262470629099,16,166,0.006938421509106674,0.07405251546883829
14792,53069,Wahkiakum,Washington,2012,1094,1119,100,2313,0.47297881539126674,0.48378728923476005,0.043233895373973194,-27,20,14,7,-0.013144341590519915,0.008541787828439805,0.004602553762080075,-25,-41,-0.010808473843493316,-0.01774689535259999
14793,53069,Wahkiakum,Washington,2016,832,1344,253,2429,0.34252778921366817,0.553314121037464,0.10415808974886785,-262,153,225,116,-0.13045102617759857,0.06092419437489466,0.06952683180270397,-512,-487,-0.21078633182379586,-0.19997785798030254
14794,53071,Walla Walla,Washington,2000,7188,13304,873,21365,0.3364380996957641,0.6227006786800843,0.04086122162415165,0,0,0,0,0.0,0.0,0.0,-6116,0,-0.28626257898432017,0.0
14795,53071,Walla Walla,Washington,2004,8257,14323,345,22925,0.36017448200654306,0.6247764449291167,0.01504907306434024,1069,-528,1019,1560,0.02373638231077896,-0.025812148559811413,0.0020757662490323847,-6066,50,-0.2646019629225736,0.021660616061746574
14796,53071,Walla Walla,Washington,2008,10081,14182,614,24877,0.4052337500502472,0.5700848173011215,0.024681432648631266,1824,269,-141,1952,0.04505926804370414,0.009632359584291027,-0.054691627627995176,-4101,1965,-0.16485106725087428,0.09975089567169931
14797,53071,Walla Walla,Washington,2012,9768,14648,882,25298,0.3861174796426595,0.5790181041979603,0.034864416159380185,-313,268,466,421,-0.019116270407587677,0.010182983510748918,0.00893328689683881,-4880,-779,-0.19290062455530077,-0.028049557304426487
14798,53071,Walla Walla,Washington,2016,9694,13651,2883,26228,0.36960500228763155,0.5204743022723807,0.1099206954399878,-74,2001,-997,930,-0.016512477355027977,0.07505627928060761,-0.05854380192557962,-3957,923,-0.15086929998474913,0.04203132457055164
14799,53073,Whatcom,Washington,2000,34033,34287,5437,73757,0.46142061092506476,0.46486435185812874,0.07371503721680654,0,0,0,0,0.0,0.0,0.0,-254,0,-0.003443740933063988,0.0
14800,53073,Whatcom,Washington,2004,48268,40296,1830,90394,0.5339734938159613,0.44578179967696974,0.020244706507069055,14235,-3607,6009,16637,0.07255288289089651,-0.05347033070973749,-0.019082552181159007,7972,8226,0.08819169413899153,0.09163543507205552
14801,53073,Whatcom,Washington,2008,58236,40205,2465,100906,0.5771311914058629,0.3984401324004519,0.024428676193685214,9968,635,-91,10512,0.04315769758990162,0.004183969686616159,-0.04734166727651784,18031,10059,0.178691059005411,0.09049936486641946
14802,53073,Whatcom,Washington,2012,57089,42703,3996,103788,0.5500539561413651,0.41144448298454545,0.03850156087408949,-1147,1531,2498,2882,-0.02707723526449779,0.014072884680404279,0.01300435058409355,14386,-3645,0.13860947315681965,-0.04008158584859134
14803,53073,Whatcom,Washington,2016,60340,40599,12400,113339,0.5323851454486099,0.3582085601602273,0.1094062943911628,3251,8404,-2104,9551,-0.017668810692755166,0.0709047335170733,-0.05323592282431816,19741,5355,0.17417658528838265,0.035567112131562995
14804,53075,Whitman,Washington,2000,6509,9003,725,16237,0.40087454579047854,0.554474348709737,0.04465110549978444,0,0,0,0,0.0,0.0,0.0,-2494,0,-0.15359980291925845,0.0
14805,53075,Whitman,Washington,2004,8287,9397,328,18012,0.46008216744392627,0.5217077503886298,0.018210082167443926,1778,-397,394,1775,0.05920762165344773,-0.026441023332340514,-0.032766598321107177,-1110,1384,-0.06162558294470355,0.0919742199745549
14806,53075,Whitman,Washington,2008,9070,8104,415,17589,0.5156631985900278,0.46074250952299733,0.023594291886974813,783,87,-1293,-423,0.05558103114610158,0.005384209719530887,-0.060965240865632486,966,2076,0.054920689067030515,0.11654627201173406
14807,53075,Whitman,Washington,2012,8037,8507,726,17270,0.46537348002316153,0.4925883034163289,0.04203821656050955,-1033,311,403,-319,-0.050289718566866315,0.01844392467353474,0.031845793893331586,-470,-1436,-0.027214823393167387,-0.0821355124601979
14808,53075,Whitman,Washington,2016,8146,7403,2479,18028,0.4518526736188152,0.41063900599068115,0.13750832039050367,109,1753,-1104,758,-0.01352080640434633,0.09547010382999413,-0.08194929742564777,743,1213,0.041213667628134054,0.06842849102130144
14809,53077,Yakima,Washington,2000,25546,39494,2342,67382,0.37912202071769907,0.5861209225015582,0.03475705678074263,0,0,0,0,0.0,0.0,0.0,-13948,0,-0.20699890178385916,0.0
14810,53077,Yakima,Washington,2004,28474,43352,964,72790,0.3911801071575766,0.5955763154279434,0.01324357741448001,2928,-1378,3858,5408,0.012058086439877547,-0.02151347936626262,0.009455392926385198,-14878,-930,-0.2043962082703668,0.002602693513492349
14811,53077,Yakima,Washington,2008,33792,41946,1796,77534,0.43583460159413934,0.541001367142157,0.023164031263703665,5318,832,-1406,4744,0.04465449443656272,0.009920453849223654,-0.05457494828578646,-8154,6724,-0.10516676554801763,0.09922944272234918
14812,53077,Yakima,Washington,2012,33217,42239,2050,77506,0.42857327174670345,0.5449771630583439,0.02644956519495265,-575,254,293,-28,-0.007261329847435882,0.0032855339312489844,0.003975795916186908,-9022,-868,-0.11640389131164042,-0.01123712576362279
14813,53077,Yakima,Washington,2016,31291,41735,6715,79741,0.392407920643082,0.5233819490600821,0.08421013029683601,-1926,4665,-504,2235,-0.03616535110362146,0.05776056510188336,-0.02159521399826181,-10444,-1422,-0.13097402841700007,-0.014570137105359648
14814,54001,Barbour,West Virginia,2000,2503,3411,137,6051,0.41365063625846965,0.563708477937531,0.02264088580399934,0,0,0,0,0.0,0.0,0.0,-908,0,-0.15005784167906133,0.0
14815,54001,Barbour,West Virginia,2004,2610,4004,41,6655,0.3921863260706236,0.6016528925619835,0.006160781367392938,107,-96,593,604,-0.02146431018784606,-0.0164801044366064,0.03794441462445253,-1394,-486,-0.20946656649135992,-0.059408724812298586
14816,54001,Barbour,West Virginia,2008,2419,3685,128,6232,0.3881578947368421,0.5913029525032092,0.02053915275994865,-191,87,-319,-423,-0.004028431333781501,0.014378371392555713,-0.01034994005877432,-1266,128,-0.2031450577663671,0.006321508724992819
14817,54001,Barbour,West Virginia,2012,1768,3824,185,5777,0.3060411978535572,0.6619352605158386,0.03202354163060412,-651,57,139,-455,-0.08211669688328488,0.01148438887065547,0.07063230801262943,-2056,-790,-0.3558940626622814,-0.1527490048959143
14818,54001,Barbour,West Virginia,2016,1222,4527,367,6116,0.1998037933289732,0.7401896664486592,0.06000654022236756,-546,182,703,339,-0.10623740452458402,0.02798299859176344,0.07825440593282063,-3305,-1249,-0.540385873119686,-0.1844918104574046
14819,54003,Berkeley,West Virginia,2000,8797,13619,594,23010,0.38231203824424165,0.5918730986527597,0.025814863102998697,0,0,0,0,0.0,0.0,0.0,-4822,0,-0.20956106040851807,0.0
14820,54003,Berkeley,West Virginia,2004,12244,21293,248,33785,0.3624093532632825,0.6302501109960041,0.007340535740713334,3447,-346,7674,10775,-0.01990268498095915,-0.018474327362285364,0.03837701234324442,-9049,-4227,-0.26784075773272165,-0.05827969732420357
14821,54003,Berkeley,West Virginia,2008,15994,20841,565,37400,0.42764705882352944,0.5572459893048128,0.015106951871657753,3750,317,-452,3615,0.06523770556024694,0.007766416130944419,-0.0730041216911913,-4847,4202,-0.1295989304812834,0.13824182725143824
14822,54003,Berkeley,West Virginia,2012,14275,22156,876,37307,0.3826359664406144,0.5938831854611735,0.02348084809821213,-1719,311,1315,-93,-0.04501109238291506,0.008373896226554378,0.03663719615636063,-7881,-3034,-0.2112472190205591,-0.08164828853927569
14823,54003,Berkeley,West Virginia,2016,12321,28244,2799,43364,0.2841296928327645,0.6513236786274329,0.0645466285398026,-1954,1923,6088,6057,-0.09850627360784986,0.04106578044159047,0.05744049316625943,-15923,-8042,-0.3671939857946684,-0.1559467667741093
14824,54005,Boone,West Virginia,2000,5656,3353,132,9141,0.6187506837326332,0.3668088830543704,0.01444043321299639,0,0,0,0,0.0,0.0,0.0,2303,0,0.2519418006782628,0.0
14825,54005,Boone,West Virginia,2004,5933,4207,58,10198,0.5817807413218278,0.41253186899392036,0.005687389684251814,277,-74,854,1057,-0.03696994241080542,-0.008753043528744576,0.04572298593954993,1726,-577,0.16924887232790742,-0.08269292835035535
14826,54005,Boone,West Virginia,2008,4529,3632,209,8370,0.5410991636798088,0.4339307048984468,0.024970131421744327,-1404,151,-575,-1828,-0.04068157764201896,0.01928274173749251,0.02139883590452646,897,-829,0.107168458781362,-0.06208041354654542
14827,54005,Boone,West Virginia,2012,2790,5467,245,8502,0.32815808045165845,0.6430251705481064,0.028816749000235238,-1739,36,1835,132,-0.21294108322815036,0.0038466175784909115,0.20909446564965956,-2677,-3574,-0.3148670900964479,-0.4220355488778099
14828,54005,Boone,West Virginia,2016,1790,6504,485,8779,0.20389566009796103,0.7408588677525915,0.05524547214944755,-1000,240,1037,277,-0.12426242035369742,0.02642872314921231,0.09783369720448509,-4714,-2037,-0.5369632076546305,-0.22209611755818254
14829,54007,Braxton,West Virginia,2000,2719,2529,80,5328,0.5103228228228228,0.47466216216216217,0.015015015015015015,0,0,0,0,0.0,0.0,0.0,190,0,0.03566066066066065,0.0
14830,54007,Braxton,West Virginia,2004,3035,2986,30,6051,0.5015699884316642,0.4934721533630805,0.00495785820525533,316,-50,457,723,-0.008752834391158593,-0.010057156809759684,0.018809991200918308,49,-141,0.008097835068583747,-0.0275628255920769
14831,54007,Braxton,West Virginia,2008,2704,2629,82,5415,0.49935364727608494,0.4855032317636196,0.015143120960295476,-331,52,-357,-636,-0.0022163411555792822,0.010185262755040145,-0.007968921599460888,75,26,0.013850415512465353,0.005752580443881605
14832,54007,Braxton,West Virginia,2012,1998,2725,87,4810,0.4153846153846154,0.5665280665280665,0.01808731808731809,-706,5,96,-605,-0.08396903189146954,0.002944197127022612,0.08102483476444694,-727,-802,-0.15114345114345112,-0.16499386665591648
14833,54007,Braxton,West Virginia,2016,1321,3537,242,5100,0.25901960784313727,0.6935294117647058,0.04745098039215686,-677,155,812,290,-0.15636500754147814,0.02936366230483877,0.1270013452366393,-2216,-1489,-0.43450980392156857,-0.28336635277811745
14834,54009,Brooke,West Virginia,2000,4678,4195,532,9405,0.49739500265816056,0.4460393407761829,0.05656565656565657,0,0,0,0,0.0,0.0,0.0,483,0,0.051355661881977654,0.0
14835,54009,Brooke,West Virginia,2004,5493,5189,91,10773,0.5098858256752994,0.4816671307899378,0.008447043534762833,815,-441,994,1368,0.01249082301713883,-0.04811861303089374,0.03562779001375488,304,-179,0.028218694885361606,-0.02313696699661605
14836,54009,Brooke,West Virginia,2008,4717,4961,179,9857,0.4785431672922796,0.5032971492340469,0.01815968347367353,-776,88,-228,-916,-0.031342658383019806,0.009712639938910698,0.02163001844410911,-244,-548,-0.02475398194176731,-0.05297267682712892
14837,54009,Brooke,West Virginia,2012,4005,5060,263,9328,0.429352487135506,0.5424528301886793,0.02819468267581475,-712,84,99,-529,-0.04919068015677358,0.01003499920214122,0.0391556809546324,-1055,-811,-0.11310034305317329,-0.08834636111140598
14838,54009,Brooke,West Virginia,2016,2568,6625,503,9696,0.26485148514851486,0.6832714521452146,0.05187706270627063,-1437,240,1565,368,-0.16450100198699114,0.023682380030455877,0.14081862195653527,-4057,-3002,-0.4184199669966997,-0.3053196239435264
14839,54011,Cabell,West Virginia,2000,14896,16440,880,32216,0.46237894214055125,0.5103054382915322,0.027315619567916564,0,0,0,0,0.0,0.0,0.0,-1544,0,-0.047926496150980935,0.0
14840,54011,Cabell,West Virginia,2004,16583,21035,332,37950,0.43696969696969695,0.5542819499341238,0.008748353096179183,1687,-548,4595,5734,-0.0254092451708543,-0.01856726647173738,0.04397651164259164,-4452,-2908,-0.11731225296442688,-0.06938575681344594
14841,54011,Cabell,West Virginia,2008,15292,18793,647,34732,0.4402856155706553,0.541086030173903,0.018628354255441668,-1291,315,-2242,-3218,0.0033159186009583674,0.009880001159262485,-0.013195919760220831,-3501,951,-0.10080041460324768,0.0165118383611792
14842,54011,Cabell,West Virginia,2012,13568,17985,605,32158,0.421916785869768,0.5592698550904907,0.018813359039741278,-1724,-42,-808,-2574,-0.018368829700887324,0.0001850047842996104,0.018183824916587654,-4417,-916,-0.13735306922072266,-0.03655265461747498
14843,54011,Cabell,West Virginia,2016,11447,19850,2288,33585,0.34083668304302517,0.5910376656245347,0.06812565133244007,-2121,1683,1865,1427,-0.08108010282674283,0.04931229229269879,0.031767810534044094,-8403,-3986,-0.2502009825815096,-0.11284791336078692
14844,54013,Calhoun,West Virginia,2000,1112,1425,78,2615,0.42523900573613765,0.5449330783938815,0.02982791586998088,0,0,0,0,0.0,0.0,0.0,-313,0,-0.11969407265774384,0.0
14845,54013,Calhoun,West Virginia,2004,1266,1588,35,2889,0.43821391484942884,0.5496711664935964,0.012114918656974732,154,-43,163,274,0.012974909113291189,-0.01771299721300615,0.004738088099714877,-322,-9,-0.11145725164416753,0.008236821013576312
14846,54013,Calhoun,West Virginia,2008,993,1366,70,2429,0.4088102099629477,0.5623713462330177,0.02881844380403458,-273,35,-222,-460,-0.02940370488648114,0.016703525147059847,0.01270017973942128,-373,-51,-0.15356113627006995,-0.04210388462590242
14847,54013,Calhoun,West Virginia,2012,818,1319,73,2210,0.37013574660633486,0.5968325791855204,0.0330316742081448,-175,3,-47,-219,-0.03867446335661284,0.004213230404110216,0.034461232952502696,-501,-128,-0.2266968325791855,-0.07313569630911554
14848,54013,Calhoun,West Virginia,2016,456,2035,147,2638,0.1728582259287339,0.7714177407126611,0.055724033358605006,-362,74,716,428,-0.19727752067760096,0.02269235915046021,0.17458516152714076,-1579,-1078,-0.5985595147839272,-0.3718626822047417
14849,54015,Clay,West Virginia,2000,1617,1887,78,3582,0.45142378559463986,0.5268006700167505,0.021775544388609715,0,0,0,0,0.0,0.0,0.0,-270,0,-0.0753768844221106,0.0
14850,54015,Clay,West Virginia,2004,1835,2198,39,4072,0.4506385068762279,0.5397838899803536,0.009577603143418467,218,-39,311,490,-0.0007852787184119414,-0.012197941245191248,0.012983219963603188,-363,-93,-0.08914538310412573,-0.013768498682015129
14851,54015,Clay,West Virginia,2008,1421,1755,89,3265,0.4352220520673813,0.5375191424196019,0.027258805513016845,-414,50,-443,-807,-0.015416454808846625,0.01768120236959838,-0.0022647475607517897,-334,29,-0.10229709035222057,-0.013151707248094835
14852,54015,Clay,West Virginia,2012,931,1971,116,3018,0.30848243870112657,0.6530815109343936,0.038436050364479786,-490,27,216,-247,-0.12673961336625472,0.011177244851462941,0.11556236851479174,-1040,-706,-0.344599072233267,-0.24230198188104646
14853,54015,Clay,West Virginia,2016,568,2300,127,2995,0.18964941569282137,0.7679465776293823,0.04240400667779633,-363,11,329,-23,-0.1188330230083052,0.003967956313316541,0.11486506669498875,-1732,-692,-0.578297161936561,-0.23369808970329398
14854,54017,Doddridge,West Virginia,2000,773,1955,88,2816,0.2745028409090909,0.6942471590909091,0.03125,0,0,0,0,0.0,0.0,0.0,-1182,0,-0.4197443181818182,0.0
14855,54017,Doddridge,West Virginia,2004,800,2362,17,3179,0.2516514627241271,0.7430009436929852,0.0053475935828877,27,-71,407,363,-0.0228513781849638,-0.0259024064171123,0.04875378460207613,-1562,-380,-0.4913494809688581,-0.07160516278703993
14856,54017,Doddridge,West Virginia,2008,735,2218,65,3018,0.24353876739562624,0.7349237905897945,0.021537442014579192,-65,48,-144,-161,-0.00811269532850084,0.01618984843169149,-0.008077153103190682,-1483,79,-0.49138502319416827,-3.554222531015894e-05
14857,54017,Doddridge,West Virginia,2012,575,2130,69,2774,0.2072819033886085,0.7678442682047585,0.02487382840663302,-160,4,-88,-244,-0.03625686400701775,0.003336386392053827,0.03292047761496397,-1555,-72,-0.56056236481615,-0.06917734162198169
14858,54017,Doddridge,West Virginia,2016,362,2358,143,2863,0.12644079636744673,0.8236115962277332,0.04994760740482012,-213,74,228,89,-0.08084110702116176,0.0250737789981871,0.05576732802297468,-1996,-441,-0.6971707998602864,-0.13660843504413644
14859,54019,Fayette,West Virginia,2000,8371,5897,351,14619,0.5726109857035365,0.40337916410151176,0.024009850194951776,0,0,0,0,0.0,0.0,0.0,2474,0,0.16923182160202477,0.0
14860,54019,Fayette,West Virginia,2004,8971,7881,115,16967,0.5287322449460717,0.46448989214357284,0.006777862910355396,600,-236,1984,2348,-0.043878740757464785,-0.01723198728459638,0.06111072804206108,1090,-1384,0.0642423528024989,-0.10498946879952586
14861,54019,Fayette,West Virginia,2008,7242,7658,294,15194,0.4766355140186916,0.504014742661577,0.019349743319731473,-1729,179,-223,-1773,-0.05209673092738015,0.012571880409376077,0.03952485051800414,-416,-1506,-0.02737922864288539,-0.09162158144538429
14862,54019,Fayette,West Virginia,2012,5419,8350,301,14070,0.3851457000710732,0.5934612651030562,0.021393034825870648,-1823,7,692,-1124,-0.0914898139476184,0.002043291506139175,0.08944652244147921,-2931,-2515,-0.208315565031983,-0.18093633638909762
14863,54019,Fayette,West Virginia,2016,4290,10357,831,15478,0.27716759271223673,0.6691433001679804,0.05368910711978292,-1129,530,2007,1408,-0.10797810735883645,0.03229607229391227,0.07568203506492421,-6067,-3136,-0.39197570745574367,-0.18366014242376066
14864,54021,Gilmer,West Virginia,2000,1092,1560,88,2740,0.39854014598540144,0.5693430656934306,0.032116788321167884,0,0,0,0,0.0,0.0,0.0,-468,0,-0.1708029197080292,0.0
14865,54021,Gilmer,West Virginia,2004,1159,1665,28,2852,0.4063814866760168,0.5838008415147266,0.009817671809256662,67,-60,105,112,0.007841340690615373,-0.022299116511911223,0.014457775821295926,-506,-38,-0.17741935483870974,-0.0066164351306805536
14866,54021,Gilmer,West Virginia,2008,1004,1445,72,2521,0.3982546608488695,0.5731852439508132,0.028560095200317333,-155,44,-220,-331,-0.0081268258271473,0.01874242339106067,-0.010615597563913393,-441,65,-0.17493058310194365,0.0024887717367660933
14867,54021,Gilmer,West Virginia,2012,840,1595,87,2522,0.3330689928628073,0.6324345757335448,0.0344964314036479,-164,15,150,1,-0.06518566798606223,0.005936336203330568,0.05924933178273162,-755,-314,-0.2993655828707375,-0.12443499976879385
14868,54021,Gilmer,West Virginia,2016,545,1896,138,2579,0.2113222179139201,0.7351686700271423,0.053509112058937575,-295,51,301,57,-0.12174677494888717,0.019012680655289674,0.10273409429359748,-1351,-596,-0.5238464521132221,-0.22448086924248462
14869,54023,Grant,West Virginia,2000,891,3571,72,4534,0.1965152183502426,0.7876047640052933,0.015880017644464048,0,0,0,0,0.0,0.0,0.0,-2680,0,-0.5910895456550507,0.0
14870,54023,Grant,West Virginia,2004,963,4063,21,5047,0.19080641965524073,0.805032692688726,0.004160887656033287,72,-51,492,513,-0.0057087986950018765,-0.01171912998843076,0.01742792868343268,-3100,-420,-0.6142262730334853,-0.02313672737843464
14871,54023,Grant,West Virginia,2008,997,3166,55,4218,0.2363679468942627,0.750592697961119,0.013039355144618302,34,34,-897,-829,0.04556152723902196,0.008878467488585015,-0.054439994727606966,-2169,931,-0.5142247510668564,0.10000152196662893
14872,54023,Grant,West Virginia,2012,718,3783,87,4588,0.15649520488230165,0.8245422842197035,0.01896251089799477,-279,32,617,370,-0.07987274201196104,0.005923155753376468,0.0739495862585845,-3065,-896,-0.6680470793374019,-0.15382232827054554
14873,54023,Grant,West Virginia,2016,512,4346,107,4965,0.10312185297079557,0.8753272910372608,0.021550855991943604,-206,20,563,377,-0.05337335191150608,0.0025883450939488337,0.050785006817557266,-3834,-769,-0.7722054380664652,-0.10415835872906332
14874,54025,Greenbrier,West Virginia,2000,5627,6866,315,12808,0.43933479075577764,0.5360712054965646,0.024594003747657713,0,0,0,0,0.0,0.0,0.0,-1239,0,-0.09673641474078698,0.0
14875,54025,Greenbrier,West Virginia,2004,6084,8358,111,14553,0.41805813234384664,0.5743145743145743,0.007627293341579056,457,-204,1492,1745,-0.021276658411930993,-0.016966710406078656,0.038243368818009715,-2274,-1035,-0.1562564419707277,-0.05952002722994071
14876,54025,Greenbrier,West Virginia,2008,5881,7567,284,13732,0.42826973492572096,0.5510486454995631,0.020681619574715992,-203,173,-791,-821,0.010211602581874313,0.013054326233136935,-0.023265928815011216,-1686,588,-0.12277891057384216,0.03347753139688553
14877,54025,Greenbrier,West Virginia,2012,4710,7930,365,13005,0.3621683967704729,0.609765474817378,0.028066128412149175,-1171,81,363,-727,-0.06610133815524805,0.007384508837433183,0.058716829317814856,-3220,-1534,-0.24759707804690506,-0.1248181674730629
14878,54025,Greenbrier,West Virginia,2016,3765,9556,903,14224,0.26469347581552305,0.671822272215973,0.06348425196850394,-945,538,1626,1219,-0.09747492095494986,0.035418123556354764,0.06205679739859504,-5791,-2571,-0.40712879640044997,-0.1595317183535449
14879,54027,Hampshire,West Virginia,2000,2069,3879,149,6097,0.3393472199442349,0.6362145317369198,0.024438248318845335,0,0,0,0,0.0,0.0,0.0,-1810,0,-0.2968673117926849,0.0
14880,54027,Hampshire,West Virginia,2004,2455,5489,52,7996,0.30702851425712857,0.6864682341170585,0.0065032516258129065,386,-97,1610,1899,-0.03231870568710632,-0.017934996693032428,0.05025370238013871,-3034,-1224,-0.3794397198599299,-0.08257240806724503
14881,54027,Hampshire,West Virginia,2008,2983,5222,142,8347,0.3573739067928597,0.6256139930513958,0.01701210015574458,528,90,-267,351,0.050345392535731115,0.010508848529931673,-0.06085424106566273,-2239,795,-0.26824008625853607,0.11119963360139384
14882,54027,Hampshire,West Virginia,2012,2299,5523,197,8019,0.28669410150891633,0.6887392442947998,0.024566654196283826,-684,55,301,-328,-0.07067980528394335,0.007554554040539247,0.06312525124340407,-3224,-985,-0.4020451427858835,-0.13380505652734742
14883,54027,Hampshire,West Virginia,2016,1580,6692,407,8679,0.1820486231132619,0.7710565733379422,0.046894803548795945,-719,210,1169,660,-0.10464547839565444,0.02232814935251212,0.08231732904314237,-5112,-1888,-0.5890079502246803,-0.18696280743879684
14884,54029,Hancock,West Virginia,2000,6249,6458,765,13472,0.46385095011876487,0.4793646080760095,0.056784441805225655,0,0,0,0,0.0,0.0,0.0,-209,0,-0.015513657957244631,0.0
14885,54029,Hancock,West Virginia,2004,6906,7298,117,14321,0.48222889463026325,0.5096012848264786,0.008169820543258152,657,-648,840,849,0.01837794451149838,-0.0486146212619675,0.030236676750469094,-392,-183,-0.027372390196215346,-0.011858732238970715
14886,54029,Hancock,West Virginia,2008,5504,7518,198,13220,0.416338880484115,0.5686838124054463,0.01497730711043873,-1402,81,220,-1101,-0.06589001414614826,0.006807486567180578,0.0590825275789677,-2014,-1622,-0.1523449319213313,-0.12497254172511596
14887,54029,Hancock,West Virginia,2012,4627,7226,297,12150,0.3808230452674897,0.5947325102880658,0.024444444444444446,-877,99,-292,-1070,-0.03551583521662527,0.009467137334005716,0.026048697882619543,-2599,-585,-0.21390946502057612,-0.06156453309924481
14888,54029,Hancock,West Virginia,2016,3262,8909,631,12802,0.25480393688486175,0.6959068895485081,0.049289173566630214,-1365,334,1683,652,-0.12601910838262798,0.024844729122185768,0.10117437926044226,-5647,-3048,-0.44110295266364635,-0.22719348764307024
14889,54031,Hardy,West Virginia,2000,1621,2816,77,4514,0.35910500664599027,0.6238369517058041,0.017058041648205582,0,0,0,0,0.0,0.0,0.0,-1195,0,-0.26473194505981384,0.0
14890,54031,Hardy,West Virginia,2004,1617,3635,24,5276,0.30648218347232753,0.6889689158453374,0.004548900682335102,-4,-53,819,762,-0.052622823173662736,-0.01250914096587048,0.06513196413953326,-2018,-823,-0.38248673237300984,-0.117754787313196
14891,54031,Hardy,West Virginia,2008,1901,3376,130,5407,0.3515812835213612,0.6243758091363047,0.02404290734233401,284,106,-259,131,0.04509910004903367,0.019494006659998907,-0.06459310670903262,-1475,543,-0.27279452561494355,0.10969220675806629
14892,54031,Hardy,West Virginia,2012,1482,3536,163,5181,0.28604516502605676,0.6824937270797143,0.031461107894228915,-419,33,160,-226,-0.06553611849530444,0.007418200551894905,0.05811791794340959,-2054,-579,-0.3964485620536576,-0.12365403643871403
14893,54031,Hardy,West Virginia,2016,1155,4274,245,5674,0.20356009869580544,0.7532604864293267,0.043179414874867816,-327,82,738,493,-0.08248506633025132,0.011718306980638901,0.07076675934961241,-3119,-1065,-0.5497003877335214,-0.15325182567986378
14894,54033,Harrison,West Virginia,2000,13009,12948,621,26578,0.4894649710286703,0.48716983971705924,0.02336518925427045,0,0,0,0,0.0,0.0,0.0,61,0,0.002295131311611076,0.0
14895,54033,Harrison,West Virginia,2004,13238,17111,239,30588,0.432784098339218,0.5594023800183079,0.007813521642474173,229,-382,4163,4010,-0.05668087268945232,-0.015551667611796277,0.07223254030124865,-3873,-3934,-0.1266182816790899,-0.12891341299070097
14896,54033,Harrison,West Virginia,2008,13582,17824,672,32078,0.42340544921753226,0.5556456138163227,0.020948936966145023,344,433,713,1490,-0.009378649121685734,0.01313541532367085,-0.0037567662019851733,-4242,-369,-0.13224016459879046,-0.00562188291970056
14897,54033,Harrison,West Virginia,2012,9732,15876,663,26271,0.3704464999429028,0.60431654676259,0.02523695329450725,-3850,-9,-1948,-5807,-0.05295894927462946,0.004288016328362228,0.04867093294626723,-6144,-1902,-0.23387004681968715,-0.1016298822208967
14898,54033,Harrison,West Virginia,2016,7694,18750,1907,28351,0.27138372544178335,0.6613523332510317,0.06726394130718494,-2038,1244,2874,2080,-0.09906277450111944,0.042026988012677687,0.057035786488441764,-11056,-4912,-0.38996860780924836,-0.1560985609895612
14899,54035,Jackson,West Virginia,2000,4937,6341,240,11518,0.4286334433061295,0.5505296058343463,0.020836950859524223,0,0,0,0,0.0,0.0,0.0,-1404,0,-0.12189616252821678,0.0
14900,54035,Jackson,West Virginia,2004,5384,7686,88,13158,0.4091807265541876,0.5841313269493844,0.006687946496428028,447,-152,1345,1640,-0.019452716751941934,-0.014149004363096195,0.03360172111503812,-2302,-898,-0.17495060039519683,-0.05305443786698005
14901,54035,Jackson,West Virginia,2008,4861,7148,227,12236,0.39727034978751224,0.584177835894083,0.01855181431840471,-523,139,-538,-922,-0.011910376766675335,0.011863867821976681,4.650894469859779e-05,-2287,15,-0.18690748610657076,-0.011956885711373932
14902,54035,Jackson,West Virginia,2012,3854,7408,332,11594,0.33241331723305156,0.6389511816456788,0.028635501121269624,-1007,105,260,-642,-0.06485703255446068,0.010083686802864915,0.05477334575159576,-3554,-1267,-0.3065378644126272,-0.11963037830605644
14903,54035,Jackson,West Virginia,2016,2663,9020,621,12304,0.21643368010403122,0.7330949284785435,0.05047139141742523,-1191,289,1612,710,-0.11597963712902035,0.021835890296155607,0.09414374683286475,-6357,-2803,-0.5166612483745123,-0.21012338396188512
14904,54037,Jefferson,West Virginia,2000,6860,7045,473,14378,0.4771178188899708,0.48998469884545837,0.03289748226457087,0,0,0,0,0.0,0.0,0.0,-185,0,-0.012866879955487576,0.0
14905,54037,Jefferson,West Virginia,2004,9301,10539,153,19993,0.465212824488571,0.5271344970739759,0.007652678437453109,2441,-320,3494,5615,-0.011904994401399804,-0.025244803827117763,0.037149798228517494,-1238,-1053,-0.061921672585404874,-0.0490547926299173
14906,54037,Jefferson,West Virginia,2008,11687,10600,372,22659,0.5157773952954676,0.4678052870823955,0.0164173176221369,2386,219,61,2666,0.050564570806896636,0.00876463918468379,-0.05932920999158037,1087,2325,0.04797210821307213,0.109893780798477
14907,54037,Jefferson,West Virginia,2012,10398,11258,580,22236,0.46762007555315704,0.5062960964202194,0.026083828026623495,-1289,208,658,-423,-0.04815731974231058,0.009666510404486597,0.03849080933782395,-860,-1947,-0.0386760208670624,-0.08664812908013453
14908,54037,Jefferson,West Virginia,2016,9518,13204,1786,24508,0.38836298351558673,0.5387628529459768,0.07287416353843643,-880,1206,1946,2272,-0.07925709203757031,0.04679033551181293,0.03246675652575737,-3686,-2826,-0.15039986943039008,-0.11172384856332768
14909,54039,Kanawha,West Virginia,2000,38524,36809,1337,76670,0.5024651102125994,0.48009651754271554,0.017438372244685012,0,0,0,0,0.0,0.0,0.0,1715,0,0.02236859266988389,0.0
14910,54039,Kanawha,West Virginia,2004,43010,44430,488,87928,0.48915021381130014,0.5052997907378765,0.005549995450823401,4486,-849,7621,11258,-0.013314896401299292,-0.011888376793861611,0.025203273195160913,-1420,-3135,-0.016149576926576314,-0.038518169596460206
14911,54039,Kanawha,West Virginia,2008,40594,40952,1341,82887,0.48975110692871016,0.4940702402065463,0.016178652864743567,-2416,853,-3478,-5041,0.0006008931174100174,0.010628657413920165,-0.011229550531330179,-358,1062,-0.004319133277836118,0.011830443648740196
14912,54039,Kanawha,West Virginia,2012,32480,41364,1468,75312,0.4312725727639686,0.5492351816443595,0.019492245591671977,-8114,127,412,-7575,-0.05847853416474158,0.0033135927269284104,0.0551649414378132,-8884,-8526,-0.1179626088803909,-0.11364347560255478
14913,54039,Kanawha,West Virginia,2016,28263,43850,4775,76888,0.3675866194984913,0.5703100613879929,0.06210331911351576,-4217,3307,2486,1576,-0.06368595326547727,0.04261107352184379,0.021074879743633423,-15587,-6703,-0.2027234418895016,-0.08476083300911069
14914,54041,Lewis,West Virginia,2000,2355,3606,173,6134,0.3839256602543202,0.5878708835996087,0.02820345614607108,0,0,0,0,0.0,0.0,0.0,-1251,0,-0.20394522334528853,0.0
14915,54041,Lewis,West Virginia,2004,2475,4445,79,6999,0.35362194599228464,0.6350907272467495,0.011287326760965851,120,-94,839,865,-0.03030371426203554,-0.016916129385105227,0.047219843647140824,-1970,-719,-0.2814687812544649,-0.07752355790917637
14916,54041,Lewis,West Virginia,2008,2109,4335,164,6608,0.3191585956416465,0.6560230024213075,0.024818401937046004,-366,85,-110,-391,-0.03446335035063813,0.013531075176080152,0.02093227517455798,-2226,-256,-0.336864406779661,-0.05539562552519611
14917,54041,Lewis,West Virginia,2012,1736,4375,183,6294,0.2758182395932634,0.6951064505878615,0.029075309818875118,-373,19,40,-314,-0.0433403560483831,0.004256907881829114,0.03908344816655396,-2639,-413,-0.41928821099459807,-0.08242380421493706
14918,54041,Lewis,West Virginia,2016,1347,5274,315,6936,0.19420415224913495,0.7603806228373703,0.04541522491349481,-389,132,899,642,-0.08161408734412845,0.016339915094619694,0.06527417224950882,-3927,-1288,-0.5661764705882353,-0.14688825959363722
14919,54043,Lincoln,West Virginia,2000,3939,3389,136,7464,0.5277331189710611,0.4540460878885316,0.01822079314040729,0,0,0,0,0.0,0.0,0.0,550,0,0.0736870310825295,0.0
14920,54043,Lincoln,West Virginia,2004,4048,4102,162,8312,0.4870067372473532,0.4935033686236766,0.019489894128970165,109,26,713,848,-0.040726381723707905,0.001269100988562876,0.039457280735144984,-54,-604,-0.006496631376323392,-0.08018366245885289
14921,54043,Lincoln,West Virginia,2008,3029,3637,169,6835,0.4431602048280907,0.5321141185076811,0.024725676664228237,-1019,7,-465,-1477,-0.04384653241926251,0.005235782535258072,0.03861074988400448,-608,-554,-0.08895391367959038,-0.08245728230326699
14922,54043,Lincoln,West Virginia,2012,2227,4383,208,6818,0.3266353769433852,0.6428571428571429,0.030507480199471988,-802,39,746,-17,-0.11652482788470553,0.005781803535243751,0.11074302434946182,-2156,-1548,-0.3162217659137577,-0.22726785223416734
14923,54043,Lincoln,West Virginia,2016,1459,5307,371,7137,0.20442763065713884,0.7435897435897436,0.05198262575311756,-768,163,924,319,-0.12220774628624634,0.02147514555364557,0.10073260073260071,-3848,-1692,-0.5391621129326047,-0.22294034701884702
14924,54045,Logan,West Virginia,2000,8927,5334,178,14439,0.618256111919108,0.369416164554332,0.012327723526560011,0,0,0,0,0.0,0.0,0.0,3593,0,0.248839947364776,0.0
14925,54045,Logan,West Virginia,2004,7877,7047,63,14987,0.5255888436645092,0.4702075131780877,0.004203643157403083,-1050,-115,1713,548,-0.09266726825459881,-0.00812408036915693,0.10079134862375566,830,-2763,0.05538133048642152,-0.19345861687835447
14926,54045,Logan,West Virginia,2008,5873,7326,325,13524,0.43426501035196685,0.5417036379769299,0.024031351671103224,-2004,262,279,-1463,-0.09132383331254235,0.01982770851370014,0.07149612479884221,-1453,-2283,-0.10743862762496303,-0.16281995811138456
14927,54045,Logan,West Virginia,2012,3469,8222,281,11972,0.2897594386902773,0.6867691279652522,0.02347143334447043,-2404,-44,896,-1552,-0.14450557166168954,-0.0005599183266327933,0.14506548998832236,-4753,-3300,-0.39700968927497493,-0.2895710616500119
14928,54045,Logan,West Virginia,2016,2092,9897,451,12440,0.16816720257234727,0.7955787781350482,0.0362540192926045,-1377,170,1675,468,-0.12159223611793005,0.01278258594813407,0.10880965016979594,-7805,-3052,-0.6274115755627009,-0.23040188628772595
14929,54047,McDowell,West Virginia,2000,4845,2348,110,7303,0.6634259893194577,0.32151170751745856,0.015062303163083664,0,0,0,0,0.0,0.0,0.0,2497,0,0.3419142818019992,0.0
14930,54047,McDowell,West Virginia,2004,4501,2762,36,7299,0.6166598164132073,0.37840800109604056,0.004932182490752158,-344,-74,414,-4,-0.0467661729062504,-0.010130120672331506,0.056896293578582,1739,-758,0.23825181531716677,-0.1036624664848324
14931,54047,McDowell,West Virginia,2008,3430,2882,118,6430,0.5334370139968896,0.44821150855365477,0.018351477449455676,-1071,82,120,-869,-0.08322280241631774,0.013419294958703518,0.06980350745761421,548,-1191,0.08522550544323482,-0.15302630987393195
14932,54047,McDowell,West Virginia,2012,2109,3959,120,6188,0.34082094376212024,0.6397866839043309,0.019392372333548805,-1321,2,1077,-242,-0.19261607023476934,0.001040894884093129,0.19157517535067614,-1850,-2398,-0.29896574014221067,-0.3841912455854455
14933,54047,McDowell,West Virginia,2016,1438,4629,179,6246,0.23022734550112073,0.7411143131604226,0.028658341338456614,-671,59,670,58,-0.11059359826099951,0.00926596900490781,0.10132762925609173,-3191,-1341,-0.510886967659302,-0.2119212275170913
14934,54049,Marion,West Virginia,2000,12315,9972,586,22873,0.5384077296375639,0.435972544047567,0.02561972631486906,0,0,0,0,0.0,0.0,0.0,2343,0,0.10243518558999687,0.0
14935,54049,Marion,West Virginia,2004,12771,12150,273,25194,0.5069064062872113,0.48225768040009526,0.010835913312693499,456,-313,2178,2321,-0.031501323350352606,-0.014783813002175562,0.04628513635252823,621,-1722,0.02464872588711603,-0.07778645970288084
14936,54049,Marion,West Virginia,2008,11618,11501,621,23740,0.4893850042122999,0.48445661331086776,0.02615838247683235,-1153,348,-649,-1454,-0.017521402074911374,0.01532246916413885,0.0021989329107724997,117,-504,0.004928390901432156,-0.019720334985683874
14937,54049,Marion,West Virginia,2012,8959,12054,540,21553,0.4156729921588642,0.5592724910685287,0.02505451677260706,-2659,-81,553,-2187,-0.0737120120534357,-0.0011038657042252882,0.07481587775766096,-3095,-3212,-0.1435994989096645,-0.14852788981109666
14938,54049,Marion,West Virginia,2016,6964,14668,1732,23364,0.29806539976031504,0.6278034583119328,0.0741311419277521,-1995,1192,2614,1811,-0.11760759239854918,0.049076625155145034,0.06853096724340413,-7704,-4609,-0.3297380585516178,-0.1861385596419533
14939,54051,Marshall,West Virginia,2000,6000,6859,639,13498,0.44451029782189955,0.5081493554600681,0.0473403467180323,0,0,0,0,0.0,0.0,0.0,-859,0,-0.06363905763816857,0.0
14940,54051,Marshall,West Virginia,2004,6435,8516,121,15072,0.42695063694267515,0.5650212314225053,0.008028131634819533,435,-518,1657,1574,-0.017559660879224392,-0.03931221508321277,0.056871875962437146,-2081,-1222,-0.1380705944798301,-0.07443153684166154
14941,54051,Marshall,West Virginia,2008,5996,7759,246,14001,0.4282551246339547,0.5541747018070138,0.017570173559031496,-439,125,-757,-1071,0.0013044876912795544,0.009542041924211963,-0.010846529615491485,-1763,318,-0.12591957717305907,0.01215101730677104
14942,54051,Marshall,West Virginia,2012,4484,8135,341,12960,0.34598765432098766,0.6277006172839507,0.02631172839506173,-1512,95,376,-1041,-0.08226747031296705,0.008741554836030233,0.07352591547693688,-3651,-1888,-0.281712962962963,-0.15579338578990393
14943,54051,Marshall,West Virginia,2016,2918,9666,767,13351,0.21856040746011535,0.7239907123061943,0.05744888023369036,-1566,426,1531,391,-0.1274272468608723,0.03113715183862863,0.09629009502224362,-6748,-3097,-0.5054303048460789,-0.22371734188311587
14944,54053,Mason,West Virginia,2000,4963,5972,288,11223,0.442216876058095,0.5321215361311592,0.02566158781074579,0,0,0,0,0.0,0.0,0.0,-1009,0,-0.08990466007306419,0.0
14945,54053,Mason,West Virginia,2004,5408,6487,95,11990,0.45104253544620515,0.5410341951626355,0.0079232693911593,445,-193,515,767,0.00882565938811014,-0.01773831841958649,0.008912659031476311,-1079,-70,-0.08999165971643036,-8.699964336617017e-05
14946,54053,Mason,West Virginia,2008,4484,5853,266,10603,0.4228991794775064,0.5520135810619636,0.02508723946053004,-924,171,-634,-1387,-0.02814335596869877,0.01716397006937074,0.01097938589932812,-1369,-290,-0.12911440158445725,-0.03912274186802689
14947,54053,Mason,West Virginia,2012,3778,5741,271,9790,0.3859039836567926,0.586414708886619,0.027681307456588356,-706,5,-112,-813,-0.036995195820713755,0.0025940679960583177,0.03440112782465532,-1963,-594,-0.20051072522982633,-0.07139632364536908
14948,54053,Mason,West Virginia,2016,2081,7654,534,10269,0.2026487486610186,0.7453500827733957,0.052001168565585745,-1697,263,1913,479,-0.18325523499577404,0.02431986110899739,0.1589353738867767,-5573,-3610,-0.5427013341123771,-0.34219060888255076
14949,54055,Mercer,West Virginia,2000,8347,10206,322,18875,0.4422251655629139,0.5407152317880795,0.017059602649006623,0,0,0,0,0.0,0.0,0.0,-1859,0,-0.09849006622516554,0.0
14950,54055,Mercer,West Virginia,2004,9178,13057,144,22379,0.4101166271951383,0.5834487689351624,0.0064346038696992715,831,-178,2851,3504,-0.03210853836777561,-0.010624998779307351,0.042733537147082945,-3879,-2020,-0.1733321417400241,-0.07484207551485855
14951,54055,Mercer,West Virginia,2008,7450,13246,393,21089,0.35326473516999385,0.6280999573237233,0.018635307506282898,-1728,249,189,-1290,-0.05685189202514446,0.012200703636583626,0.04465118838856086,-5796,-1917,-0.2748352221537294,-0.10150308041370532
14952,54055,Mercer,West Virginia,2012,5432,15450,431,21313,0.2548679209871909,0.72490967953831,0.020222399474499133,-2018,38,2204,224,-0.09839681418280294,0.0015870919682162352,0.09680972221458672,-10018,-4222,-0.47004175855111907,-0.19520653639738966
14953,54055,Mercer,West Virginia,2016,4704,17404,1089,23197,0.2027848428676122,0.7502694313919903,0.046945725740397466,-728,658,1954,1884,-0.05208307811957871,0.026723326265898333,0.025359751853680335,-12700,-2682,-0.5474845885243781,-0.07744282997325902
14954,54057,Mineral,West Virginia,2000,3341,6180,261,9782,0.341545696176651,0.6317726436311593,0.026681660192189736,0,0,0,0,0.0,0.0,0.0,-2839,0,-0.2902269474545083,0.0
14955,54057,Mineral,West Virginia,2004,3518,7854,89,11461,0.3069540179739988,0.6852805165343339,0.0077654654916673935,177,-172,1674,1679,-0.03459167820265219,-0.018916194700522342,0.0535078729031746,-4336,-1497,-0.37832649856033507,-0.08809955110582679
14956,54057,Mineral,West Virginia,2008,3750,7616,181,11547,0.3247596778383996,0.6595652550446003,0.015675067117000088,232,92,-238,86,0.017805659864400802,0.007909601625332694,-0.025715261489733576,-3866,470,-0.3348055772062007,0.04352092135413438
14957,54057,Mineral,West Virginia,2012,2885,7833,270,10988,0.2625591554423007,0.7128685839097197,0.024572260647979613,-865,89,217,-559,-0.06220052239609891,0.008897193530979525,0.05330332886511946,-4948,-1082,-0.45030942846741906,-0.11550385126121837
14958,54057,Mineral,West Virginia,2016,2050,9070,551,11671,0.17564904464056208,0.7771399194584868,0.047211035900951076,-835,281,1237,683,-0.0869101108017386,0.022638775252971463,0.06427133554876707,-7020,-2072,-0.6014908748179247,-0.15118144635050568
14959,54059,Mingo,West Virginia,2000,6049,3866,128,10043,0.6023100667131335,0.38494473762819875,0.012745195658667729,0,0,0,0,0.0,0.0,0.0,2183,0,0.21736532908493472,0.0
14960,54059,Mingo,West Virginia,2004,5983,4612,60,10655,0.5615204129516659,0.4328484279680901,0.005631159080244017,-66,-68,746,612,-0.04078965376146759,-0.0071140365784237115,0.047903690339891336,1371,-812,0.1286719849835758,-0.08869334410135893
14961,54059,Mingo,West Virginia,2008,3582,4587,169,8338,0.42959942432237946,0.5501319261213721,0.020268649556248502,-2401,109,-25,-2317,-0.13192098862928642,0.014637490476004485,0.11728349815328198,-1005,-2376,-0.12053250179899261,-0.2492044867825684
14962,54059,Mingo,West Virginia,2012,2428,6191,236,8855,0.2741953698475438,0.6991530208921514,0.026651609260304913,-1154,67,1604,517,-0.15540405447483568,0.006382959704056411,0.1490210947707793,-3763,-2758,-0.4249576510446076,-0.304425149245615
14963,54059,Mingo,West Virginia,2016,1370,7911,229,9510,0.1440588853838065,0.8318611987381703,0.024079915878023134,-1058,-7,1720,655,-0.13013648446373727,-0.002571693382281779,0.13270817784601896,-6541,-2778,-0.6878023133543638,-0.2628446623097562
14964,54061,Monongalia,West Virginia,2000,12603,13595,1169,27367,0.4605181422881573,0.49676617824387037,0.042715679467972376,0,0,0,0,0.0,0.0,0.0,-992,0,-0.036248035955713076,0.0
14965,54061,Monongalia,West Virginia,2004,16313,17670,323,34306,0.4755144872617035,0.515070250102023,0.009415262636273538,3710,-846,4075,6939,0.014996344973546183,-0.033300416831698834,0.018304071858152637,-1357,-365,-0.03955576284031953,-0.0033077268846064545
14966,54061,Monongalia,West Virginia,2008,17060,15775,734,33569,0.5082069766749084,0.4699276117846823,0.021865411540409305,747,411,-1895,-737,0.03269248941320496,0.012450148904135767,-0.04514263831734072,1285,2642,0.03827936489022615,0.07783512773054568
14967,54061,Monongalia,West Virginia,2012,13826,16831,934,31591,0.4376562945142604,0.5327783229400779,0.02956538254566174,-3234,200,1056,-1978,-0.07055068216064803,0.007699971005252434,0.06285071115539559,-3005,-4290,-0.09512202842581746,-0.13340139331604361
14968,54061,Monongalia,West Virginia,2016,14699,18432,3633,36764,0.39982047655314984,0.5013600261125014,0.09881949733434882,873,2699,1601,5173,-0.037835817961110574,0.06925411478868708,-0.031418296827576464,-3733,-728,-0.10153954955935157,-0.00641752113353411
14969,54063,Monroe,West Virginia,2000,2094,2940,105,5139,0.407472270869819,0.5720957384705195,0.020431990659661413,0,0,0,0,0.0,0.0,0.0,-846,0,-0.1646234676007005,0.0
14970,54063,Monroe,West Virginia,2004,2311,3590,50,5951,0.3883380944379096,0.6032599563098638,0.008401949252226516,217,-55,650,812,-0.0191341764319094,-0.012030041407434897,0.03116421783934431,-1279,-433,-0.21492186187195422,-0.05029839427125371
14971,54063,Monroe,West Virginia,2008,2014,3397,164,5575,0.3612556053811659,0.6093273542600897,0.029417040358744394,-297,114,-193,-376,-0.027082489056743708,0.021015091106517877,0.006067397950225817,-1383,-104,-0.24807174887892375,-0.033149887006969525
14972,54063,Monroe,West Virginia,2012,1455,3616,161,5232,0.27809633027522934,0.691131498470948,0.03077217125382263,-559,-3,219,-343,-0.08315927510593657,0.0013551308950782368,0.08180414421085835,-2161,-778,-0.41303516819571867,-0.16496341931679492
14973,54063,Monroe,West Virginia,2016,1111,4443,298,5852,0.18984962406015038,0.7592276144907724,0.05092276144907724,-344,137,827,620,-0.08824670621507896,0.020150590195254607,0.06809611601982435,-3332,-1171,-0.569377990430622,-0.1563428222349033
14974,54065,Morgan,West Virginia,2000,1939,3639,194,5772,0.33593208593208596,0.6304573804573804,0.03361053361053361,0,0,0,0,0.0,0.0,0.0,-1700,0,-0.29452529452529447,0.0
14975,54065,Morgan,West Virginia,2004,2272,4511,64,6847,0.3318241565649189,0.6588286840952242,0.00934715933985687,333,-130,872,1075,-0.004107929367167029,-0.024263374270676735,0.028371303637843792,-2239,-539,-0.3270045275303053,-0.03247923300501082
14976,54065,Morgan,West Virginia,2008,2721,4428,127,7276,0.3739692138537658,0.6085761407366685,0.017454645409565695,449,63,-83,429,0.04214505728884688,0.008107486069708824,-0.05025254335855567,-1707,532,-0.23460692688290274,0.09239760064740254
14977,54065,Morgan,West Virginia,2012,2363,4513,195,7071,0.3341818696082591,0.6382407014566539,0.027577428935086974,-358,68,85,-205,-0.03978734424550673,0.010122783525521279,0.029664560719985356,-2150,-443,-0.30405883184839483,-0.06945190496549208
14978,54065,Morgan,West Virginia,2016,1573,5732,432,7737,0.20330877601137393,0.7408556287966912,0.05583559519193486,-790,237,1219,666,-0.13087309359688515,0.028258166256847884,0.1026149273400373,-4159,-2009,-0.5375468527853173,-0.2334880209369225
14979,54067,Nicholas,West Virginia,2000,4059,4359,161,8579,0.4731320666744376,0.5081011772933909,0.01876675603217158,0,0,0,0,0.0,0.0,0.0,-300,0,-0.0349691106189533,0.0
14980,54067,Nicholas,West Virginia,2004,4788,5485,78,10351,0.4625640034779248,0.5299004927060187,0.007535503816056419,729,-83,1126,1772,-0.010568063196512767,-0.011231252216115161,0.021799315412627807,-697,-397,-0.06733648922809388,-0.032367378609140574
14981,54067,Nicholas,West Virginia,2008,4357,4804,200,9361,0.46544172631129155,0.5131930349321654,0.021365238756543104,-431,122,-681,-990,0.002877722833366736,0.013829734940486685,-0.016707457773853296,-447,250,-0.047751308620873845,0.019585180607220032
14982,54067,Nicholas,West Virginia,2012,2664,5898,229,8791,0.3030371971334319,0.6709134341940621,0.02604936867250597,-1693,29,1094,-570,-0.16240452917785964,0.004684129915962867,0.15772039926189674,-3234,-2787,-0.3678762370606302,-0.3201249284397564
14983,54067,Nicholas,West Virginia,2016,1840,7251,488,9579,0.19208685666562272,0.7569683683056686,0.05094477502870863,-824,259,1353,788,-0.11095034046780919,0.02489540635620266,0.08605493411160647,-5411,-2177,-0.5648815116400459,-0.19700527457941563
14984,54069,Ohio,West Virginia,2000,7653,9607,704,17964,0.4260187040748163,0.53479180583389,0.039189490091293695,0,0,0,0,0.0,0.0,0.0,-1954,0,-0.10877310175907368,0.0
14985,54069,Ohio,West Virginia,2004,8543,11694,155,20392,0.41893879952922713,0.5734601804629267,0.007601020007846214,890,-549,2087,2428,-0.007079904545589155,-0.03158847008344748,0.03866837462903672,-3151,-1197,-0.15452138093369955,-0.04574827917462587
14986,54069,Ohio,West Virginia,2008,8593,10694,253,19540,0.43976458546571134,0.5472876151484135,0.012947799385875128,50,98,-1000,-852,0.02082578593648421,0.005346779378028914,-0.026172565314513174,-2101,1050,-0.10752302968270216,0.04699835125099738
14987,54069,Ohio,West Virginia,2012,6786,10768,405,17959,0.3778606826660727,0.5995879503313102,0.022551367002617072,-1807,152,74,-1581,-0.061903902799638644,0.009603567616741944,0.05230033518289667,-3982,-1881,-0.22172726766523748,-0.11420423798253532
14988,54069,Ohio,West Virginia,2016,5493,11139,1582,18214,0.3015812012737455,0.6115625343142638,0.08685626441199078,-1293,1177,371,255,-0.07627948139232721,0.0643048974093737,0.01197458398295359,-5646,-1664,-0.3099813330405183,-0.0882540653752808
14989,54071,Pendleton,West Virginia,2000,1172,1996,53,3221,0.36386215461036947,0.6196833281589569,0.016454517230673704,0,0,0,0,0.0,0.0,0.0,-824,0,-0.2558211735485874,0.0
14990,54071,Pendleton,West Virginia,2004,1381,2146,17,3544,0.3896726862302483,0.6055304740406321,0.004796839729119639,209,-36,150,323,0.02581053161987884,-0.011657677501554066,-0.014152854118324787,-765,59,-0.21585778781038378,0.03996338573820363
14991,54071,Pendleton,West Virginia,2008,1310,2035,50,3395,0.3858615611192931,0.5994108983799705,0.014727540500736377,-71,33,-111,-149,-0.0038111251109552158,0.009930700771616738,-0.006119575660661569,-725,40,-0.21354933726067743,0.0023084505497063534
14992,54071,Pendleton,West Virginia,2012,1074,2095,87,3256,0.3298525798525799,0.6434275184275184,0.02671990171990172,-236,37,60,-139,-0.05600898126671322,0.011992361219165342,0.044016620047547916,-1021,-296,-0.31357493857493857,-0.10002560131426114
14993,54071,Pendleton,West Virginia,2016,729,2398,127,3254,0.2240319606637984,0.7369391518131531,0.039028887523048554,-345,40,303,-2,-0.10582061918878147,0.012308985803146835,0.09351163338563462,-1669,-648,-0.5129071911493547,-0.1993322525744161
14994,54073,Pleasants,West Virginia,2000,1267,1884,57,3208,0.3949501246882793,0.587281795511222,0.017768079800498753,0,0,0,0,0.0,0.0,0.0,-617,0,-0.19233167082294267,0.0
14995,54073,Pleasants,West Virginia,2004,1349,2061,25,3435,0.3927219796215429,0.6,0.00727802037845706,82,-32,177,227,-0.0022281450667363534,-0.010490059422041693,0.012718204488778029,-712,-95,-0.20727802037845705,-0.014946349555514382
14996,54073,Pleasants,West Virginia,2008,1142,1772,61,2975,0.3838655462184874,0.5956302521008403,0.020504201680672268,-207,36,-289,-460,-0.00885643340305553,0.013226181302215208,-0.0043697478991596705,-630,82,-0.2117647058823529,-0.00448668550389586
14997,54073,Pleasants,West Virginia,2012,955,1825,61,2841,0.3361492432242168,0.6423794438577966,0.021471312917986624,-187,0,53,-134,-0.0477163029942706,0.0009671112373143553,0.04674919175695624,-870,-240,-0.30623020063357975,-0.09446549475122684
14998,54073,Pleasants,West Virginia,2016,621,2358,200,3179,0.19534444793960365,0.7417426863793646,0.06291286568103177,-334,139,533,338,-0.14080479528461315,0.04144155276304515,0.09936324252156803,-1737,-867,-0.546398238439761,-0.24016803780618123
14999,54075,Pocahontas,West Virginia,2000,1392,1970,105,3467,0.40149985578309777,0.5682145947505047,0.03028554946639746,0,0,0,0,0.0,0.0,0.0,-578,0,-0.16671473896740696,0.0
15000,54075,Pocahontas,West Virginia,2004,1573,2295,50,3918,0.40148034711587544,0.5857580398162328,0.012761613067891782,181,-55,325,451,-1.9508667222334353e-05,-0.017523936398505677,0.017543445065728025,-722,-144,-0.18427769270035732,-0.01756295373295036
15001,54075,Pocahontas,West Virginia,2008,1548,2011,83,3642,0.42504118616144976,0.5521691378363537,0.022789676002196595,-25,33,-284,-276,0.023560839045574322,0.010028062934304813,-0.03358890197987907,-463,259,-0.12712795167490393,0.05714974102545339
15002,54075,Pocahontas,West Virginia,2012,1303,2182,106,3591,0.36285157337788915,0.607630186577555,0.029518240044555832,-245,23,171,-51,-0.06218961278356061,0.006728564042359237,0.05546104874120128,-879,-416,-0.24477861319966582,-0.11765066152476189
15003,54075,Pocahontas,West Virginia,2016,928,2496,251,3675,0.2525170068027211,0.6791836734693878,0.06829931972789116,-375,145,314,84,-0.11033456657516805,0.03878107968333533,0.07155348689183283,-1568,-689,-0.4266666666666667,-0.18188805346700088
15004,54077,Preston,West Virginia,2000,3515,6607,317,10439,0.33671807644410384,0.6329150301753041,0.030366893380592012,0,0,0,0,0.0,0.0,0.0,-3092,0,-0.2961969537312003,0.0
15005,54077,Preston,West Virginia,2004,3963,7855,111,11929,0.3322156090200352,0.6584793360717579,0.00930505490820689,448,-206,1248,1490,-0.0045024674240686235,-0.021061838472385123,0.025564305896453754,-3892,-800,-0.3262637270517227,-0.030066773320522377
15006,54077,Preston,West Virginia,2008,4205,7325,266,11796,0.35647677178704645,0.6209732112580536,0.022550016954899967,242,155,-530,-133,0.024261162767011235,0.013244962046693077,-0.0375061248137043,-3120,772,-0.26449643947100715,0.061767287580715535
15007,54077,Preston,West Virginia,2012,2931,7889,363,11183,0.26209425020119825,0.7054457658946616,0.03245998390414021,-1274,97,564,-613,-0.0943825215858482,0.009909966949240245,0.08447255463660797,-4958,-1838,-0.4433515156934633,-0.17885507622245617
15008,54077,Preston,West Virginia,2016,2470,9538,756,12764,0.19351300532748356,0.7472579128799749,0.05922908179254152,-461,393,1649,1581,-0.0685812448737147,0.02676909788840131,0.041812146985313325,-7068,-2110,-0.5537449075524914,-0.11039339185902808
15009,54079,Putnam,West Virginia,2000,7891,12173,362,20426,0.3863213551356115,0.5959561343385881,0.017722510525800452,0,0,0,0,0.0,0.0,0.0,-4282,0,-0.20963477920297657,0.0
15010,54079,Putnam,West Virginia,2004,9301,15716,134,25151,0.36980636952805057,0.6248658105045525,0.005327819967396922,1410,-228,3543,4725,-0.016514985607560928,-0.01239469055840353,0.028909676165964404,-6415,-2133,-0.2550594409765019,-0.04542466177352533
15011,54079,Putnam,West Virginia,2008,9334,15162,391,24887,0.3750552497287741,0.60923373648893,0.015711013782295977,33,257,-554,-264,0.005248880200723505,0.010383193814899055,-0.0156320740156225,-5828,587,-0.2341784867601559,0.020880954216346004
15012,54079,Putnam,West Virginia,2012,7256,16032,472,23760,0.3053872053872054,0.6747474747474748,0.019865319865319864,-2078,81,870,-1127,-0.0696680443415687,0.004154306083023886,0.06551373825854478,-8776,-2948,-0.3693602693602694,-0.1351817826001135
15013,54079,Putnam,West Virginia,2016,5884,17788,1539,25211,0.23339018682321208,0.705565031137202,0.061044782039585896,-1372,1067,1756,1451,-0.07199701856399329,0.04117946217426603,0.030817556389727274,-11904,-3128,-0.4721748443139899,-0.10281457495372054
15014,54081,Raleigh,West Virginia,2000,11047,12587,427,24061,0.4591247246581605,0.5231287145172686,0.017746560824570882,0,0,0,0,0.0,0.0,0.0,-1540,0,-0.0640039898591081,0.0
15015,54081,Raleigh,West Virginia,2004,11815,18519,191,30525,0.38705978705978705,0.6066830466830467,0.006257166257166257,768,-236,5932,6464,-0.07206493759837346,-0.011489394567404625,0.08355433216577812,-6704,-5164,-0.21962325962325968,-0.15561926976415158
15016,54081,Raleigh,West Virginia,2008,10237,17548,474,28259,0.3622562723380162,0.6209703103436074,0.016773417318376446,-1578,283,-971,-2266,-0.024803514721770836,0.010516251061210189,0.014287263660560656,-7311,-607,-0.2587140380055912,-0.03909077838233149
15017,54081,Raleigh,West Virginia,2012,7739,20614,484,28837,0.26837049623747267,0.7148455109754829,0.016783992787044424,-2498,10,3066,578,-0.09388577610054355,1.0575468667978205e-05,0.09387520063187549,-12875,-5564,-0.4464750147380102,-0.18776097673241904
15018,54081,Raleigh,West Virginia,2016,6443,22048,1401,29892,0.21554262009902314,0.7375886524822695,0.046868727418707345,-1296,917,1434,1055,-0.052827876138449525,0.030084734631662922,0.02274314150678658,-15605,-2730,-0.5220460323832463,-0.0755710176452361
15019,54083,Randolph,West Virginia,2000,4028,5248,266,9542,0.42213372458604065,0.5499895200167679,0.027876755397191366,0,0,0,0,0.0,0.0,0.0,-1220,0,-0.12785579543072728,0.0
15020,54083,Randolph,West Virginia,2004,4892,6512,86,11490,0.4257615317667537,0.5667536988685814,0.007484769364664926,864,-180,1264,1948,0.0036278071807130385,-0.02039198603252644,0.01676417885181347,-1620,-400,-0.14099216710182771,-0.013136371671100433
15021,54083,Randolph,West Virginia,2008,4539,6060,234,10833,0.41899750761561894,0.5594018277485461,0.02160066463583495,-353,148,-452,-657,-0.006764024151134751,0.014115895271170024,-0.007351871120035325,-1521,99,-0.14040432013292714,0.0005878469689005739
15022,54083,Randolph,West Virginia,2012,3342,6160,276,9778,0.34178768664348536,0.6299856821435876,0.02822663121292698,-1197,42,100,-1055,-0.07720982097213358,0.006625966577092031,0.07058385439504156,-2818,-1297,-0.2881979955001023,-0.14779367536717514
15023,54083,Randolph,West Virginia,2016,2735,7629,605,10969,0.24933904640350077,0.6955055155438052,0.055155438052693954,-607,329,1469,1191,-0.09244864023998459,0.026928806839766974,0.06551983340021761,-4894,-2076,-0.44616646914030444,-0.15796847364020217
15024,54085,Ritchie,West Virginia,2000,1024,2717,71,3812,0.26862539349422876,0.7127492130115425,0.018625393494228752,0,0,0,0,0.0,0.0,0.0,-1693,0,-0.4441238195173137,0.0
15025,54085,Ritchie,West Virginia,2004,1070,3086,40,4196,0.2550047664442326,0.7354623450905624,0.009532888465204958,46,-31,369,384,-0.01362062704999617,-0.009092505029023795,0.022713132079019926,-2016,-323,-0.4804575786463298,-0.0363337591290161
15026,54085,Ritchie,West Virginia,2008,998,2781,67,3846,0.2594903796151846,0.7230889235569423,0.017420696827873113,-72,27,-305,-350,0.00448561317095203,0.007887808362668156,-0.012373421533620088,-1783,233,-0.4635985439417577,0.016859034704572118
15027,54085,Ritchie,West Virginia,2012,768,2921,101,3790,0.20263852242744063,0.770712401055409,0.026649076517150396,-230,34,140,-56,-0.05685185718774399,0.009228379689277283,0.047623477498466626,-2153,-370,-0.5680738786279683,-0.10447533468621062
15028,54085,Ritchie,West Virginia,2016,496,3405,204,4105,0.12082825822168088,0.8294762484774665,0.04969549330085262,-272,103,484,315,-0.08181026420575975,0.023046416783702225,0.058763847422057536,-2909,-756,-0.7086479902557856,-0.1405741116278173
15029,54087,Roane,West Virginia,2000,2332,3172,121,5625,0.41457777777777777,0.5639111111111111,0.021511111111111113,0,0,0,0,0.0,0.0,0.0,-840,0,-0.14933333333333337,0.0
15030,54087,Roane,West Virginia,2004,2612,3440,48,6100,0.4281967213114754,0.5639344262295082,0.007868852459016393,280,-73,268,475,0.013618943533697636,-0.01364225865209472,2.3315118397038148e-05,-828,12,-0.13573770491803278,0.013595628415300598
15031,54087,Roane,West Virginia,2008,2511,2943,122,5576,0.4503228120516499,0.5277977044476327,0.02187948350071736,-101,74,-497,-524,0.02212609074017452,0.014010631041700968,-0.036136721781875436,-432,396,-0.07747489239598282,0.058262812522049956
15032,54087,Roane,West Virginia,2012,1939,2982,139,5060,0.383201581027668,0.5893280632411068,0.027470355731225297,-572,17,39,-516,-0.06712123102398193,0.005590872230507936,0.061530358793474016,-1043,-611,-0.20612648221343877,-0.12865158981745595
15033,54087,Roane,West Virginia,2016,1222,3781,312,5315,0.2299153339604892,0.7113828786453433,0.058701787394167454,-717,173,799,255,-0.1532862470671788,0.031231431662942157,0.12205481540423657,-2559,-1516,-0.48146754468485414,-0.2753410624714154
15034,54089,Summers,West Virginia,2000,2299,2304,110,4713,0.4877997029492892,0.48886059834500317,0.023339698705707616,0,0,0,0,0.0,0.0,0.0,-5,0,-0.0010608953957139677,0.0
15035,54089,Summers,West Virginia,2004,2504,2978,42,5524,0.4532947139753802,0.5391020999275887,0.007603186097031137,205,-68,674,811,-0.03450498897390902,-0.01573651260867648,0.05024150158258556,-474,-469,-0.08580738595220855,-0.08474649055649458
15036,54089,Summers,West Virginia,2008,2290,2891,135,5316,0.43077501881113617,0.5438299473288186,0.025395033860045147,-214,93,-87,-208,-0.022519695164244014,0.01779184776301401,0.00472784740122989,-601,-127,-0.11305492851768245,-0.027247542565473903
15037,54089,Summers,West Virginia,2012,1621,2981,142,4744,0.34169477234401346,0.6283726812816189,0.02993254637436762,-669,7,90,-572,-0.0890802464671227,0.004537512514322474,0.08454273395280032,-1360,-759,-0.2866779089376055,-0.17362298041992302
15038,54089,Summers,West Virginia,2016,1190,3455,248,4893,0.24320457796852646,0.7061107704884529,0.05068465154302064,-431,106,474,149,-0.098490194375487,0.02075210516865302,0.077738089206834,-2265,-905,-0.4629061925199265,-0.176228283582321
15039,54091,Taylor,West Virginia,2000,2473,3124,115,5712,0.4329481792717087,0.5469187675070029,0.020133053221288517,0,0,0,0,0.0,0.0,0.0,-651,0,-0.11397058823529416,0.0
15040,54091,Taylor,West Virginia,2004,2617,3893,41,6551,0.39948099526789804,0.5942604182567547,0.0062585864753472754,144,-74,769,839,-0.03346718400381066,-0.013874466745941241,0.04734165074975183,-1276,-625,-0.19477942298885664,-0.08080883475356249
15041,54091,Taylor,West Virginia,2008,2462,3605,136,6203,0.39690472352087697,0.5811704014186684,0.02192487506045462,-155,95,-288,-348,-0.002576271747021075,0.015666288585107345,-0.013090016838086305,-1143,133,-0.1842656778977914,0.01051374509106523
15042,54091,Taylor,West Virginia,2012,1941,3840,140,5921,0.32781624725553116,0.6485390981253166,0.02364465461915217,-521,4,235,-282,-0.06908847626534581,0.0017197795586975512,0.06736869670664825,-1899,-756,-0.32072285086978547,-0.13645717297199406
15043,54091,Taylor,West Virginia,2016,1491,4733,369,6593,0.22614894585166084,0.7178826027605035,0.055968451387835585,-450,229,893,672,-0.10166730140387031,0.03232379676868341,0.0693435046351869,-3242,-1343,-0.4917336569088427,-0.17101080603905722
15044,54093,Tucker,West Virginia,2000,1319,1935,92,3346,0.39420203227734607,0.578302450687388,0.02749551703526599,0,0,0,0,0.0,0.0,0.0,-616,0,-0.18410041841004188,0.0
15045,54093,Tucker,West Virginia,2004,1400,2179,21,3600,0.3888888888888889,0.6052777777777778,0.005833333333333334,81,-71,244,254,-0.0053131433884571755,-0.021662183701932656,0.026975327090389856,-779,-163,-0.2163888888888889,-0.03228847047884703
15046,54093,Tucker,West Virginia,2008,1288,2123,96,3507,0.36726546906187624,0.6053607071571143,0.02737382378100941,-112,75,-56,-93,-0.021623419827012658,0.021540490447676076,8.292937933651601e-05,-835,-56,-0.23809523809523808,-0.021706349206349174
15047,54093,Tucker,West Virginia,2012,880,2176,82,3138,0.2804333970681963,0.6934353091140854,0.026131293817718292,-408,-14,53,-369,-0.08683207199367993,-0.0012425299632911162,0.08807460195697103,-1296,-461,-0.41300191204588904,-0.17490667395065096
15048,54093,Tucker,West Virginia,2016,751,2565,185,3501,0.21451013996001142,0.7326478149100257,0.05284204512996287,-129,103,389,363,-0.06592325710818489,0.02671075131224458,0.03921250579594038,-1814,-518,-0.5181376749500143,-0.10513576290412524
15049,54095,Tyler,West Virginia,2000,1214,2582,132,3928,0.3090631364562118,0.6573319755600815,0.03360488798370672,0,0,0,0,0.0,0.0,0.0,-1368,0,-0.3482688391038697,0.0
15050,54095,Tyler,West Virginia,2004,1401,2798,46,4245,0.3300353356890459,0.6591283863368669,0.010836277974087162,187,-86,216,317,0.02097219923283411,-0.022768610009619557,0.0017964107767853843,-1397,-29,-0.32909305064782096,0.019175788456048726
15051,54095,Tyler,West Virginia,2008,1241,2415,85,3741,0.33172948409516173,0.6455493183640738,0.0227211975407645,-160,39,-383,-504,0.001694148406115814,0.01188491956667734,-0.013579067972793069,-1174,223,-0.3138198342689121,0.015273216378908883
15052,54095,Tyler,West Virginia,2012,890,2314,81,3285,0.2709284627092846,0.70441400304414,0.024657534246575342,-351,-4,-101,-456,-0.06080102138587712,0.0019363367058108406,0.058864684680066226,-1424,-250,-0.4334855403348554,-0.11966570606594334
15053,54095,Tyler,West Virginia,2016,507,2996,189,3692,0.13732394366197184,0.8114842903575298,0.05119176598049838,-383,108,682,407,-0.13360451904731277,0.026534231733923035,0.10707028731338974,-2489,-1065,-0.6741603466955579,-0.2406748063607025
15054,54097,Upshur,West Virginia,2000,2770,5165,188,8123,0.34100701711190445,0.6358488243259879,0.023144158562107595,0,0,0,0,0.0,0.0,0.0,-2395,0,-0.29484180721408343,0.0
15055,54097,Upshur,West Virginia,2004,3034,6191,68,9293,0.32648229850425053,0.6662003658667814,0.00731733562896804,264,-120,1026,1170,-0.01452471860765392,-0.015826822933139556,0.03035154154079356,-3157,-762,-0.3397180673625309,-0.04487626014844748
15056,54097,Upshur,West Virginia,2008,2925,5911,135,8971,0.3260506075130978,0.6589009029093746,0.015048489577527588,-109,67,-280,-322,-0.00043169099115275555,0.007731153948559548,-0.007299462957406799,-2986,171,-0.33285029539627686,0.006867771966254044
15057,54097,Upshur,West Virginia,2012,2158,5939,201,8298,0.2600626657025789,0.7157146300313328,0.024222704266088215,-767,66,28,-673,-0.06598794181051887,0.009174214688560627,0.0568137271219582,-3781,-795,-0.45565196432875393,-0.12280166893247707
15058,54097,Upshur,West Virginia,2016,1766,7005,527,9298,0.1899333189933319,0.7533878253387826,0.056678855667885567,-392,326,1066,1000,-0.070129346709247,0.03245615140179735,0.037673195307449725,-5239,-1458,-0.5634545063454507,-0.10780254201669676
15059,54099,Wayne,West Virginia,2000,7940,7993,308,16241,0.4888861523305215,0.49214949818360937,0.018964349485869097,0,0,0,0,0.0,0.0,0.0,-53,0,-0.003263345853087851,0.0
15060,54099,Wayne,West Virginia,2004,8411,10070,128,18609,0.45198559836638186,0.5411360094577893,0.0068783921758289,471,-180,2077,2368,-0.03690055396413966,-0.012085957310040196,0.04898651127417991,-1659,-1606,-0.08915041109140742,-0.08588706523831957
15061,54099,Wayne,West Virginia,2008,6137,8947,346,15430,0.3977316915100454,0.5798444588464031,0.022423849643551524,-2274,218,-1123,-3179,-0.054253906856336465,0.015545457467722623,0.03870844938861384,-2810,-1151,-0.18211276733635773,-0.0929623562449503
15062,54099,Wayne,West Virginia,2012,4931,8688,390,14009,0.3519880077093297,0.6201727460917982,0.027839246198872153,-1206,44,-259,-1421,-0.045743683800715695,0.005415396555320629,0.040328287245395056,-3757,-947,-0.2681847383824685,-0.08607197104611075
15063,54099,Wayne,West Virginia,2016,3357,11152,838,15347,0.2187398188571056,0.7266566755717729,0.05460350557112139,-1574,448,2464,1338,-0.1332481888522241,0.026764259372249237,0.10648392947997476,-7795,-4038,-0.5079168567146674,-0.23973211833219887
15064,54101,Webster,West Virginia,2000,1764,1484,60,3308,0.5332527206771464,0.4486094316807739,0.018137847642079808,0,0,0,0,0.0,0.0,0.0,280,0,0.08464328899637247,0.0
15065,54101,Webster,West Virginia,2004,1965,1724,25,3714,0.5290791599353797,0.4641895530425417,0.006731287022078622,201,-35,240,406,-0.004173560741766669,-0.011406560620001185,0.01558012136176784,241,-39,0.06488960689283796,-0.01975368210353451
15066,54101,Webster,West Virginia,2008,1552,1386,119,3057,0.5076872751063134,0.4533856722276742,0.03892705266601243,-413,94,-338,-657,-0.021391884829066288,0.03219576564393381,-0.01080388081486755,166,-75,0.05430160287863922,-0.010588004014198737
15067,54101,Webster,West Virginia,2012,947,1710,116,2773,0.3415073927154706,0.6166606563288857,0.04183195095564371,-605,-3,324,-284,-0.1661798823908428,0.0029048982896312803,0.1632749841012115,-763,-929,-0.2751532636134151,-0.3294548664920543
15068,54101,Webster,West Virginia,2016,556,2302,153,3011,0.18465626037861177,0.764530056459648,0.050813683161740286,-391,37,592,238,-0.15685113233685882,0.008981732206096577,0.14786940013076233,-1746,-983,-0.5798737960810363,-0.3047205324676212
15069,54103,Wetzel,West Virginia,2000,2849,3239,200,6288,0.4530852417302799,0.5151081424936387,0.031806615776081425,0,0,0,0,0.0,0.0,0.0,-390,0,-0.06202290076335876,0.0
15070,54103,Wetzel,West Virginia,2004,3330,3656,52,7038,0.4731457800511509,0.5194657573174197,0.007388462631429384,481,-148,417,750,0.020060538320870958,-0.024418153144652042,0.004357614823781053,-326,64,-0.04631997726626885,0.015702923497089905
15071,54103,Wetzel,West Virginia,2008,2942,3342,170,6454,0.45584133870467924,0.5178184071893399,0.026340254105980787,-388,118,-314,-584,-0.017304441346471633,0.018951791474551404,-0.0016473501280798164,-400,-74,-0.06197706848466067,-0.015657091218391817
15072,54103,Wetzel,West Virginia,2012,2217,3473,185,5875,0.37736170212765957,0.5911489361702128,0.03148936170212766,-725,15,131,-579,-0.07847963657701967,0.005149107596146875,0.07333052898087289,-1256,-856,-0.21378723404255323,-0.15181016555789256
15073,54103,Wetzel,West Virginia,2016,1359,4519,434,6312,0.2153041825095057,0.7159378960709759,0.06875792141951838,-858,249,1046,437,-0.16205751961815387,0.037268559717390716,0.12478895990076311,-3160,-1904,-0.5006337135614702,-0.286846479518917
15074,54105,Wirt,West Virginia,2000,818,1518,46,2382,0.3434089000839631,0.6372795969773299,0.019311502938706968,0,0,0,0,0.0,0.0,0.0,-700,0,-0.29387069689336687,0.0
15075,54105,Wirt,West Virginia,2004,896,1727,31,2654,0.33760361718161264,0.6507159005275056,0.011680482290881688,78,-15,209,272,-0.005805282902350439,-0.00763102064782528,0.013436303550175666,-831,-131,-0.31311228334589297,-0.019241586452526105
15076,54105,Wirt,West Virginia,2008,782,1496,48,2326,0.33619948409286327,0.6431642304385211,0.02063628546861565,-114,17,-231,-328,-0.0014041330887493708,0.008955803177733963,-0.007551670088984497,-714,117,-0.30696474634565785,0.006147537000235126
15077,54105,Wirt,West Virginia,2012,676,1427,68,2171,0.31137724550898205,0.6573007830492861,0.03132197144173192,-106,20,-69,-155,-0.024822238583881218,0.010685685973116268,0.014136552610764963,-751,-37,-0.345923537540304,-0.03895879119464618
15078,54105,Wirt,West Virginia,2016,386,1911,125,2422,0.1593724194880264,0.7890173410404624,0.051610239471511145,-290,57,484,251,-0.15200482602095564,0.020288268029779226,0.13171655799117632,-1525,-774,-0.629644921552436,-0.283721384012132
15079,54107,Wood,West Virginia,2000,12664,20428,765,33857,0.37404377233659214,0.6033611956168592,0.02259503204654872,0,0,0,0,0.0,0.0,0.0,-7764,0,-0.22931742328026705,0.0
15080,54107,Wood,West Virginia,2004,14025,24948,254,39227,0.3575343513396385,0.6359905167359217,0.006475131924439799,1361,-511,4520,5370,-0.016509420996953628,-0.01611990012210892,0.03262932111906247,-10923,-3159,-0.27845616539628315,-0.0491387421160161
15081,54107,Wood,West Virginia,2008,12573,22896,657,36126,0.34803188839063276,0.6337817638266069,0.018186347782760338,-1452,403,-2052,-3101,-0.009502462949005752,0.011711215858320538,-0.0022087529093147706,-10323,600,-0.28574987543597413,-0.0072937100396909815
15082,54107,Wood,West Virginia,2012,11230,22183,663,34076,0.3295574597957507,0.6509860312243221,0.01945650897992722,-1343,6,-713,-2050,-0.018474428594882075,0.0012701611971668823,0.01720426739771519,-10953,-630,-0.3214285714285714,-0.035678695992597265
15083,54107,Wood,West Virginia,2016,8400,25434,2229,36063,0.2329257133349971,0.7052657848764662,0.06180850178853673,-2830,1566,3251,1987,-0.09663174646075359,0.04235199280860951,0.0542797536521441,-17034,-6081,-0.47234007154146906,-0.15091150011289767
15084,54109,Wyoming,West Virginia,2000,4289,3473,116,7878,0.5444275196750444,0.44084793094694086,0.014724549378014725,0,0,0,0,0.0,0.0,0.0,816,0,0.10357958872810358,0.0
15085,54109,Wyoming,West Virginia,2004,3694,4985,39,8718,0.42372103693507684,0.5718054599678826,0.004473503097040606,-595,-77,1512,840,-0.12070648273996759,-0.010251046280974119,0.1309575290209417,-1291,-2107,-0.14808442303280572,-0.2516640117609093
15086,54109,Wyoming,West Virginia,2008,2735,4621,174,7530,0.36321381142098275,0.6136786188579018,0.023107569721115537,-959,135,-364,-1188,-0.0605072255140941,0.018634066624074932,0.04187315889001919,-1886,-595,-0.250464807436919,-0.10238038440411329
15087,54109,Wyoming,West Virginia,2012,1583,5769,174,7526,0.2103374966781823,0.7665426521392505,0.0231198511825671,-1152,0,1148,-4,-0.15287631474280045,1.2281461451563863e-05,0.1528640332813488,-4186,-2300,-0.5562051554610683,-0.3057403480241493
15088,54109,Wyoming,West Virginia,2016,1062,6547,271,7880,0.13477157360406092,0.8308375634517766,0.03439086294416244,-521,97,778,354,-0.07556592307412138,0.011271011761595336,0.06429491131252607,-5485,-1299,-0.6960659898477157,-0.13986083438664743
15089,55001,Adams,Wisconsin,2000,4826,3920,370,9116,0.5293988591487494,0.4300131636682756,0.04058797718297499,0,0,0,0,0.0,0.0,0.0,906,0,0.09938569548047382,0.0
15090,55001,Adams,Wisconsin,2004,5447,4890,119,10456,0.5209449120122418,0.4676740627390972,0.011381025248661056,621,-251,970,1340,-0.0084539471365076,-0.02920695193431393,0.037660899070821596,557,-349,0.05327084927314463,-0.046114846207329196
15091,55001,Adams,Wisconsin,2008,5806,3974,206,9986,0.5814139795714,0.3979571399959944,0.020628880432605648,359,87,-916,-470,0.06046906755915815,0.009247855183944591,-0.06971692274310276,1832,1275,0.18345683957540554,0.1301859903022609
15092,55001,Adams,Wisconsin,2012,5542,4644,99,10285,0.5388429752066116,0.45153135634419056,0.009625668449197862,-264,-107,670,299,-0.042571004364788334,-0.011003211983407786,0.053574216348196146,898,-934,0.08731161886242106,-0.09614522071298448
15093,55001,Adams,Wisconsin,2016,3745,5966,419,10130,0.3696939782823297,0.588943731490622,0.04136229022704837,-1797,320,1322,-155,-0.16914899692428192,0.031736621777850506,0.1374123751464314,-2221,-3119,-0.21924975320829226,-0.3065613720707133
15094,55003,Ashland,Wisconsin,2000,4356,3038,496,7890,0.5520912547528517,0.3850443599493029,0.06286438529784537,0,0,0,0,0.0,0.0,0.0,1318,0,0.16704689480354878,0.0
15095,55003,Ashland,Wisconsin,2004,5805,3313,81,9199,0.6310468529187955,0.36014784215675616,0.00880530492444831,1449,-415,275,1309,0.07895559816594377,-0.05405908037339706,-0.024896517792546757,2492,1174,0.2708990107620393,0.10385211595849053
15096,55003,Ashland,Wisconsin,2008,5818,2634,122,8574,0.6785630977373455,0.3072078376487054,0.014229064613949148,13,41,-679,-625,0.04751624481854999,0.005423759689500839,-0.05294000450805075,3184,692,0.37135526008864006,0.10045624932660074
15097,55003,Ashland,Wisconsin,2012,5399,2820,151,8370,0.6450418160095579,0.33691756272401435,0.018040621266427716,-419,29,186,-204,-0.033521281727787566,0.0038115566524785684,0.029709725075308946,2579,-605,0.30812425328554355,-0.06323100680309651
15098,55003,Ashland,Wisconsin,2016,4226,3303,503,8032,0.5261454183266933,0.4112300796812749,0.06262450199203187,-1173,352,483,-338,-0.11889639768286464,0.04458388072560415,0.07431251695726054,923,-1656,0.11491533864541836,-0.19320891464012518
15099,55005,Barron,Wisconsin,2000,8928,9848,1128,19904,0.44855305466237944,0.49477491961414793,0.05667202572347267,0,0,0,0,0.0,0.0,0.0,-920,0,-0.0462218649517685,0.0
15100,55005,Barron,Wisconsin,2004,11696,12030,211,23937,0.4886159502026152,0.5025692442661988,0.00881480553118603,2768,-917,2182,4033,0.04006289554023579,-0.047857220192286644,0.007794324652050821,-334,586,-0.013953294063583532,0.032268570888184966
15101,55005,Barron,Wisconsin,2008,12078,10457,351,22886,0.5277462203967491,0.45691689242331557,0.015336887179935331,382,140,-1573,-1051,0.0391302701941339,0.0065220816487493016,-0.04565235184288319,1621,1955,0.07082932797343355,0.08478262203701709
15102,55005,Barron,Wisconsin,2012,10890,11443,321,22654,0.48070980842235367,0.5051205085194668,0.014169683058179571,-1188,-30,986,-232,-0.04703641197439545,-0.0011672041217557598,0.0482036160961512,-553,-2174,-0.024410700097113103,-0.09524002807054666
15103,55005,Barron,Wisconsin,2016,7889,13614,1168,22671,0.34797759251907723,0.6005028450443297,0.051519562436593,-3001,847,2171,17,-0.13273221590327644,0.03734987937841343,0.09538233652486294,-5725,-5172,-0.2525252525252525,-0.22811455242813938
15104,55007,Bayfield,Wisconsin,2000,4427,3266,566,8259,0.5360213100859669,0.3954473907252694,0.06853129918876377,0,0,0,0,0.0,0.0,0.0,1161,0,0.14057391936069746,0.0
15105,55007,Bayfield,Wisconsin,2004,5845,3754,100,9699,0.6026394473657078,0.3870502113619961,0.010310341272296113,1418,-466,488,1440,0.06661813727974097,-0.058220957916467656,-0.008397179363273333,2091,930,0.21558923600371177,0.07501531664301431
15106,55007,Bayfield,Wisconsin,2008,5972,3365,131,9468,0.6307562315166878,0.3554076890578792,0.013836079425433037,127,31,-389,-231,0.028116784150979957,0.0035257381531369238,-0.031642522304116905,2607,516,0.27534854245880863,0.05975930645509686
15107,55007,Bayfield,Wisconsin,2012,6033,3603,152,9788,0.6163669799754802,0.36810380057212916,0.015529219452390683,61,21,238,320,-0.014389251541207626,0.0016931400269576454,0.012696111514249986,2430,-177,0.24826317940335102,-0.027085363055457612
15108,55007,Bayfield,Wisconsin,2016,4953,4124,535,9612,0.5152933832709113,0.42904702455264254,0.05565959217644611,-1080,383,521,-176,-0.10107359670456884,0.040130372724055424,0.060943223980513384,829,-1601,0.0862463587182688,-0.16201682068508222
15109,55009,Brown,Wisconsin,2000,49096,54258,4415,107769,0.45556699978658055,0.503465746179328,0.04096725403409144,0,0,0,0,0.0,0.0,0.0,-5162,0,-0.04789874639274749,0.0
15110,55009,Brown,Wisconsin,2004,54935,67173,1186,123294,0.4455610167566954,0.5448196992554383,0.0096192839878664,5839,-3229,12915,15525,-0.010005983029885146,-0.03134797004622504,0.04135395307611023,-12238,-7076,-0.09925868249874287,-0.051359936105995374
15111,55009,Brown,Wisconsin,2008,67269,55854,1631,124754,0.5392131715215545,0.44771309937957904,0.013073729098866569,12334,445,-11319,1460,0.09365215476485905,0.003454445111000168,-0.09710659987585923,11415,23653,0.09150007214197542,0.1907587546407183
15112,55009,Brown,Wisconsin,2012,62526,64836,1565,128927,0.48497211600362994,0.5028892318909151,0.012138652105455025,-4743,-66,8982,4173,-0.05424105551792452,-0.000935076993411544,0.05517613251133602,-2310,-13725,-0.017917115887285118,-0.10941718802926054
15113,55009,Brown,Wisconsin,2016,53382,67210,8419,129011,0.4137786700358884,0.5209633287084047,0.06525800125570688,-9144,6854,2374,84,-0.07119344596774152,0.053119349150251856,0.018074096817489615,-13828,-11518,-0.10718465867251625,-0.08926754278523114
15114,55011,Buffalo,Wisconsin,2000,3237,3038,366,6641,0.48742659238066555,0.4574612257190182,0.05511218190031622,0,0,0,0,0.0,0.0,0.0,199,0,0.02996536666164734,0.0
15115,55011,Buffalo,Wisconsin,2004,3998,3502,91,7591,0.526676327229614,0.4613357923857199,0.011987880384666052,761,-275,464,950,0.03924973484894845,-0.043124301515650165,0.0038745666667017176,496,297,0.06534053484389407,0.03537516818224673
15116,55011,Buffalo,Wisconsin,2008,3949,2923,128,7000,0.5641428571428572,0.4175714285714286,0.018285714285714287,-49,37,-579,-591,0.037466529913243174,0.006297833901048235,-0.04376436381429133,1026,530,0.14657142857142857,0.0812308937275345
15117,55011,Buffalo,Wisconsin,2012,3570,3364,103,7037,0.5073184595708399,0.4780446212874805,0.014636919141679692,-379,-25,441,37,-0.05682439757201729,-0.003648795144034595,0.06047319271605189,206,-820,0.029273838283359388,-0.11729759028806919
15118,55011,Buffalo,Wisconsin,2016,2525,4048,408,6981,0.36169603208709356,0.5798596189657642,0.05844434894714224,-1045,305,684,-56,-0.14562242748374632,0.043807429805462546,0.10181499767828373,-1523,-1729,-0.21816358687867066,-0.24743742516203004
15119,55013,Burnett,Wisconsin,2000,3626,3967,558,8151,0.44485339222181325,0.48668874984664456,0.06845785793154215,0,0,0,0,0.0,0.0,0.0,-341,0,-0.041835357624831315,0.0
15120,55013,Burnett,Wisconsin,2004,4499,4743,79,9321,0.4826735328827379,0.508850981654329,0.008475485462933162,873,-479,776,1170,0.03782014066092465,-0.059982372468608984,0.022162231807684396,-244,97,-0.02617744877159106,0.015657908853240254
15121,55013,Burnett,Wisconsin,2008,4337,4200,151,8688,0.49919429097605894,0.48342541436464087,0.017380294659300185,-162,72,-543,-633,0.016520758093321042,0.008904809196367023,-0.02542556728968809,137,381,0.01576887661141807,0.04194632538300913
15122,55013,Burnett,Wisconsin,2012,3986,4550,141,8677,0.4593753601475164,0.5243747839114902,0.01624985594099343,-351,-10,350,-11,-0.03981893082854254,-0.0011304387183067553,0.0409493695468493,-564,-701,-0.06499942376397377,-0.08076830037539184
15123,55013,Burnett,Wisconsin,2016,2949,5410,379,8738,0.33749141680018313,0.6191348134584573,0.04337376974135958,-1037,238,860,61,-0.12188394334733327,0.027123913800366148,0.09476002954696716,-2461,-1897,-0.2816433966582742,-0.21664397289430043
15124,55015,Calumet,Wisconsin,2000,8202,10837,908,19947,0.41118965257933526,0.5432897177520429,0.045520629668621845,0,0,0,0,0.0,0.0,0.0,-2635,0,-0.13210006517270767,0.0
15125,55015,Calumet,Wisconsin,2004,10290,14721,265,25276,0.4071055546763728,0.5824101914859946,0.010484253837632537,2088,-643,3884,5329,-0.004084097902962436,-0.03503637583098931,0.039120473733951666,-4431,-1796,-0.17530463680962177,-0.0432045716369141
15126,55015,Calumet,Wisconsin,2008,13295,12722,457,26474,0.5021908287376293,0.48054695172622197,0.017262219536148673,3005,192,-1999,1198,0.0950852740612565,0.006777965698516136,-0.10186323975977263,573,5004,0.021643877011407353,0.19694851382102913
15127,55015,Calumet,Wisconsin,2012,11489,14539,392,26420,0.43485995457986376,0.5503028009084028,0.014837244511733535,-1806,-65,1817,-54,-0.06733087415776556,-0.0024249750244151377,0.0697558491821808,-3050,-3623,-0.11544284632853902,-0.13708672333994637
15128,55015,Calumet,Wisconsin,2016,9642,15367,1586,26595,0.3625493513818387,0.5778153788306073,0.059635269787554054,-1847,1194,828,175,-0.07231060319802507,0.04479802527582052,0.027512577922204517,-5725,-2675,-0.2152660274487686,-0.09982318112022959
15129,55017,Chippewa,Wisconsin,2000,12102,12835,1236,26173,0.46238490046994996,0.49039086081075917,0.04722423871929087,0,0,0,0,0.0,0.0,0.0,-733,0,-0.02800596034080921,0.0
15130,55017,Chippewa,Wisconsin,2004,14751,15450,323,30524,0.48325907482636615,0.5061590879308085,0.010581837242825317,2649,-913,2615,4351,0.020874174356416197,-0.03664240147646555,0.015768227120049383,-699,34,-0.022900013104442396,0.005105947236366815
15131,55017,Chippewa,Wisconsin,2008,16239,13492,500,30231,0.5371638384439813,0.44629684760676125,0.016539313949257384,1488,177,-1958,-293,0.05390476361761515,0.005957476706432067,-0.0598622403240473,2747,3446,0.09086699083722005,0.11376700394166245
15132,55017,Chippewa,Wisconsin,2012,15237,15322,370,30929,0.492644443725953,0.4953926735426299,0.011962882731417117,-1002,-130,1830,698,-0.04451939471802829,-0.004576431217840267,0.04909582593586864,-85,-2832,-0.0027482298166768837,-0.09361522065389694
15133,55017,Chippewa,Wisconsin,2016,11887,17916,1765,31568,0.3765522047643183,0.5675367460719716,0.055911049163710085,-3350,1395,2594,639,-0.11609223896163473,0.04394816643229297,0.07214407252934169,-6029,-5944,-0.1909845413076533,-0.18823631149097642
15134,55019,Clark,Wisconsin,2000,5931,7461,757,14149,0.4191815676019507,0.527316418121422,0.053502014276627326,0,0,0,0,0.0,0.0,0.0,-1530,0,-0.10813485051947136,0.0
15135,55019,Clark,Wisconsin,2004,6966,7966,193,15125,0.46056198347107435,0.5266776859504132,0.012760330578512396,1035,-564,505,976,0.041380415869123666,-0.04074168369811493,-0.0006387321710088489,-1000,530,-0.06611570247933884,0.042019148040132515
15136,55019,Clark,Wisconsin,2008,7454,6383,350,14187,0.5254105871572566,0.449918939874533,0.024670472968210334,488,157,-1583,-938,0.06484860368618228,0.011910142389697937,-0.07675874607588018,1071,2071,0.07549164728272362,0.14160734976206246
15137,55019,Clark,Wisconsin,2012,6172,7412,217,13801,0.4472139700021738,0.5370625317006014,0.015723498297224837,-1282,-133,1029,-386,-0.07819661715508286,-0.008946974670985496,0.08714359182606835,-1240,-2311,-0.08984856169842759,-0.1653402089811512
15138,55019,Clark,Wisconsin,2016,4221,8652,800,13673,0.30871059752797486,0.6327799312513713,0.05850947122065384,-1951,583,1240,-128,-0.13850337247419892,0.042785972923429005,0.09571739955076997,-4431,-3191,-0.32406933372339647,-0.23422077202496888
15139,55021,Columbia,Wisconsin,2000,12636,11987,964,25587,0.4938445304256068,0.4684800875444562,0.037675382029937074,0,0,0,0,0.0,0.0,0.0,649,0,0.025364442881150584,0.0
15140,55021,Columbia,Wisconsin,2004,14300,14956,299,29555,0.48384368127220434,0.5060395872102859,0.010116731517509728,1664,-665,2969,3968,-0.010000849153402436,-0.027558650512427348,0.037559499665829665,-656,-1305,-0.022195905938081517,-0.0475603488192321
15141,55021,Columbia,Wisconsin,2008,16661,12193,418,29272,0.5691787373599344,0.41654140475539764,0.014279857884667941,2361,119,-2763,-283,0.08533505608773007,0.004163126367158213,-0.08949818245488822,4468,5124,0.15263733260453677,0.17483323854261829
15142,55021,Columbia,Wisconsin,2012,17175,13026,345,30546,0.5622667452366922,0.42643881359261443,0.01129444117069338,514,-73,833,1274,-0.006911992123242228,-0.002985416713974561,0.009897408837216792,4149,-319,0.13582793164407775,-0.01680940096045902
15143,55021,Columbia,Wisconsin,2016,13528,14163,2007,29698,0.4555188901609536,0.47690080140076774,0.06758030843827867,-3647,1662,1137,-848,-0.10674785507573858,0.05628586726758529,0.05046198780815331,-635,-4784,-0.021381911239814144,-0.1572098428838919
15144,55023,Crawford,Wisconsin,2000,4005,3024,365,7394,0.5416553962672437,0.408980254260211,0.04936434947254531,0,0,0,0,0.0,0.0,0.0,981,0,0.13267514200703268,0.0
15145,55023,Crawford,Wisconsin,2004,4656,3680,123,8459,0.5504196713559523,0.43503960278992787,0.014540725854119873,651,-242,656,1065,0.008764275088708584,-0.034823623618425434,0.026059348529716864,976,-5,0.1153800685660244,-0.01729507344100828
15146,55023,Crawford,Wisconsin,2008,4987,2830,164,7981,0.6248590402205237,0.35459215637138203,0.020548803408094223,331,41,-850,-478,0.07443936886457148,0.00600807755397435,-0.08044744641854584,2157,1181,0.2702668838491417,0.15488681528311732
15147,55023,Crawford,Wisconsin,2012,4629,3067,121,7817,0.5921709095560956,0.39235000639631573,0.015479084047588588,-358,-43,237,-164,-0.032688130664428106,-0.005069719360505634,0.0377578500249337,1562,-595,0.1998209031597799,-0.07044598068936181
15148,55023,Crawford,Wisconsin,2016,3419,3836,473,7728,0.44241718426501037,0.4963768115942029,0.06120600414078675,-1210,352,769,-89,-0.14975372529108527,0.04572692009319816,0.10402680519788715,-417,-1979,-0.05395962732919252,-0.2537805304889724
15149,55025,Dane,Wisconsin,2000,142317,75790,14632,232739,0.6114875461353705,0.32564374685806846,0.062868707006561,0,0,0,0,0.0,0.0,0.0,66527,0,0.285843799277302,0.0
15150,55025,Dane,Wisconsin,2004,181052,90369,2828,274249,0.6601737836783361,0.3295144193780105,0.010311796943653395,38735,-11804,14579,41510,0.04868623754296564,-0.0525569100629076,0.0038706725199420533,90683,24156,0.3306593643003256,0.044815565023023585
15151,55025,Dane,Wisconsin,2008,205984,73065,3890,282939,0.7280155793298202,0.258235874163689,0.013748546506490798,24932,1062,-17304,8690,0.06784179565148407,0.0034367495628374028,-0.07127854521432153,132919,42236,0.4697797051661312,0.1391203408658056
15152,55025,Dane,Wisconsin,2012,216071,83644,4427,304142,0.7104280237520632,0.2750162752924621,0.014555700955474746,10087,537,10579,21203,-0.01758755557775704,0.0008071544489839481,0.016780401128773104,132427,-492,0.43541174845960107,-0.034367956706530145
15153,55025,Dane,Wisconsin,2016,217697,71275,20382,309354,0.7037148380172876,0.2303994776211072,0.06588568436160515,1626,15955,-12369,5212,-0.006713185734775529,0.0513299834061304,-0.044616797671354874,146422,13995,0.4733153603961804,0.03790361193657932
15154,55027,Dodge,Wisconsin,2000,14580,21684,1437,37701,0.3867271425161136,0.575157157635076,0.03811569984881038,0,0,0,0,0.0,0.0,0.0,-7104,0,-0.1884300151189624,0.0
15155,55027,Dodge,Wisconsin,2004,16690,27201,445,44336,0.3764435221941537,0.613519487549621,0.01003699025622519,2110,-992,5517,6635,-0.010283620321959897,-0.02807870959258519,0.038362329914545024,-10511,-3407,-0.23707596535546732,-0.04864595023650492
15156,55027,Dodge,Wisconsin,2008,19183,23015,625,42823,0.4479602082992784,0.5374448310487355,0.014594960651986082,2493,180,-4186,-1513,0.07151668610512468,0.0045579703957608925,-0.07607465650088552,-3832,6679,-0.08948462274945712,0.1475913426060102
15157,55027,Dodge,Wisconsin,2012,18762,25211,514,44487,0.42174118281745226,0.566704880077326,0.01155393710522175,-421,-111,2196,1664,-0.02621902548182614,-0.003041023546764332,0.029260049028590474,-6449,-2617,-0.14496369725987374,-0.055479074510416615
15158,55027,Dodge,Wisconsin,2016,13968,26635,2475,43078,0.32424903663122706,0.6182970425739357,0.05745392079483727,-4794,1961,1424,-1409,-0.0974921461862252,0.04589998368961552,0.051592162496609695,-12667,-6218,-0.29404800594270863,-0.1490843086828349
15159,55029,Door,Wisconsin,2000,6560,7810,850,15220,0.43101182654402104,0.5131406044678055,0.05584756898817345,0,0,0,0,0.0,0.0,0.0,-1250,0,-0.08212877792378448,0.0
15160,55029,Door,Wisconsin,2004,8367,8910,214,17491,0.4783602995826425,0.5094048367731976,0.012234863644159854,1807,-636,1100,2271,0.04734847303862144,-0.0436127053440136,-0.0037357676946079277,-543,707,-0.03104453719055511,0.05108424073322937
15161,55029,Door,Wisconsin,2008,10142,7112,227,17481,0.5801727589954808,0.4068417138607631,0.012985527143756078,1775,13,-1798,-10,0.10181245941283834,0.0007506634995962241,-0.10256312291243447,3030,3573,0.1733310451347177,0.2043755823252728
15162,55029,Door,Wisconsin,2012,9357,8121,193,17671,0.5295116292230208,0.4595665214192745,0.010921849357704714,-785,-34,1009,190,-0.05066112977246007,-0.0020636777860513645,0.05272480755851139,1236,-1794,0.06994510780374624,-0.10338593733097146
15163,55029,Door,Wisconsin,2016,8014,8580,998,17592,0.4555479763528877,0.4877216916780355,0.056730331969076855,-1343,805,459,-79,-0.07396365287013307,0.045808482611372145,0.028155170258760964,-566,-1802,-0.03217371532514779,-0.10211882312889403
15164,55031,Douglas,Wisconsin,2000,13593,6930,1183,21706,0.6262323781442919,0.3192665622408551,0.054501059614853034,0,0,0,0,0.0,0.0,0.0,6663,0,0.3069658159034368,0.0
15165,55031,Douglas,Wisconsin,2004,16537,8448,202,25187,0.6565688648906182,0.33541112478659624,0.008020010322785563,2944,-981,1518,3481,0.030336486746326274,-0.04648104929206747,0.016144562545741148,8089,1426,0.3211577401040219,0.014191924200585126
15166,55031,Douglas,Wisconsin,2008,15830,7835,401,24066,0.6577744535859719,0.32556303498711875,0.016662511426909332,-707,199,-613,-1121,0.0012055886953536987,0.008642501104123769,-0.009848089799477489,7995,-94,0.3322114185988531,0.011053678494831187
15167,55031,Douglas,Wisconsin,2012,14863,7705,326,22894,0.6492093998427536,0.3365510614134708,0.014239538743775662,-967,-75,-130,-1172,-0.008565053743218254,-0.00242297268313367,0.010988026426352049,7158,-837,0.3126583384292828,-0.019553080169570303
15168,55031,Douglas,Wisconsin,2016,11357,9661,1518,22536,0.5039492367767128,0.42869187078452253,0.06735889243876464,-3506,1192,1956,-358,-0.14526016306604084,0.05311935369498898,0.09214080937105174,1696,-5462,0.07525736599219024,-0.23740097243709257
15169,55033,Dunn,Wisconsin,2000,9172,8911,1247,19330,0.474495602690119,0.4609932747025349,0.0645111226073461,0,0,0,0,0.0,0.0,0.0,261,0,0.01350232798758405,0.0
15170,55033,Dunn,Wisconsin,2004,12039,10879,254,23172,0.51954945624029,0.469489038494735,0.01096150526497497,2867,-993,1968,3842,0.04505385355017105,-0.053549617342371125,0.008495763792200073,1160,899,0.05006041774555503,0.03655808975797098
15171,55033,Dunn,Wisconsin,2008,13002,9566,421,22989,0.565574840140937,0.4161120535908478,0.018313106268215234,963,167,-1313,-183,0.04602538390064692,0.007351601003240263,-0.053376984903887204,3436,2276,0.14946278655008916,0.09940236880453412
15172,55033,Dunn,Wisconsin,2012,11316,10224,450,21990,0.5145975443383356,0.4649386084583902,0.020463847203274217,-1686,29,658,-999,-0.05097729580260135,0.0021507409350589833,0.04882655486754239,1092,-2344,0.04965893587994541,-0.09980385067014375
15173,55033,Dunn,Wisconsin,2016,9034,11486,1586,22106,0.4086673301366145,0.5195874423233511,0.07174522754003437,-2282,1136,1262,116,-0.1059302142017211,0.051281380336760156,0.05464883386496089,-2452,-3544,-0.11092011218673659,-0.160579048066682
15174,55035,Eau Claire,Wisconsin,2000,24078,20921,2876,47875,0.502934725848564,0.4369921671018277,0.06007310704960835,0,0,0,0,0.0,0.0,0.0,3157,0,0.06594255874673632,0.0
15175,55035,Eau Claire,Wisconsin,2004,30068,24653,716,55437,0.542381441997222,0.4447029961938777,0.012915561808900192,5990,-2160,3732,7562,0.03944671614865802,-0.04715754524070816,0.007710829092050009,5415,2258,0.09767844580334434,0.031735887056608014
15176,55035,Eau Claire,Wisconsin,2008,33146,20959,905,55010,0.6025449918196691,0.38100345391746954,0.0164515542628613,3078,189,-3694,-427,0.06016354982244709,0.0035359924539611065,-0.06369954227640817,12187,6772,0.2215415379021996,0.12386309209885527
15177,55035,Eau Claire,Wisconsin,2012,30666,23256,883,54805,0.5595474865431986,0.42434084481342943,0.016111668643371956,-2480,-22,2297,-205,-0.042997505276470505,-0.00033988561948934334,0.04333739089595989,7410,-4777,0.1352066417297692,-0.0863348961724304
15178,55035,Eau Claire,Wisconsin,2016,27340,23331,4354,55025,0.4968650613357565,0.42400726942298955,0.07912766924125397,-3326,3471,75,220,-0.06268242520744216,0.06301600059788201,-0.0003335753904398775,4009,-3401,0.07285779191276692,-0.06234884981700228
15179,55037,Florence,Wisconsin,2000,816,1528,61,2405,0.3392931392931393,0.6353430353430354,0.025363825363825365,0,0,0,0,0.0,0.0,0.0,-712,0,-0.29604989604989607,0.0
15180,55037,Florence,Wisconsin,2004,993,1703,28,2724,0.3645374449339207,0.6251835535976505,0.010279001468428781,177,-33,175,319,0.025244305640781395,-0.015084823895396584,-0.010159481745384835,-710,2,-0.26064610866372984,0.03540378738616623
15181,55037,Florence,Wisconsin,2008,1134,1512,39,2685,0.4223463687150838,0.5631284916201117,0.01452513966480447,141,11,-191,-39,0.05780892378116309,0.004246138196375688,-0.06205506197753885,-378,332,-0.1407821229050279,0.11986398575870194
15182,55037,Florence,Wisconsin,2012,953,1645,27,2625,0.36304761904761906,0.6266666666666667,0.010285714285714285,-181,-12,133,-60,-0.059298749667464734,-0.004239425379090184,0.06353817504655501,-692,-314,-0.26361904761904764,-0.12283692471401975
15183,55037,Florence,Wisconsin,2016,665,1898,93,2656,0.2503765060240964,0.7146084337349398,0.035015060240963854,-288,66,253,31,-0.11267111302352267,0.024729345955249567,0.08794176706827306,-1233,-541,-0.4642319277108434,-0.20061288009179573
15184,55039,Fond du Lac,Wisconsin,2000,18181,26548,1860,46589,0.3902423318809161,0.5698340810062461,0.03992358711283779,0,0,0,0,0.0,0.0,0.0,-8367,0,-0.17959174912533,0.0
15185,55039,Fond du Lac,Wisconsin,2004,19216,33291,529,53036,0.36231993362998716,0.6277057093295121,0.009974357040500792,1035,-1331,6743,6447,-0.02792239825092896,-0.029949230072336998,0.05787162832326598,-14075,-5708,-0.26538577569952493,-0.08579402657419494
15186,55039,Fond du Lac,Wisconsin,2008,23463,28164,696,52323,0.44842612235536955,0.538271888079812,0.01330198956481853,4247,167,-5127,-713,0.0861061887253824,0.003327632524317739,-0.08943382124970012,-4701,9374,-0.08984576572444242,0.1755400099750825
15187,55039,Fond du Lac,Wisconsin,2012,22379,30355,662,53396,0.41911379129522813,0.5684882762753765,0.01239793242939546,-1084,-34,2191,1073,-0.029312331060141417,-0.0009040571354230701,0.030216388195564492,-7976,-3275,-0.14937448498014833,-0.05952871925570591
15188,55039,Fond du Lac,Wisconsin,2016,17387,31022,3387,51796,0.3356822920688856,0.5989265580353695,0.06539114989574485,-4992,2725,667,-1600,-0.08343149922634252,0.052993217466349385,0.03043828175999308,-13635,-5659,-0.2632442659664839,-0.1138697809863356
15189,55041,Forest,Wisconsin,2000,2158,2404,154,4716,0.4575911789652248,0.5097540288379983,0.03265479219677693,0,0,0,0,0.0,0.0,0.0,-246,0,-0.052162849872773476,0.0
15190,55041,Forest,Wisconsin,2004,2509,2608,36,5153,0.48690083446536,0.5061129439161653,0.006986221618474675,351,-118,204,437,0.0293096555001352,-0.025668570578302255,-0.0036410849218329044,-99,147,-0.01921210945080537,0.032950740421968105
15191,55041,Forest,Wisconsin,2008,2673,1963,47,4683,0.5707879564381807,0.4191757420456972,0.010036301516122144,164,11,-645,-470,0.08388712197282072,0.003050079897647469,-0.08693720187046816,710,809,0.1516122143924835,0.17082432384328888
15192,55041,Forest,Wisconsin,2012,2425,2172,51,4648,0.5217297762478486,0.46729776247848537,0.010972461273666093,-248,4,209,-35,-0.049058180190332146,0.0009361597575439484,0.04812202043278818,253,-457,0.054432013769363186,-0.09718020062312033
15193,55041,Forest,Wisconsin,2016,1579,2787,179,4545,0.3474147414741474,0.6132013201320132,0.039383938393839385,-846,128,615,-103,-0.17431503477370114,0.028411477120173292,0.14590355765352786,-1208,-1461,-0.2657865786578658,-0.320218592427229
15194,55043,Grant,Wisconsin,2000,10691,10240,1025,21956,0.4869284022590636,0.46638732009473494,0.04668427764620149,0,0,0,0,0.0,0.0,0.0,451,0,0.02054108216432865,0.0
15195,55043,Grant,Wisconsin,2004,12864,12208,192,25264,0.5091830272324256,0.4832172260924636,0.007599746675110829,2173,-833,1968,3308,0.022254624973362003,-0.03908453097109066,0.016829905997728656,656,205,0.025965801139961997,0.005424718975633347
15196,55043,Grant,Wisconsin,2008,14875,9068,377,24320,0.6116365131578947,0.37286184210526313,0.015501644736842105,2011,185,-3140,-944,0.1024534859254691,0.007901898061731276,-0.11035538398720046,5807,5151,0.23877467105263156,0.21280886991266956
15197,55043,Grant,Wisconsin,2012,13594,10255,398,24247,0.5606466779395389,0.42293892027879737,0.01641440178166371,-1281,21,1187,-73,-0.05098983521835576,0.0009127570448216066,0.05007707817353424,3339,-2468,0.13770775766074156,-0.10106691339189
15198,55043,Grant,Wisconsin,2016,10051,12350,1967,24368,0.4124671700590939,0.506812212738017,0.08072061720288903,-3543,1569,2095,121,-0.14817950788044504,0.06430621542122532,0.08387329245921965,-2299,-5638,-0.09434504267892313,-0.2320528003396647
15199,55045,Green,Wisconsin,2000,7863,6790,623,15276,0.5147289866457188,0.4444880858863577,0.04078292746792354,0,0,0,0,0.0,0.0,0.0,1073,0,0.07024090075936107,0.0
15200,55045,Green,Wisconsin,2004,9575,8497,176,18248,0.5247150372643578,0.4656400701446734,0.009644892590968873,1712,-447,1707,2972,0.009986050618638997,-0.031138034876954664,0.021151984258315715,1078,5,0.05907496711968435,-0.011165933639676717
15201,55045,Green,Wisconsin,2008,11502,6730,302,18534,0.6205891874393007,0.3631164346606237,0.016294377900075537,1927,126,-1767,286,0.09587415017494294,0.006649485309106664,-0.10252363548404969,4772,3694,0.257472752778677,0.19839778565899263
15202,55045,Green,Wisconsin,2012,11206,7857,259,19322,0.5799606665976607,0.40663492392091916,0.013404409481420142,-296,-43,1127,788,-0.04062852084164004,-0.0028899684186553948,0.043518489260295445,3349,-1423,0.1733257426767415,-0.08414701010193548
15203,55045,Green,Wisconsin,2016,9122,8693,1170,18985,0.48048459309981567,0.4578878061627601,0.06162760073742428,-2084,911,836,-337,-0.09947607349784499,0.04822319125600413,0.051252882241840936,429,-2920,0.02259678693705558,-0.15072895573968592
15204,55047,Green Lake,Wisconsin,2000,3301,5451,355,9107,0.3624684308773471,0.5985505654990666,0.03898100362358625,0,0,0,0,0.0,0.0,0.0,-2150,0,-0.2360821346217195,0.0
15205,55047,Green Lake,Wisconsin,2004,3605,6472,101,10178,0.35419532324621733,0.6358813126350953,0.009923364118687364,304,-254,1021,1071,-0.008273107631129761,-0.02905763950489889,0.037330747136028686,-2867,-717,-0.28168598938887796,-0.04560385476715845
15206,55047,Green Lake,Wisconsin,2008,4000,5393,143,9536,0.41946308724832215,0.5655411073825504,0.014995805369127516,395,42,-1079,-642,0.06526776400210482,0.005072441250440152,-0.07034020525254492,-1393,1474,-0.14607802013422821,0.13560796925464974
15207,55047,Green Lake,Wisconsin,2012,3793,5782,99,9674,0.3920818689270209,0.597684515195369,0.010233615877610088,-207,-44,389,138,-0.02738121832130125,-0.0047621894915174275,0.03214340781281866,-1989,-596,-0.20560264626834812,-0.05952462613411991
15208,55047,Green Lake,Wisconsin,2016,2693,6216,507,9416,0.2860025488530161,0.6601529311809685,0.053844519966015296,-1100,408,434,-258,-0.10607932007400478,0.043610904088405206,0.06246841598559949,-3523,-1534,-0.3741503823279524,-0.16854773605960427
15209,55049,Iowa,Wisconsin,2000,5842,4221,478,10541,0.5542168674698795,0.40043639123422825,0.04534674129589223,0,0,0,0,0.0,0.0,0.0,1621,0,0.15378047623565128,0.0
15210,55049,Iowa,Wisconsin,2004,7122,5348,72,12542,0.5678520172221336,0.4264072715675331,0.00574071121033328,1280,-406,1127,2001,0.013635149752254105,-0.03960603008555895,0.025970880333304858,1774,153,0.14144474565460052,-0.012335730581050752
15211,55049,Iowa,Wisconsin,2008,7987,3829,153,11969,0.6673072102932576,0.31990976689781936,0.012783022808923052,865,81,-1519,-573,0.09945519307112394,0.007042311598589771,-0.10649750466971375,4158,2384,0.3473974433954382,0.2059526977408377
15212,55049,Iowa,Wisconsin,2012,8105,4287,142,12534,0.6466411361097814,0.34202967927237915,0.011329184617839477,118,-11,458,565,-0.020666074183476213,-0.001453838191083575,0.02211991237455979,3818,-340,0.3046114568374022,-0.042785986558036004
15213,55049,Iowa,Wisconsin,2016,6669,4809,797,12275,0.5432993890020367,0.39177189409368635,0.06492871690427698,-1436,655,522,-259,-0.10334174710774469,0.053599532286437504,0.049742214821307196,1860,-1958,0.15152749490835032,-0.15308396192905188
15214,55051,Iron,Wisconsin,2000,1620,1734,153,3507,0.4619332763045338,0.49443969204448246,0.04362703165098375,0,0,0,0,0.0,0.0,0.0,-114,0,-0.03250641573994867,0.0
15215,55051,Iron,Wisconsin,2004,1956,1884,39,3879,0.5042536736272235,0.48569218870843,0.010054137664346482,336,-114,150,372,0.04232039732268972,-0.033572893986637264,-0.008747503336052453,72,186,0.018561484918793503,0.05106790065874217
15216,55051,Iron,Wisconsin,2008,1914,1464,54,3432,0.5576923076923077,0.42657342657342656,0.015734265734265736,-42,15,-420,-447,0.0534386340650842,0.005680128069919254,-0.059118762135003444,450,378,0.13111888111888115,0.11255739620008764
15217,55051,Iron,Wisconsin,2012,1784,1790,58,3632,0.4911894273127753,0.49284140969163,0.015969162995594713,-130,4,326,200,-0.06650288037953239,0.0002348972613289771,0.06626798311820342,-6,-456,-0.0016519823788546661,-0.1327708634977358
15218,55051,Iron,Wisconsin,2016,1275,2081,157,3513,0.3629376601195559,0.592371192712781,0.04469114716766297,-509,99,291,-119,-0.1282517671932194,0.028721984172068254,0.09952978302115106,-806,-800,-0.22943353259322513,-0.22778155021437047
15219,55053,Jackson,Wisconsin,2000,4380,3670,367,8417,0.5203754306760129,0.4360223357490792,0.043602233574907924,0,0,0,0,0.0,0.0,0.0,710,0,0.08435309492693366,0.0
15220,55053,Jackson,Wisconsin,2004,5249,4387,90,9726,0.5396874357392556,0.4510590170676537,0.009253547193090685,869,-277,717,1309,0.01931200506324271,-0.03434868638181724,0.015036681318574496,862,152,0.08862841867160187,0.0042753237446682135
15221,55053,Jackson,Wisconsin,2008,5572,3552,127,9251,0.6023132634309805,0.38395849097394874,0.013728245595070803,323,37,-835,-475,0.06262582769172487,0.0044746984019801185,-0.06710052609370498,2020,1158,0.21835477245703172,0.12972635378542985
15222,55053,Jackson,Wisconsin,2012,5298,3900,115,9313,0.5688822076667025,0.4187694620423065,0.012348330290991088,-274,-12,348,62,-0.03343105576427796,-0.0013799153040797152,0.03481097106835773,1398,-622,0.15011274562439603,-0.0682420268326357
15223,55053,Jackson,Wisconsin,2016,3818,4906,543,9267,0.41199956836085033,0.5294054170713284,0.058595014567821305,-1480,428,1006,-46,-0.15688263930585217,0.046246684276830215,0.1106359550290219,-1088,-2486,-0.11740584871047804,-0.26751859433487407
15224,55055,Jefferson,Wisconsin,2000,15203,19204,1692,36099,0.4211474002049918,0.5319814953322807,0.0468711044627275,0,0,0,0,0.0,0.0,0.0,-4001,0,-0.11083409512728887,0.0
15225,55055,Jefferson,Wisconsin,2004,17925,23776,414,42115,0.42562032529977445,0.5645494479401638,0.009830226760061735,2722,-1278,4572,6016,0.004472925094782643,-0.037040877702665766,0.032567952607883144,-5851,-1850,-0.13892912264038937,-0.0280950275131005
15226,55055,Jefferson,Wisconsin,2008,21448,21096,622,43166,0.4968725385720243,0.4887179724783394,0.014409488949636288,3523,208,-2680,1051,0.07125221327224984,0.004579262189574553,-0.0758314754618244,352,6203,0.008154566093684867,0.14708368873407424
15227,55055,Jefferson,Wisconsin,2012,20158,23517,606,44281,0.4552291050337617,0.5310855671732797,0.013685327792958606,-1290,-16,2421,1115,-0.04164343353826261,-0.0007241611566776822,0.04236759469494028,-3359,-3711,-0.07585646213951802,-0.08401102823320289
15228,55055,Jefferson,Wisconsin,2016,16569,23417,3123,43109,0.38435129555313274,0.5432044352687374,0.07244426917812986,-3589,2517,-100,-1172,-0.07087780948062894,0.05875894138517126,0.012118868095457702,-6848,-3489,-0.15885313971560466,-0.08299667757608664
15229,55057,Juneau,Wisconsin,2000,4813,4910,495,10218,0.47103151301624585,0.48052456449403014,0.04844392248972402,0,0,0,0,0.0,0.0,0.0,-97,0,-0.009493051477784287,0.0
15230,55057,Juneau,Wisconsin,2004,5734,6473,172,12379,0.46320381290895873,0.5229016883431618,0.013894498747879474,921,-323,1563,2161,-0.007827700107287117,-0.03454942374184455,0.042377123849131615,-739,-642,-0.05969787543420302,-0.05020482395641873
15231,55057,Juneau,Wisconsin,2008,6186,5148,196,11530,0.5365134431916739,0.4464874241110147,0.01699913269731136,452,24,-1325,-849,0.0733096302827152,0.003104633949431888,-0.07641426423214703,1038,1777,0.09002601908065921,0.14972389451486223
15232,55057,Juneau,Wisconsin,2012,6242,5411,174,11827,0.5277754291029001,0.45751247146360025,0.01471209943349962,56,-22,263,297,-0.008738014088773838,-0.0022870332638117424,0.011025047352585526,831,-207,0.07026295763929985,-0.019763061441359364
15233,55057,Juneau,Wisconsin,2016,4073,7130,532,11735,0.34708138048572645,0.6075841499786963,0.045334469535577335,-2169,358,1719,-92,-0.18069404861717364,0.030622370102077717,0.150071678515096,-3057,-3888,-0.2605027694929698,-0.33076572713226965
15234,55059,Kenosha,Wisconsin,2000,32429,28891,2389,63709,0.5090175642373919,0.4534838091949332,0.03749862656767489,0,0,0,0,0.0,0.0,0.0,3538,0,0.055533755042458666,0.0
15235,55059,Kenosha,Wisconsin,2004,40107,35587,734,76428,0.5247684094834354,0.4656277803946198,0.009603810121944837,7678,-1655,6696,12719,0.015750845246043532,-0.027894816445730056,0.012143971199686576,4520,982,0.05914062908881562,0.003606874046356956
15236,55059,Kenosha,Wisconsin,2008,45836,31609,1344,78789,0.5817563365444415,0.401185444668672,0.017058218786886493,5729,610,-3978,2361,0.05698792706100608,0.0074544086649416565,-0.06444233572594776,14227,9707,0.18057089187576947,0.12143026278695385
15237,55059,Kenosha,Wisconsin,2012,44867,34977,1052,80896,0.5546256922468354,0.4323699564873418,0.013004351265822785,-969,-292,3368,2107,-0.027130644297606032,-0.004053867521063709,0.03118451181866977,9890,-4337,0.12225573575949367,-0.0583151561162758
15238,55059,Kenosha,Wisconsin,2016,35799,36037,4468,76304,0.469162822394632,0.47228192493185156,0.05855525267351646,-9068,3416,1060,-4592,-0.08546286985220347,0.045550901407693675,0.03991196844450978,-238,-10128,-0.003119102537219587,-0.12537483829671325
15239,55061,Kewaunee,Wisconsin,2000,4670,4883,531,10084,0.46310987703292344,0.48423244744149146,0.05265767552558508,0,0,0,0,0.0,0.0,0.0,-213,0,-0.02112257040856802,0.0
15240,55061,Kewaunee,Wisconsin,2004,5175,5970,128,11273,0.4590614743191697,0.5295839616783465,0.011354564002483811,505,-403,1087,1189,-0.004048402713753729,-0.041303111523101274,0.04535151423685507,-795,-582,-0.07052248735917682,-0.0493999169506088
15241,55061,Kewaunee,Wisconsin,2008,5902,4711,174,10787,0.5471400760174284,0.43672939649578196,0.016130527486789656,727,46,-1259,-486,0.08807860169825871,0.004775963484305845,-0.09285456518256457,1191,1986,0.11041067952164646,0.18093316688082328
15242,55061,Kewaunee,Wisconsin,2012,5153,5747,137,11037,0.4668841170607955,0.5207030896076833,0.012412793331521246,-749,-37,1036,250,-0.0802559589566329,-0.0037177341552684096,0.08397369311190134,-594,-1785,-0.05381897254688778,-0.16422965206853424
15243,55061,Kewaunee,Wisconsin,2016,3627,6618,522,10767,0.336862635831708,0.6146558930064084,0.04848147116188353,-1526,385,871,-270,-0.13002148122908752,0.036068677830362286,0.09395280339872514,-2991,-2397,-0.27779325717470044,-0.22397428462781266
15244,55063,La Crosse,Wisconsin,2000,28455,24327,2777,55559,0.5121582461887363,0.43785885275112946,0.04998290106013427,0,0,0,0,0.0,0.0,0.0,4128,0,0.07429939343760683,0.0
15245,55063,La Crosse,Wisconsin,2004,33170,28289,677,62136,0.5338290202137247,0.4552755246555942,0.010895455130681086,4715,-2100,3962,6577,0.021670774024988404,-0.03908744592945318,0.01741667190446472,4881,753,0.07855349555813051,0.004254102120523684
15246,55063,La Crosse,Wisconsin,2008,38524,23701,993,63218,0.6093834034610396,0.3749090448922775,0.015707551646682905,5354,316,-4588,1082,0.0755543832473149,0.0048120965160018195,-0.08036647976331668,14823,9942,0.2344743585687621,0.15592086301063157
15247,55063,La Crosse,Wisconsin,2012,36693,25751,1005,63449,0.5783069867137386,0.4058535201500418,0.01583949313621964,-1831,12,2050,231,-0.031076416747300994,0.00013194148953673407,0.03094447525776428,10942,-3881,0.1724534665636968,-0.062020892005065276
15248,55063,La Crosse,Wisconsin,2016,32406,26378,4890,63674,0.5089361434808556,0.41426641957470867,0.07679743694443572,-4287,3885,627,225,-0.069370843232883,0.06095794380821608,0.008412899424666886,6028,-4914,0.09466972390614692,-0.07778374265754989
15249,55065,Lafayette,Wisconsin,2000,3710,3336,217,7263,0.5108082059754923,0.4593143329202809,0.029877461104226902,0,0,0,0,0.0,0.0,0.0,374,0,0.05149387305521136,0.0
15250,55065,Lafayette,Wisconsin,2004,4402,3929,57,8388,0.5247973295183596,0.4684072484501669,0.006795422031473534,692,-160,593,1125,0.013989123542867299,-0.023082039072753368,0.009092915529886003,473,99,0.056390081068192655,0.004896208012981296
15251,55065,Lafayette,Wisconsin,2008,4732,2984,115,7831,0.6042651002426255,0.3810496743710893,0.014685225386285276,330,58,-945,-557,0.07946777072426592,0.007889803354811743,-0.08735757407907763,1748,1275,0.2232154258715362,0.16682534480334354
15252,55065,Lafayette,Wisconsin,2012,4536,3314,102,7952,0.5704225352112676,0.4167505030181087,0.012826961770623743,-196,-13,330,121,-0.03384256503135785,-0.0018582636156615328,0.0357008286470194,1222,-526,0.15367203219315895,-0.06954339367837725
15253,55065,Lafayette,Wisconsin,2016,3288,3977,397,7662,0.4291307752545027,0.5190550770033934,0.05181414774210389,-1248,295,663,-290,-0.1412917599567649,0.03898718597148015,0.1023045739852847,-689,-1911,-0.08992430174889066,-0.2435963339420496
15254,55067,Langlade,Wisconsin,2000,4199,5125,397,9721,0.4319514453245551,0.5272091348626684,0.040839419812776466,0,0,0,0,0.0,0.0,0.0,-926,0,-0.09525768953811331,0.0
15255,55067,Langlade,Wisconsin,2004,4751,6235,88,11074,0.4290229366082716,0.5630305219432906,0.007946541448437781,552,-309,1110,1353,-0.0029285087162834733,-0.032892878364338685,0.03582138708062221,-1484,-558,-0.134007585335019,-0.03874989579690569
15256,55067,Langlade,Wisconsin,2008,5182,5081,139,10402,0.49817342818688715,0.4884637569698135,0.013362814843299365,431,51,-1154,-672,0.06915049157861552,0.005416273394861584,-0.07456676497347714,101,1585,0.009709671217073668,0.14371725655209266
15257,55067,Langlade,Wisconsin,2012,4573,5816,130,10519,0.43473714231390814,0.5529042684665842,0.012358589219507558,-609,-9,735,117,-0.063436285872979,-0.0010042256237918074,0.06444051149677077,-1243,-1344,-0.1181671261526761,-0.12787679736974977
15258,55067,Langlade,Wisconsin,2016,3250,6478,458,10186,0.3190653838602003,0.6359709405065777,0.04496367563322207,-1323,328,662,-333,-0.11567175845370786,0.03260508641371451,0.0830666720399934,-3228,-1985,-0.3169055566463774,-0.19873843049370127
15259,55069,Lincoln,Wisconsin,2000,6664,6727,848,14239,0.4680103939883419,0.47243486199873586,0.05955474401292225,0,0,0,0,0.0,0.0,0.0,-63,0,-0.004424468010393978,0.0
15260,55069,Lincoln,Wisconsin,2004,7484,8024,192,15700,0.476687898089172,0.5110828025477707,0.012229299363057325,820,-656,1297,1461,0.008677504100830125,-0.04732544464986493,0.038647940549034865,-540,-477,-0.03439490445859872,-0.02997043644820474
15261,55069,Lincoln,Wisconsin,2008,8424,6519,325,15268,0.5517422059208803,0.42697144354204875,0.021286350537070998,940,133,-1505,-432,0.0750543078317083,0.009057051174013673,-0.08411135900572198,1905,2445,0.12477076237883156,0.15916566683743028
15262,55069,Lincoln,Wisconsin,2012,7563,7455,198,15216,0.49704258675078866,0.4899447949526814,0.013012618296529969,-861,-127,936,-52,-0.05469961917009164,-0.008273732240541029,0.06297335141063265,108,-1797,0.007097791798107267,-0.11767297058072429
15263,55069,Lincoln,Wisconsin,2016,5371,8401,940,14712,0.3650761283306145,0.5710304513322458,0.06389342033713975,-2192,742,946,-504,-0.13196645842017418,0.05088080204060978,0.08108565637956444,-3030,-3138,-0.20595432300163136,-0.21305211479973862
15264,55071,Manitowoc,Wisconsin,2000,17667,19358,1799,38824,0.4550535751081805,0.4986091077683907,0.046337317123428805,0,0,0,0,0.0,0.0,0.0,-1691,0,-0.04355553266021017,0.0
15265,55071,Manitowoc,Wisconsin,2004,20652,23027,481,44160,0.4676630434782609,0.5214447463768116,0.010892210144927536,2985,-1318,3669,5336,0.012609468370080368,-0.03544510697850127,0.022835638608420916,-2375,-684,-0.05378170289855072,-0.010226170238340548
15266,55071,Manitowoc,Wisconsin,2008,22428,19234,752,42414,0.5287876644504174,0.45348234073654925,0.01772999481303343,1776,271,-3793,-1746,0.061124620972156485,0.006837784668105895,-0.06796240564026235,3194,5569,0.07530532371386811,0.12908702661241883
15267,55071,Manitowoc,Wisconsin,2012,20403,21604,607,42614,0.47878631435678415,0.5069695405265875,0.014244145116628339,-2025,-145,2370,200,-0.05000135009363321,-0.0034858496964050925,0.05348719979003824,-1201,-4395,-0.028183226169803344,-0.10348854988367145
15268,55071,Manitowoc,Wisconsin,2016,14538,23244,3004,40786,0.3564458392585691,0.5699014367675183,0.07365272397391262,-5865,2397,1640,-1828,-0.12234047509821505,0.05940857885728428,0.06293189624093076,-8706,-7505,-0.21345559750894916,-0.1852723713391458
15269,55073,Marathon,Wisconsin,2000,26546,28883,2945,58374,0.4547572549422688,0.49479220200774315,0.05045054304998801,0,0,0,0,0.0,0.0,0.0,-2337,0,-0.040034947065474336,0.0
15270,55073,Marathon,Wisconsin,2004,30899,36394,766,68059,0.4540031443306543,0.5347419151030723,0.01125494056627338,4353,-2179,7511,9685,-0.0007541106116145113,-0.03919560248371463,0.03994971309532919,-5495,-3158,-0.08073877077241803,-0.0407038237069437
15271,55073,Marathon,Wisconsin,2008,36367,30345,1228,67940,0.5352811304091846,0.4466440977332941,0.018074771857521342,5468,462,-6049,-119,0.08127798607853026,0.006819831291247962,-0.08809781736977823,6022,11517,0.08863703267589046,0.1693758034483085
15272,55073,Marathon,Wisconsin,2012,32363,36617,878,69858,0.463268344355693,0.5241633026997624,0.012568352944544647,-4004,-350,6272,1918,-0.0720127860534916,-0.005506418912976695,0.0775192049664683,-4254,-10276,-0.06089495834406944,-0.1495319910199599
15273,55073,Marathon,Wisconsin,2016,26481,39014,4023,69518,0.38092292643631864,0.5612071693662073,0.05786990419747404,-5882,3145,2397,-340,-0.08234541791937433,0.04530155125292939,0.03704386666644488,-12533,-8279,-0.18028424292988865,-0.11938928458581921
15274,55075,Marinette,Wisconsin,2000,8676,10535,710,19921,0.43552030520556195,0.5288389137091511,0.035640781085286885,0,0,0,0,0.0,0.0,0.0,-1859,0,-0.0933186085035892,0.0
15275,55075,Marinette,Wisconsin,2004,10190,11866,214,22270,0.4575662325999102,0.5328244274809161,0.009609339919173777,1514,-496,1331,2349,0.02204592739434824,-0.02603144116611311,0.003985513771764926,-1676,183,-0.07525819488100588,0.018060413622583316
15276,55075,Marinette,Wisconsin,2008,11195,9726,334,21255,0.5266996000940956,0.45758645024700073,0.015713949658903787,1005,120,-2140,-1015,0.06913336749418536,0.00610460973973001,-0.07523797723391534,1469,3145,0.06911314984709482,0.1443713447281007
15277,55075,Marinette,Wisconsin,2012,9882,10619,276,20777,0.4756220821100255,0.5110939981710545,0.01328391971891996,-1313,-58,893,-478,-0.051077517984070064,-0.002430029939983827,0.05350754792405377,-737,-2206,-0.03547191606102901,-0.10458506590812383
15278,55075,Marinette,Wisconsin,2016,6409,13122,812,20343,0.3150469448950499,0.6450376050729981,0.03991545003195202,-3473,536,2503,-434,-0.16057513721497557,0.026631530313032063,0.13394360690194362,-6713,-5976,-0.3299906601779482,-0.2945187441169192
15279,55077,Marquette,Wisconsin,2000,3437,3522,235,7194,0.4777592438142897,0.48957464553794827,0.03266611064776202,0,0,0,0,0.0,0.0,0.0,-85,0,-0.01181540172365858,0.0
15280,55077,Marquette,Wisconsin,2004,3785,4604,88,8477,0.44650230034210214,0.5431166686327711,0.010381031025126814,348,-147,1082,1283,-0.03125694347218755,-0.022285079622635207,0.05354202309482281,-819,-734,-0.09661436829066894,-0.08479896656701036
15281,55077,Marquette,Wisconsin,2008,4068,3654,124,7846,0.5184807545245985,0.46571501401988274,0.015804231455518736,283,36,-950,-631,0.07197845418249638,0.005423200430391921,-0.07740165461288834,414,1233,0.052765740504715775,0.14938010879538471
15282,55077,Marquette,Wisconsin,2012,4014,3992,99,8105,0.49524984577421344,0.49253547193090685,0.012214682294879703,-54,-25,338,259,-0.023230908750385082,-0.0035895491606390325,0.02682045791102411,22,-392,0.0027143738433065834,-0.05005136666140919
15283,55077,Marquette,Wisconsin,2016,2808,4709,374,7891,0.35584843492586493,0.5967557977442656,0.04739576732986947,-1206,275,717,-214,-0.1394014108483485,0.03518108503498977,0.10422032581335872,-1901,-1923,-0.24090736281840064,-0.24362173666170722
15284,55078,Menominee,Wisconsin,2000,949,225,59,1233,0.7696674776966748,0.18248175182481752,0.047850770478507706,0,0,0,0,0.0,0.0,0.0,724,0,0.5871857258718572,0.0
15285,55078,Menominee,Wisconsin,2004,1412,288,10,1710,0.8257309941520468,0.16842105263157894,0.005847953216374269,463,-49,63,477,0.056063516455372,-0.04200281726213344,-0.014060699193238574,1124,400,0.6573099415204678,0.0701242156486106
15286,55078,Menominee,Wisconsin,2008,1257,185,6,1448,0.8680939226519337,0.1277624309392265,0.004143646408839779,-155,-4,-103,-262,0.04236292849988699,-0.0017043068075344898,-0.04065862169235243,1072,-52,0.7403314917127073,0.08302155019223945
15287,55078,Menominee,Wisconsin,2012,1191,179,7,1377,0.8649237472766884,0.1299927378358751,0.005083514887436456,-66,1,-6,-71,-0.003170175375245332,0.000939868478596677,0.002230306896648576,1012,-60,0.7349310094408134,-0.005400482271893936
15288,55078,Menominee,Wisconsin,2016,1002,267,39,1308,0.7660550458715596,0.20412844036697247,0.02981651376146789,-189,32,88,-69,-0.09886870140512882,0.024732998874031437,0.07413570253109739,735,-277,0.5619266055045871,-0.1730044039362263
15289,55079,Milwaukee,Wisconsin,2000,252329,163491,17717,433537,0.5820241409614404,0.37710968152660557,0.040866177511954,0,0,0,0,0.0,0.0,0.0,88838,0,0.20491445943483483,0.0
15290,55079,Milwaukee,Wisconsin,2004,297653,180287,4296,482236,0.6172351296875389,0.3738563690806991,0.008908501231762041,45324,-13421,16796,48699,0.03521098872609851,-0.03195767628019196,-0.0032533124459064866,117366,28528,0.24337876060683983,0.038464301172005
15291,55079,Milwaukee,Wisconsin,2008,319819,149445,5928,475192,0.6730311116348761,0.31449393087425714,0.012474957490866849,22166,1632,-30842,-7044,0.05579598194733715,0.003566456259104808,-0.059362438206441936,170374,53008,0.3585371807606189,0.11515842015377908
15292,55079,Milwaukee,Wisconsin,2012,332438,154924,5210,492572,0.674902349301219,0.31452051679754434,0.010577133901236773,12619,-718,5479,17380,0.0018712376663428953,-0.0018978235896300755,2.6585923287192337e-05,177514,7140,0.3603818325036746,0.001844651743055703
15293,55079,Milwaukee,Wisconsin,2016,288822,126069,26162,441053,0.654846469698653,0.28583639607938277,0.05931713422196425,-43616,20952,-28855,-51519,-0.02005587960256594,0.04874000032072748,-0.028684120718161565,162753,-14761,0.36901007361927024,0.008628241115595625
15294,55081,Monroe,Wisconsin,2000,7460,8217,658,16335,0.4566880930517294,0.503030303030303,0.040281603917967555,0,0,0,0,0.0,0.0,0.0,-757,0,-0.046342209978573634,0.0
15295,55081,Monroe,Wisconsin,2004,8973,10375,206,19554,0.4588830929733047,0.5305819781118952,0.01053492891480004,1513,-452,2158,3219,0.0021949999215752913,-0.029746675003167515,0.027551675081592175,-1402,-645,-0.07169888513859052,-0.025356675160016884
15296,55081,Monroe,Wisconsin,2008,10198,8666,288,19152,0.5324770258980785,0.45248538011695905,0.015037593984962405,1225,82,-1709,-402,0.07359393292477384,0.004502665070162365,-0.07809659799493618,1532,2934,0.0799916457811195,0.15169053091971002
15297,55081,Monroe,Wisconsin,2012,9515,9675,290,19480,0.48844969199178645,0.49666324435318276,0.014887063655030801,-683,2,1009,328,-0.0440273339062921,-0.00015053032993160402,0.04417786423622372,-160,-1692,-0.008213552361396315,-0.08820519814251582
15298,55081,Monroe,Wisconsin,2016,7052,11356,1291,19699,0.35798771511244226,0.5764759632468653,0.06553632164069242,-2463,1001,1681,219,-0.1304619768793442,0.050649257985661625,0.07981271889368258,-4304,-4144,-0.21848824813442308,-0.21027469577302677
15299,55083,Oconto,Wisconsin,2000,7260,8706,630,16596,0.4374548083875633,0.5245842371655821,0.03796095444685466,0,0,0,0,0.0,0.0,0.0,-1446,0,-0.08712942877801882,0.0
15300,55083,Oconto,Wisconsin,2004,8534,11043,217,19794,0.431140749722138,0.5578963322218854,0.010962918055976559,1274,-413,2337,3198,-0.006314058665425282,-0.026998036390878104,0.03331209505630328,-2509,-1063,-0.1267555824997474,-0.03962615372172856
15301,55083,Oconto,Wisconsin,2008,9927,8755,286,18968,0.5233551244200759,0.46156684943062,0.015078026149304091,1393,69,-2288,-826,0.09221437469793792,0.0041151080933275325,-0.09632948279126541,1172,3681,0.06178827498945594,0.18854385748920333
15302,55083,Oconto,Wisconsin,2012,8865,10741,252,19858,0.44641957901097795,0.5408903212810958,0.012690099707926276,-1062,-34,1986,890,-0.07693554540909797,-0.002387926441377815,0.07932347185047584,-1876,-3048,-0.09447074227011787,-0.1562590172595738
15303,55083,Oconto,Wisconsin,2016,5940,13345,921,20206,0.29397208749876275,0.6604473918638029,0.045580520637434424,-2925,669,2604,348,-0.1524474915122152,0.03289042092950815,0.11955707058270704,-7405,-5529,-0.3664753043650401,-0.27200456209492224
15304,55085,Oneida,Wisconsin,2000,8339,9512,1040,18891,0.4414271346143666,0.5035201948017575,0.05505267058387592,0,0,0,0,0.0,0.0,0.0,-1173,0,-0.06209306018739086,0.0
15305,55085,Oneida,Wisconsin,2004,10464,11351,224,22039,0.4747946821543627,0.5150415173102227,0.010163800535414493,2125,-816,1839,3148,0.0333675475399961,-0.04488887004846143,0.01152132250846527,-887,286,-0.04024683515586003,0.02184622503153083
15306,55085,Oneida,Wisconsin,2008,11907,9630,390,21927,0.5430291421535094,0.439184566972226,0.017786290874264605,1443,166,-1721,-112,0.06823445999914668,0.007622490338850112,-0.07585695033799672,2277,3164,0.10384457518128337,0.1440914103371434
15307,55085,Oneida,Wisconsin,2012,10452,10917,281,21650,0.4827713625866051,0.5042494226327945,0.012979214780600462,-1455,-109,1287,-277,-0.06025777956690431,-0.004807076093664143,0.06506485566056847,-465,-2742,-0.021478060046189407,-0.12532263522747278
15308,55085,Oneida,Wisconsin,2016,8109,12132,1290,21531,0.3766197575588686,0.5634666295109377,0.05991361293019368,-2343,1009,1215,-119,-0.10615160502773646,0.046934398149593215,0.05921720687814325,-4023,-3558,-0.18684687195206912,-0.1653688119058797
15309,55087,Outagamie,Wisconsin,2000,32735,39460,3547,75742,0.4321908584404954,0.5209791133056957,0.046830028253808983,0,0,0,0,0.0,0.0,0.0,-6725,0,-0.08878825486520031,0.0
15310,55087,Outagamie,Wisconsin,2004,40169,48903,978,90050,0.4460744031093837,0.5430649639089394,0.010860632981676846,7434,-2569,9443,14308,0.013883544668888304,-0.03596939527213214,0.02208585060324375,-8734,-2009,-0.09699056079955576,-0.008202305934355447
15311,55087,Outagamie,Wisconsin,2008,50294,39677,1592,91563,0.5492830073282876,0.4333300569007132,0.0173869357709992,10125,614,-9226,1513,0.10320860421890393,0.006526302789322355,-0.10973490700822625,10617,19351,0.11595295042757442,0.21294351122713018
15312,55087,Outagamie,Wisconsin,2012,45659,47372,1560,94591,0.48269919971244624,0.500808745018025,0.016492055269528814,-4635,-32,7695,3028,-0.06658380761584137,-0.0008948805014703867,0.06747868811731178,-1713,-12330,-0.018109545305578734,-0.13406249573315315
15313,55087,Outagamie,Wisconsin,2016,38068,49879,5986,93933,0.40526758434203103,0.5310061426761628,0.06372627298180618,-7591,4426,2507,-658,-0.07743161537041521,0.047234217712277364,0.03019739765813778,-11811,-10098,-0.12573855833413172,-0.10762901302855299
15314,55089,Ozaukee,Wisconsin,2000,15030,31155,1566,47751,0.3147578061192436,0.6524470691713262,0.03279512470943017,0,0,0,0,0.0,0.0,0.0,-16125,0,-0.33768926305208263,0.0
15315,55089,Ozaukee,Wisconsin,2004,17714,34904,414,53032,0.3340247397797556,0.6581686528888219,0.007806607331422537,2684,-1152,3749,5281,0.01926693366051202,-0.024988517378007634,0.0057215837174956485,-17190,-1065,-0.32414391310906626,0.013545349943016372
15316,55089,Ozaukee,Wisconsin,2008,20579,32172,614,53365,0.3856272838002436,0.6028670476904338,0.01150566850932259,2865,200,-2732,333,0.05160254402048797,0.0036990611779000523,-0.055301605198388115,-11593,5597,-0.21723976389019017,0.10690414921887609
15317,55089,Ozaukee,Wisconsin,2012,19159,36077,574,55810,0.3432897330227558,0.646425371797169,0.010284895180075256,-1420,-40,3905,2445,-0.0423375507774878,-0.001220773329247334,0.04355832410673521,-16918,-5325,-0.3031356387744132,-0.08589587488422301
15318,55089,Ozaukee,Wisconsin,2016,20170,30464,3926,54560,0.36968475073313783,0.5583577712609971,0.0719574780058651,1011,3352,-5613,-1250,0.02639501771038205,0.06167258282578985,-0.08806760053617191,-10294,6624,-0.18867302052785923,0.11446261824655396
15319,55091,Pepin,Wisconsin,2000,1854,1631,179,3664,0.506004366812227,0.4451419213973799,0.048853711790393016,0,0,0,0,0.0,0.0,0.0,223,0,0.060862445414847144,0.0
15320,55091,Pepin,Wisconsin,2004,2181,1853,32,4066,0.5363994097393016,0.455730447614363,0.007870142646335464,327,-147,222,402,0.03039504292707451,-0.040983569144057555,0.010588526216983085,328,105,0.08066896212493857,0.019806516710091426
15321,55091,Pepin,Wisconsin,2008,2102,1616,53,3771,0.5574118271015646,0.42853354547865286,0.01405462741978255,-79,21,-237,-295,0.021012417362263003,0.006184484773447086,-0.027196902135710133,486,158,0.1288782816229117,0.048209319497973135
15322,55091,Pepin,Wisconsin,2012,1876,1794,29,3699,0.5071640984049743,0.48499594484995945,0.007839956745066235,-226,-24,178,-72,-0.05024772869659022,-0.006214670674716316,0.05646239937130659,82,-404,0.02216815355501489,-0.10671012806789681
15323,55091,Pepin,Wisconsin,2016,1344,2206,185,3735,0.3598393574297189,0.5906291834002677,0.049531459170013385,-532,156,412,36,-0.14732474097525544,0.04169150242494715,0.10563323855030826,-862,-944,-0.2307898259705488,-0.2529579795255637
15324,55093,Pierce,Wisconsin,2000,8559,8169,1234,17962,0.47650595702037635,0.45479345284489475,0.06870059013472887,0,0,0,0,0.0,0.0,0.0,390,0,0.021712504175481595,0.0
15325,55093,Pierce,Wisconsin,2004,11176,10437,263,21876,0.5108795026513073,0.47709818979703783,0.012022307551654782,2617,-971,2268,3914,0.03437354563093098,-0.05667828258307409,0.02230473695214308,739,349,0.033781312854269496,0.012068808678787901
15326,55093,Pierce,Wisconsin,2008,11803,9812,492,22107,0.5339032885511377,0.4438413172298367,0.02225539421902565,627,229,-625,231,0.02302378589983034,0.010233086667370868,-0.03325687256720111,1991,1252,0.09006197132130095,0.05628065846703145
15327,55093,Pierce,Wisconsin,2012,10235,10397,388,21020,0.4869172216936251,0.49462416745956234,0.018458610846812558,-1568,-104,585,-1087,-0.046986066857512554,-0.0037967833722130917,0.05078285022972562,-162,-2153,-0.007706945765937223,-0.09776891708723817
15328,55093,Pierce,Wisconsin,2016,8399,11272,1705,21376,0.3929172904191617,0.5273203592814372,0.0797623502994012,-1836,1317,875,356,-0.09399993127446343,0.061303739452588636,0.03269619182187483,-2873,-2711,-0.1344030688622755,-0.12669612309633826
15329,55095,Polk,Wisconsin,2000,8961,9557,1244,19762,0.45344600748912056,0.4836048982896468,0.06294909422123267,0,0,0,0,0.0,0.0,0.0,-596,0,-0.03015889080052625,0.0
15330,55095,Polk,Wisconsin,2004,11173,12095,235,23503,0.4753861209207335,0.5146151555120623,0.009998723567204187,2212,-1009,2538,3741,0.02194011343161295,-0.05295037065402848,0.03101025722241546,-922,-326,-0.03922903459132876,-0.00907014379080251
15331,55095,Polk,Wisconsin,2008,10876,11282,485,22643,0.4803250452678532,0.4982555315108422,0.021419423221304596,-297,250,-813,-860,0.0049389243471196775,0.011420699654100409,-0.016359624001220097,-406,516,-0.017930486242988986,0.021298548348339774
15332,55095,Polk,Wisconsin,2012,10073,12094,406,22573,0.44624108448146016,0.5357728259424976,0.017986089576042176,-803,-79,812,-70,-0.03408396078639303,-0.00343333364526242,0.03751729443165547,-2021,-1615,-0.08953174146103748,-0.0716012552180485
15333,55095,Polk,Wisconsin,2016,7565,13810,1370,22745,0.3326005715541877,0.6071664102000439,0.0602330182457683,-2508,964,1716,172,-0.11364051292727245,0.042246928669726125,0.07139358425754627,-6245,-4224,-0.2745658386458562,-0.18503409718481872
15334,55097,Portage,Wisconsin,2000,17942,13214,2604,33760,0.531457345971564,0.3914099526066351,0.07713270142180095,0,0,0,0,0.0,0.0,0.0,4728,0,0.14004739336492894,0.0
15335,55097,Portage,Wisconsin,2004,21861,16546,554,38961,0.561099561099561,0.424681091347758,0.014219347552680886,3919,-2050,3332,5201,0.02964221512799703,-0.06291335386912007,0.03327113874112292,5315,587,0.13641846975180305,-0.0036289236131258895
15336,55097,Portage,Wisconsin,2008,24817,13810,795,39422,0.6295215869311552,0.35031200852315963,0.02016640454568515,2956,241,-2736,461,0.06842202583159418,0.005947056993004263,-0.07436908282459836,11007,5692,0.2792095784079956,0.14279110865619254
15337,55097,Portage,Wisconsin,2012,22075,16615,644,39334,0.5612193013677734,0.42240809477805463,0.016372603854171962,-2742,-151,2805,-88,-0.0683022855633818,-0.003793800691513187,0.072096086254895,5460,-5547,0.1388112065897188,-0.1403983718182768
15338,55097,Portage,Wisconsin,2016,18529,17305,2755,38589,0.4801627406773951,0.4484438570577107,0.07139340226489414,-3546,2111,690,-745,-0.08105656069037831,0.05502079841072218,0.026035762279656094,1224,-4236,0.03171888361968439,-0.1070923229700344
15339,55099,Price,Wisconsin,2000,3413,4136,381,7930,0.430390920554855,0.52156368221942,0.048045397225725095,0,0,0,0,0.0,0.0,0.0,-723,0,-0.09117276166456495,0.0
15340,55099,Price,Wisconsin,2004,4349,4312,102,8763,0.4962912244665069,0.49206892616683784,0.011639849366655255,936,-279,176,833,0.06590030391165191,-0.03640554785906984,-0.029494756052582116,37,760,0.0042222982996690805,0.09539505996423403
15341,55099,Price,Wisconsin,2008,4559,3461,174,8194,0.5563827190627288,0.422382230900659,0.021235050036612156,210,72,-851,-569,0.06009149459622193,0.0095952006699569,-0.06968669526617882,1098,1061,0.13400048816206983,0.12977818986240075
15342,55099,Price,Wisconsin,2012,3887,3884,130,7901,0.49196304265282875,0.49158334388052144,0.01645361346664979,-672,-44,423,-293,-0.0644196764099001,-0.0047814365699623655,0.06920111297986242,3,-1095,0.0003796987723073131,-0.13362078938976252
15343,55099,Price,Wisconsin,2016,2667,4559,342,7568,0.35240486257928116,0.6024048625792812,0.04519027484143763,-1220,212,675,-333,-0.1395581800735476,0.02873666137478784,0.11082151869875972,-1892,-1895,-0.25,-0.2503796987723073
15344,55101,Racine,Wisconsin,2000,41563,44014,3288,88865,0.4677094469138581,0.4952906093512632,0.03699994373487875,0,0,0,0,0.0,0.0,0.0,-2451,0,-0.027581162437405105,0.0
15345,55101,Racine,Wisconsin,2004,48229,52456,884,101569,0.4748397641012514,0.5164567929190993,0.008703442979649303,6666,-2404,8442,12704,0.00713031718739332,-0.028296500755229444,0.021166183567836117,-4227,-1776,-0.0416170288178479,-0.014035866380442796
15346,55101,Racine,Wisconsin,2008,53408,45954,1280,100642,0.5306730788338865,0.45660857296158663,0.012718348204526938,5179,396,-6502,-927,0.055833314732635086,0.004014905224877635,-0.05984821995751266,7454,11681,0.07406450587229985,0.11568153469014775
15347,55101,Racine,Wisconsin,2012,53008,49347,989,103344,0.512927697786035,0.47750232234091966,0.009569979873045363,-400,-291,3393,2702,-0.017745381047851505,-0.003148368331481575,0.020893749379333026,3661,-3793,0.035425375445115315,-0.03863913042718453
15348,55101,Racine,Wisconsin,2016,42641,46681,4980,94302,0.4521749273610316,0.49501601238573945,0.052809060253228984,-10367,3991,-2666,-9042,-0.06075277042500338,0.04323908038018362,0.017513690044819785,-4040,-7701,-0.04284108502470785,-0.07826646046982316
15349,55103,Richland,Wisconsin,2000,3837,3994,462,8293,0.4626793681418063,0.48161099722657663,0.055709634631617024,0,0,0,0,0.0,0.0,0.0,-157,0,-0.018931629084770307,0.0
15350,55103,Richland,Wisconsin,2004,4501,4836,83,9420,0.4778131634819533,0.513375796178344,0.00881104033970276,664,-379,842,1127,0.015133795340146972,-0.046898594291914265,0.031764798951767315,-335,-178,-0.03556263269639065,-0.016631003611620343
15351,55103,Richland,Wisconsin,2008,5041,3298,111,8450,0.5965680473372781,0.3902958579881657,0.013136094674556212,540,28,-1538,-970,0.11875488385532479,0.004325054334853452,-0.12307993819017826,1743,2078,0.2062721893491124,0.24183482204550305
15352,55103,Richland,Wisconsin,2012,4969,3573,113,8655,0.5741190063547083,0.4128249566724437,0.013056036972848064,-72,2,275,205,-0.022449040982569834,-8.005770170814788e-05,0.022529098684277993,1396,-347,0.16129404968226457,-0.04497813966684783
15353,55103,Richland,Wisconsin,2016,3569,4013,487,8069,0.44231007559796753,0.4973354814723014,0.06035444292973107,-1400,374,440,-586,-0.13180893075674072,0.047298405956883005,0.08451052479985771,-444,-1840,-0.055025405874333855,-0.21631945555659843
15354,55105,Rock,Wisconsin,2000,40472,27467,2465,70404,0.5748537014942333,0.39013408329072213,0.0350122152150446,0,0,0,0,0.0,0.0,0.0,13005,0,0.18471961820351118,0.0
15355,55105,Rock,Wisconsin,2004,46598,33151,730,80479,0.5790081884715267,0.41192112228034644,0.00907068924812684,6126,-1735,5684,10075,0.00415448697729337,-0.02594152596691776,0.021787038989624308,13447,442,0.16708706619118024,-0.017632552012330938
15356,55105,Rock,Wisconsin,2008,50529,27364,1276,79169,0.6382422412813096,0.34564033902158675,0.016117419697103664,3931,546,-5787,-1310,0.05923405280978289,0.007046730448976824,-0.06628078325875969,23165,9718,0.2926019022597228,0.12551483606854258
15357,55105,Rock,Wisconsin,2012,49219,30517,954,80690,0.6099764530920808,0.3782005205105961,0.011823026397323088,-1310,-322,3153,1521,-0.028265788189228758,-0.004294393299780576,0.032560181489009354,18702,-4463,0.2317759325814847,-0.06082596967823811
15358,55105,Rock,Wisconsin,2016,39339,31493,5242,76074,0.5171149144254279,0.41397849462365593,0.06890659095091621,-9880,4288,976,-4616,-0.09286153866665292,0.05708356455359312,0.03577797411305983,7846,-10856,0.10313641980177196,-0.12863951277971275
15359,55107,Rusk,Wisconsin,2000,3161,3758,447,7366,0.42913385826771655,0.5101819169155579,0.060684224816725495,0,0,0,0,0.0,0.0,0.0,-597,0,-0.08104805864784137,0.0
15360,55107,Rusk,Wisconsin,2004,3820,3985,122,7927,0.4818973129809512,0.502712249274631,0.015390437744417812,659,-325,227,561,0.052763454713234625,-0.04529378707230768,-0.007469667640926936,-165,432,-0.02081493629367981,0.06023312235416156
15361,55107,Rusk,Wisconsin,2008,3855,3253,164,7272,0.5301155115511551,0.44733223322332233,0.022552255225522552,35,42,-732,-655,0.04821819857020393,0.00716181748110474,-0.055380016051308656,602,767,0.08278327832783278,0.10359821462151259
15362,55107,Rusk,Wisconsin,2012,3397,3676,118,7191,0.4723960506188291,0.5111945487414824,0.0164094006396885,-458,-46,423,-81,-0.057719460932325994,-0.006142854585834051,0.06386231551816007,-279,-881,-0.03879849812265329,-0.12158177645048607
15363,55107,Rusk,Wisconsin,2016,2171,4564,353,7088,0.3062923250564334,0.6439051918735892,0.04980248306997743,-1226,235,888,-103,-0.16610372556239572,0.03339308243028893,0.1327106431321068,-2393,-2114,-0.3376128668171558,-0.2988143686945025
15364,55109,St. Croix,Wisconsin,2000,13077,15240,1637,29954,0.4365694064231822,0.508780129531949,0.0546504640448688,0,0,0,0,0.0,0.0,0.0,-2163,0,-0.07221072310876675,0.0
15365,55109,St. Croix,Wisconsin,2004,18784,22679,372,41835,0.44900203179156206,0.5421058921955301,0.008892076012907852,5707,-1265,7439,11881,0.012432625368379857,-0.045758388031960945,0.033325762663581115,-3895,-1732,-0.09310386040396801,-0.02089313729520126
15366,55109,St. Croix,Wisconsin,2008,21177,22837,807,44821,0.47247941812989447,0.509515628834698,0.01800495303540751,2393,435,158,2986,0.023477386338332407,0.009112877022499659,-0.03259026336083204,-1660,2235,-0.03703621070480356,0.056067649699164446
15367,55109,St. Croix,Wisconsin,2012,19910,25503,811,46224,0.43072862582208377,0.551726375908619,0.017544998269297334,-1267,4,2666,1403,-0.0417507923078107,-0.0004599547661101773,0.04221074707392092,-5593,-3933,-0.12099775008653518,-0.08396153938173162
15368,55109,St. Croix,Wisconsin,2016,17482,26222,3804,47508,0.36798012966237265,0.5519491454070893,0.08007072493053802,-2428,2993,719,1284,-0.06274849615971112,0.06252572666124068,0.00022276949847033212,-8740,-3147,-0.18396901574471664,-0.06297126565818145
15369,55111,Sauk,Wisconsin,2000,13035,11586,1032,25653,0.5081277043620629,0.4516430826803883,0.040229212957548825,0,0,0,0,0.0,0.0,0.0,1449,0,0.05648462168167462,0.0
15370,55111,Sauk,Wisconsin,2004,15708,14415,294,30417,0.5164217378439688,0.47391261465627776,0.009665647499753427,2673,-738,2829,4764,0.008294033481905938,-0.0305635654577954,0.02226953197588949,1293,-156,0.04250912318769107,-0.013975498493983551
15371,55111,Sauk,Wisconsin,2008,18617,11562,447,30626,0.6078821916019069,0.37752236661660027,0.014595441781492849,2909,153,-2853,209,0.0914604537579381,0.004929794281739421,-0.0963902480396775,7055,5762,0.23035982498530666,0.1878507017976156
15372,55111,Sauk,Wisconsin,2012,18736,12838,350,31924,0.5868938729482521,0.4021425886480391,0.010963538403708808,119,-97,1276,1298,-0.020988318653654803,-0.0036319033777840407,0.02462022203143882,5898,-1157,0.18475128430021304,-0.045608540685093624
15373,55111,Sauk,Wisconsin,2016,14690,14799,1868,31357,0.46847593838696305,0.4719520362279555,0.05957202538508148,-4046,1518,1961,-567,-0.11841793456128907,0.04860848698137267,0.06980944757991642,-109,-6007,-0.0034760978409924537,-0.1882273821412055
15374,55113,Sawyer,Wisconsin,2000,3333,3972,462,7767,0.429123213595983,0.511394360757049,0.05948242564696794,0,0,0,0,0.0,0.0,0.0,-639,0,-0.08227114716106604,0.0
15375,55113,Sawyer,Wisconsin,2004,4411,4951,91,9453,0.4666243520575479,0.5237490743679255,0.009626573574526604,1078,-371,979,1686,0.03750113846156489,-0.04985585207244134,0.012354713610876478,-540,99,-0.05712472231037763,0.02514642485068841
15376,55113,Sawyer,Wisconsin,2008,4765,4199,121,9085,0.5244909190974133,0.46219042377545405,0.013318657127132635,354,30,-752,-368,0.057866567039865424,0.003692083552606031,-0.06155865059247145,566,1106,0.06230049532195925,0.11942521763233688
15377,55113,Sawyer,Wisconsin,2012,4486,4442,97,9025,0.49706371191135734,0.4921883656509695,0.01074792243767313,-279,-24,243,-60,-0.027427207186055957,-0.002570734689459505,0.029997941875515466,44,-522,0.004875346260387825,-0.05742514906157142
15378,55113,Sawyer,Wisconsin,2016,3503,5185,449,9137,0.3833862318047499,0.5674729123344643,0.049140855860785815,-983,352,743,112,-0.11367748010660744,0.03839293342311269,0.07528454668349477,-1682,-1726,-0.18408668052971439,-0.1889620267901022
15379,55115,Shawano,Wisconsin,2000,7335,9548,720,17603,0.4166903368743964,0.5424075441686076,0.04090211895699597,0,0,0,0,0.0,0.0,0.0,-2213,0,-0.1257172072942112,0.0
15380,55115,Shawano,Wisconsin,2004,8657,12150,192,20999,0.41225772655840753,0.5785989809038525,0.009143292537739892,1322,-528,2602,3396,-0.00443261031598885,-0.03175882641925608,0.03619143673524494,-3493,-1280,-0.166341254345445,-0.04062404705123379
15381,55115,Shawano,Wisconsin,2008,10259,9538,292,20089,0.5106774851909005,0.47478719697346805,0.01453531783563144,1602,100,-2612,-910,0.09841975863249297,0.005392025297891548,-0.10381178393038448,721,4214,0.03589028821743245,0.20223154256287745
15382,55115,Shawano,Wisconsin,2012,9000,11022,257,20279,0.44380886631490707,0.5435179249469895,0.012673208738103457,-1259,-35,1484,190,-0.06686861887599344,-0.001862109097527983,0.06873072797352142,-2022,-2743,-0.0997090586320824,-0.13559934684951486
15383,55115,Shawano,Wisconsin,2016,6068,12769,973,19810,0.30630994447248866,0.6445734477536598,0.049116607773851594,-2932,716,1747,-469,-0.1374989218424184,0.036443399035748135,0.1010555228066703,-6701,-4679,-0.3382635032811711,-0.2385544446490887
15384,55117,Sheboygan,Wisconsin,2000,23569,29648,1984,55201,0.42696690277350047,0.5370917193529102,0.035941377873589246,0,0,0,0,0.0,0.0,0.0,-6079,0,-0.11012481657940976,0.0
15385,55117,Sheboygan,Wisconsin,2004,27608,34458,559,62625,0.44084630738522956,0.5502275449101797,0.008926147704590819,4039,-1425,4810,7424,0.013879404611729096,-0.027015230168998428,0.013135825557269443,-6850,-771,-0.1093812375249501,0.0007435790544596532
15386,55117,Sheboygan,Wisconsin,2008,30395,30801,911,62107,0.489397330413641,0.49593443573188206,0.01466823385447695,2787,352,-3657,-518,0.04855102302841141,0.005742086149886132,-0.054293109178297605,-406,6444,-0.006537105318241088,0.10284413220670902
15387,55117,Sheboygan,Wisconsin,2012,27918,34072,654,62644,0.4456611966030266,0.543898857033395,0.010439946363578315,-2477,-257,3271,537,-0.043736133810614364,-0.004228287490898635,0.04796442130151296,-6154,-5748,-0.09823766043036841,-0.09170055511212732
15388,55117,Sheboygan,Wisconsin,2016,23000,32514,4252,59766,0.38483418666131247,0.5440216845698224,0.07114412876886524,-4918,3598,-1558,-2878,-0.06082700994171414,0.060704182405286924,0.000122827536427339,-9514,-3360,-0.1591874979085099,-0.06094983747814148
15389,55119,Taylor,Wisconsin,2000,3254,5278,460,8992,0.36187722419928825,0.5869661921708185,0.05115658362989324,0,0,0,0,0.0,0.0,0.0,-2024,0,-0.22508896797153022,0.0
15390,55119,Taylor,Wisconsin,2004,3829,5582,132,9543,0.40123650843550246,0.5849313633029446,0.013832128261552971,575,-328,304,551,0.03935928423621421,-0.03732445536834027,-0.0020348288678738724,-1753,271,-0.18369485486744214,0.04139411310408808
15391,55119,Taylor,Wisconsin,2008,4563,4586,197,9346,0.48823025893430344,0.49069120479349454,0.021078536272202013,734,65,-996,-197,0.08699375049880098,0.007246408010649042,-0.09424015850945006,-23,1730,-0.0024609458591910993,0.18123390900825104
15392,55119,Taylor,Wisconsin,2012,3763,5601,148,9512,0.395605550883095,0.5888351555929352,0.015559293523969722,-800,-49,1015,166,-0.09262470805120843,-0.005519242748232291,0.09814395079944066,-1838,-1815,-0.19322960470984019,-0.1907686588506491
15393,55119,Taylor,Wisconsin,2016,2393,6579,499,9471,0.252666033153838,0.6946468165980361,0.052687150248125855,-1370,351,978,-41,-0.142939517729257,0.03712785672415613,0.10581166100510087,-4186,-2348,-0.44198078344419806,-0.24875117873435787
15394,55121,Trempealeau,Wisconsin,2000,6678,5002,488,12168,0.5488165680473372,0.41107823800131493,0.040105193951347796,0,0,0,0,0.0,0.0,0.0,1676,0,0.13773833004602232,0.0
15395,55121,Trempealeau,Wisconsin,2004,8075,5878,109,14062,0.5742426397383018,0.41800597354572605,0.0077513867159721235,1397,-379,876,1894,0.025426071690964558,-0.032353807235375676,0.006927735544411118,2197,521,0.15623666619257576,0.01849833614655344
15396,55121,Trempealeau,Wisconsin,2008,8321,4808,185,13314,0.6249812227730209,0.3611236292624305,0.013895147964548596,246,76,-1070,-748,0.05073858303471912,0.006143761248576472,-0.05688234428329553,3513,1316,0.2638575935105904,0.10762092731801465
15397,55121,Trempealeau,Wisconsin,2012,7605,5707,169,13481,0.5641272902603665,0.42333654773384766,0.01253616200578592,-716,-16,899,167,-0.060853932512654474,-0.0013589859587626752,0.062212918471417133,1898,-1615,0.1407907425265188,-0.12306685098407161
15398,55121,Trempealeau,Wisconsin,2016,5636,7366,685,13687,0.41177759918170526,0.5381749104990137,0.05004749031928107,-1969,516,1659,206,-0.1523496910786612,0.03751132831349514,0.11483836276516601,-1730,-3628,-0.12639731131730841,-0.2671880538438272
15399,55123,Vernon,Wisconsin,2000,6577,5684,783,13044,0.5042164980067464,0.43575590309720946,0.06002759889604416,0,0,0,0,0.0,0.0,0.0,893,0,0.06846059490953693,0.0
15400,55123,Vernon,Wisconsin,2004,7924,6774,147,14845,0.5337824183226676,0.45631525766251263,0.009902324014819804,1347,-636,1090,1801,0.0295659203159212,-0.050125274881224355,0.020559354565303167,1150,257,0.07746716066015497,0.009006565750618034
15401,55123,Vernon,Wisconsin,2008,8463,5367,245,14075,0.6012788632326821,0.3813143872113677,0.017406749555950268,539,98,-1407,-770,0.0674964449100145,0.007504425541130464,-0.07500087045114495,3096,1946,0.21996447602131441,0.14249731536115945
15402,55123,Vernon,Wisconsin,2012,8044,5942,283,14269,0.5637395753031046,0.41642721984722125,0.01983320484967412,-419,38,575,194,-0.0375392879295775,0.0024264552937238518,0.035112832635853575,2102,-994,0.14731235545588334,-0.07265212056543108
15403,55123,Vernon,Wisconsin,2016,6371,7004,900,14275,0.4463047285464098,0.4906479859894921,0.06304728546409807,-1673,617,1062,6,-0.1174348467566948,0.04321408061442396,0.07422076614227086,-633,-2735,-0.04434325744308232,-0.19165561289896565
15404,55125,Vilas,Wisconsin,2000,4706,6958,658,12322,0.3819185197208245,0.5646810582697614,0.053400422009414056,0,0,0,0,0.0,0.0,0.0,-2252,0,-0.18276253854893693,0.0
15405,55125,Vilas,Wisconsin,2004,5713,8155,134,14002,0.40801314097986,0.5824167976003428,0.009570061419797172,1007,-524,1197,1680,0.0260946212590355,-0.04383036058961688,0.017735739330581368,-2442,-190,-0.1744036566204828,0.008358881928454132
15406,55125,Vilas,Wisconsin,2008,6491,7055,204,13750,0.47207272727272725,0.513090909090909,0.014836363636363637,778,70,-1100,-252,0.06405958629286723,0.005266302216566465,-0.06932588850943378,-564,1878,-0.04101818181818179,0.133385474802301
15407,55125,Vilas,Wisconsin,2012,5951,7749,142,13842,0.4299234214708857,0.5598179453836151,0.010258633145499206,-540,-62,694,92,-0.04214930580184156,-0.004577730490864431,0.046727036292706026,-1798,-1234,-0.12989452391272938,-0.08887634209454759
15408,55125,Vilas,Wisconsin,2016,4770,8166,675,13611,0.3504518404231871,0.5999559180074939,0.049592241569318934,-1181,533,417,-231,-0.07947158104769858,0.03933360842381973,0.04013797262387886,-3396,-1598,-0.24950407758430682,-0.11960955367157744
15409,55127,Walworth,Wisconsin,2000,15492,22982,1984,40458,0.38291561619457215,0.5680458747342924,0.0490385090711355,0,0,0,0,0.0,0.0,0.0,-7490,0,-0.1851302585397202,0.0
15410,55127,Walworth,Wisconsin,2004,19177,28754,515,48446,0.3958427940387235,0.5935268133592041,0.01063039260207241,3685,-1469,5772,7988,0.012927177844151372,-0.03840811646906309,0.025480938624911742,-9577,-2087,-0.19768401932048058,-0.01255376078076037
15411,55127,Walworth,Wisconsin,2008,24177,25485,760,50422,0.4794930784181508,0.5054341358930625,0.01507278568878664,5000,245,-3269,1976,0.08365028437942729,0.004442393086714231,-0.08809267746614158,-1308,8269,-0.02594105747491171,0.17174296184556886
15412,55127,Walworth,Wisconsin,2012,22552,29006,745,52303,0.4311798558400092,0.5545762193373229,0.014243924822667916,-1625,-15,3521,1881,-0.048313222578141635,-0.0008288608661187243,0.04914208344426041,-6454,-5146,-0.12339636349731375,-0.09745530602240204
15413,55127,Walworth,Wisconsin,2016,18710,28863,3818,51391,0.3640715300344418,0.5616353057928432,0.07429316417271507,-3842,3073,-143,-912,-0.06710832580556736,0.060049239350047155,0.007059086455520225,-10153,-3699,-0.19756377575840134,-0.07416741226108758
15414,55129,Washburn,Wisconsin,2000,3695,3912,438,8045,0.4592914853946551,0.4862647607209447,0.05444375388440025,0,0,0,0,0.0,0.0,0.0,-217,0,-0.026973275326289625,0.0
15415,55129,Washburn,Wisconsin,2004,4705,4762,100,9567,0.49179471098567995,0.49775269154384866,0.010452597470471413,1010,-338,850,1522,0.032503225591024865,-0.04399115641392884,0.011487930822903947,-57,160,-0.005957980558168707,0.021015294768120918
15416,55129,Washburn,Wisconsin,2008,4693,4303,116,9112,0.5150351185250219,0.4722344161545215,0.012730465320456541,-12,16,-459,-455,0.02324040753934198,0.0022778678499851285,-0.02551827538932716,390,447,0.04280070237050043,0.04875868292866914
15417,55129,Washburn,Wisconsin,2012,4447,4699,141,9287,0.4788413911919888,0.5059760956175299,0.015182513190481318,-246,25,396,175,-0.03619372733303311,0.0024520478700247768,0.03374167946300838,-252,-642,-0.027134704425541056,-0.06993540679604149
15418,55129,Washburn,Wisconsin,2016,3282,5436,475,9193,0.35701076906341783,0.5913194822147286,0.051669748721853585,-1165,334,737,-94,-0.12183062212857099,0.036487235531372265,0.08534338659719876,-2154,-1902,-0.2343087131513108,-0.20717400872576974
15419,55131,Washington,Wisconsin,2000,18115,41162,2135,61412,0.2949749234677262,0.6702598840617469,0.03476519247052693,0,0,0,0,0.0,0.0,0.0,-23047,0,-0.37528496059402067,0.0
15420,55131,Washington,Wisconsin,2004,21234,50641,592,72467,0.29301613148053596,0.6988146328673741,0.008169235652089917,3119,-1543,9479,11055,-0.0019587919871902337,-0.026595956818437013,0.02855474880562725,-29407,-6360,-0.40579850138683815,-0.030513540792817484
15421,55131,Washington,Wisconsin,2008,25719,47729,963,74411,0.345634382013412,0.6414239830132642,0.012941634973323837,4485,371,-2912,1944,0.052618250532876054,0.00477239932123392,-0.05739064985410991,-22010,7397,-0.2957896009998522,0.11000890038698596
15422,55131,Washington,Wisconsin,2012,23166,54765,805,78736,0.2942237350132087,0.6955522251574883,0.010224039829302986,-2553,-158,7036,4325,-0.05141064700020331,-0.0027175951440208505,0.05412824214422407,-31599,-9589,-0.40132849014427957,-0.10553888914442738
15423,55131,Washington,Wisconsin,2016,20852,51740,4165,76757,0.27166251937934,0.6740753286345219,0.054262151986138075,-2314,3360,-3025,-1979,-0.022561215633868703,0.04403811215683509,-0.02147689652296636,-30888,711,-0.4024128092551819,-0.0010843191109023431
15424,55133,Waukesha,Wisconsin,2000,64319,133105,6310,203734,0.31570086485319093,0.6533273778554389,0.03097175729137012,0,0,0,0,0.0,0.0,0.0,-68786,0,-0.337626513002248,0.0
15425,55133,Waukesha,Wisconsin,2004,73626,154926,1811,230363,0.3196086177033638,0.6725298767597226,0.00786150553691348,9307,-4499,21821,26629,0.003907752850172863,-0.02311025175445664,0.019202498904283716,-81300,-12514,-0.35292125905635885,-0.015294746054110853
15426,55133,Waukesha,Wisconsin,2008,85339,145152,2406,232897,0.3664237839044728,0.6232454690270807,0.010330747068446567,11713,595,-9774,2534,0.04681516620110898,0.002469241531533087,-0.04928440773264198,-59813,21487,-0.2568216851226079,0.09609957393375096
15427,55133,Waukesha,Wisconsin,2012,78779,162798,2278,243855,0.32305673453486705,0.6676016485206373,0.009341616944495704,-6560,-128,17646,10958,-0.043367049369605726,-0.000989130123950863,0.044356179493556636,-84019,-24206,-0.34454491398577025,-0.08772322886316236
15428,55133,Waukesha,Wisconsin,2016,79224,142543,15826,237593,0.3334441671261359,0.5999461263589415,0.06660970651492258,445,13548,-20255,-6262,0.010387432591268841,0.05726808957042688,-0.06765552216169579,-63319,20700,-0.2665019592328056,0.07804295475296463
15429,55135,Waupaca,Wisconsin,2000,8787,12980,1037,22804,0.38532713559024734,0.5691983862480267,0.04547447816172601,0,0,0,0,0.0,0.0,0.0,-4193,0,-0.18387125065777932,0.0
15430,55135,Waupaca,Wisconsin,2004,10792,15941,241,26974,0.4000889745681026,0.5909764958849262,0.008934529546971158,2005,-796,2961,4170,0.014761838977855268,-0.036539948614754854,0.021778109636899523,-5149,-956,-0.19088752131682357,-0.007016270659044255
15431,55135,Waupaca,Wisconsin,2008,12952,12232,327,25511,0.507702559680138,0.4794794402414645,0.012818000078397554,2160,86,-3709,-1463,0.10761358511203539,0.003883470531426396,-0.11149705564346168,720,5869,0.028223119438673505,0.21911064075549708
15432,55135,Waupaca,Wisconsin,2012,11578,14002,256,25836,0.4481343861278836,0.5419569592816226,0.009908654590493884,-1374,-71,1770,325,-0.05956817355225441,-0.0029093454879036695,0.06247751904015808,-2424,-3144,-0.09382257315373899,-0.12204569259241249
15433,55135,Waupaca,Wisconsin,2016,8451,16209,1435,26095,0.32385514466372867,0.621153477677716,0.05499137765855528,-3127,1179,2207,259,-0.12427924146415492,0.045082723068061395,0.07919651839609343,-7758,-5334,-0.29729833301398734,-0.20347575986024835
15434,55137,Waushara,Wisconsin,2000,4239,5571,438,10248,0.4136416861826698,0.5436182669789227,0.04274004683840749,0,0,0,0,0.0,0.0,0.0,-1332,0,-0.1299765807962529,0.0
15435,55137,Waushara,Wisconsin,2004,5257,6888,101,12246,0.42928303119385924,0.5624693777560019,0.00824759105013882,1018,-337,1317,1998,0.015641345011189467,-0.03449245578826867,0.01885111077707924,-1631,-299,-0.13318634656214268,-0.0032097657658897716
15436,55137,Waushara,Wisconsin,2008,5868,5770,211,11849,0.49523166511941935,0.48696092497257154,0.017807409908009116,611,110,-1118,-397,0.06594863392556011,0.009559818857870295,-0.07550845278343038,98,1729,0.00827074014684781,0.1414570867089905
15437,55137,Waushara,Wisconsin,2012,5335,6562,151,12048,0.4428120849933599,0.5446547144754316,0.012533200531208499,-533,-60,792,199,-0.05241958012605946,-0.005274209376800617,0.05769378950286003,-1227,-1325,-0.10184262948207168,-0.11011336962891949
15438,55137,Waushara,Wisconsin,2016,3791,7667,616,12074,0.31398045386781515,0.6350008282259401,0.05101871790624482,-1544,465,1105,26,-0.12883163112554474,0.03848551737503632,0.0903461137505085,-3876,-2649,-0.3210203743581249,-0.21917774487605324
15439,55139,Winnebago,Wisconsin,2000,33983,38330,3767,76080,0.4466745531019979,0.5038117770767613,0.0495136698212408,0,0,0,0,0.0,0.0,0.0,-4347,0,-0.057137223974763396,0.0
15440,55139,Winnebago,Wisconsin,2004,40943,46542,1111,88596,0.4621314732042079,0.5253284572666937,0.012540069529098379,6960,-2656,8212,12516,0.015456920102210003,-0.036973600292142424,0.02151668018993247,-5599,-1252,-0.06319698406248586,-0.0060597600877224655
15441,55139,Winnebago,Wisconsin,2008,48167,37946,1564,87677,0.5493687055898354,0.4327930928293623,0.017838201580802262,7224,453,-8596,-919,0.08723723238562753,0.005298132051703883,-0.09253536443733146,10221,15820,0.11657561276047312,0.17977259682295899
15442,55139,Winnebago,Wisconsin,2012,45449,42122,1593,89164,0.5097236552868871,0.4724103898434346,0.017865954869678347,-2718,29,4176,1487,-0.03964505030294829,2.7753288876084664e-05,0.039617297014072295,3327,-6894,0.03731326544345254,-0.07926234731702059
15443,55139,Winnebago,Wisconsin,2016,37047,43445,6643,87135,0.4251678430022379,0.4985941355368107,0.07623802146095139,-8402,5050,1323,-2029,-0.0845558122846492,0.058372066591273045,0.026183745693376115,-6398,-9725,-0.07342629253457278,-0.11073955797802532
15444,55141,Wood,Wisconsin,2000,15936,17803,2022,35761,0.4456251223399793,0.49783283465227485,0.05654204300774587,0,0,0,0,0.0,0.0,0.0,-1867,0,-0.05220771231229554,0.0
15445,55141,Wood,Wisconsin,2004,18950,20592,529,40071,0.4729105837139078,0.5138878490679045,0.013201567218187717,3014,-1493,2789,4310,0.02728546137392851,-0.04334047578955815,0.016055014415629676,-1642,225,-0.040977265353996706,0.011230446958298834
15446,55141,Wood,Wisconsin,2008,21710,16581,761,39052,0.5559254327563249,0.42458772918160403,0.019486838062071084,2760,232,-4011,-1019,0.08301484904241707,0.006285270843883367,-0.08930011988630049,5129,6771,0.13133770357472085,0.17231496892871756
15447,55141,Wood,Wisconsin,2012,18581,19704,613,38898,0.4776852280322896,0.5065556069720808,0.015759164995629595,-3129,-148,3123,-154,-0.07824020472403531,-0.0037276730664414885,0.08196787779047676,-1123,-6252,-0.02887037893979122,-0.16020808251451207
15448,55141,Wood,Wisconsin,2016,14225,21498,2095,37818,0.376143635305939,0.5684594637474218,0.05539690094663917,-4356,1482,1794,-1080,-0.1015415927263506,0.03963773595100957,0.06190385677534105,-7273,-6150,-0.19231582844148287,-0.16344544950169165
15449,56001,Albany,Wyoming,2000,5069,7814,1268,14151,0.35820790050173135,0.552187124584835,0.08960497491343368,0,0,0,0,0.0,0.0,0.0,-2745,0,-0.19397922408310364,0.0
15450,56001,Albany,Wyoming,2004,7117,9006,501,16624,0.4281159769008662,0.5417468719923003,0.030137151106833494,2048,-767,1192,2473,0.06990807639913488,-0.059467823806600185,-0.010440252592534671,-1889,856,-0.11363089509143409,0.08034832899166955
15451,56001,Albany,Wyoming,2008,8644,7936,537,17117,0.5049950341765497,0.46363264590757725,0.03137231991587311,1527,36,-1070,493,0.07687905727568345,0.0012351688090396148,-0.07811422608472307,708,2597,0.04136238826897243,0.15499328336040652
15452,56001,Albany,Wyoming,2012,7458,7866,976,16300,0.45754601226993863,0.48257668711656443,0.059877300613496935,-1186,439,-70,-817,-0.047449021906611044,0.028504980697623826,0.018944041208987183,-408,-1116,-0.0250306748466258,-0.06639306311559823
15453,56001,Albany,Wyoming,2016,6890,7602,2568,17060,0.40386869871043374,0.4456037514654162,0.15052754982415006,-568,1592,-264,760,-0.05367731355950489,0.09065024921065312,-0.03697293565114823,-712,-304,-0.04173505275498246,-0.01670437790835666
15454,56003,Big Horn,Wyoming,2000,1004,3720,194,4918,0.2041480276535177,0.7564050427002846,0.03944692964619764,0,0,0,0,0.0,0.0,0.0,-2716,0,-0.5522570150467669,0.0
15455,56003,Big Horn,Wyoming,2004,960,4232,91,5283,0.18171493469619535,0.8010600037857278,0.01722506151807685,-44,-103,512,365,-0.022433092957322348,-0.022221868128120794,0.0446549610854432,-3272,-556,-0.6193450690895325,-0.06708805404276552
15456,56003,Big Horn,Wyoming,2008,1108,4045,157,5310,0.20866290018832392,0.7617702448210922,0.029566854990583803,148,66,-187,27,0.02694796549212858,0.012341793472506954,-0.0392897589646356,-2937,335,-0.5531073446327683,0.06623772445676412
15457,56003,Big Horn,Wyoming,2012,868,4285,171,5324,0.16303531179564237,0.8048459804658151,0.03211870773854245,-240,14,240,14,-0.04562758839268155,0.00255185274795865,0.04307573564472289,-3417,-480,-0.6418106686701728,-0.08870332403740444
15458,56003,Big Horn,Wyoming,2016,604,4067,646,5317,0.1135978935489938,0.764905021628738,0.1214970848222682,-264,475,-218,-7,-0.04943741824664857,0.08937837708372576,-0.039940958837077156,-3463,-46,-0.6513071280797442,-0.009496459409571445
15459,56005,Campbell,Wyoming,2000,1967,10203,370,12540,0.15685805422647528,0.8136363636363636,0.029505582137161084,0,0,0,0,0.0,0.0,0.0,-8236,0,-0.6567783094098884,0.0
15460,56005,Campbell,Wyoming,2004,2464,12415,220,15099,0.16318961520630507,0.8222398834359891,0.014570501357705809,497,-150,2212,2559,0.006331560979829787,-0.014935080779455275,0.00860351979962548,-9951,-1715,-0.659050268229684,-0.002271958819795694
15461,56005,Campbell,Wyoming,2008,2990,13011,319,16320,0.18321078431372548,0.7972426470588235,0.01954656862745098,526,99,596,1221,0.02002116910742041,0.004976067269745171,-0.024997236377165555,-10021,-70,-0.614031862745098,0.04501840548458602
15462,56005,Campbell,Wyoming,2012,2163,14953,455,17571,0.1231005634283763,0.851004496044619,0.025894940527004723,-827,136,1942,1251,-0.060110220885349175,0.0063483718995537425,0.0537618489857955,-12790,-2769,-0.7279039326162428,-0.11387206987114473
15463,56005,Campbell,Wyoming,2016,1324,15778,1097,18199,0.07275125006868509,0.8669707126765207,0.06027803725479422,-839,642,825,628,-0.050349313359691214,0.0343830967277895,0.015966216631901675,-14454,-1664,-0.7942194626078356,-0.06631552999159285
15464,56007,Carbon,Wyoming,2000,2206,4498,264,6968,0.3165901262916188,0.6455223880597015,0.03788748564867968,0,0,0,0,0.0,0.0,0.0,-2292,0,-0.3289322617680827,0.0
15465,56007,Carbon,Wyoming,2004,2158,4758,161,7077,0.3049314681362159,0.672318779143705,0.02274975272007913,-48,-103,260,109,-0.011658658155402901,-0.015137732928600548,0.026796391084003446,-2600,-308,-0.36738731100748906,-0.03845504923940635
15466,56007,Carbon,Wyoming,2008,2336,4331,187,6854,0.340822877152028,0.6318937846512985,0.027283338196673477,178,26,-427,-223,0.035891409015812115,0.004533585476594347,-0.04042499449240644,-1995,605,-0.2910709074992705,0.07631640350821856
15467,56007,Carbon,Wyoming,2012,2110,4148,251,6509,0.3241665386388078,0.6372714702719312,0.038561991089261026,-226,64,-183,-345,-0.016656338513220237,0.01127865289258755,0.005377685620632677,-2038,-43,-0.3131049316331234,-0.022034024133852914
15468,56007,Carbon,Wyoming,2016,1279,4409,686,6374,0.20065892689049264,0.6917163476623784,0.10762472544712896,-831,435,261,-135,-0.12350761174831515,0.06906273435786794,0.05444487739044723,-3130,-1092,-0.4910574207718858,-0.17795248913876238
15469,56009,Converse,Wyoming,2000,1076,3919,180,5175,0.20792270531400966,0.7572946859903381,0.034782608695652174,0,0,0,0,0.0,0.0,0.0,-2843,0,-0.5493719806763284,0.0
15470,56009,Converse,Wyoming,2004,1184,4447,94,5725,0.2068122270742358,0.7767685589519651,0.016419213973799127,108,-86,528,550,-0.0011104782397738655,-0.018363394721853048,0.019473872961626948,-3263,-420,-0.5699563318777292,-0.020584351201400786
15471,56009,Converse,Wyoming,2008,1380,4922,149,6451,0.21392032243063092,0.7629824833359169,0.02309719423345218,196,55,475,726,0.007108095356395117,0.0066779802596530526,-0.013786075616048166,-3542,-279,-0.5490621609052859,0.020894170972443282
15472,56009,Converse,Wyoming,2012,1089,5043,211,6343,0.17168532240264858,0.7950496610436701,0.03326501655368122,-291,62,121,-108,-0.04223500002798233,0.010167822320229041,0.03206717770775325,-3954,-412,-0.6233643386410216,-0.07430217773573566
15473,56009,Converse,Wyoming,2016,668,5520,466,6654,0.1003907424105801,0.8295761947700632,0.07003306281935678,-421,255,477,311,-0.07129457999206848,0.036768046265675564,0.03452653372639303,-4852,-898,-0.7291854523594831,-0.10582111371846148
15474,56011,Crook,Wyoming,2000,361,2289,88,2738,0.13184806428049672,0.8360116873630388,0.03214024835646457,0,0,0,0,0.0,0.0,0.0,-1928,0,-0.7041636230825421,0.0
15475,56011,Crook,Wyoming,2004,501,2836,59,3396,0.14752650176678445,0.8351001177856302,0.017373380447585393,140,-29,547,658,0.015678437486287722,-0.014766867908879176,-0.0009115695774085664,-2335,-407,-0.6875736160188457,0.0165900070636964
15476,56011,Crook,Wyoming,2008,612,2967,104,3683,0.16616888406190605,0.8055932663589465,0.028237849579147434,111,45,131,287,0.018642382295121607,0.01086446913156204,-0.029506851426683744,-2355,-20,-0.6394243822970405,0.04814923372180524
15477,56011,Crook,Wyoming,2012,426,3109,150,3685,0.11560379918588874,0.8436906377204885,0.0407055630936228,-186,46,142,2,-0.05056508487601731,0.012467713514475363,0.03809737136154201,-2683,-328,-0.7280868385345998,-0.0886624562375593
15478,56011,Crook,Wyoming,2016,273,3348,205,3826,0.07135389440669106,0.8750653423941454,0.05358076319916362,-153,55,239,141,-0.044249904779197685,0.012875200105540822,0.031374704673656884,-3075,-392,-0.8037114479874543,-0.07562460945285454
15479,56013,Fremont,Wyoming,2000,4172,10560,712,15444,0.2701372701372701,0.6837606837606838,0.0461020461020461,0,0,0,0,0.0,0.0,0.0,-6388,0,-0.41362341362341365,0.0
15480,56013,Fremont,Wyoming,2004,5338,11429,329,17096,0.3122367805334581,0.668518951801591,0.019244267664950864,1166,-383,869,1652,0.04209951039618798,-0.026857778437095237,-0.01524173195909273,-6091,297,-0.35628217126813294,0.05734124235528071
15481,56013,Fremont,Wyoming,2008,6016,11083,493,17592,0.3419736243747158,0.6300022737608003,0.028024101864483855,678,164,-346,496,0.029736843841257687,0.008779834199532991,-0.03851667804079073,-5067,1024,-0.2880286493860845,0.06825352188204842
15482,56013,Fremont,Wyoming,2012,5333,11075,531,16939,0.31483558651632326,0.6538166361650629,0.03134777731861385,-683,38,-8,-653,-0.027138037858392527,0.0033236754541299957,0.0238143624042626,-5742,-675,-0.33898104964873965,-0.05095240026265513
15483,56013,Fremont,Wyoming,2016,4200,11167,1656,17023,0.24672501909181696,0.6559948305234095,0.09728015038477354,-1133,1125,92,84,-0.0681105674245063,0.06593237306615969,0.0021781943583465413,-6967,-1225,-0.40926981143159247,-0.07028876178285282
15484,56015,Goshen,Wyoming,2000,1439,3922,159,5520,0.26068840579710145,0.7105072463768116,0.028804347826086957,0,0,0,0,0.0,0.0,0.0,-2483,0,-0.44981884057971017,0.0
15485,56015,Goshen,Wyoming,2004,1566,4114,99,5779,0.27098113860529505,0.7118878698736806,0.0171309915210244,127,-60,192,259,0.010292732808193594,-0.011673356305062558,0.0013806234968689601,-2548,-65,-0.44090673126838553,0.008912109311324634
15486,56015,Goshen,Wyoming,2008,1832,3942,138,5912,0.30987821380243574,0.6667794316644113,0.02334235453315291,266,39,-172,133,0.038897075197140696,0.006211363012128511,-0.04510843820926924,-2110,438,-0.3569012178619756,0.08400551340640994
15487,56015,Goshen,Wyoming,2012,1458,4178,170,5806,0.25111953151911814,0.719600413365484,0.029280055115397864,-374,32,236,-106,-0.0587586822833176,0.005937700582244954,0.05282098170107263,-2720,-610,-0.4684808818463658,-0.11157966398439023
15488,56015,Goshen,Wyoming,2016,924,4418,454,5796,0.15942028985507245,0.7622498274672188,0.07832988267770877,-534,284,240,-10,-0.0916992416640457,0.0490498275623109,0.04264941410173484,-3494,-774,-0.6028295376121464,-0.1343486557657806
15489,56017,Hot Springs,Wyoming,2000,544,1733,75,2352,0.23129251700680273,0.7368197278911565,0.03188775510204082,0,0,0,0,0.0,0.0,0.0,-1189,0,-0.5055272108843537,0.0
15490,56017,Hot Springs,Wyoming,2004,623,1812,45,2480,0.25120967741935485,0.7306451612903225,0.018145161290322582,79,-30,79,128,0.01991716041255212,-0.013742593811718235,-0.006174566600833931,-1189,0,-0.4794354838709677,0.026091727013386024
15491,56017,Hot Springs,Wyoming,2008,619,1834,93,2546,0.24312647289866457,0.7203456402199528,0.03652788688138256,-4,48,22,66,-0.00808320452069028,0.018382725591059978,-0.010299521070369688,-1215,-26,-0.4772191673212883,0.002216316549679409
15492,56017,Hot Springs,Wyoming,2012,523,1895,97,2515,0.20795228628230616,0.7534791252485089,0.03856858846918489,-96,4,61,-31,-0.035174186616358405,0.0020407015878023335,0.033133485028556064,-1372,-157,-0.5455268389662027,-0.06830767164491441
15493,56017,Hot Springs,Wyoming,2016,400,1939,247,2586,0.15467904098994587,0.7498066511987626,0.09551430781129157,-123,150,44,71,-0.0532732452923603,0.056945719342106675,-0.003672474049746355,-1539,-167,-0.5951276102088167,-0.04960077124261397
15494,56019,Johnson,Wyoming,2000,555,2886,109,3550,0.1563380281690141,0.8129577464788732,0.030704225352112677,0,0,0,0,0.0,0.0,0.0,-2331,0,-0.6566197183098591,0.0
15495,56019,Johnson,Wyoming,2004,676,3231,84,3991,0.16938110749185667,0.8095715359559008,0.021047356552242547,121,-25,345,441,0.013043079322842571,-0.009656868799870131,-0.0033862105229723882,-2555,-224,-0.6401904284640442,0.01642928984581493
15496,56019,Johnson,Wyoming,2008,908,3334,112,4354,0.20854386770785485,0.7657326596233348,0.02572347266881029,232,28,103,363,0.03916276021599818,0.0046761161165677426,-0.043838876332566,-2426,129,-0.55718879191548,0.08300163654856418
15497,56019,Johnson,Wyoming,2012,749,3363,147,4259,0.17586287861000235,0.7896219769899038,0.03451514440009392,-159,35,29,-95,-0.0326809890978525,0.008791671731283632,0.023889317366568963,-2614,-188,-0.6137590983799014,-0.056570306464421405
15498,56019,Johnson,Wyoming,2016,638,3477,302,4417,0.14444192891102559,0.7871858727643197,0.06837219832465474,-111,155,114,158,-0.03142094969897677,0.03385705392456082,-0.002436104225584046,-2839,-225,-0.6427439438532941,-0.02898484547339275
15499,56021,Laramie,Wyoming,2000,12162,21797,1364,35323,0.3443082410893752,0.6170766922401835,0.03861506667044136,0,0,0,0,0.0,0.0,0.0,-9635,0,-0.2727684511508083,0.0
15500,56021,Laramie,Wyoming,2004,13171,25951,757,39879,0.33027407908924494,0.6507434990847313,0.01898242182602372,1009,-607,4154,4556,-0.014034162000130246,-0.019632644844417638,0.033666806844547814,-12780,-3145,-0.32046941999548634,-0.04770096884467806
15501,56021,Laramie,Wyoming,2008,16072,24549,1004,41625,0.3861141141141141,0.5897657657657658,0.02412012012012012,2901,247,-1402,1746,0.05584003502486917,0.0051376982940964,-0.0609777333189655,-8477,4303,-0.20365165165165167,0.11681776834383467
15502,56021,Laramie,Wyoming,2012,14295,23904,1306,39505,0.36185293000885965,0.6050879635489178,0.033059106442222506,-1777,302,-645,-2120,-0.024261184105254463,0.008938986322102386,0.015322197783152025,-9609,-1132,-0.24323503354005815,-0.03958338188840649
15503,56021,Laramie,Wyoming,2016,11573,24847,4549,40969,0.28248187654079915,0.6064829505235666,0.11103517293563427,-2722,3243,943,1464,-0.0793710534680605,0.07797606649341177,0.001394986974648793,-13274,-3665,-0.32400107398276745,-0.0807660404427093
15504,56023,Lincoln,Wyoming,2000,1184,5415,246,6845,0.17297297297297298,0.7910883856829802,0.03593864134404675,0,0,0,0,0.0,0.0,0.0,-4231,0,-0.6181154127100073,0.0
15505,56023,Lincoln,Wyoming,2004,1364,6423,127,7914,0.17235279251958555,0.8115996967399545,0.016047510740459944,180,-119,1008,1069,-0.0006201804533874367,-0.019891130603586805,0.020511311056974235,-5059,-828,-0.6392469042203689,-0.021131491510361644
15506,56023,Lincoln,Wyoming,2008,1823,6485,260,8568,0.21276844070961717,0.7568860877684407,0.03034547152194211,459,133,62,654,0.04041564819003163,0.014297960781482166,-0.05471360897151378,-4662,397,-0.5441176470588235,0.09512925716154541
15507,56023,Lincoln,Wyoming,2012,1287,7144,187,8618,0.14933859364121607,0.8289626363425389,0.021698770016245067,-536,-73,659,50,-0.0634298470684011,-0.008646701505697043,0.07207654857409818,-5857,-1195,-0.6796240427013228,-0.13550639564249933
15508,56023,Lincoln,Wyoming,2016,1105,6779,991,8875,0.12450704225352113,0.7638309859154929,0.11166197183098592,-182,804,-365,257,-0.02483155138769494,0.08996320181474085,-0.06513165042704594,-5674,183,-0.6393239436619718,0.040300099039351056
15509,56025,Natrona,Wyoming,2000,8646,18439,1303,28388,0.30456530928561365,0.6495350147949838,0.04589967591940256,0,0,0,0,0.0,0.0,0.0,-9793,0,-0.3449697055093701,0.0
15510,56025,Natrona,Wyoming,2004,9863,21512,693,32068,0.30756517400523886,0.6708244979418735,0.021610328052887613,1217,-610,3073,3680,0.0029998647196252115,-0.02428934786651495,0.02128948314688972,-11649,-1856,-0.3632593239366346,-0.01828961842726451
15511,56025,Natrona,Wyoming,2008,10475,21906,886,33267,0.31487660444284127,0.6584903958878168,0.02663299966934199,612,193,394,1199,0.007311430437602406,0.0050226716164543765,-0.012334102054056717,-11431,218,-0.3436137914449755,0.019645532491659123
15512,56025,Natrona,Wyoming,2012,8961,22132,1280,32373,0.27680474469465294,0.6836561331974176,0.039539122107929446,-1514,394,226,-894,-0.03807185974818833,0.012906122438587457,0.02516573730960081,-13171,-1740,-0.40685138850276464,-0.06323759705778914
15513,56025,Natrona,Wyoming,2016,6577,23552,3219,33348,0.19722322178241575,0.7062492503298549,0.0965275278877294,-2384,1939,1420,975,-0.07958152291223719,0.05698840577979996,0.02259311713243728,-16975,-3804,-0.5090260285474391,-0.10217464004467441
15514,56027,Niobrara,Wyoming,2000,190,888,49,1127,0.16858917480035493,0.7879325643300799,0.043478260869565216,0,0,0,0,0.0,0.0,0.0,-698,0,-0.6193433895297249,0.0
15515,56027,Niobrara,Wyoming,2004,230,1064,20,1314,0.1750380517503805,0.8097412480974124,0.015220700152207,40,-29,176,187,0.006448876950025578,-0.028257560717358216,0.021808683767332582,-834,-136,-0.634703196347032,-0.015359806817307087
15516,56027,Niobrara,Wyoming,2008,244,1017,32,1293,0.18870843000773396,0.7865429234338747,0.02474864655839134,14,12,-47,-21,0.013670378257353455,0.009527946406184339,-0.023198324663537773,-773,61,-0.5978344934261407,0.03686870292089128
15517,56027,Niobrara,Wyoming,2012,200,1022,54,1276,0.15673981191222572,0.8009404388714734,0.04231974921630094,-44,22,5,-17,-0.031968618095508244,0.0175711026579096,0.014397515437598707,-822,-49,-0.6442006269592476,-0.046366133533106924
15518,56027,Niobrara,Wyoming,2016,115,1116,83,1314,0.08751902587519025,0.8493150684931506,0.06316590563165905,-85,29,94,38,-0.06922078603703546,0.020846156415358114,0.04837462962167727,-1001,-179,-0.7617960426179604,-0.11759541565871279
15519,56029,Park,Wyoming,2000,2424,9884,528,12836,0.18884387659707075,0.7700218136491118,0.04113430975381739,0,0,0,0,0.0,0.0,0.0,-7460,0,-0.5811779370520411,0.0
15520,56029,Park,Wyoming,2004,3007,10917,307,14231,0.21129927622795305,0.7671281006253953,0.021572623146651676,583,-221,1033,1395,0.022455399630882306,-0.019561686607165715,-0.0028937130237165487,-7910,-450,-0.5558288243974422,0.025349112654598938
15521,56029,Park,Wyoming,2008,3757,10839,389,14985,0.25071738405071736,0.7233233233233233,0.025959292625959293,750,82,-78,754,0.03941810782276431,0.004386669479307617,-0.043804777302071995,-7082,828,-0.4726059392726059,0.08322288512483628
15522,56029,Park,Wyoming,2012,2927,11234,447,14608,0.20036966046002191,0.7690306681270537,0.030599671412924426,-830,58,395,-377,-0.05034772359069545,0.0046403787869651325,0.0457073448037304,-8307,-1225,-0.5686610076670318,-0.09605506839442585
15523,56029,Park,Wyoming,2016,2535,11115,1445,15095,0.16793640278237826,0.7363365352765816,0.09572706194104008,-392,998,-119,487,-0.032433257677643657,0.06512739052811566,-0.03269413285047207,-8580,-273,-0.5684001324942034,0.0002608751728283565
15524,56031,Platte,Wyoming,2000,1249,2925,199,4373,0.2856162817287903,0.6688772010061742,0.04550651726503544,0,0,0,0,0.0,0.0,0.0,-1676,0,-0.3832609192773839,0.0
15525,56031,Platte,Wyoming,2004,1328,3149,97,4574,0.29033668561434195,0.6884564932225623,0.02120682116309576,79,-102,224,201,0.004720403885551672,-0.02429969610193968,0.0195792922163881,-1821,-145,-0.39811980760822036,-0.014858888330836428
15526,56031,Platte,Wyoming,2008,1407,3002,151,4560,0.30855263157894736,0.6583333333333333,0.0331140350877193,79,54,-147,-14,0.018215945964605407,0.011907213924623537,-0.03012315988922898,-1595,226,-0.34978070175438597,0.048339105853834385
15527,56031,Platte,Wyoming,2012,1223,3136,172,4531,0.26991834032222467,0.6921209446038402,0.037960715073935114,-184,21,134,-29,-0.038634291256722686,0.004846679986215817,0.03378761127050689,-1913,-318,-0.42220260428161555,-0.07242190252722958
15528,56031,Platte,Wyoming,2016,719,3437,373,4529,0.15875469198498565,0.758887171561051,0.08235813645396335,-504,201,301,-2,-0.11116364833723902,0.04439742138002824,0.0667662269572108,-2718,-805,-0.6001324795760654,-0.17792987529444987
15529,56033,Sheridan,Wyoming,2000,3330,8424,482,12236,0.27214776070611313,0.6884602811376267,0.03939195815626022,0,0,0,0,0.0,0.0,0.0,-5094,0,-0.41631252043151357,0.0
15530,56033,Sheridan,Wyoming,2004,4066,9689,274,14029,0.28982821298738326,0.690640815453703,0.01953097155891368,736,-208,1265,1793,0.01768045228127013,-0.019860986597346537,0.0021805343160763435,-5623,-529,-0.4008126024663198,0.015499917965193788
15531,56033,Sheridan,Wyoming,2008,4458,10177,346,14981,0.2975769307789867,0.6793271477204459,0.023095921500567385,392,72,488,952,0.0077487177916034655,0.003564949941653704,-0.011313667733257149,-5719,-96,-0.38175021694145916,0.019062385524860614
15532,56033,Sheridan,Wyoming,2012,3618,10267,437,14322,0.25261834939254296,0.7168691523530233,0.030512498254433737,-840,91,90,-659,-0.04495858138644376,0.007416576753866352,0.0375420046325774,-6649,-930,-0.4642508029604803,-0.08250058601902116
15533,56033,Sheridan,Wyoming,2016,2927,10266,1317,14510,0.20172294968986906,0.7075120606478291,0.09076498966230186,-691,880,-1,188,-0.0508953997026739,0.06025249140786812,-0.009357091705194165,-7339,-690,-0.5057891109579601,-0.04153830799747976
15534,56035,Sublette,Wyoming,2000,458,2624,134,3216,0.1424129353233831,0.8159203980099502,0.041666666666666664,0,0,0,0,0.0,0.0,0.0,-2166,0,-0.6735074626865671,0.0
15535,56035,Sublette,Wyoming,2004,730,2847,74,3651,0.19994522048753766,0.7797863599013969,0.02026841961106546,272,-60,223,435,0.05753228516415457,-0.021398247055601203,-0.03613403810855331,-2117,49,-0.5798411394138592,0.09366632327270796
15536,56035,Sublette,Wyoming,2008,936,3316,104,4356,0.21487603305785125,0.761248852157943,0.023875114784205693,206,30,469,705,0.01493081257031359,0.0036066951731402314,-0.018537507743453863,-2380,-263,-0.5463728191000918,0.03346832031376734
15537,56035,Sublette,Wyoming,2012,767,3472,137,4376,0.17527422303473492,0.793418647166362,0.031307129798903106,-169,33,156,20,-0.03960181002311633,0.007432015014697414,0.03216979500841899,-2705,-325,-0.6181444241316271,-0.07177160503153523
15538,56035,Sublette,Wyoming,2016,644,3409,337,4390,0.14669703872437356,0.7765375854214123,0.07676537585421413,-123,200,-63,14,-0.028577184310361353,0.04545824605531102,-0.016881061744949744,-2765,-60,-0.6298405466970387,-0.011696122565411637
15539,56037,Sweetwater,Wyoming,2000,5521,9425,745,15691,0.35185775285195336,0.6006628003314002,0.04747944681664649,0,0,0,0,0.0,0.0,0.0,-3904,0,-0.24880504747944682,0.0
15540,56037,Sweetwater,Wyoming,2004,5208,10653,411,16272,0.3200589970501475,0.6546828908554573,0.02525811209439528,-313,-334,1228,581,-0.031798755801805856,-0.02222133472225121,0.054020090524057096,-5445,-1541,-0.33462389380530977,-0.08581884632586295
15541,56037,Sweetwater,Wyoming,2008,5762,10360,581,16703,0.3449679698257798,0.6202478596659283,0.034784170508291926,554,170,-293,431,0.02490897277563231,0.009526058413896647,-0.03443503118952895,-4598,847,-0.2752798898401485,0.05934400396516126
15542,56037,Sweetwater,Wyoming,2012,4774,11428,693,16895,0.28256880733944956,0.6764131399822433,0.041018052678307194,-988,112,1068,192,-0.06239916248633026,0.006233882170015269,0.05616528031631496,-6654,-2056,-0.3938443326427937,-0.11856444280264522
15543,56037,Sweetwater,Wyoming,2016,3231,12154,1745,17130,0.18861646234676008,0.7095154699357852,0.10186806771745475,-1543,1052,726,235,-0.09395234499268948,0.06085001503914756,0.0331023299535419,-8923,-2269,-0.5208990075890251,-0.12705467494623135
15544,56039,Teton,Wyoming,2000,4019,5454,958,10431,0.3852938356821014,0.5228645383951682,0.09184162592273032,0,0,0,0,0.0,0.0,0.0,-1435,0,-0.13757070271306682,0.0
15545,56039,Teton,Wyoming,2004,5972,5124,263,11359,0.5257505062065323,0.4510960471872524,0.023153446606215336,1953,-695,-330,928,0.1404566705244309,-0.06868817931651498,-0.07176849120791584,848,2283,0.07465445901927992,0.21222516173234673
15546,56039,Teton,Wyoming,2008,7472,4565,279,12316,0.6066904839233518,0.37065605716141603,0.022653458915232218,1500,16,-559,957,0.08093997771681949,-0.0004999876909831183,-0.08043999002583635,2907,2059,0.23603442676193576,0.16137996774265584
15547,56039,Teton,Wyoming,2012,6213,4858,393,11464,0.5419574319609212,0.4237613398464759,0.03428122819260293,-1259,114,293,-852,-0.06473305196243062,0.011627769277370713,0.053105282685059874,1355,-1552,0.11819609211444526,-0.1178383346474905
15548,56039,Teton,Wyoming,2016,7314,3921,1392,12627,0.5792349726775956,0.31052506533618435,0.11023996198622,1101,999,-937,1163,0.03727754071667444,0.07595873379361708,-0.11323627451029156,3393,2038,0.26870990734141126,0.150513815226966
15549,56041,Uinta,Wyoming,2000,1650,5469,299,7418,0.222431922351038,0.7372607171744405,0.040307360474521436,0,0,0,0,0.0,0.0,0.0,-3819,0,-0.5148287948234025,0.0
15550,56041,Uinta,Wyoming,2004,1815,6081,185,8081,0.22460091572825144,0.7525058779853978,0.0228932062863507,165,-114,612,663,0.002168993377213435,-0.017414154188170737,0.015245160810957281,-4266,-447,-0.5279049622571463,-0.013076167433743846
15551,56041,Uinta,Wyoming,2008,2317,5763,303,8383,0.27639269951091494,0.687462722175832,0.03614457831325301,502,118,-318,302,0.0517917837826635,0.013251372026902311,-0.06504315580956577,-3446,820,-0.4110700226649171,0.11683493959222924
15552,56041,Uinta,Wyoming,2012,1628,6615,296,8539,0.1906546434008666,0.774680875980794,0.034664480618339384,-689,-7,852,156,-0.08573805611004834,-0.0014800976949136263,0.087218153804962,-4987,-1541,-0.5840262325799275,-0.17295620991501037
15553,56041,Uinta,Wyoming,2016,1202,6154,1114,8470,0.14191263282172373,0.7265643447461629,0.13152302243211333,-426,818,-461,-69,-0.048742010579142875,0.09685854181377396,-0.04811653123463111,-4952,35,-0.5846517119244392,-0.0006254793445117368
15554,56043,Washakie,Wyoming,2000,806,3138,107,4051,0.1989632189582819,0.7746235497408047,0.026413231300913356,0,0,0,0,0.0,0.0,0.0,-2332,0,-0.5756603307825228,0.0
15555,56043,Washakie,Wyoming,2004,855,3200,59,4114,0.20782693242586292,0.7778317938745746,0.01434127369956247,49,-48,62,63,0.008863713467581025,-0.012071957601350885,0.0032082441337698553,-2345,-13,-0.5700048614487117,0.005655469333811114
15556,56043,Washakie,Wyoming,2008,1042,2956,91,4089,0.2548300317926143,0.722915138175593,0.022254830031792613,187,32,-244,-25,0.0470030993667514,0.007913556332230143,-0.05491665569898152,-1914,431,-0.46808510638297873,0.10191975506573292
15557,56043,Washakie,Wyoming,2012,794,3014,136,3944,0.2013184584178499,0.7641987829614605,0.034482758620689655,-248,45,58,-145,-0.05351157337476442,0.012227928588897041,0.041283644785867435,-2220,-306,-0.5628803245436106,-0.09479521816063186
15558,56043,Washakie,Wyoming,2016,532,2911,371,3814,0.13948610382800208,0.7632406921866807,0.09727320398531725,-262,235,-103,-130,-0.061832354589847816,0.06279044536462759,-0.0009580907747798184,-2379,-159,-0.6237545883586786,-0.060874263815068
15559,56045,Weston,Wyoming,2000,449,2521,90,3060,0.14673202614379086,0.8238562091503268,0.029411764705882353,0,0,0,0,0.0,0.0,0.0,-2072,0,-0.6771241830065359,0.0
15560,56045,Weston,Wyoming,2004,580,2739,73,3392,0.17099056603773585,0.8074882075471698,0.02152122641509434,131,-17,218,332,0.024258539893944997,-0.007890538290788014,-0.01636800160315699,-2159,-87,-0.6364976415094339,0.04062654149710199
15561,56045,Weston,Wyoming,2008,658,2618,117,3393,0.19392867668729738,0.771588564692013,0.034482758620689655,78,44,-121,1,0.022938110649561527,0.012961532205595316,-0.03589964285515679,-1960,199,-0.5776598880047156,0.058837753504718315
15562,56045,Weston,Wyoming,2012,422,2821,116,3359,0.1256326287585591,0.8398332837153915,0.03453408752604942,-236,-1,203,-34,-0.06829604792873828,5.1328905359762644e-05,0.06824471902337848,-2399,-439,-0.7142006549568324,-0.1365407669521168
15563,56045,Weston,Wyoming,2016,299,3033,194,3526,0.08479863868406126,0.8601815087918321,0.055019852524106634,-123,78,212,167,-0.04083399007449784,0.020485764998057217,0.02034822507644063,-2734,-335,-0.7753828701077708,-0.06118221515093847
